area,date,h,id,image_url,issue_id,max_x,max_y,min_x,min_y,n_pages,ocr,ocr_url,page,page_id,paper_title,w
5331732,1851/08/13 00:00:00,4005,ddd:010923676:mpeg21:a0013,http://imageviewer.kb.nl/ImagingService/imagingService?id=ddd:010923676:mpeg21:p004:image&x=91&y=89&w=2544&h=4005,ddd:010923676:mpeg21,2635,4094,91,89,4,"NADERE OPROEPING VAN SCHULDEISCHERS. De Schuldeiscbers in het Faillissement van TEUNIS DE VROEDE Schoenmaker en Winkelier.te Legden worden Opgeroepen om op Maandag den 18den Augustus 1851 des namiddags ten één ure de nadere bijeenkomst van Schuldeiscbers hij te wonen in de Audientie-Zaal der Arrondissement Regtbank te Legden om als nog over te gaan tot de A'erificatie hunner schuldvorderingen. » - ' .. . Mr. L. C. DU RIEU Curator. Rij Vonnis van de Arrondissements-Regtbank te Legden van den llden dezer is van dien dag af verklaard le zijn in Staat van Faillissement JOHANNES HENRICUS DELFORNO Winkelier te Leyden. Tot Regier- Commissaris is benoemd Mr. J. F. PRINGLE tot Curator Mr. A. P. A. SCHMIDT. De Curator. VERANDERING VAN WOONPLAATS. De Ondergeteekende heeft de Eer zijne geëerde Regunstigers en Stadgenooten te berigten dat hij zijne FARRIEK en zijn MAGAZIJN van MEURELS thans heeft overgebragt van de Haarlemmerstraat bij de Janvossensteeg op dezelfde straat tegenover de Kcrksteeg AVijk VI. N». 452 alwaar hij zoo door de ruime woning en werkplaatsen als verfraaijing van den AVinkelstand in het bezit van eene schoone en groote sortering in staal is in dat vak tegen alle andere steden te kunnen concurreren waarbij hij zich minzaam aanbeveelt belovende eene prompte bediening. Letden 8 Augustus 1851. p. RANDOE. Door bovengemelde Verandering van AVoonplaats zijn er tot een zeer billijken prijs uit de hand te Koop: TAVEE AVINKELK.ASTEN met Glazen en Houten Schuifdeuren: de een hoog 3 EI breed 5 El 2 Palm en diep 5 Palm; de andere hoog 3EI 5 Palm breed 7 El en diep 4 Palm 5 Duim Zeer geschikt om in vier afzonderlijke deelen te splitsen. Men adressere zich met franco brieven. In een stil Rurger Huisgezin zonder Kinderen te Legden biedt zich de gelegenheid aan voor een HEER of JUFVROUAV Kost Inwoning Huiselijk verkeer en vrije Slaapkamer voor ƒBOO 's jaars. Franco Brieven Lett. «i. bij den Roekhandelaar A. A. RENSINK fireedestraat te Leyden. Burgemeester en Wethouders der Stad Legden zijn van meening met bewilliging van den Ed. Achtb. Raad in het bijzijn der Commissie van Fabricagie in het Openbaar aan te (Besteden : De jaarlijksché leverancie in Huur van de benoodigde Kagchels voor de onderscheidene Stedelijke Localen. En zulks op het Raadhuis binnen gemelde Stad op Donderdag den 14'»™"" Augustus 1851 des Voormiddags ten 12 ure. Zullende de Voorwaarden van heden af dagelijks (uitgezonderd de Zondag) ter Rekenkamer dezer Stad ter lezing liggen van 's Voormiddags ten tien tot 's Namiddags ten twee ure. Alsmede aan de Stads Timmerwerf van 's Voormiddags ten tien tot 's Namiddags ten vijf are terwijl door den Stads Architect de verlangde ophelderingen en aanwijzingen zullen worden gegeven.  Het bekende Dentifricium Anglicanum olJÈngelsch 'É'antt middel. hetwelk de vuilste en zwartste Tanden ivoor wit maakt den; worm en kalkaangroeijing belet; wegnemende alle bederf en invreting van* scheurbuik maakt tot in den hoogsten ouderdom alle Tanden en Kiezen vast mond en adem frisch en is een preservatief.. AVordt a- 70 Cents in Commissie verkocht te Leyden bij de AVed. J. A. KALDENRERG in de Maarsmansteeg; 's Hage bij Ph. AAr. SACK en Comp. en in het Hoofd-Depót te- Amsterdam bij M. van ROSSEN Leydsche Straat N°. 22. OPEINBARE TERKOOPING >$_§. In het Heeren-Logement aan den Rurg te Leyden op Zaturdag |I;Ë| den 16*len Augustus 1851 bij Opveiling en op Zaturdag den; Êja__l 23s«™ Augustus 1851 bij Afslag des Avonds ten 7 ure van: Een PAKHUIS en ERVE te Leyden aan den Ouden Rijn noordzijde. AVijk VI. N». 143 Kadaster Sectie H. N». 636 groot 52 ellen. Te bezigtigen daags vóór de A'eiling en Afslag terwijl informatiën zijn te bekomen ten Kantore van den Notaris D. N. ROSKES te Leyden alwaar na de Areiling tot en met den 22'!terl Augustus 1851 Verhoogino-en worden aangenomen tegen genot van een vijfde der Verhoocgelden. Bewonderenswaardige genezing- van een. open been na zestig jaren lijilens door de Pillen en Kalf van Holloway. het zieke been niet meer kon staan. Toen besloot hij nog'de Pillen en Zalf van Hoilowat te gebruiken na te vergeefs alle andere middelen in het werk gesteld te hebben en werkelijk heeft dit uitmuntend geneesmiddel hem zoo volkomen hersteld dat hij thans in staat is als een man van 50 jaren tcgaan. Door het vermeerderd debiet zijn de prijzen als volgt : Doosjes Pillen a ƒ0.90 ƒ2.10 ƒ3.30 ƒ7.75 ƒ15.50 ƒ2350 Potjes Zalf k f 0.90 ƒ2.10 ƒ3.30 ƒ8.15 ƒ15.90 / 23.90! Te bekomen te 's Ilertogenbosch bij J. STRAATMAN te '* Ha«e bii AV. C. tan DORT en te Gouda bij J. A. P. P. tan der HEYDEN alsmede te Londen Strand 244 Holloway's Etablissement.",http://resolver.kb.nl/resolve?urn=ddd:010923676:mpeg21:a0013:ocr,4,ddd:010923676:mpeg21:p004,Leydse courant,2544
2109632,1851/12/20 00:00:00,1939,ddd:010073123:mpeg21:a0025,http://imageviewer.kb.nl/ImagingService/imagingService?id=ddd:010073123:mpeg21:p003:image&x=1139&y=93&w=1088&h=1939,ddd:010073123:mpeg21,2227,2032,1139,93,4,"_j VERIFICATIE. Alle Crediteuren Pand- of Hypotheek hebbende daaronder begrepen ' yan de Failliete Massa van F. WELLINGHOFF Winkelier in Kruidenierswaren wonende te Amsterdam in de Oude Leliestraat worden bij deze opgeroepen tot het bywonen der 2de Verificatie van Schuldvorderingen ten laste van gemelde Massa welke onder Voorzitting van den Edel Achtb. Heer Mn. C. F. GULCHER Regter-Commissaris in i voormeld Faillissement gehouden zal worden op Donderdag den 29sten Januarij 1852 des Namiddags ten Half Twee Ure op het Palcis van Justitie Eerste Kamer. Ma. L. H. KUHN Curator (19615) Singel over de Warmocsgracht N°. 136. FAIL LI S~S~Ë""""i_ E _f tT~ De Ondergeteekenden Curators in het Faillissement van JACOB JAN STORM VAN VGEAVESANDEenvandeFirmaJ. J. en F. O. STORM VAN 's GRAVESANDE te Zutphen zullen op daartoe verleend Bevelschrift van hunnen Regter-Commissaris Jonkh-EU Mn. PIETER NICOLAAS QUARLES VAN UFFORD dd. 16 jl. overgaan tot het afleggen hunner Rekening en Verantwoording  en deze goedgekeurd wordende  daarbij tevens tot de ponds ponds gelijke uitbetaling van het Saldo op Woensdag den 31 sten December aanstaande des Morgens ten 10 ure in de Raadzaal van dc Arrondissements-Regtbank te Zutphen. Le Curators voornoemd J. L. STEENLACK. lt. A. HOLSBOEIi. (19613) H. D. MISPELBLOM BEVER. NEDEELAINjDSOHE RHIJN-SPOORWEG MAATSCHAPPIJ. RE DIRECTIE maakt bekend dat op Woensdag den __ten Deeeniber 1851 des Middags ten 12 ure aan het Station te Amsterdam bij Inschrijving zal worden AANBESTEED: DE LEVERANTIE VAN HOIJTIMATEI-lALEN BENOODIGD VOOR HET ONDERHOUD VAN DEN WEG GEDURENDE HET JAAR 1852. Het Bestek en de Voorwaarden volgens welke deze Aanbesteding zal plaats hebben ligt ter visie en is te verkrijgen aan de Stations te Amsterdam Utrecht en Arnhem en kunnen de Gegadigden verder alle inlichtingen bekomen bij den Ingenieur der Maatschappij BARON VAN REEDE VAN OUDSHOORN te Utrecht. Amsterdam B. DONKER CURTICS President 1 December 1851. Jl. C. S' JACOB Secretaris. (18815) Verzoeke dit Advertentie niet over te slaan. |aßSssf»a_> r wordt tegen Primo MeTaanstaande T E KO O P ** ""*J* gevraagd: Eene A_FAIRE welke een Burger Bestaan oplevert en des noods door eene Vrouw kan waargenomen worden. Met opgave van Ergs en van welke kwaliteit adressere men zich met Franco Brieven onder Lett. J. F. Bureau Handelsblad. (19505) -FïC.O-'SïI.BT T Ulï VE HAND TE KOOP: Een extra VIUDU_I_-_l_U_ groote zoogoed als nieuwe VISCIIZE- GËN zonder fouten bewerkt van het beste driedraads HENNEPGAREN; de Kuil ruim 20 Ellen Vierkant iedere Vleugel27s Utreehfcsche Voeten Lang en 29 Voeten Diep. Verder eene zeer goede EIKENHOUTEN VISCHSCIIUIT met dubbele BUN KOPEREN PLATEN MAST GAFFELZEIL FOK en ZWAARDEN alles Compleet en goed onderhouden. Nadere inlichtingen met Franco Brieven te bekomen en alles te zien bij den Heer W. v. OOSTEN aan de Zwemsehool te Utrecht. . (19518)",http://resolver.kb.nl/resolve?urn=ddd:010073123:mpeg21:a0025:ocr,3,ddd:010073123:mpeg21:p003,Algemeen Handelsblad,1088
18564,1851/04/04 00:00:00,52,ddd:000019931:mpeg21:a0047,http://imageviewer.kb.nl/ImagingService/imagingService?id=ddd:000019931:mpeg21:p003:image&x=3322&y=3772&w=357&h=52,ddd:000019931:mpeg21,3679,3824,3322,3772,4,HdwrUntitn.,http://resolver.kb.nl/resolve?urn=ddd:000019931:mpeg21:a0047:ocr,3,ddd:000019931:mpeg21:p003,"Nieuwe Rotterdamsche courant : staats-, handels-, nieuws- en advertentieblad",357
3899320,1851/01/28 00:00:00,2746,ddd:010583920:mpeg21:a0004,http://imageviewer.kb.nl/ImagingService/imagingService?id=ddd:010583920:mpeg21:p004:image&x=1527&y=2409&w=1420&h=2746,ddd:010583920:mpeg21,2947,5155,1527,2409,4,"STEEN HOUWER IJ. NHEERINGA Steenhouwer te Dockum maakt door deze bekend dat bij • hem alles te bekomen is wat tot genoemd vak behoort tegen billijke prijzen. Ik verklaar uit waarheidsliefde en in de hoop dat het voor anderen nuttig kunne zijn dat mijne Vrouw JANNETJE KRAAN sedert twee jaren aan eene hevige liheumatische Ziekte geleden heeft en wel zoo erg dat zij geheel si ij fen hulpeloos ook de minste buisselijke bezigheid niet konde verriaten. Zij heeft nu sedert vier weken een GOLDBERGERSCHEN KETTING gedragen dien ik bij DIRKS . in Leiden gekocht heb en is geheel weer beter. Langeraar hij Leiden  den 22 Januarij 1851. DIRK vai. der ZWAAN. DE ECHTE KETTINGEN met het Rosabandje zijn in de onderstaande De< pots te verkrijgen voor/ 180 ƒ 270 / 3.60 en f 540. Amsterdam Verkoop/mis; Akkrum  Pieter K. de Groot; Bolsward .V. 5 Oostetbnan; Dokkum A. Schaafsma ; Franeker K. Drager; Gorredijk S. G. Swart; Groningen R. Hartman J. ƒ. Lcgro Jr. en C. Rikkers ; Hindéloopeo Di.-rid de Jong ; Heeren veen G. O verdiep en Gebr. Padberg <f Comp. ; Harlingen L. P. Miranda Pz. ; Leeuwarden .V. P. Poslma; Pekel-A Gebr. Polak; . Sneek ƒ>. T. Pot ma; Veendam 5. Savenye; Winschoten G. Wasman en > verder in bijna alle andere steden van het Rijk. EENE ZWARE DOOR GAL EN GEBREK AAN SPIJSVERTEERING VEROORZAAKTE ONGESTELDHEID DOOR DE PILLEN VAN HOLLOWAY GENEZEN. Kliairatee Khau koopman te Patna in Oost-Indien  leed sedert jaren aan een galachtig gestel en gebrek aan spijsvertering en ofschoon hij de meest vermaarde geneesheeren zijner provincie raadpleegde vond hij niet alleen geene verl.gi.ng „ de door hun voorgeschreven geneesmiddelen maar gevoelde zelfs dat zijne kwaal steeds toenam. Op zekeren dag een zwaardere aanval zijner ziekte dan gewoonlijk hebbende besloot hij de Pillen van Hollowau te beproeven en dit door de geheele wereld zoo voordeelig bekende middel hersteld | hem binnen korten tnd geheel en al ; en uit dankbaarheid voor deze weldadige uitwerking deed hij de bewonderenswaardige genezing openlijk bekend maken. ' Door hel vermeerderd debiet zijn de prijzen ah volgt • RE»? Vu'r Van^ft0Q9no>/30'/3-SO./775/1550/2350. POUES ZAL! van - 090 - 210 - 3.30 - 815 -15 90 - 2390. A^JS/^ÏÏ^TtTIT' dc™tant> te bekomen aan het Hoofddepót b§ den Heer J. STRAATMAN te 's Hertogenbosch ; J. C. II van HARINXMA te Leeuwarden; M. GAARBEEK te Groningen; H. A. P vai GORCUM te Assen alsmede te Londen Strand 244 HollouÜy's Etablissement. G°UCÜM' TT"" vodro?""nhyPot'eek « 5 % wenscht men te beleggen / 20000. Adre* JL Notaris LAND te Franeker. bö J men ongehuwd persoon als Meesterknecht in eene Grof- en Hoefsmedcrij kun- \ KERne'e StTCn.'- p'"" 'T-den 12 Mei e' k' werk bekü™» b«j de Wed. W  KLti  te ot. Jacooi-Parochie. J pen SMlDSKNECHT.het^Scheepswcrk verstaande kan op Mei e. k. va.t Ui werk bekomen bij J. CONRADIE te Makkum. Tiende laten taïïL* P""Pi' ' KLEIK"" en «ESCHÜITBAKKEN wil- MARS JrßaUernt; ES?"" ** h I~' W raet franco brieven bij W. L* V PUBLIEKE YERKOOPINGEN VAN BOEKEN KUNSTWERKEN EN LIEFHEBBERIJEN. 's Gravenhage is ongetwijfeld eene dier plaatsen welke het beste eeschikt i> lot den vnnrdeebgen verkoop van BIHLIO f HF.K EN ra aHeg waPtot^» SI « daartoe op Pnieaw 7. in^rX Ef™ ST* *""* ' 'VT vni aanzienlijke JLrXoV^ ""? ""'""' ï ""SI Willen maken om ziel van eene jSËrt V. * """""" d""e Bee»e""hed BebrU„ mindere of meerdere ni.rebreld ed i * '""""ü106""- Ik""UJ diU de""W' Z ondergeleekende te adr'ssere e «IlSf!'' *""'h mot fraHCO brieVC"" ""^ r waarden als a.ulerzins wüÏÏeV£*&?£J"" diar""I» onmivldelijk omtrent de voof 's Gravenhage Januarij 1851. ' „ prjnßf.",http://resolver.kb.nl/resolve?urn=ddd:010583920:mpeg21:a0004:ocr,4,ddd:010583920:mpeg21:p004,Leeuwarder courant,1420
11485650,1851/03/31 00:00:00,3966,ddd:010060240:mpeg21:a0020,http://imageviewer.kb.nl/ImagingService/imagingService?id=ddd:010060240:mpeg21:p005:image&x=35&y=130&w=2552&h=3966,ddd:010060240:mpeg21,2587,4096,35,130,6,"tëjs&* pt Ten overstaan van den Notaris SCHMOLCK I Bpf^ito&N la'< net openbaar in het VENBUHUIS BER NOi If*:^l^ TARISSEN IN BE NOBELSTRAAT te 'sG'r«- I )&i^""~^ïT*^f/ ve""naffe. °l» HEDEN den 81 Maart 1851 des £%%&^^:'!*ié& namiddags ten 5 ure worden geveild en op ■^^-^^.^""i^S Maandag den 7 April daaraanvolgende des avonds ten 7 ure worden verkocht: | N°. 1. Eene BOUWMANSWONING en ERVE KOE-en PA ARDENSTALLING BERGEN SCHUUR DORSCHVLOER ZOMERHUIS groola WERF BOOMGAARDen BOSCH-HAKHOUT mitsgaders eenè partij TEELLAND alles staande en gelegen in den grootcn droog' gemaakteo polder onder de gemeente Stompwijk bekend op den kadastralen legger dier gemeente onder sectie D n°'. 127 428 429 480 483 en 486 als te zamen groot 5 bunders 70 roeden en 80 ellen en n°. 431 gedeeltelijk voor het geheel groot 5 roeden 20 ellen belend len noordoosten het perceel n°. 3 en Maria ronder Groen ten noordwesten het perceel n°. 2 ten zuidwesten Abraham van den Akker en consorten en Mevrouw de Weduwe ran der Kun  en ten zuidoosten de Watering. N°. 2. Een partij WEI-of HOOILAND gelegen nis voren  bekend op den kadastralen legger der gemeente Stompwijk onder sectie D n°». 481 482 433 en 437  als tezamen groot 4 bunders 08 roeden en 80 ellen en n°. 485 gedeeltelijk  voor het geheel groot 5 roeden 20 ellen belend ten noordoosten het perceel n°. 4 ten noord- en zuidwesten Abraham ran den Akker en consorten en ten zuidoosten het voorgaande perceel. N°. 8. Eene parlij WEI- en TEELLAND mitsgaders BOSCH-HAKHOUT gelegen als voren bekend op den kadastralen legger der gemeente Stompwijk ouder sectie I) n"".. 296 297 301 802 en 809 als tezamen i Sroot 5 bunders 47 roeden en 90 ellen  en n°. 800 gedeeltelijk  voor het geheel groot 5 meden 80 ellen lidend ten noordoosten de Erven van den beer de Vogel ran Aalst en Adrianus van Leeuwen ten noordwesten het volgende perceel ten zuidwesten het perceel n°. 1 en ten zuidoosten Maria van der Groen de Diaconie Armen I van Stompwijk Adrianus ran Leeuwen de Erven van voormelden ; heer de Vogel van Aalst en de Watering. N°. 4. Eene partij WEI: en TEELLAND gelegen als voren  bekend op den kadastralen legger der gemeente Stompwijk  onder sectie D nos. 295 298 en 299  \ als te zamen groot 4 bunders 81 roeden en 90 ellen en n°. 800 \ gedeeltelijk voor het geheel groot 5 roeden 80 ellen belend ten noordoosten en noordwesten Abraham ran den Akker en consorten  ten i zuidwesten het perceel n°. 2 en ten zuidoosten het voorgaande ! perceel ; aangeslagen over 1849 in het Rijnlandsch bundergeld ! met j 1 per bunder voorde binnenlandsche koston over 1849 niet/ I per bunder in het Molengeld over 1849' met ƒ8 petbunder en in de directe belastingen als gebouwd en ongebouwd : eigendom over 1850 met ƒ 86.85. Alle welke percelen te zamen thans in gebruik zijn bij de Weduwe A. Kroon gehuwd met Ense de Landerijen tot Kersmis 1851  en de woning tot Mei 1852' zul| lende eerst afzonderlijk en daarna gecombineerd ten verkoop worden ; aangeboden ; kunnende dagelijks worden bezigtigd  uitgezonderd des Zondags. Nadere in forma tien te bak omen ten kantore van den voornoemden Notaris Schmolck alwaar in tijds de voorwaarden I dezer verkooping en bewijzen van eigendom ter inzage zullen liggen. ËMen zal op HEDEN Maandag den 81 Maart 1851 des namiddags ten vijf ure in het VENBUHUIS BER NOTARISSEN IN BE NOBELSTRAAT  te's Gravenhage publiek veilen en op Maandag d.ui 7 April daaraanvol gende des avonds ten zeven ure aldaar finaal verkoopeni>u. 1. Eén hecht sterk weldooriiinmerd ULTS en ERVE bevattendo drie benedenkamers keuken en kelder vier bovenkamers met vrijen opgang en keuken beide keukens met pompen voor regen- enXwclwater; wijders zolder en hetgeen verder tot eene goc/le woning vereischt wordt alles staande engelegen aan de zuidwestzijde van den Denneweg te 's Gravenhage op den kadastralen legger bekend sectie E  n°. 285 A  groot 97 ellen; in de grondlasten  over den jare 1851  aangeslagen tot/32.78 en verhuurd tot I°. November 1851 het bencdcnhuis tegen ƒ144 'sjaars en het bovenhuis in twee gedeelten te zamen voor ƒ 192 'sjaars en N°. 2. Een hecht sterk wcldoortimmerd HUIS en ERVE mede bevattende drie benedenkamers keuken en kelder  vier bovenkamers met vrijen opgang en keuken  beide keukens met pompen voor Tegen- en welwater wijders zolder en hetgeen verder tot eene goede woning wordt vereischt mede slaande en gelegen aan de zuidwestzijde van den Denneweg te 's Gravenhage  op den kadastralen legger bekend sectie E  n°. 285 k groot 97 ellen indegrondlasten over den jaro 1851 aangeslagen tot ƒ 32.73 en verhuurd het benedenhuis tot I°. Mei 1#52  voor ƒ2oo'sjaars  en het b venhuis in twee gedeelten beide tot I°. November 1851  te zamen voor ƒ 196 'sjaars; kunnende alsnog bezigtigd worden op Heden en aanstaande Woensdag Vrijdag en Maandag des middags van 12 tot 2 ure. Nadere onderrigting te bekomen en do koop voor waard en te leien ten kantore van den Notaris Mr. M. EYSSELL Mz. en len kantore van den Notaris P. F. vak deb MEULEN beide te 's Gravenhage. Ten overstaan van den Notaris Hr. J. He BAS Jz.  zal J-^ :?K in het VENBUHUIS BER NOTARISSEN XX BE NO* BELSTRAAT te 's Gravenhage op HEDEN den 31 Maart 1851 des namiddags ten vijl' ure in het openbaar worden geveild en op Maandag den 7 April tmMss daaraanvolgende des avonds ten zeven ure (maal verkocht : Ecu hecht voor weinige jaren gedeeltelijk vernieuwd en opgetrokken HUIS ERVE groote met vele exquise vruchthoumen beplante TUIN en SCHUUR  staande en gelegen Ie 's Gravenhage aan het Kleine Groenewegje wijk N . n°. 419 verponding n. 4«  kadaster sectie R nu. 309 810 en 311 ter inhoudsgroolte vau 5 roeden 38 ellen; hebbende dit huis ecu alleraangenaamst uitzigt op de daar achter gelegen Landen en den Spoorweg naar Rotterdam  en bevattende hetzelve zeven zoo grootere als kleinere b.iven- ot beneden vertrekken  alle behangen len deele gep'afonneerd en van stookplantsën voorzien ruime zolder keuken kelderen al hetgeen verder tot eene welingerigte woning behoort ; aangeslagen in de grondbelasting over 1851 met ƒ 30.20 ; te aanvaarden bij do betaling van den koopprijs op I"". Augustus aanslaande of zooveel vroeger als nader mogt worden overeengekomen en te bezigtigen op Maandag Woensdag en Vrijdag van elke week van 's namiddags 2 lot 4 ure mits bevorens belet vragende. Jladere onderrigtingen zijn te bekomen ten kantore van voornoemden Notaris alwaar de eigendomsbewijzen en verkoopvoorwaarden tijdig ter inzage zullen liggen. ÉSÊÜ» Men is van meening ten overstaan van den Ie sGraven|S3 hage residerenden Notaris D. OVERKLIFT VAUPEL KLEYN liiÜ op HEDEN den 31 Maart 18öl  des avonds ten 5 ure iif hot VENBUHUIS BER NOTARISSEN  IN DE NOBELSTK.AAT aldaar in het openbaar te veilen en op Maandag den 7 April daaraanvolgende des avonds ten 7 ure (maal te verknopen : Een hecht weldoortinimerd en sterk DUBBEL HUIS ERVE en TUIN waarin sedert vele jaren eene Affaire in Wijnen en Gedisloleerd met het beste gevolg is en nog steeds wordt uitgeoefend staande cii gelegen aan de oostzijde van de Pastoorswarande te 's Gravenhage wijk C n°«. 458 en 459 verponding n°«. 454 en 455  kadaster sectie C n°. 14G9 groot 1 roede; bevattende bebalveden winkel zes zoo boven- als benedenkamers en een kantoortje alle behangen en de meeste van slookplaatsen voorzien drie zolders keuken kelder en verder alles wat tot eene geschil; Ie woning behoort. Dit perceel «lat aangeslagen is in de grondbelasting over het jaar 1851 met ƒ 82.73 en dat inmiddels UIT DE RAND TE KOOP is kan worden aanvaard bij de betaling der kooppenningen op I°. Mei 1881 en bezigtigd Dingsdag Woensdag en Donderdag van 10 tot I ure. Nadere infnrmatien zijn Ie bekomen ten kantore van voornoemden Notaris alwaar in tyds de bewijzen van eigendom en de verkoopvoorwaarden lor lezing zullen liggen. MMcn is van meening ten overstaan van den Ie 's Gravenhage residerenden Notaris J. W. vau des BERGH in het VÏNIMJ3D2J BER NOTARISSEN  IN BE NOBEESTRAAT aldaar op HEDEN den 81 Maart 1851 des namiddags ten 5 ure (e veilen en op Maandag den 7 April daaraanvolgende desavonds ten 7 ure te verknopen: I°. Een BLOK van tweo HUIZEN en ERVEN met eene Boyenwoning staande en gelegen aan de noordzijde van de Ammunitiebaven  te's Gravenhage wijk P  n<"". 348 310 en 350  verponding n°'. 82S 824 en §25 kadaster sectie sectie G  n°. 1014; verhuurd in gedeelten bij de weck  on renderende te zamen / 275.60 'sjaars. 2°. Een HUIS niet ACHTERHUIS ERVE en de gemeenschap ran eene Plaats staande en gelegen aan de noordzijde van de Tarot- of El/.enioerstraat te '«Gravenhage wijk P n°. 178 verp. n°. 161 kadaster sectie G n°. 889; verhuurd in gedeelten bij de woek  en renderende te zamen/104 'sjaars ;do voorschreven percelen zijn in de grondbelasting over 1851 legen gebouwd en ongebouwd eigendom aangeslagen  als: n°. 1 met ƒ 2>.67 en n°. 2 met ƒ 8.10 en te bezigtigen des Maandags on Donderdags des namiddags tusseben 1 en 3 ure. Nadere informatien zijn te bekomen ten kantore van voornoemden Notaris. »#* Men zal <>p HEDEN den 31 Maart 1851 des morgens ten 10 ure voor de huizing aau den Zuidwal bij de Beestenmarkt te 's Gravenhage  wijk U n°. 72 len overstaan van den Notaris J. BEfiVOÏaS  in het openbaar verkoopen eenige MOBILAIRE en andere ROERENDE GOEDEREN als: Kabinet Chifonnière Secretaire Tafels Stoelen staande Klok  Ledekant Bedden en toebehooren  Manskleederen  voorts Koper-  Tin- en Ijzerwerk  eenig gemaakt Zilverwerk en hetgeen verder te koop zal worden aangeboden. •„* Men is van meening tenoverstaan vanden Notaris J. BERVOETS aan het huis in de eerste Wagenstraat te 's Gravenhage  wijkS n°. 75 op MORGEN den I April 1851 en volgende dagen  des voormiddags ten 10 ure in het openbaar te verkoopen oenen netten souden meest modernen INBOEDEL voornamelijk bestaande in : Mnhonyhoutcn Kabinetten  Bufetten  Luketkasten Psyche-  Eet- Thee- Speel- Penant- Bloem- eu andere Tafels Mahonyhouten en andere Stoelen met Kussens Kasten eu Kanapés Ledekanten met Behangsels Meubelgordijnen en Vensterbankkussens Bedden en loebehooren Dekens Vloerkleeden Gangloopers en Karpetten Pendules Vazen  Candelabres onder Stolpen  een Japansch Kabinetstel  van 5 stuks en meer Porselein Schilderijen in Olieverf waaronder van Kruseman Rooseboom Mittelholser en Kleun Platen in Lijst en Glas Oostindische Kist met Koper gemonteerd gemaakt Goud en Zilverwerk als: Hoiologien Lepels en Vorken Olie- en Azijnstel Suikerbussen Inktkokers üessertdoozen Tabak- en Thecdoozen Vuurkomfeur Sehenkketcl niet Komfoor Chocolade- en Koffdkan en meer gebronsde Kamerkroon en Moderaleirlampen  twee Piano-Fortes Doos met Speelwerk Mangel en Pers Zinken Badkuip Brabandsch Biljard Brandspiegel Illumineer-en Opticakasten Glas- en Aardewerk Tafel- en Theeserviezen IJzer- Koper- Tin- Blik- en Lakwerk en hetgeen verder te koop zal worden aangeboden. Zijnde alles Ie bezigtigen op Heden vóór de verkooping van des vonrmiddags 11 tot des namiddags 8 ure. ** Men zal ten overstaan van den Notaris J. BERVOETS op Dingsdag den 15 April 1851 en  zoo noodig  den volgenden dag des morgens ten 10 ure  aan de h lizing in het Noordiende te 's Gravenhage wijk F n°. 162 in het openbaar verkoopen eenige goed onderhouden MEUBELEN en HUISRAAD als  Mahonyhouten Linnenkast Kabinet.' Secretaires Boekenkast Toilet- Etens- Thee- Speel- en andere Tafels Canapés en Stoelen Geverwde Kasten Ledekanten Matrassen Dekens Vloerkleeden en Gordijnen Kristal en Glaswerk  eene buitengewoone solide ijzeren Brandkast Kagchels Koperwerk Kenkengereédschap en 't geen verder te koop zal worden aangeboden; kunnende al hetzelve worden bezigtigd daags vóór de verknoping van 11 tot 3 ure. %* Men zal ten overstaan van den Notaris J. BERVOETS op Donderdag den 17 April 1851  en volgende dagen  des morgens ten tien ure aan dehuizing  wijk I n°. 216 aan de oostzijde van het Lango Voorhout te 's Gravenhage in het openbaar verkoopen een' netten en eindelijken INBOEDEL hoofdzakelijk bestaande in Mahonyhouten en andere Kabinetten  Secretaires  B ifetlen  Eet- Thee- Speel- en Schrijftafels Canapés en Stoelen met trijpten en andere zittingen Wasch- en Nachttafels Kasten Oostindische Kisten Ledekantcn een fraai goudlederen Scherm slaande Klok Spiegels in vergulde lijsten  Kamerkroon  Pendules en Candelabres ; voorts Kronenburgsche en Saksische Tafel- en Theeserviezen eenig Oostindisch en ander Porselein  Glas- Verlakt- en Platedwerk Persen Vloerkleeden een' ijzeren Brandkast Geldkisten Kagchels en Haarden eene Cuisinière een Huisbrandspuit een Bad eenig Koper- Tin- en Blik werk en hetgeen meer te koop zal worden aangeboden ; kunnende al hetzelve worden bezigtigd des Dingsdag en Woensdag vóór de verkooping van des morgens 11 tot 3 ure. *„• Men zal op Maandag den 7 April 1851  en volgende dagen  aan het Venduhuis in de Nobel straat Ie 's Gravenhage verkoopen allerhande moderne eu wel oiiderlioudene MEUBELEN. nUISSIERADEN en andere GOEDEREN  afkomstig van onderscheidene deftige eu zindelijke Inboedels bestaande in: Ledekanten Mahonyhouten en andere Kabinetten  Secretaires  Garderobes  Chifonnières Elagèrés Bufetten Etens- Thee- en andere Tafels  Bergères Fauteuils en andere Stoelen Canapés Glas- en Meubelgordijnen  Piano-Fortes Spiegels staande Klokken mot Speelwerk  Pendules Sniyrnasche en andere Tapijten Karpetten Porseleinen Tafel- en Thceserviescii  Aarde- en Glaswerk Koper- Tin- Verlakt- en Ijzerwerk Klcèr- en andere Kasten Mangels Persen zindelijke Bedden Matrassen Dekens Tafel- Bed- en ander Linnen Kansen Vrouweiikleedercn Juweelen Gn'id en Zilverwerk en verdere Goederen meer. Alles te zien Vrijdag en Zaturdag vóór de verkooping  van des morgens 11 tot 3 ure.",http://resolver.kb.nl/resolve?urn=ddd:010060240:mpeg21:a0020:ocr,5,ddd:010060240:mpeg21:p005,Dagblad van 's Gravenhage,2552
2995520,1851/01/28 00:00:00,1480,ddd:010771606:mpeg21:a0016,http://imageviewer.kb.nl/ImagingService/imagingService?id=ddd:010771606:mpeg21:p004:image&x=1097&y=3795&w=2024&h=1480,ddd:010771606:mpeg21,3121,5275,1097,3795,6,*„.* Door de Erven. C. M. VAM lioi.illis HOITSI ._A is aan de Inteekenaren verzonden : Het Iste en 2de Vel voor 1851 van het Tijdschrift. getiteH : DE HUISVRIEND; Gemengde .Lectuur voor Burgers in Stad en .Land VERZAMELD DOOR J. J. A. -}OE_ERr.EIIR Prijs /' S— ©O per Jaargang. Van dit Tijdschrift wordt in dit jaar de Ode Jaargang met een steeds even gelukkig gevolg uitgegeven terwijl van de vijf eerste Jaargangen die den verminderden en hoogst geringen prijs van 7 Gulden verkrijgbaar gesield warm nog slechts eeirge weinige Exemplaren meer voorhanden zijn. WJ_Al_i\_EMl_*-K____« - SïaS gedaan te Groningen; inedegjcdeeld van wege het Ge .ootschap : Ter bevuriLering der Natuurkundige Wetenschappen JANUARIJ 1851. ' _l t „-.„ „ VOCHTIGHBIDB- ' = % BAROMETER Opo°. THERMOMBTER. TOESTAND. WINDSTREEK. LUCHT» «BTBI.DHBID. O ' ? 8 uur. 2 uur. 8 uur. Bu. 2u. Bu. Bu. 2u. Ba. 8 uur. 2 uur. 8 uur. 8 uur. 2 uur. 8 uur. 19 76835 76692 76641 02 24 20 089 090 090 Zuid Zuid mistig mistig mistig 20 76397 76183 75902 -04 10 05 092 084 089 » _ » » ~~ 21 75156 75113 75171 35 71 70 089 092 093 Z.Z.W. betrokken betrokken regen 22 75478 75986 76473 50 67 30 082 078 087 Z.W. W.Z.W. bewolkt bwolkt helder 23 76952 77042 177182 20 58 20:087 089 092 Z.Z.W. West » » mistig 21 7701)8 77094 j 76749 16 37 15 088 077 083 ZZ.O. Z.O. nuttig - bewolkt 25 76355 17 „326 )76293 10 22 12 081080 083 Z.O. » betrokken betrokken betrokken Te Groningen bij de Erven C. M. va* BOLHUIS HOITSEMA.,http://resolver.kb.nl/resolve?urn=ddd:010771606:mpeg21:a0016:ocr,4,ddd:010771606:mpeg21:p004,Groninger courant,2024
6894724,1851/11/07 00:00:00,3947,ddd:010060339:mpeg21:a0012,http://imageviewer.kb.nl/ImagingService/imagingService?id=ddd:010060339:mpeg21:p003:image&x=51&y=169&w=2512&h=3947,ddd:010060339:mpeg21,2563,4116,51,169,4,"■gr gt « Men zal op Maandag den 10 November 1851 j ■Mr Jm_s&?=--- es nal--a'f*aos te"" v'j' '""""e in het venduhuis ■^^T^j^l^j^g DEH. NOTARISSEN IN DE NOBELSTRAAT  &_£.... j&gS&fZïtal tQ 'sGravenhage publiek veilen en op Maandag den 17 daaraanvolgende des avonds ten zeven ure aldaar finaal verkoopen: N°. 1. Een perceel UITERWAARD gelegen aan de rivier de Maas gemeente Poederoijen  canton Zalt-Boemel Provincie Gelderland  van ouds bekend onder de benaming van Gandel- en Middelwaard' Ihans kadastraal seclie A n°. 31  alsgroot 2 bunders 95 roeden' 50 ellen; 32 als groot 46 roeden 90 ellen; 83 als groot 1 bunder 55 roeden 70 ellen; 34 als groot 4 bunders 97 roeden. 50 ellen; 35 als groot 4 bunders 12 roeden 60 ellen; 86 als groot 87 roeden 90 ellen ; 87 als groot 1 bunder 92 roeden' 40 ellen; 88 als groot 43 roeden 40 ellen; 39 alsgroot 3 bunders. 84 roeden 50 ellen; 40 als groot 92 roeden 10 ellen; 41 als groot 54 roeden en sectie B u°. I  ala groot 5 bunders 59 roeden 90 ellen; 2 als groot 9 bunders 18 roeden 70 ellen; 8 als groot 7 bunders 52 roeden 40 ellen en 4 als groot 2 bunders  48 roeden 20 ellen ; in de grondlasten over den jare 1851 aangeslagen tot ƒ 150. No. 2. Een perceel HOOI- OF WEILAND genaamd de Hooge vijf Morgen gelegen in het Muniiikenland tusschen Maas en Waai boven Loc vestein gemeente Poederoijen voormeld thans kadastra il bekend sectie B n°. 7 als groot 4 bunders 25 roeden indegroudlasten  over den jare 1851  aangeslagen tot f 11.50. N°. 8. Een perceel WEI- OV HOOILAND genaamd de Lage Vier Morgen gelegeu als vorens thans kasdastraal bekend sectie B n°. 14 alsgroot 3 bunders 96 roeden 40 ellen in de grondlasten overden jare 1851 aangeslagen tot ƒ 6. N°. 4. Een perceel WEI- of HOOILAND genaamd de Hooge vier Morgen gelegen als voren thans kadastraal bekend sectie A. n°. 17 als groot 3 bunders 34 roeden  80 ellen; in de grondlasten over den jare 1851 aangeslagen tot ƒ 16.20 en N=. 5. Een perceel ELZENWAARD en GRIEND genaamd dc Potschuren gelegen als voren thans kadastraal bekend sectie A „°. 2 als groot 98 roeden 90 ellen en sectie A n°. 8 alsgroot 41 roeden 50 ellen; in de grondlasten over den jare 1851 aan. geslagen tot ƒ 0.08. De polderlasten van de percelen n°'. 2 8 4 en 5 zijn over het dienstjaar van in 1851 tot iv 1852 aangeslagen tot ƒ 10 per bun. der terwijl op ruin een bunder van liet perceel n°* 1  mede del zeilde polderlasten rusten ;- al de percelen zijn dagelijks  cxc ~A des Zondags te bezigtigen en de aanwijzing nopens derzelver ligging zal op aanvrage geschieden door of van wege den heer L. van Hemert  deurwaarder bij het cantongeregt te Heusden  door Wouter Lievaart Arbeider en Opziener wonende aan de Nol onder Rijswijk en door Cornelis van Noorloos Arbeider en Opziener wonende te Andel. Nadere onderrigting te bekomen en de koopsvoorwaarden te lezen ten kantore van den Notaris Mr. M. EYSSELL Mz.  en ten kantore van den Notaris P. F. van der MEULEN beiden te sGravenhage mitsgaders bij den heer cantonregter Vreede te Heusden. *** VEILING m BÜHEINGOEDEREN TE 'SGRAVENRAGE. Op Vrijdag den 21 November 1851 des voormiddags ten 10 ure tal al of niet onder voorzitting van den Directeur der Rcgislratic en Domeinen voor de provincie Zuidholland door den Ontvanger der Domeinen te 'sGravenhage ten overstaan van den aldaar gevestigden Notaris C. J. SCHIEFBAAN  in het Venduhuis der Notarissen te 'sGravenhage  worden overgegaan tot de voorloopige ■veiling en op Vrijdag den 28 dier maand te zelfder ure en plaatse lot den aflag en de toewijzing of verkooping van DOMANIALE VASTE GOEDEHEN gelegen onder de gemeenten Hazerswoude  Wateringen  Reeuwijk Sluipwijk en Gouda; welke Goederen in het breede zijn omschreven in dc verspreide aanplakbiljetten alsmede in den Catalogus die voor 10 cents verkrijgbaar is bij 'den opgemelden Ontvanger bij de Ontvangers van de Registratie en Domeinen te Leiden Alphen Delft Gouda Haarlem en Utrecht en bijden Ontvanger der Domeinen te 's Herto lenbosch; terwijl de verkoopvoorwaarden voor een ieder ter lezing liggen aan de kantoren van de vijf eerstgemelde Ontvangers  en van den voorn. Notaris en aan het Raadhuis der stad 's Gravenhage. 'sG-iAVE-UuaE den 29 Oetober 1851 De Directeur der Registratie en Domeinen  voor Zuidhoiland PFISTER. * » Men zal op Maandag den 10 November 1851 en volgende dagen aan het Venduhuis in de Nobelstraat te 'sGravenhage verkoopen allerhande moderne en wel onderschoudene MEUBELEN HUISSIERADEN en andere GOEDEREN afkomstig van onderscheidene deftige en zindelijke Inboedels bestaande in : Ledekanten  Mahonyhouten en andere Kabinetten Secretaires Garderobes Chifonnières Etagères Bufetten Etens- Thee-  Speel- en andere Tafels Ber""ères Fauteuils en andere Stoelen Canapes Glas- en Meuhelp-ordijnen welluidende Piano-Fortes Spiegels Pendules Smyrnasehe Schotsche en andere Tapijten Karpetten Oosindische eu andere Porseleinen Aarde- en Glaswerk Koper- Tin- Verlakten Uzerwerk Haarden en Kagchels Kleer- en andere Kasten Mangels Persen zindelijke Bedden Matrassen Dekens Tafel- Bed"" en' ander Linnen Mans- en Vrouwenkleederen eenige Juweelen waaronder twee paar briliante Orlietten dito Oor- en Handringen verder Goud Zilver en andere Goederen meer. Alles te zien Heden en Morgen vóór de verkooping van des morgens 11 tot 3 ure. *** OPENBARE VERKOOPING TE SCHEVENINGEN. De OPPERSTRANDVONDERS van het Noordelijk gedeelte van Zuidholland zullen ingevolge bekomene magtiging vanJoAi» Button 'scheepskapitein op MORGEN Zaturdag den 8 November 1851 des middags ten 12 ure in het Hotel van den heer Maas om contant geld doen verkoopen het HOL of CASCO van het aldaar op den % November 1851 gestrande Engelsche Schoenerschip New Amitu; alsmede de daarvan geborgen inventaris bestaande in : ANKERS ZEILEN POMPEN  KETTINGEN STAAND en LOOPEND WANT KOKSGEREEDSCHAP en andereSCHEEPSGOEDEHEN ; voorts zullen alsmede op de daartoe bekomene magtiging ten gemelden dageen plaatse in het openbaar om contant geld worden verkocht ongeveer 10 a 12 LAST beschadigde TARWE afkomstig uit bovengemelden bodem. Alle welke Goederen van Hedeu af kunuen worden _bezi»*tigd ; terwijl inmiddels bij den Subsituut Staiidvonder teScheveningen informatien omtrent een en ander zijn te bekomen. ** De ondergeteekende heeft de eer  zijnen geëerde begunsiigers te berigten dat hij  door VERTIMMEREN en VERGROOTEN van zijn MAGAZIJN  de voorhanden zijnde GOEDEREN tegen zeer ** KKMI.t- BKRDK «loch VASTC.K_STKI_.DK PIÏMJXEX zal UITVERKOOPEN. Hij noodigt derhalve zijne geachte begunstigers beleefdeliik uit. van deze voordeelige gelegenheid gebrnik le maken. J 11. CRAMER voorheen 11. RUTIIERFORD en COMP. %» De ondergeleekende heeft de eer de Dames te berigten dat hij de WINTERMODES MANTELS en diverse Zijden en Wollen STOFFEN uit Parys heeft ontvangen alle van den laatsten en nieiiwsien smaak en tot zeer billijke prijzen. Eene partij FRANSCHE MERINOSSEN en ZIJ DEN STOFFEN worden UITVERKOCHT onder inkoopsprijzen. ANDRÉ SALMON Plein 418. *(t* *W. T. GTIjIiART a I'honneur d'annoncer aux Dames qu'elle vient de recevoir de Paris nn bel assortiment de MODES Ü'HIVER en tons genres. Noordeinde n°. 86  visd-vis la salie gothique de feu S. M. Guillaume 11. *.# STEENKOLEN- EN CÖKES-BERIGT. Daar door de vele bestellingen de orders voor GAS-COKESen STEENKOLEN niet altijd denzelfden dag bezorgd kunnen worden zoo verzoekt de ondergeteekende beleefdelijk  zoo veel mogelijk deze bestellingen één of twee dagen te voren te doen  hetzij mondeling of per post aan zijn Magazijn op het Groenewegje of aan dc Gasfabrijk. If. MOVEN.",http://resolver.kb.nl/resolve?urn=ddd:010060339:mpeg21:a0012:ocr,3,ddd:010060339:mpeg21:p003,Dagblad van 's Gravenhage,2512
3456927,1851/08/29 00:00:00,3803,ddd:010805348:mpeg21:a0004,http://imageviewer.kb.nl/ImagingService/imagingService?id=ddd:010805348:mpeg21:p004:image&x=963&y=463&w=909&h=3803,ddd:010805348:mpeg21,1872,4266,963,463,4,Koestal gemerkt N. 215 Zom. rhuis Koetshuis en Paardenstal Schuur Wagenloots Hooiberg en verdere betimmering met de daarbij behoorende zeer goede Boomgaard Bouw- Wei- en Hooilanden te zamen groot 16 bunders 19 r. 25 e. staande en gelegen op den Noordzijden polder onder de gemeente Bodegraven bij den ingang van het Dorp aan den Straatweg met een onbelemmerd uitzigt op den Rijn kadaster sectie B No. 883 a 889 913 a 924 933 a 935 939 a 941 2217 a 2220 en 2238. No. 2 en 3. Twee perceelen HOOILAND te zamen groot 6 bunders 68 r. 99 e. gelegen in den binnenpolder onder de gemeente Zwammerdam kadaster sectie B No. 1199 a 1202 en sectie C No. 90 752 a 755 en No. 4. Eene WONING gemerkt D No. 199/i2oi met derzelver Erf en Tuin staande en gelegen te Bodegraveu kadaster sectie B No. 784 en 785 groot 6 roeden 27 ellen. Zijnde de Goederen onder No. 1 2 en 3 vermeld met uitzondering der Ileeren-Huizinge en Tuin welke uiterlijk 1 Mei 1852 kunnen worden aanvaard verhuurd aan Gerrit van der Maat tot 1 Januarij en 1 Mei 1857 voor / 800 'sjaars en het perceel onder No. 4 omschreven bij continuatie . tot / 4680 'sjaars. Al.es breeder omschreven bij billetten en nadere informatien te bekomen ten kantore van den Notaris W. A. van ZIJST te Woerden alwaar de bewijzen van eigendom en koopsvoorwaarden berustende zijn; terwijl kopij der veilconditien 14 dagen voor den verkoopdag mede zullen voorbanden zijn ten kantore van den Makelaar H. ROMIJN Pz. op de Prinsengracht te Amsterdam. LEES H.Eft! (5590) *«« Men verlangt in HUUR met half October e. k. voor de wintermaanden  vier GEMEUBILEERDE KAMERS waarvan drie met Slaapplaatsen en een meiden Kamertje voorzien van de noodige gemakken en stookplaatsen  gelegen op een aangenamen stand. Opgaaf met franco brieven aan het Bureau dezer Courant oi.de-r La. D. AVIS MEDICAL. (5 591) %* Ee Docteur SAMUEL LA'MERT rnembre de rUniversité d'Edimbourg menibre honoraire de la Sociéié Médicale de Londres &c. <&c. Auteur de la Pi!es__kvation Pkhsonnelle  et de la Sciencf. DE la ViE a I'hontieur d'inforuier les personnes qui désirent Ie consulte-r sur les différent elésordres des Organes de la Géuération résultants d'Exces ou d'habitudes seciêtes contraciccs dans la jeunesse de la Sypbilis de la Gonorrbée d'Ecoulenients de Retréei. sements et sur les cas de Débililé nerceuse de Faibiesse locale et générale prée-urseurs de la stérilité de t'impuissance de I'aiiéaiitisseuient des plaisirs de la vie et du but spécial du Muriage que cbaque jour il recoit il sa résidence SS BEDFORT SQUARE A LONDRES Les heures fixées sont de 11 heures du matin èi 2 l.eur s de l'ap.6s-midi. Prix de la consultatiou 25 francs soit pe-rsonnelle soit par coirespoudance. — Le secret est inviolabte et les lettres reudues sur réclamations — Les iiié.licanieuts nécessaires sont expédiés avec sécurité  dans toutes les partics du monde. La Preskrvation Peuso_.xei.-_ est illnstréa de quarante figure-s -.oloriées sur l'an.ttomie la physiologie et les maladies des organes de la génération prix sous enveloppe 5 francs franco sfr. 50c. Lu Scik.nce de LA Vie secret pour vivre longtemps  avec portrait et plauches prix 4 fr. frauco 4fr. 50c. Tous les excmplaires non revêtus de la signature ele I'auteur doivent être considéiés comme coutrefacons et le public est prié de ne leur accordcr anttuie conüane-e. En vente chez M. M. les Hériticrs DOORMAN a la llaye chez M. TORMIJN Libraire h Amsterdam chez M. 11. T. HENDRIKSEN Libraire a Rotterdam.,http://resolver.kb.nl/resolve?urn=ddd:010805348:mpeg21:a0004:ocr,4,ddd:010805348:mpeg21:p004,Utrechtsche provinciale en stads-courant : algemeen advertentieblad,909
3102094,1851/04/03 00:00:00,2867,ddd:010072874:mpeg21:a0015,http://imageviewer.kb.nl/ImagingService/imagingService?id=ddd:010072874:mpeg21:p003:image&x=2233&y=71&w=1082&h=2867,ddd:010072874:mpeg21,3315,2938,2233,71,6,"OUDHEDEN -_ ZELDZAAIHEBEH. Op Dingsdag den 20sten Mei 1851 en volgende Dagen zal onder directie van de Makelaars A. B. VAN DER VIES en J. W. MIJNSSEN en ten overstaan van den Heer J. GOLDSMIT Deurwaarder in de Garnalen Doelen op den Singel te Amsterdam in het openbaar worden Verkocht: De aanzienlijke Verzameling van OUDHEDEN en kostbare ZELDZAAIHHEDEN . bljecngebragt en nagelaten door Wijlen den' WEL-EDELEN HEER W. JöSEPHUS JITTA  waaronder voorkomen antieke Meubelen Bronzen Zilver- en Goudwerk  Wapens  Camees Porcelein Glaswerk  Marmer- en Lakwerk  Schildpad- Ivoor Paarlemoer en Houtsneêwerken Kanten enz. enz. Te bezigtigen in den Doelen van 12 tot en met 18 Mei 1851 tegen betaling van 25 Cents per Persoon ten behoeve van de Armen uitgezonderd Dingsdag en Vrijdag 13 en 16 Mei op welke 2 dagen de toegang vrij zal zijn. — De Catalogus in kwarto in dc Hollandsche en Fransche talen en voorzien van Lithographiën der voornaamste stukken ii te bekomen tegen betaling van Een Gulden te Amsterdam bij gemelde Makelaars en in de voornaamste hoofdsteden van Europa aan de adressen bij de Catalogus aangewezen. (4814) (4315) F. DER KINDEREN en 11. I. RIETVELD Makelaars  zullen op Maandag den 2Qstcn April 1851 des Avonds ten 6 Ure te Amsterdam in de Nieuwe Stads Herberg aan het IJ Verkoopen : Een e xtra snelzeilend gekoperd en kopervast Nederïandsch CREGATSCHIP genaamd JOHANNA gevoerd door Kapt. J. H. SCHIPPERS; volgens Nederlandschen Mcetbrief lang 40 ellen wijd 7 ellen 68 duimen Hol 6 ellen 15 duimen en alzoo gemeten op 840 tonnen of 443 lakten. Breeder bij Inventaris en berigt bij bovengemelde Makelaars of bij de Cargadoor» HOYMAN en SCHUURMAN. (5210) Op een nader te bepalen dag zal ten overstaan van den te Alphen residerenden Notaris Mn. C. A. KLUIT in het openbaar worden geveild: Eene sedert weinige jaren nieuw gebouwde HEER EN HUIZING bevattende Tien Vertrekken allen gestukadoord en de meeste van Stookplaatsen voorzien voorts KELDER KEUKEN DROOG-en MANGELZOLDER REGEN- en POMPWATER met een ruimen nieuw aangelegden TUBN staande en gelegen te Alphen aan den Straatweg en Rijn zijnde het Perceel inmiddels ÜBT DE HAND TE -400 B*. Te bevragen in Persoon of met franco brieven ten Kantore van voornoemden Notaris. VERKOOPING VAN BOEKEN El. H. ISBEURS Boekh. te 's Gravenhage zal op Maandag den 7den April 1851 en volgende Dagen Publiek Verkoopen: Eene fraaije en belangrijke Verzameling BOEKEN in verschillende Talen en Vakken van Wetenschap; voorts GÉNÉALOGIEN HANDSCHRIFTEN WAPENen RIVIERKAARTEN PRENTWERKEN TEEKENINGEN PRENTEN PORTRETTEN DIV. VOORWERPEN benevens WINKELGOEDEREN KINDERWERKJES PRENTENBOEKEN div. Papieren en Kantoorbehoeften grootendeels nagelaten door wijlen den Heer P. C. DILL in leven Boekh. te 's Gravenhage en andere voorname Lief hebbers. De Catalogus is op Franco aanvrage verkrijgbaar. (4869) (4979) Men verlangt tegen Mei te plaatsen bij een APO I'HEKER van de Protestantsche Godsdienst te Amsterdam een Fatsoenlijk .JONGELING van bijna 16 Jaar van het Platteland die vlug Receptèert liefst bij zoodanig APOTBJERER dio zelf mede werkzaam is en waar tijd kan gegeven worden tot het Aanleeren van het LATIJN. Er zal meer op fatsoenlijke Behandeling dan op Salaris gelet worden. Reflecterende adressere zich Franco onder Lett. 8. bij den Boekhandelaar J. C. LOMAN Jn. Kalverstraat te Amsterdam. (_il4j Er wordt gevraagd om niet Primo Mei of dadelijk in Dienst te kunnen treden: Een zijn Vak grondig verètaande GRUTTERS"" HK ECHT. Brieven Franco  Bureau Handelsblad Lett. G. Z. (4879) Ter waarneming vau eene APOTHEEK in een Stadje in Gelderland verlangt men met Mei aanstaande een PROVISOR belijdende de Hervormde Godsdienst. Men adressere zich met Franco Brieven  onder Lett. 8. aan het Postkantoor te Elburg. ïtnTF3___ In Ambtenlam wordt bij een APOTHEKER i UillLiEm. e"" CHSMIST gevraagd: Een Protest. JONGELING als Leerling of lemand reeds eenigen tijd in een WINKEL werkzaam geweest beide lust gevoelende zich verder Theoretisch en Practisch te bekwamen kunnen op voordeelige voorwaarden geplaatst worden. Adres Franco Brieven onder Lett. X. bij den Boekhandelaar H. HiiVEKER Hecrcngr. bij de Wolvcnstraat aldaar. (4962) AI'O'B'UEB-ERS-HEDIËNIïËr^jTpTMAÏ-ILSTEDE Heel- en Vroedme.ester te Thamen aan den Amstel verlangt met I°. Mei aanst. een bekwaam APOTHEKËHS-HEDIENDE van goede Getuigschriften voorzien. Men adressere zich in Persoon of met Franco Brieven. (4822) (4628) Een Fatsoenlijk -SONG ÜBEN SCH  van de Herv. Gortsd. zich verder wemchende bekwaam te maken tot HEELMEESTER TEN PLATTEN LANDE zag zich gaarne op billijke voorwaarden daartoe geplaatst in eene APOTHEEEt binnen Amsterdam ten einde aldaar werkzaam te zijn en tevens de Klinische Lessen te kunnen bijwonen. Adres franco Brieven aan het Postkantoor te Oldcnznal Lett. O.",http://resolver.kb.nl/resolve?urn=ddd:010072874:mpeg21:a0015:ocr,3,ddd:010072874:mpeg21:p003,Algemeen Handelsblad,1082
2554688,1851/01/17 00:00:00,2864,ddd:010805250:mpeg21:a0029,http://imageviewer.kb.nl/ImagingService/imagingService?id=ddd:010805250:mpeg21:p004:image&x=1879&y=1271&w=892&h=2864,ddd:010805250:mpeg21,2771,4135,1879,1271,4,"213. _§.taats - Loterij. Trekking der Eerste Klasse. 2de Lijst No. 11228 f 1250. No. 9445 637 en en 11731 ieder / 1000. 3de Lijst No. 14130 f 5000. No. 10825 1-5641 8425 en 13471 ieder f 1000. Nijmegen den 14. Jau. Alhier was de imddelprijs ter markt vau gisteren: van do 130 verkochte mudden Tarwe per Ned. mud ƒ 735 ; van de 470 verkochte mudden Rogge/ 570. Van de Gerst was de hoogste prijs /""4üü en de laagste/340; van de Boekweit de hoogste ƒ 570 en de laagste / 540; van den Haver de hoogste prijs .300 en de laagst* f 250. De prijs van de Boter was per Ned. pond ƒ 055 a ƒ o<i2. WAARNEMINGEN gedaan op het Meteorologisch Observatorium te Utrecht. (Zonnenburg.) . i Wind- Barom. Tla-r.i Afivijk. iVoclr-JGev. ' "" _ lri«.___■•■_. bii°° F ""-■""""■l'-!'--h--■•- ■„ Aanmerkingen. mm n-m )4 8 zzo. 1 75834804 097 o Betrokken. 2 zo. 2 554.. 35(i1— 1.3 85 0 Ligt bewolkt. 10 zzo. 2 5201 30_ 97 0 Helder. 15 8 zo. 2 5006.3201 93 0 id. 2 zzo. 2 5041 ..99[H- 3.1 70 0 Bewolkt. 10 z.j 1 5459J381| 9. 01 id. kring ora du maan. PR.UZEH DER EFFECTEN. AMSTBRDAM 15 Jan. 1851. volgens de Societ. tot nut OMSCHRIJVING. des. Obligatie-Handels. van tot gold. Nedekland. Wcrkel. Schuld. . . 2VS pCt. 57 57'/ 57'/_ dito dito 3 „ 66% 67 66'% dito dito 4 „ 88 8.% 89 Amortisatie Syndicaat 3% „ 88% 89 89  Üost-Ind. Leening. . 4 „ 87 '/4 Frankrijk. Ccriifieateu 3 „ 53% 53% 38*/|» Rusland. bij Hope en Comp. .. 5 pCt. 105'/j dito 182 S en 1829. . 5 „ 104 104 V 104% dito dito 1840 ... 4 ~ 87 Certificaten bij Slieglilz 4 „ 86% --Vio 86% dito Adm. te Lond. 4-"" „ 94% 94% 94'/4 Polen. Aandceien 1835 ./-SCO. .. . / 143% Obligatien 4 „ 75'/j Sl-ANJE. Oblig. Ardoin. i 85 5 pCt. 12'/ - 510 5 „ 18% 12% |8% Obligatien „ 39 '.'4 Biniieul. Schuld. ... 3 „ 33Vi« 33% 83'/ Ardoin Coup. ..... 7% Oostenrijk. Oblig. Metaliek .... 5 „ 70% dito dito. N 5 „ 75% 75% 75% dito .2% „ 37 '/ 37% 37' I -Kl.i-.I E. Certificaten 2'/> pCt. 47%. Certific. bij Rotschild 2% „ 47% 47»/» 47% I'OKTCGAL. te- Londen ...... 4 „ 35% dito 4 „ 34'% 84% 34'% Amerika. Ven. Obl. 6 pCt. thans 3 pCt. 80% 31% Grenada Oblig. . . . 1% „. 17% Mexico Obl. 1837 t 100 5 „ 331/ 84% 34% Haarl. Meer 5 pCt. 104; Buss. to Hamb. 97% * Pool». Aand. fl. -00 256; Den. te Londen 98%; Bral. 184* i 100 87%; F(jundor.3!/i«; Gren. ui(g. 4 %",http://resolver.kb.nl/resolve?urn=ddd:010805250:mpeg21:a0029:ocr,4,ddd:010805250:mpeg21:p004,Utrechtsche provinciale en stads-courant : algemeen advertentieblad,892
2585050,1851/06/17 00:00:00,2665,ddd:010518350:mpeg21:a0016,http://imageviewer.kb.nl/ImagingService/imagingService?id=ddd:010518350:mpeg21:p003:image&x=2006&y=2231&w=970&h=2665,ddd:010518350:mpeg21,2976,4896,2006,2231,4,* * * Degenen die iets te vorderen hebben van  of verschuldigd zijn aan den Boedel van deu Heer HENDRIK OTTO AMANDUS JANSSEN in leven zonder beroep gewoond hebbende te 's Hertogenbosch en aldaar overleden den 9de» Mei 1851 worden verzocht daarvan binnen eene maand opgave of betaling te doen ten Kantore van HTJBERT Notaris. 's Hertogenbosch 10 Junij 1851. *** Men verlangt met Augustus in de Provincie Utrecht voor een klein getal Kostleerlingen : Eenen SECONDANT in staat het Onderwijs te kunnen geven in de vier moderne Talen en de beginselen der Algebra en Wiskunde. Adres met franco Brieven onder Lett. M aandeßoekhandelaars A. F. BLANCHE en COMP. te Utrecht. V lEMAND bezittende den 3d™ Rang bekwaam voor de Kerkedienst en goed Klassikaal Onderwijs vraagt eene Betrekking. Adres met franco Brieven onder Lett. A bij J. T. SOMMER Boekh. te Almelo. *** Om mede te arbeiden aan een DAGBLAD iv eene der voornaamste steden van Noord-Holland wordt gevraagd een Persoon die het Hollandsch zuiver schrijft en in staat is onfuaauwkeurig eu vlug uit het Fransch Hoogduitsch eu Engelsch te vertalen. Adres met vrachtvrije Brieven onder de letters A. Z. bij J. H. KNOOP  aan het Donkere Sparen te Haarlem. *#* NOTARIAAT. In Gelderland op een der voornaamste Dorpen is de gelegenheid voor een JONG MENSCH van eenigzins gedistingeerden huize en G. G. om zich ten Kantore van eenen Notaris in het Theoretische en Practische van het Notariële vak te bekwamen. Reflecterenden adresseren zich ten spoedigste onder Letter E. bij den Boekhandelaar NI JHOFF te Arnhem. Brieven franco. *** Men vraagt lEMAND vau de Herv. Godsd. tusschen de 25 en 35 jaren oud van goede getuigschriften voorzien en bekwaam tot waarneming van een' Gruttersen Kruideniers-Winkel. Tevens geschikt zijnde tot waarneming vau het Huishouden adressere men zich franco Brieven Letter A bij J. W. EVERSZ Boekverkooper te Zeijst. *** Er wordt gevraagd met p°. Augustus: Een BANKET en KOEKBAKKERS-BEDIENDE alle vereischten grondig verstaande. Alleen zullen die in aanmerking komen met getuigschriften van bekwaamheden en zedig gedrag' (bij voorkeur R. C). Adres met franco Brieven Letter ü. bij Mej. de Wed. NIESTEN te Haarlem. *#* AAN H. H. BOUWKUNDIGE!.. ' Voor een' JONGELING oud 17 jaren van goeden huize en lid van de Hervormde Kerk die wel ervaren is in de Rekenkunde Algebra Vlakte- Driehoeks- en Ligchaamsmeting die een Meetkundig Examen afgelegd en zeer goede vorderingen gemaakt heeft in het Handen Kaartteekenen eenige bekwaamheid bezit in het Regtlijmg Teekenen en overigens eene algemeeu wetenschappelijke opvoeding heeft genoten wenscht men eene goede gelegenheid te vinden ter Theoretische en Practische on leiding tot Bouwkundige; wordende daarbij vereischt dat hij eenige voorname deelen van het Timmerwerk ei' genhaudig leere uitoefenen. Heeren Architecten hierop reflecterende gelieven hunne voorwaarden franco op te geven liefst met Kost en Inwoning aan L. BLANKENBIJL Kostschoolhouder te l)nmmelei_ bij Geertruidenberg.,http://resolver.kb.nl/resolve?urn=ddd:010518350:mpeg21:a0016:ocr,3,ddd:010518350:mpeg21:p003,Opregte Haarlemsche Courant,970
4590136,1851/12/11 00:00:00,5362,ddd:000020216:mpeg21:a0051,http://imageviewer.kb.nl/ImagingService/imagingService?id=ddd:000020216:mpeg21:p004:image&x=2049&y=51&w=1974&h=5362,ddd:000020216:mpeg21,4023,5413,2049,51,4,"¦——¦¦w________ il i ¦mm —_w_^-»_nw—»—_——————¦».—¦_»¦_¦———_¦_—m^ Voor Handel en Onderwijs. De Boekhandelaar J. OOM KEN f)  J.zoon te Groningen  heeft uitgegeven : J. Jaeger GROOTE KAART VAN EUROPA ingerigt voor den Handel en het Onderwijs en opgedragen aan het Nederlandsch Onderwijzers-Genootschap in 6 Bladen. Atlas tormaat. f 6.00. J. van Wijk Roclandscn. en J. Jaeger ATLAS DER GEHEELE AARDE. Ten dienste van Nederlanders  naar de laatste ontdekkingen en vorderingen in de Aardrijkskunde bewerkt Bevattende in 34 Kaarten de Wereldkaart de Werelddeelen de Landen van Europa de Provinciën van het Koningrijk der Nederlanden en de Nederlandsche Overzeesche Bezittingen f 9.00. (7417) Dezelfde Atlas gebonden in Half Linnen Band. f 10.00. (7412) WILLIAM THORN  Corr ot tier de Londrët (10 John St. Oxford Street) veut prevenir les Mess. qui ne lui ont pas encore honoré de leur commande qu'il part pour Londres Samedi le 13me Dee. Il reste Jeudi le 1 Ime a I'Hótel Mareehal Turenne d la Haye; et Vendredi le 12me__ V Hotel des Bains a Rotterdam. Il a Dessins de toutes espèce de VOITCRES et . toutes prix. "" jC=a J- F- L"" de VlieglT Jjjgggg^^^M berigt ontvangen te hebben : nieuwe feffflir extra solide Fransehe PIANI' m |M NOS  alsmede eene PIANINO S_l-S=sp_s!g3^L dOecasion voor welker deugdzaamheid geguarandeerd wordt. Hij recommandeert zich voor het Stemmen en Re» pareren. (7415) Adres: Boerensteiger wijk 10 No. 39. _-^ De Ondergeteekende neemt de vrij!j||l heid zich aan te bevelen voor het £.'"". maken stemmen repareren pH en vernieuwen van PIANO'S gJ.' en PIANINO'S en al hetgeen daarsbß&' op betrekking heeft belovende alles te zullen aanwenden om de genegenheid zijner Begunstigers waardig te zijn. Rotterdam (7409) W. Geo. A. RIJKEN. 10 December 1851. Posthoornsteeg  wijk 2 No. 148. ~;s|| Door bijzondere omslan* 1 - digheden mit de hand te hoop een uitgy- iillw muntende 6£ Octaafs PIANI* -££l_\mW jj^j sterk en aangenaam van Toon. in Palisanderhouten Kast voor een civilen prijs; voor de deugd wordt geguarandeerd. Te bevragen bij de ER^EN PEYPERS Hoogstraat wijk 10. No. 67. (7425) «p+r _r.y~l__ Een JONGELING oud 17 jaren .^""""van fatsoenlijken Huize niet onbekend It*mam& met de Engelsche Fransche en Duitsche Talen  zag zich gaarne op een geacht Koopman*- °' Commisslonnalrs-Hantoor geplaatst Hierop Rellecterenden gelieven zich schriftelijk onder de letter H te adresseren bij de Boekh. M. WIJT en ZONEN. (74-1) twArm*~'S^-m. lEMAND met de Fransche EngelÏS sche en Hoogduitsche Talen bekend  eene i=f**fc_s^ goede hand schrijvende zag zich gaarne hier ter Stede geplaatst zullende meer op eenige vooruitzigten dan wel op groot Salaris gereflecteerd worden- Adres lett. A B . bij //. T. HENDRIKSEN  Boekhandel en Drukkerij Hoogstraat 7 58. (7414) f-r... . In een Winkel wordt gevraagd een 11l fatsoenlijk JONGELING niet beneden S**""«i_S_' de 16 jaren; er bestaat des verkiezende gelegenheid tot opleiding in het vak. Adres onder letter F bij H. T. HENDRIKSEN Boekhandel en Drukkerij Hoogstraat 7 58. (7418) f'*W -\_._i___^ 1L PJFrLETIER Onderwijzer te .s£' "" Stryen Provincie Zuid-Holland vraagt tf**w«-*y zoo sroedig mogelijk eenen ONDER"" MEESTER van den' aden of Sden Rang  P. G. goed bekend met 's Prinscns Leerwijze en de Zangkunst  die bewijzen kan overleggen een goed Schoolhouder te zijn en zij die grondig Onderwijs in de Wiskunde kunnen geven zullen bij voorkeur in aanmerking komen; ""terwijl men in de gelegenheid is zich bij hem in de Fransche Engelsche en Hoogduitsche Talen te oefenen. Brieven franco doch liefst in Persoon. (7431) LEES HIER. De MAN en de VROUW . die zich in den laten avond van 1 Augustus 11. bevonden hebben op den Weg -a*l Bergschenhoek naar Rotterdam en die kort vóór Ilillegersberg achterhaald ziju door een MAN  welke met hen tot Rotterdam is mede gewandeld  en hun gesproken heeft over eene vreeselijke daad waarvan hij beschuldigd werd worden ten dringendste verzocht ten spoedigste hunnen naam en woonplaats op te geven bij den Boekhandelaar BELINFANTE 's Gravethage onder de letters B. G. P. daar het eene zaak van liet grootste gewigt geldt. (7066) Verloren. Op gisteren 10 December op het Willemsplein of den aanvang van de Willemskade: Een klein Papieren DOOSJE  waarin een Gouden Medaillon met Daguerrotype-Portret. Die hetzelve teregt brengt aan het Bureau dezer Courant kan de volle waarde tot belooning genieten. (7423) (7408) Bij den Uitgever H. NI.IGH ïeßotlerdam is van de Pers gekomen: DOK CAS Jaarboekje tooi* 1852. ONDER REDACTIE van W\ _J. HOJFDrjTK. Pr||«. f a 30.",http://resolver.kb.nl/resolve?urn=ddd:000020216:mpeg21:a0051:ocr,4,ddd:000020216:mpeg21:p004,"Nieuwe Rotterdamsche courant : staats-, handels-, nieuws- en advertentieblad",1974
2426544,1851/09/14 00:00:00,2466,ddd:000020128:mpeg21:a0056,http://imageviewer.kb.nl/ImagingService/imagingService?id=ddd:000020128:mpeg21:p004:image&x=2994&y=2020&w=984&h=2466,ddd:000020128:mpeg21,3978,4486,2994,2020,4,"I gebakgau's water. Ontvangen eene bezending verseh GEBANGAN'9 WATER  gevuld op nieuwe Model-Kruiken bij ROGGENBACH & VAN DER HOOP. Rotlerdam in September 185 L. (5543) af-""* In eene Apotheek te Rotterda» '""''' wordt gevraagd een LEERLING. '?'•¦¦»**-::>-' Adres onder letter N  bij den Boekhandelaar H. A. KRAMERS te Rotterdam. (5563) fi -.-is*. Er wordt £evraag(l een JONGELING tusschen de 14 en 16 jaren atW_S_f oud eene goede hand schrijvende voor* j loopend Kantoorwerk. Adres met franco brieven  onder i letter Q aan het Bureau dezer Courant. (5572) _____ G*""'^ kunnende verdienen en geen geld 'y.^ hebbende zoo wordt gevraagd een : ""f«-ia__S_gF _ DEELGENOOT die ƒ3OOO kan bijbrengen. Hierop reflecterende adressere men zich met ! franco brieven onder letter K  bij F. J. W. KLOOS| TERMAN. (5574) Gymnasiën. A. C. KRUSEMAN te Haarlem heeft uitgegeven ; ten gebruike in Gymnasiën en bij Privaat-onderwijs: Dr. E. F. Bojcsen HANDBOEK DER ROMEINi SCHE ANTIQUITEITEN benevens eene korte Geschiej denis der Romeinsche Letterkunde naar het Hoogduitsch | van Dr. J. Hoffa  door Dr. H. C. Michaelis . Rector !te Enkhuizen. Tweede vermeerderde en verbeterde druk. f 2 10. I HANDBOEK DER GRIEK! SCHE ANTIQUITEITEN naar het Hoogduitsch vam Dr. J. Hoffa  door Dr. H. C. Michaeu.  tweede herziene en vermeerderde druk f 1.90. 11. C. Michaelis EPITOME ANTIQUITATUM ROMANARUM et GRAECARUM Ex Bojesenii dc ..n---tiqiiitabu. libres f 1.30 (5367) ODÉON. ZONDAG 14 SEPTEMBER 1851: i VOCAAL BN INSTROXERTAAL COHCBRT door de beroemde Bachsche Concert-Gesellschaft uit Bonn onder directie van den verdienstelijken Orchest*Directeur TWenigtnann. Waarop zal ten gehoore gebragt worden: Nicu.tr i Lied van Turijn te zingen door den Heer Peretti ' Solo-Tenor van het Mannersangverei.u tc Bonn. Ouver! t nres Zampa. Freyschütz. Nieuwe Fantasten met Solo's uit la Juive Ireyscfriils enz. enz. ' Entree ƒl gedeeltelijk in vertering. 8 Ure. F. TORCHIANA. NB. Geene Diploma's noch Societeitskaarten gangbaar. Maandag 15 Septemb.: VOCAAL EN INSTRU MEN TAAL CONCERT. (5516)",http://resolver.kb.nl/resolve?urn=ddd:000020128:mpeg21:a0056:ocr,4,ddd:000020128:mpeg21:p004,"Nieuwe Rotterdamsche courant : staats-, handels-, nieuws- en advertentieblad",984
922548,1851/03/13 00:00:00,957,ddd:000019909:mpeg21:a0053,http://imageviewer.kb.nl/ImagingService/imagingService?id=ddd:000019909:mpeg21:p004:image&x=2052&y=4517&w=964&h=957,ddd:000019909:mpeg21,3016,5474,2052,4517,4,(1556) De Boekhandelaar H. NIJGH te liotterdam heelt verzonden de TWEEDE AFLEVERING van: de NEDERLANDSCHE SCHEEPVAARTWETGEVING door M. Was Bias Verslaggever van de Handelingen der Kamers. Deze Aflevering bevat het vervolg en slot van het Geschiedkundig Overzigt onzer Handels- en Scheepvaart wetgeving  sedert de vereeniging met Beliiè'' en behandelt meer bepaald: de intrekking der GRAAN WET; de TRACTATEN tusschen Nederland en andere Rijken gesloten  met ophelderende aanteekeningen en onlangs ter sprake gebragte punten daarmede in verband; de STATISTIEK van Handel en Scheepvaart in 1849. Wijders als Tweede Hoofdstuk. DE HERVORMING DER ENGELSCHE SCHEEPVAARTWETTEN met de vertaling der Engelsche Wet van 26 Junij 1849  en eindelijk  als begin van het Derde Hoofdstuk de omschrijving van INHOUD en STREKKING der Nederlandsche Scheepvaartwetten bij wijze van Algemeen Geschiedkundig Overzigt. De DERDE Aflevering waarmede het EERSTE DEEL compleet zal zijn is ter perse; behalve het vervolg en slot van dat algemeen overzigt worden daarin behandeld eenig» der afzonderlijke vraagstukken aangeduid in de Inleiding.,http://resolver.kb.nl/resolve?urn=ddd:000019909:mpeg21:a0053:ocr,4,ddd:000019909:mpeg21:p004,"Nieuwe Rotterdamsche courant : staats-, handels-, nieuws- en advertentieblad",964
7502676,1851/07/07 00:00:00,3983,ddd:010060282:mpeg21:a0020,http://imageviewer.kb.nl/ImagingService/imagingService?id=ddd:010060282:mpeg21:p005:image&x=46&y=131&w=2545&h=3983,ddd:010060282:mpeg21,2591,4114,46,131,6,"inden Oudenbroekpolder in de Gemeente Rijswijk Jijt ifirV  grool 3 bunders 19 roeden 4 ellen  op den \>''l'ri'_\^^°P]fS__y_f kadastralen legger voorkomende in sectie F n°'. s*/so^^sp. 57 59 tot en met 62 376 tot en met 579 aafTgeslagen m 'i de grondbelasting over den jare IÜSI  voo/ ongebouwd eigendom tot ƒ 29.63 en voor gebouwd tot ƒ 104.71 in sluisgelden binnenlandsehe kosten over 1850 toty 12.15 en in het molengeld toty 12.51. 2°. Eeue naar den laatsten smaak aangelegde OVERPLAATS  aan het eerstgemelde perceel riante uitzigten gevende met bare Bosschen Vijvers bepotingeii en beplantingen; staande op dezelve Overplaats een onlangs nieuw gebouwde KOEPEL  verder STAL en KOETSHUIS alsmede BOSCHWACHTERSWOiNIMr alles gelegen langs de Vliet van 's Gravenhage en ook uitkomende aan den Schelweg in den Plaspoelpoider onder Rijswijk te zamen groot 3 bunders 88 roeden 32 ellen  bij het kadaster beken iin sectie G  nu. 85  86i.-v 88 210 834 886 840; 841 en .sectie F  n°'. 408 alsmede nog een klein gedeelte van sectie G n°. 32; aangeslagen ia de grondbelasting over den jare 1851  voor ongebouwd eigendom tot ƒ 31.-45 en voorgebouwd lot ƒ 16.03 in sluisgelden en binnenlandsehe kosten over 1850 tot ƒ 14.00 eu ii"" liet molengeld toty 5.98; te aanvaarden bij de betaling van den koopprijs met 15 October 1851  en kunnende 3 malen 's weeks worden bezigtigd op Maandag Woensdag en Vrijdag van des voormiddags 11 tot 3 ure op toegangbiljet (en verkrijgbaar len kantore van de Notarissen F. M. Sohmolck  te 's Gravenhage en J. JV. Schuurman le Rijswijk bij wie nadere inlormatien zijn te bekomen ; terwijl bij Laatstgenoemden de voorwaarden van verkoop acht dagen vóór de veiling zullen ter u'sio liggen. ■ tßfflHaSav Men is van meening len overstaan van den Notaris »ü ra v*l' DM BERGH residerende te 'sGravenhage iv HE I het openbaar in liet VENDUHUIS DER NOTAaiSöEJ»;  SMIS """"""W DX NO3Er..3XE.iiAT aidaar op Maandag deu i^s|^ .T ul ij 1851 «les namiddags ten '5 ure te veilen en op Maandag den 23 daaraanvolgende des avonds ten 7 ure  te verkoopen ; N°. 1. Een hecht sterk en sedert weinige jaren geheel vernieuwd HUIS met ACHTERHUIS en ERVE staande en gelegen aan de noordzijde van de Katerstraat te 'sGravenhage wijk T 248 kadaster sectie S n°. 802; bevatlende het Huis twee beneden- mi eene bovenkamer twee zolders en kelder en bet Achterhuis één vertrek  zolder en kelder ; in gedeelten verhuurd met de week  renderende te zamen ƒ 260 'sjaars ; aangeslagen in de grondbelasting over 1851  wegens gebouwd en ongebouwd eigendom  mcl / 20.68. .V. 2. Een BLOK van drie HUIZEN en ERVEN staande eu geleden in het Marionetten Slop uitkomende aan de zuidzijde van de Ragijueitstraal le 'sGravenhage wijk Q n»1. 300 31)1 en 803' kadaster sectie G n"". 599 000 en 601  verhuurd bij de week i.-e.leren.ie le zamen ƒ 249.60 'sjaars; aangeslagen in .de grondbelasting  als voren niel f 15.13. De voorschreven percelen kunnen op den 1 October 1851 bij da betaling dei- kooppenningen worden aanvaard en zijn te bezigtigen des Maandags en Donderdags des namiddags tusschen 1 en 3 ure. Nadere informatiën zijn te bekomen ten kantore van voornoemden Notaris van den Bergh alwaar in tijds de bewijzen van eigendom en de verkoopvoorwaarden ter lezing zullen liggen. JjC§'Sl&r Men is van meening ten overslaan van den Notaris WsTS V.. .). vas dk WATERING te 's Gravenhage in bet gg BÜ VENDUHUIS DER NOTARISSEN IN DE NOBEESTRAAT if'SS te 's Gravenhage op Maandag den 21 Julij 1051 des .fflli->l^iM. namiddags ten 5 ure le veilen en op Maandag den 28 daaraanvolgende des avonds len 7 ure te verkoopen: ]\o i. Een hecht en sterk MUIS en ERVE met ecu stuk onbebouwde GROM) daar achter slaande en gelegen aan de noordzijde van het Lage Westeinde bij de Loosdiiinsche Brug te «Gravenhage wijk A n°. 56 verponding n°. 01 kadaster sectie C n°. 46 groot 3 roeden 98 ellen; bevattende bet Hnis (""en' ruimen winkel of voorhuis benevens drie groole vertrekken keuken drong- en turfzolder en hetgeen verder lot eene geschikte woning behoor! ; aangeslagen in de grondbelasting over hel jaar 1851 met /'21.01. Jv.o. 2. Een BLOK van acht IiUIZE.'v en ERVEN benevens twee SCHUURTJES waarvan één Huis voor aan straat en zeven in een' gang op poort daar achter staande en gelegen nevens bet voorgaande perceel wijk A n°. 50 tot en met 55 verponding n°. 58 10l eu met 03 kadaster sectie C n°. 39 groot 14 ellen 40 groot 21 ellen 41 groot 20 ellen 52 groot 19 ellen 42/ n.s groot 16 ellen 43 groot 17 ellen iSbis groot 1 roede 67 ellen  44 groot 17 ellen en 15 groot 23 ellen; aangeslagen als voren met ƒ50.92. N°. 3. Een hecht en sterk WINKELHUIS en ERVE aau den Zuidoost Buitensingel oi' Uileiiboomcn  le 's Gravenhage wijk M n°. 889 verponding n°. 310 kadaster sectie B n°. 700 groot 86 ellen; aangeslagen als voren met ƒ 15.655. De voormelde percelen zullen kunnen worden aanvaard bij de betaling der kooppenningen  op I°. November 1851  en bezigtigd tweemaal 's weeks op Dingsdag en Woensdag des namiddag van 2 tot 4 ure; zijnde nader* onderrigting te bekomen ten kantore van voornoemden Notaris en van Mr. B. van der Haak op den Fluweel en Burgwal alwaar in tijds de conditiën der verkooping teilezing zullen liggen. SNÉnfi Men zal in bet. VENDUHUIS DER NOTARISSEN IM DE NOBEESTRAAT te '.sGravenhage in het openbaar fflUi ""P Maanclibr> clt'"" 28 JuliJ 1801 ' des namiddags ten 5 ure »||p<j™ veilen en op Maandag den 4 Augustu» daaraan volgende J>- ~'iV. des avonds ten 7 ure verkoopen: N°. 1. Een kapitaal hecht  sterk en extra goed onderhouden DUBBEL HUIS ERVE en groolen TUIN met TUINKAMER staande en gelegen aan de noordzijde van dc Prinsegracht op de Bloemmarkt tev's Gravenhage wijk W n°. 111 verponding n°- 110 kadaster sectie L. n°. 4üB  groot 7 roeden 80 ellen hebbende de tuin eenen Witgang op de Laan over de Jan Hendrikstraat; bevattende het gemelde huis een aantal zoo boven- als bedenkamers en kabinetjes waaronder bijzonder uitmunten cene groote Zaal met gobelin behangsel en kostbare wit marmeren schoorsteen alle geplafonneerd en mcl spiegels of schilderijen in de scboorsteenen ol boven dedcuren ; onder welke schilderijen zich onder anderen bevindt ecu groot stuk van den schilder Eekhout; voorts ruime vestibule trap met extra fraai stukadoorwerk groote droogzolder  provisie-en dienstbodenkamers ruim goed droog onderhuis met afzonderlijken ingang waarin groole keuken kelders kncchlskanier en hetgeen verder tol eene gemakkelijke en aanzienlijke woning behoort: aangeslagen in de directe belastingen als gebouwden ongebouwd eigendom over 1851 met ƒ 176.51. N°. 2. Een onlangs bijua geheel vernieuwde STAL voor zes paarden > bijzonder ruim en goed van alle gemakken voorzien gestukadoord KOETSHUIS met vaste Tuigenkasten KOETSIERSWONING groote Hooizolder Plaats waarop Mcstput  niet afzonderlijken uitgang alsmede TUINTJE staande en gelegen aan de zuidzijde van hel Hoogezand te'sGravenhage wijk V n°. 298 verponding n°. 278 kadaster sectie K n-. BGo groot 2 roeden 7Pellen ; aangeslagen in cle directe belastingen  ais gebouwd en onge bouwd eigendom over 1851 met ƒ 87.94; te aanvaarden bij dc betaling van den koopprijs opden 1 November 1851  en kunnende  tweemalen 's weeks worden beaigtigd op Dingsdag en Dnnd-rdag van 12 tot 4 ure mits voor het perceel n°. 1 bevorens belet wagende. Nadere informatiën te bekomen ten kantore van de Notarissen F. il. Schmolck le 'sGravenhage eu J //"". Schuurman te Rijswijk; terwijl bij eerstgemelden de voorwaarden der verkooping en bewijzen van eigendom  acht dagen vóór de veiling ler inzage zullen liggen. *-* In de maand September of October aanstaande zal  ten overstaan van den Notaris SCHMOLCK te 'sGravenhage in het openbaar worden verkocht een aanzienlijk HEERENHUIS met grooten TUIN STAL en KOETSHUIS staande op een' der deftigste en aangenaamste standen aidaar. awrw^ OPENBARE VERKOOP!!*-*» van ZEVEN REFORMjP^ty^ PAARDEN op Maandag den 14 Julij 1851 dcv nainid£_____jj______\___B dags ten één ure bij de Caserne bewoond door het 2de regement Dragonders alwaar die Paarden een uur vóór de verkooping te zien zullen zijn. Op last de Kapitein-Kwartiermeetter bij voormeld corps  MUSJE SM. *#* Men zal op MORGEN Dingsdag den 8 Julij 1851  des namiddags ten 5 ure ten huize van J. Hartens to Rijswijk in het openbaar  VERPACHTEN het GRASGEWAS van S bunders  59 roeden 40 ellen Lands  in den Noordpolder onder Rijswijk kadaster sectie A n°. 163 en 164; de betaling op den 1 November 1851.",http://resolver.kb.nl/resolve?urn=ddd:010060282:mpeg21:a0020:ocr,5,ddd:010060282:mpeg21:p005,Dagblad van 's Gravenhage,2545
5752956,1851/04/22 00:00:00,5412,ddd:000019948:mpeg21:a0051,http://imageviewer.kb.nl/ImagingService/imagingService?id=ddd:000019948:mpeg21:p004:image&x=31&y=185&w=1063&h=5412,ddd:000019948:mpeg21,1094,5597,31,185,4,"GENERAL-SCREW-STEAM-SHIPProG-CÖIIPAM [Incorporated by Royal Charter.) DIENST TUSSCHEN ROTTERDAM en LONDON. VOOR GOEDEREN EN TEE. Het Engelsche Sehroefstoomschip EARJL OF AI7CKI.AIVD Kapitein William Wintle Vertrekt Woensdag 23 April des morgens. Adres tyj de Agenten GEORGE LEVINGSTON en J. A. HOUWENS te Rotterdam en W. H. CAREY te London. (2427) Stoomboot-Dienst TDSSCHBN Rotterdam en Huil Voor PASSAGIERS GOEDEREN en VEE. Het nieuw gebouwde IJzeren Sehroefstoomschip Canterton  Kapt. H. Cross  vertrekt van Rotterdam naar Huil aanstaanden Woensdag morgen den 23sten April des morgens ten 4 ure. Adres bij BOUTMY & Co. (2499) Stoompacket-Vaart TUSSCHEN ROTTERDAM EN HAVRE. GEREGELDE DIENST. In Correspondentie voor PASSAGIERS en GOEDEREN met de geregelde AMERIKAAN SCHE PACKETTEN tusschen Havre Xetc- Xorh en Weac- Orleans. De Stoompacket Rot f erdatn Kapt. Coütard vertrekt DONDERDAG 24 DEZER des morgens. Adres ten Kantore van SMITH & Co. Boompjes 1 No. 187. (2482) _^X»^'ÏT;^E^IJ/_jtik °P -Ma«»«tia_f •*'* tipril MERWEDE^ StoomJagt hebbende Machines van lage drukking tiissclien GORINCHEM DORDRECHT ROTTERDAM en tusschen liggende Plaatsen viee versa. APVAART: OPVAART: Zondag van Zondag van Gorinchem 'smorg. 6_ ure. Rotterdam 'snamidd. 5 ure. Dordrecht circa 7 f - Dordrecht circa 6 - Maandag en Dingsdag van Maandag en Dingsdag van Gorinchem 's morg. 51 ure. Rotterdam 's namidd. 2 ure. Dordrecht circa 7 - Dordrecht circa 3 * Woensdag Donderdag Woensdag Donderdag Vrijdag en Zaturdag van Vrijdag en Zaturdag van Gorinchem 'smorg. 5£ ure. Rotterdam 'smorg. 9 ure. - 'snamidd. 1 - - 'snamidd. 5 - Dordrecht circa 7 - Dordrecht circa 10 ~ r #2_» » »6- De Directie maakt bekend dat door de snelle vaart van het Stoomjagt gelegenheid bestaat om met den IJzeren Spoortrein des morgens ten acht ure van 's Gravenhage naar Rotterdam door te kunnen reizen naar '* Hertogenbosch  in correspondentie met de Stoomboot die ten twaalf ure van Gorinchem vertrekt. Ook bestaat er gelegenheid met de Boot van één ure van Gorinchem om bij aankomst te Rotterdam met de Diligence van den Heer J. P. KOENS ten vier en een hall ure naar '* Gravenhage te vertrekken. Correspondeert met de meeste afgaande en aankomende Treinen bij welker aankomst even als bij aankomst der Boot de Reizigers met hunne Goederen van en naar den Spoortrein worden gebragt. Informatiën zijn te bekomen bij de Directie P. SMIT en Co. aan den Kinderdijk en verder bij de Commissarissen te Gorinchem den Heer W. VAN OOSTERDIJK Wz. te Dordrecht Mejufvrouw de Wed. A. VERHEUL aan het Rietdijksche Hoofd te Rotterdam den Heer J. v. d. MADE aan de Oude Hoofdpoort. (2446) Ifcfi^ l\aar Curapao yfeyj|^^ COIRECT) v\___f\ j*^ JmÉ^- gt te Motterdam in Lading M_t_\*\ _JiïQ}S_E^ om sPoedig na zijne binnenkomst te WlÊS___^Z_3_&_TËKË ver trekken. het Gekoperd en Kopervast Galjootschip JttaracaXbo  Kapitein W. C. Kool  voor GOEDEREN en PASSAGIERS. (1825) Te bevragen bij den Reeder H. VAN RIJCKEVORSEL •n bij de Cargadoors HUDIG en BLOKHUYZEN. gSh-ajaL Te Rotterdam ligt 'Qr ?|§yj^b. Naar VALPARAISO het >»^pl? ¦¦ /Jffiß»r^_^_ tyJzoncler Snelzeüend Gekoperd Schoenerschip Ceres Kapt. Hendrik de Vries. Vertrekt uiterlijk den \sten Mei. Adres ten Kantore van KUYPER VAN DAM en SMEER alhier en A. PRINS en Co. te Schiedam. (1794) £&z3È*~""' Naar Newyork ijjLvw^r&È^ ligt in Lading te Amsterdam .iM^sy--^WP^_k. het nieuw Gekoperd extra Snel__*B^-/tJI J___W_-^^ zei'enc' Tweedeks Barkschip het ¦'KSi-awL-ïl-ÏSaSB^ Goede Vertrouwen Kapi tem D. A. Zijlstra. Adres bij de Cargadoors de WED. JAN VAN WESEL en ZOON of WEHLBURG en \ER aldaar. (2472) Publieke Aanbesteding. & De CÓ_ÏMISSIE vaa OPPERTOEZIGT en KERKMEESTEREN over de GOEDEREN behoorende tot het HERVORMD KERKGENOOTSCHAP te Zwijndrecht V zijn voornemens onder nadere approbatie van de Edele V AcKtbare Heeren GEDEPUTEERDE STATEN dezer Provincie in het openbaar aan te besteden op Woensdag den 7den Mei 1851 des voormiddags ten elf W|> in bet Gemeentehuis van Zwijndrecht bij L. DE J Jlc[ l°«-'«--» van een NIEUW WOONHUIS en GE*'OLGBBL dienende tot eene zoogenaamde Pastorij ii""ift-Bjlant van gemelde Hervormde Gemeente lB«3i) een stukJ|Hd gelegen aan den Grooten Weg onder _^y'»_*/*-«A^*aekadastreerd sectie B nummer 1183 gedeel-",http://resolver.kb.nl/resolve?urn=ddd:000019948:mpeg21:a0051:ocr,4,ddd:000019948:mpeg21:p004,"Nieuwe Rotterdamsche courant : staats-, handels-, nieuws- en advertentieblad",1063
2391778,1851/07/24 00:00:00,4811,ddd:010518374:mpeg21:a0020,http://imageviewer.kb.nl/ImagingService/imagingService?id=ddd:010518374:mpeg21:p003:image&x=78&y=99&w=2894&h=4811,ddd:010518374:mpeg21,2972,4910,78,99,4,"Telt! De ""nd«rge«*ekende1 sedert eene reeks van jaren Kostscboo houder te Breda beveelt zijn INSTITUUT on meuw n de aandacht vau Ouders of Voogdendie hunne £ Bred°a MS Vool' f K°»inkl^ Militaire Akadem.--13. en..Dflft wenschen opgeleid te hebben. Vangrou- Se.iikfr!'IJS I'Rlle 7akkeu' beneveas godsdienstig en zedelijke opvoeding kau meu zich verzekerd houden. W. H. J A N S S E N. MEEStS VrHagi te^U S*Pte«ib'^st.: EenONDER? MEESTER van den 3«™ Rang bekend met de leerwild enT IZTr dCn ZTDg CU *eschikt voor de K«kl feF^fe^^rdeu Boekhftnd- ONDP^Mlr^lV6^11 ?7tob« °f NoTe^eTeXTËeli' ONDERMEESIER van den 4««. Rang. Boven de gewone voordcelen geniet men eenig Salaris. «egew.ua Belanghebbenden adresseren zich met franco Brievo.. onder de Letters H.M.K. bij den Boekhandelaar H n van STEEDEN te Hellevoetsluis. anaelf""» «• G. V ?AVAN DER VELDEN> °ade7^-ei^el_^roi redyk (Gemeente Naaldwyk)  vraagt AeKenTa.fSep _ aanst. of vroeger: Eenen geschikten ONDERMPPq TER van den 3^.. Rang in staat zynde de SL van den Heer Prinsen te kunnen onderwijzen etlZ fl*f uiterlijk hebbeude en de Herv. Godsd \Jvi\a!^ goed gen Kost Inwoning Bewas chen en een%""de' te' ƒBO- 's jaars. Men vervoege zL_l in Saans vau >*22_J__i__2!_^^ met bekend met de Frausche T«_J f i • Godsdie^t en beden. Ook is er gelegnlJidiotnlt*™ bekwaair- JONGE LIEDENrïK!iïiSÏiStB TaneeüPaar LiHJK^Wrf Adres te Amersfoort. UU W-R» Boekbinder *** Men vraagt tegen den lstfn Sept op zeer aannemelijke voorwaarden: Ecu SECONDANT van den 2im of 3at"" Rang en van de Protest. Godsdienst. Brieven franco onder Let. X aan den Heer W. J. THIEME te Zutphen. V Een JONGELING 20 jareu oud van de P. G. den 3d™ Rang bezittende en in staat om in het onderwijs der Frausche Taal behulpzaam te zijn zag zich gaarne tegen genot van Inwoning Kost en eenig Salaris opeen welingerigt Instituut geplaatst. Adres franco onder Letter L aan de Boekverkoopers LOMAN & REUDLER in de Kalverstraat . hoek van de Jonge Roelensteeg N°. 11 te Amsterdam. *%* Men vraagt op een' Korenmolen in Zuid-Holland : Ecu BAAS of MEESTERKNECHT volkomen in staat om een' tamelijk drukken Korenmolen te kunnen dirigeren. Diegenen welke reeds in betrekking als Zetbaas zijn werkzaam geweest en voldoende informatien kuunen leveren zullen het meest in aaumerking komen. Adres) alleen franco Brieven onder Letter A. bij J. 11. KNOOP op 't Donkere Spareu te Haarlem.",http://resolver.kb.nl/resolve?urn=ddd:010518374:mpeg21:a0020:ocr,3,ddd:010518374:mpeg21:p003,Opregte Haarlemsche Courant,2894
4395396,1851/06/02 00:00:00,4191,ddd:010805309:mpeg21:a0026,http://imageviewer.kb.nl/ImagingService/imagingService?id=ddd:010805309:mpeg21:p003:image&x=63&y=86&w=2732&h=4191,ddd:010805309:mpeg21,2795,4277,63,86,4,"ga-. (4 77 9) V Op Zaturdag ?^S--b|ba3_|""llïl en -'-den Junij 1851 des namiddags ten een ure precies zal men aan het lokaal van verkoopingen binnen Utrecht achter St. Pieter publiek verkoopen: Eene kapitale HOFSTEDE genaamd VEELUST met wel betimmerde HEEREN- en BOUWMANS-WONING Achterhuis Schuur Berg enz. uitmuntende Boomgaarden Tuin Wei- Hooien Groenlanden te zamen groot 25 bunders 26 roeden 45 ellen io het Nedereinde van Jutphaas. De Hofstede verhuurd voor ƒ 850 en het Heerenhuis voor ƒ 180 in het jaar met uitzondering der Boomvruchten welke na eene 12jarige doorsnijding hebben opgebragt ƒ 398 in het jaar. Eene HUIZINGE genaamd BONENBURG met ERF GROND en TUIN ingerigt tot Bloemisterij groot 18 roeden 5 ellen staande en gelegen voor het vorige perceel en verhuurd voor ƒ1 70 in het jaar. Welke beide perceelen te zamen een schoon geheel uitmaken en derhalve in eene massa zullen worden geveild. Breeder bij billetten en nader onderrigt te bekomen ten kantore der Notarissen STEVENS en BUSKES te Utrecht. J*% (4780) V Op Zaturdag 14 Junij 1851 _■*. 's namiddags ten 5 ure zal in het Verkoopings Locaal te Utrecht achter St. Pieter in het openbaar worden verkocht: No. l. Een HUIS en ERVE staande te Utrecht aan de Westzijde van de Jeru-alemsteeg wijk F No. 43 4. En No. 2. Eer.a WONING en GROND staande te Utrecht aan de Noordzijde van het Zilversteepje wijk B No. 763. Breeder bij biljetteu en nader onderrigt ten kantore van den Notaris H. DUYFJES te Utrecht. (4781) V Verkooping van HOOIGRAS en NAWEIDE op de uitterwaarden van den Huize AMERONGEN op Dingsdag den 17den Junij 1851 namiddags om 4 ure in de herberg de Ronde Leeuw. te Amerongen. (gMl\ (4782) V Men zal op Zaturdag den Inj'|.3 21sten Junij 1851 des namiddags ten 5 __pi__J___ —--_-_- ure in het Lokaal van Verkoopingen achter St. Pieter te Utrecht in het openbaar verkojpen: No. 1. Een HUIS met grond en verder aanbehooreu waarin de Broodbakkerij met goed gevolg wordt uitgeoefend te Utrecht aan de Westzijde van de Vinkenbirrgsteeg wijk G. No. 84 en S 5 verhuurd aan Jan van Dam lot 1 Mei 1852 om / 260 in het jaar; en No. 2 en 3. Vier WONINGEN met aanbehooren te Utrecht in wijk: 15 als: Één aan de Zuidzijde van de Braodstet-g jfo. SI 4 vtöroürd om 9u centen iv de v-■--:_. en. drie achter den ""Wal ütnslreeks de Zilversteeg No. 725 724 en 723 ieder verhuurd om 70 centen in de week. Breeder bij billetten omschreven to bezigtigen gelijk daarbij is vermeld en nader onderrigt te bekomen ten kantore van den Notaris DWARS. VERKOOPING EN DE BANK VAN LEENING TE UTRECHT. (4788) V De PANDEN welke beleend zijn van 1 Jan. 1850 tot 31 Maart 1850 zuilenuiterlijk 16. Junij 1851 gelost of afgedaan moeten worden. — De Verkooping zal in de Weeskerk plaats hebben Dingsdag 24. Junij 1851. - (4784) \* Naar NEW-YORK ligt te MR Amsterdam in lading voor goederen én lÖb' passagiers der eerste en tweede Klasse *És____% het buitengewoon snelzeilend gekoperd Barkschip CHINA kapt. D. A. Zidstra; adres bij de Cargadoors de Wed. JAN VAN WESEL f.n Zoon of WEHLBURG en BREUKER aldaar. LÏ¥i^TERT^ (47 85) ** De ondergeteekende heeft de eer het geachte publiek te berigten dat hij een Handel in KANTOOR- SCHRIJF- en TEEKENBEHOEFTEN etc. geopend heeft aan de oostzijde van de Oude Gracht in het buis van ouds genaamd het land van belofte tusschen de Wees- en Smeebruggen. Bekend met de voornaamste fabrieken zal hij alle zijne artikelen tot de laagste f rijzen leveren terwijl voor derzelver deugdzaamheid wordt ingestaan. J. EIJKEL. (4786) *«* Ondergeteekende maakt door deze aan zijne geëerde stadgenooten bekend dat hij zich op heden gevestigd heeft als KAMERBEHANGER wonende in de Minderbroederstraat N°. 269. Utrecht 1. Junij 1851. J. A. ten GEUZENDAM.",http://resolver.kb.nl/resolve?urn=ddd:010805309:mpeg21:a0026:ocr,3,ddd:010805309:mpeg21:p003,Utrechtsche provinciale en stads-courant : algemeen advertentieblad,2732
3192024,1851/10/08 00:00:00,3531,ddd:010805366:mpeg21:a0019,http://imageviewer.kb.nl/ImagingService/imagingService?id=ddd:010805366:mpeg21:p004:image&x=1869&y=755&w=904&h=3531,ddd:010805366:mpeg21,2773,4286,1869,755,4,"(5936) %* EENE ZWARE door gal en gebrek aan spijsvertering veroorzaakte ongesteldheid door de pillen van Holloway genezen. Khairatee Khau koopman te Patna in Oost-Indiën leed sedert jaren aan een galachtig gestel en gebrek aan spijsvertering en ofschoon hij de meest vermaarde gencesheeren zijner provincie raadpleegde vond hij niet alleen geen verlichting in de door hun voorgeschreven geneesmiddelen maar gevoelde zelfs dat zijne kwaal steeds toenam. Op zekeren dag een zwaardere aanval zijner ziekte als gewoonlijk hebbende besloot hij de pillen van Holloway te beproeven en dit door de geheele wereld zoo voordoelig bekonde middel herstelde hem binnen korten tijd geheel en al- en uit dankbaarheid voor deze weldadige uitwerking deed hij de bewonderenswaardige genezing opentlijk bekend maken. Zijn op franco aanvragen a contant te bekomen bij den Heer A. ï\ Milius te Utrecht bjj den Heer G. C. T< van be Roemer te Amersfoort en bij den Heer J. Straatman  Hoofd-DepSthouder te 's Kertogenbosch. alsmede te Londen Strand 244 Holloway's etablissement. Voor het vermeerderd debiet zijn de prijzen als volgt Doosjes Pillen _ ƒ 090 J 210 ƒ 330 f 775 / 1550 f 2530. Potjes Zalf _ ƒ 090 . 210 ƒ 330 enz. ' WAARNEMINGEN gedaan op het Meteorologisch Observatorium te Utrecht. (Zonnenburg.) . _ Wind- Barom. Thcr. Afwijk. Vocli- liev. ' ' o a ""'- -■ k'- biJ °° F d- temP- ''&■ ""sen Aanmerkingt*. mm — —————— 5 8 zzw. 2 75480525 0.92 01 Bewolkt. 2 zzw. 4 5531590— 0.7 7. 0 id 10 zzw. 2 5661(505 89 02 Zwaar bewolkt. 6 8 zzw. 3 5890;50.2 90 02 Bewolkt 2 zw. 3 5689|538 — 6.3 90 11 Zwaar bewolk-10 zw. 1 99 20 Ligt bewolkt. PRIJZEN DER EFFECTEN. AMSTERDAM 6 October 1851-. volgens de Societ. tot n-< OMSCHRIJVING. des Obligatie-Handels. van tot gebL Nederland. Werkel. Schuld. . . 2>/_ pCt. 58 _87„ 58t/4 dito dito 3 „ 69 69Vit 69 dito dito 4 „ 90'/4 90V_ »o__ Aand. Rlnjn-Spoorweg 4'/_ „ 9_r.2 Frankrijk Certificaten 3 „ 52V4 Rusland. bij Hope en Comp. .. 5 pCt. 106 106'/. 106'/. dito 1828 eu 1829. . 5 „ 105 dito dito 1840 ... 4 „ 89 Certificaten bij Stieglitz 4 „ 68' V Certific. van Assign. .6 „ 66 Spanje. Oblig. Ardoin. _ 85 5 pCt. 14% 14""/ n 148'« £ 510 5 „ 141'/ Onb. Stukken 5 „ 145/_ Obligatien 3 „ 38 Vg Binnenl. Schuld. ... 3 _. 35 ~„ Paasive 51/ Ardoin Coup sl/. Oostenrijk. Oblig. Metaiiek 5 - 72'/8 73'/. dito dito. N 4 „ 79 791 791/ dito 2'/_ „ 38 38'/. Bei.qie. Certific. bij Rotschild 2'/_ pCt. 48 PORTOOAL. te Londen 4 „ 3-*.a dito. . . 4 _ 33»/ Amerika. Mexico Obl. 1837 £ 100 5 „ 26V18 Spanje Fr. uitgestelde 35 ..; Denen 101 V.: Onde pCt. Metalliek 363._. Onze binnenlandsche fondsen waren heden onveranderd Spaansche en Portugesehe zonder variatie; Russische v»*' üüsteurijksehe in eene flaauwe stemmiug; van de over valt niets bijzonders te vermelden. -> Itrecüt by i_. E. BOSCH en Lomp.",http://resolver.kb.nl/resolve?urn=ddd:010805366:mpeg21:a0019:ocr,4,ddd:010805366:mpeg21:p004,Utrechtsche provinciale en stads-courant : algemeen advertentieblad,904
2193607,1851/10/02 00:00:00,2033,ddd:010276226:mpeg21:a0010,http://imageviewer.kb.nl/ImagingService/imagingService?id=ddd:010276226:mpeg21:p002:image&x=2251&y=2983&w=1079&h=2033,ddd:010276226:mpeg21,3330,5016,2251,2983,2,"HAARDEN EN KAGCHELS. Magazijnen: Langendelft B. 133 en groote Markt K. 4. £)e ondergeteekenden berigten dat zij uithoofde van buitengewone concurrentie alleen gedurende de eerste helft dezer maand met een rabat van 25 pCt. op de gewoue prijzen  en tegen comptante betaling verkoopen zullen  de bij hen voorhandene HAARDEN en KAGCHELS in de beste Fabrieken en naar de nieuwste modellen vervaardigd  en voor verschillende gebruiken geschikt. Zij zijn mede ruim voorzien van Engelsche HAARDSTELLEN en verdere STOOKBEHOEFTEN gegotene TUINBANKEN PARAPLUIE-STAANDERS en alle verdere artikels tot hun vak behoorende tot uiterst civile prijzen. ANT. V. D. BBOECKE GEBs- BOUDEIVIJNSE. In de volgende week staat te arriveren Schipper P. van Maaren van deze Stad met eene lading beste WINTERAARDAPPELEN ; adres bij J. de Kok op de Heeren gracht Wijk M. No. 31. "" £)e Boekverkooper J. C. de BUISONJÉ  Lange Groenewoud Wijk H. No. 20 te Vlissingen vraagt een LEERLING en LOOPJONGEN. Xegen November eene Burger DIENSTMEID benoodigd Wagenaarstraat Lett. D. No. 78. SPECIALE BEHANDELING van ZENU WZIEKTEN door den eenigen Bezitter der Remedie van den Eerwaardigen P.Bonhijver Apotheker van het Klooster der Capucijnen te Brussel ter radicale genezing van alle Zenuwziekten  Lamheid Vallendeziekte Moederwee en Hoofdpijn  Asthma. — Adres bij den Heer NISSE Keizerstraat No. 29 buiten de Keulsche Poort bij Brussel. — franco. Consultatien kunnen schriftelijk gedaan worden. •#. J. Ij. TEW MATE Predikant te Middelburg TWAALFTAL LEERREDENEN. Prijs f 290. Is te bekomen in den Boekwinkel van VAN BENTHEM & JUTTING.",http://resolver.kb.nl/resolve?urn=ddd:010276226:mpeg21:a0010:ocr,2,ddd:010276226:mpeg21:p002,Middelburgsche courant,1079
2939285,1851/09/19 00:00:00,2095,ddd:010583987:mpeg21:a0011,http://imageviewer.kb.nl/ImagingService/imagingService?id=ddd:010583987:mpeg21:p004:image&x=106&y=103&w=1403&h=2095,ddd:010583987:mpeg21,1509,2198,106,103,6,"Verkoop van een Heeren Huis Plaats en Tuin op het Noordvliet te Leeuwarden. r_e Notaris J. C. KUTSCH te Leeuwarden zal op Dingsdag den 23 Sep|em- II her 1851 bij Keizer in het Gouden Wagentje bij de Lange Pijp »""»« veilen rn op Maandag den 6 October daaraanvolgende bij de \ rus  i Dockumer Veerhuis aldaar telkens namiddags 4 uur finaal verkoopen: Eene hechte HEEREN HUIZINGE met PLAATS en TUIN lett. M no. Vö op b>t Noordvliet te Leeuwarden; verhuurd aan den Heer de Beer voor f in bet jaar; den 12 Mei 1852 te aanvaarden. To bezigtigen op de zitdagen van 10—1 uur. Verkoop vau drie Huizen in de Sacramentstraat lianiasteeg en Burinaniastraat te Leeuwarden. Do Notaris J. C. KUTSCH zal op tijd en plaats voormeld •m\ea koopen het Bde perceel ten verzoeke van den Deurwaarder L. HAIUI-^--.20N qq te Leeuwarden : _ 1. Eene HUIZINGE en ERF in de Sacramentstraat te Leeuwarden lett. K n». 23a beneden verhuurd aan de Jong voor f 160 in de week en boven aan Grim voor f 130 in de week. 2. Een HUIS PLAATS BLEEK en STEEG in de Haniasteeg aldaar lett. E n». 129; verhuurd aan c. d. Steeg voor f 070 aan Tijssel voor ƒ 065 en aan Gouwenaar voor f C.SÖ in de de week en eene Kamer dooi- den eigenaar G v. d. Broek bewoond. 3. E>n HUIS in de Burinaniastraat aldaar lett. F no. 52; verhuurd aan Joh*. Bruineman  vuur f 180 in de week. Alle perceelen den 12 Mei 1852 te aanvaarden. Te bezigtigen op de zitdagen van 10 —12 en van 2—4 uur. Verkoop van Thee Sigaren  Tabak Snuif Eau de Cologne enz. De Notaris J. C. KUTSCH te Leeuwarden zal ten verzoeke van S. TULP aldaar op Dingsdag den 7 October 1851 en volgende dagen telkens des voordemiddags 9 uur in de Koornbeurs bij de Weduwe Adama aldaar verkoopen : Eene aanzienlijke partij diverse soorten van beste Peceo- en groene THEE in Kistjes; SIGABÈN SNUIF EAU DE COLOGNE TOILET-ZEEP beste WIJNAZIjV enz. ; te bezigtigen op Maandag den 6 October 1851  van des voormiddags 10 tot namiddags 1 uur en van 8 tot 5 uur. De Goederen kunnen inmiddels UIT DE HAND WORDEN GEKOCHT tot den 26 September 1851 ingesloten  na welken tijd de specifieke Lijsten der Goederen zullen verkrijgbaar zijn. Nader onderrigt bij S. TULP. Houtveiliüg van zware Esschea Boomen. De Notaris J. C KUTSCH te Leeuwarden zal ten verzoeke van S. TULP aldaar op Donderdag den 9 October 1851  ten 9 ure voor den middag bij de Gaz-Fabriek verkoopen : 1 lading zware ESSCHEN BOOMEN en 3 ladingen EIKEN WOUDBOOMEN van onderscheidene zwaarte en lengte KROMHOUT HEK- en STEKPALEN LEGGERS en DAMLEGGERS ; voorts 48 beste zware ZEEUWSCHE- IJPEN- en BEUKEN-BOOMEN 5 zware LINDEBOOMEN POPULIEREN en eene partij 5 duims nieuwe SCHROTEN breed 10 en 12 duim; alles zeer geschikt voor Huis- er. Seheepstimmerlieden  Molen- en Wagenmakers Kastraakers  Kuipers enz.",http://resolver.kb.nl/resolve?urn=ddd:010583987:mpeg21:a0011:ocr,4,ddd:010583987:mpeg21:p004,Leeuwarder courant,1403
1731107,1851/08/29 00:00:00,4791,ddd:010518405:mpeg21:a0025,http://imageviewer.kb.nl/ImagingService/imagingService?id=ddd:010518405:mpeg21:p004:image&x=117&y=71&w=1923&h=4791,ddd:010518405:mpeg21,2040,4862,117,71,4,"Door W. H. van HEYNINGEN wordt dezer dagen verzonden : GODSDIENSTIG HANDBOEK VOOR DEN SEEMAÏÏs BLOEI- II DOORNSTÜKJES urn üjm «Biineit BB ¥H©ÏÏW adolphFmonod. EEN DER BESTE ROMANS VAN ONZEN TUD. *** Cp den lsl"""" Augustus 1851 is uitgegeveu en .aan de Inteekenaren verzonden: Het VIJFDE DEEL der OUDENKWAARDIGIIEDEN uit de GESCHIEDENIS van GELDERLAND door onuitgegeven oorkonden OPGEHELDERD F.N BEVESTIGD: DOOR Is. An. NYHOFF. Dit Deel omvat het Tijdvak der Bourgondische Heerschappij in Gelderland loopende over de jaren 1473 tot 1492. Het is eveu als de voorgaande ingerigt en van uitvoerige Registers voorzien. De Inteekeiiprijs is ƒ (i. - NB. Het vierde Deel vau dit Werk is uitgegeven in Augustus- 1847. Zij welke na dien rijd door aankoop uit de .nalatenschap vau Inteekenaren in het bezit der vier eerste Deelen gekomen zijn kunnen ook het uu uitgekomen vijfde Deel tegen lnteekenprijs bekomen.",http://resolver.kb.nl/resolve?urn=ddd:010518405:mpeg21:a0025:ocr,4,ddd:010518405:mpeg21:p004,Opregte Haarlemsche Courant,1923
2022124,1851/12/02 00:00:00,1924,ddd:010073105:mpeg21:a0054,http://imageviewer.kb.nl/ImagingService/imagingService?id=ddd:010073105:mpeg21:p006:image&x=2267&y=3302&w=1051&h=1924,ddd:010073105:mpeg21,3318,5226,2267,3302,6,"T (\V AA T IN HET VOORHOUT TE 'eo^ JjUiVJLIÜLJj ""He Avonden precies ten 8 Ure Voorstelli»*?'"" MEISTER-S DIORAMAS. (YïtWjy VERKOOPING VAN HUIZEN. ___*S Maandag 1 December in het O. Z. Heeren-Logement. i N\ 1. Huis Heerengracht bij het Reguliersplein ƒ 22000. / Fikkert. — 2. Dito. Niet geveild. — 3. Koetshuis Elandstraat a r Metselaars-Hofje./IOOO.ƒ 150. J. A. Nicuwenhuijs. — 4.Huis. Nie?V veild. — 5. Dito Achterburgwal bij de Korte Stormsteeg ƒ 3580. Opg^ 6. Dito Kerkstraat bij de Spiegelstraat.ƒ4loo. J. van Dijk. ""^'fof Prinsengracht bij de Vijzelgracht.ƒ297s.ƒ2s. P. Baaij. _8. Dito-%j(l liestraat./ 1675.ƒ25. J. A. van Minden. — 9. Dito als voren.f^ ƒ3. R. W. Hartgerink. — 10. Dito N. Z. Achterburgwal hoek ff kamsteeg. ƒ 4000. ƒ 40. P. Baaij. — 11. Dito Lindenstraat. ƒ 240y-^j T. Sanders Jr. — 12. Dito Boomstraat bij de eerste Dwarsstraat ƒ 'ft f 5. C. H. Gijselman. — 13. Dito Hartenstraat bij de Keizereg-1 / 7700. / 50. Opgeh. — 14. Dito. Niet geveild. — 15. Dito &""$ Tuindwarsstraat.ƒ 760. P. D. Lusink Jr. — 16. Dito Anjeliersgrs**'1 „p de derde Dwarsstraat.ƒ4so. G. van Heerde. — 1.7. Twee Woninge%|-het Steenpad./550. J. F. Schutte. — 18. Buitenverblijf aan den *■* walerweg./1000./5. A. Craandijk. SCHOUWBURGEN CONCERTEN E^> STADS SCHOUWBURG. Woensdag 3 Dec. (N°. 56 At** De Oude Magister Tooneelspel in 4 bedrijven naar het Hoogdu""^-door den Heer H. Tiggelaar. Gevolgd door: Atim en Zora groot **^» Pantomime. Tusschen het voorstuk en het ballet: Muzijkaal InMtx waarin zich dc Heer Victor Pctit en zijne Dochter Hermencc Peti'.\ 3 jaren zullen doen hooren. (6 „fic"" VERWACHT DONDERDAG 4 DECEMBER ten bene'  ran den Heer A. P. Voitus van Hamme: DE VERKWISTER t0° irama in drie bedrijven. % ï VjU SALON DES VARIÉTÉS in de Nes. Woensdag 3 Dcc * f ;weede voorstelling van: De Verleiding vanden Rijkdom drama-*""""^*' n 3 bedrijven en 4 tafercelen naar het Fransch. Na hetzelve: V* iige Misvatting vaudeville in 1 bedrijf naar het Fransch.  _. 'Aanvang ten 8 ure. Entree 75 Cents in verterH*** J. E. nVP9K___^^_ SALON DES VARIÉTÉS in de Amstelstraat. Woensdag 3 De Artesische Pat nieuw kluchtig melodrama in 9 tafercelen B ___no' üoogduitsch met nieuwe decoratien en costumes de Muzijk S*00*^1 leerd en gearrangeerd door den Heer A. Berlijn lste taf. De Onderaar 3rot. — 2de taf. De Artesische Put en het Aardmannetje. — *» P* \bd-el-Kader. — 4de taf. Het Fransche leger in Algiers. — *** Jnderaardsche Hulptroepen. — 6de taf. De Terugkomst van ""/""Tyor' loon. —7de taf. De Ijsbergen aan de Noordpool. — Bste taf. Der?U ooid. — 9de taf. De Tempel van Afreduros. Aanvang 8 Ure- Entree 75 Cts. in vertering. BOAS & JUj^gJ^g^ VAUDEVILLE ERANCAIS.JMercrediJ3Dec.: lerde*butde» j le Villeclair dans 1' emploi des jeunes Coquettes Amoureuses: j» 4 heures vaudeville en vn acte; Mlle de Villeclair' remplira ie . l'Angèle. Fargeau le Nourrisseur comédie en 2 actes. «nrSiflt Entree 75 Cts. sans consommation. J. H. WILBHJ*^",http://resolver.kb.nl/resolve?urn=ddd:010073105:mpeg21:a0054:ocr,6,ddd:010073105:mpeg21:p006,Algemeen Handelsblad,1051
7471944,1851/08/30 00:00:00,1884,ddd:010077781:mpeg21:a0012,http://imageviewer.kb.nl/ImagingService/imagingService?id=ddd:010077781:mpeg21:p004:image&x=122&y=50&w=3966&h=1884,ddd:010077781:mpeg21,4088,1934,122,50,4,"—— Natmnalp Wpr)tpliihi> l°' gelden en de vervallen renten Seswföi £ rit^SJ KONING&D& DER NEDERLA N DEM sïWïrtrsctts™ ™i!;' .veerde rente vermeerderd worden ten einde nu ter- DOOR DE **"" ¦^swot""te G»«MS volgens dv Statuten : fortf öafl den ifê PO»/1 weïlAl «feste verèónigingèn  uitsluitend belast is met de ontvangst en be zijn aanqeganu aan da alsdan nog in leven zijnde I üIM I I i\ \ l KI; MA A I 3(] II A PP IJ KWrMIJ der gelden zoo ook met dv uitbetaling inschrijvers (de zoodanigen die kapitalen gestort fÊ\ ~M'7\ YW%*S d 8~71 ¥7 /f""^ M /Hf £?1 fTffl ""^ *""^*""rfefl ""* «»-hebben) of deelgenooten (te wier be/were kapitalen f§ B^ $Rt RJ B^ Jg ; ¦\;. ' 3o' />f'' 5 Commissarissen aanvankelijk door de gestort worden) hetzij in kapitaal /;c/^y /« rente. jÊiW B .J bl SL_i^ I 1 J |.|i WjL inschrijvers zelvcn fe kiese» het ioesigt over verdeeld te irortlen. De Maulsclmppij zal ook ver- de handelingen der Directie hebben en zonder óéniginaen van kapitalen tonnen icaarran de deel- _ _— wier medewerking geena gelden van hét grootnenooten dadelijk de rente genieten hetzij voor ecnen Goedgekeurd bij Koninklijk Besluit van 2!) peCember 1850 No. 48 en 7 April 1851  ffo. 62' boek kunnen worden afgeschreven 'bepaalden tijd hetzij hvetultlm ""'¦""' vermeerderd gevestigd fg AMSTERDAM. 4<l- Dat Me inschrijver of deelgenoot zich ten worden naarmate hel getal reiltehe/fers door ster/te IIUEcnK VAN allen tijde ""«» den slaat eener f'erèèniqing kan vermindert. W. G. VAN MARSELIS UAftTSINCK.' P. ROHIJN Ju. BS Mn. H. Clfïl. HEDENAN "".llGzzr. overtuigen door een extract uil het grootboek hem ¦ op zijne aanvrage door de Directie uit te reiken. ER 'lm W SOORTE.\ Hg VERÉÉMIMO M WEL : A. Om kapitalen in ééns of bij B. Om kapitalen in ééns of bij gedeelten ge-j C. Om de deelgenooten van kapitalen in |). Om kapitalen iv ééns gestort E. Om kapitalen in ééns gestort voor een zeker gedeelten gestort te verééuigen ten stort Ie vcréeriigerl  feu einde dezelve gedurende ééns gestuit dadelijke rente te doen genieten voor een zeker aantal jaren te vereeui- aantal jaren te vereenigen. Waarvan de renten einde dezelve gedurende een zeker een zeker aantal jaren door rente te vermeerderen welke vermeerderd wordt naarmate het gen waarvan de renten aan de iuschrij- halfjaarlijks aan de in 'leven zijnde deelgenooten aantal jaren door rente en door De renten van dit veréénigde kapitaal worden als-getal deelgenooten door sterfte vermindert vers hunne erven of rcgtvcrltrijgcudo'n worden 'uitgekeerd terwijl het kapitaal"" na de liet aandeel der vóórnvei leden deel-dan onder de in léven zij:.de deelgenooten ver- :\a den dood van den laatslen rontelieHer  halfjaai lijks worden uitgekeerd. Hijonl- ontbinding der vereeniging aan de oorspronkelijke genoten Ie vermeerderen  en on- ile.-ld  bit op den dood van den langstlevenden keert het kapitaal tot de oorspronkelijke in- binding dezer vereeniging wordt het inschrijvers hunne erven of regtverkrijgcu Jen wordt der de dan nog levenden van deze deelgenoot der veiééniging . als wanneer het kapi- schrijvers hunne erven of regtverkrij'gonden maatschappelijk kapitaal onder de dan gerestitueerd. te verdeelen. taal 10l de oorspronkelijke inschrijvers of hunne terug. nog levende deelgenooten verdeeld. Indien ten behoeve van b. v. 20 deelgenooten Indien b. v. ten hchoe vc van 100 erven en reglverkrijgenden terugkeert. Indien 25 personen b. r. rau 50— :>.' jaren Indien ten behoeve van 100 kinderen van gevorderden leeftijd f 60000 wordt i'ngeschrekinderen f 100000 wordt ingeschrc- Indien ten behoeve van 100 kinderen f 100000 ""» kapitaal van f 100000 bijeenbrengen dan een kapitaal van f 100000 wordt inge- ven 'met het doel om deze personen de renten daarren om na verloop iriu 20 jaren. wordl ingeschreven om na verloop van 20 jaren)'Jc""""'tc"" de deelgenooten van den dag aj der schreven om na 20 jaren onder de dan van vermeerderd door de onder hen successievelijk dit door telkens gekapitaliseerde levenslang rente ie trekken bedraagt hel kapitaal storting halfjaarlijks de. renten van hun- kapi. nog in leven zijnde deelgenooten te. plaats hebbende sterfgevallen te doen""genieten dan rente vermeerderd kapitaal onder de 0p /<„. '{„g ?„ / rerdee/ing der rente f 210112'""""/- a-elke natuurlijk vermeerdert naarmate er worden verdeeld en de inschrijvers trek- trekt ieder dan nog in leven zijnde deelgenoo- en bekomt ieder deelgenoot jaarlijks : leden der vereeniging sterven zoodat zoolang ken halfjaarlijks de renten van het'door zoo lang er 20 in leven zijn de rente van f 3000. ten te verdeelen. dan zal dit kapi- IW  f(. jn jevm -j. J 25.20. er '"" lerca BÜ'h »&* hun gestorte 'kapitaal dan is elk aan- 15 » » » » ? „ 4000. taaieene som bedragen van f 2101 12 r}Q „ „ „„ j 75.29. aandeel da rente trekt van f 4.000. deel op den dag der\verdceling. 10 » » » > » » 6000. «n bekomt ieder deelgenoot alsdan 25 » » » » 350.58. leden » » 5000. indien er 70 in'leven'zijnf 1428.57 5 » » > » » » 12000. voor zijn f 1000 gestort kapitaal.- fl „ „ „ „ 1752 BÜe«3 10 "" "" "" 10.000. 50 » » » » 2000.00 2 » » » » » „30)00 indiener 70 leven f 3130.17 f)(llU de hnl^hrcnde de rente van het'geheele  *!) """" *$&%> 2l>» "" -« J^^'^oo er voor de epiratie der vevééniging slechts 50 )» > 4382.2-4  . . „.„/' y; .;.-„ „¦./;;/... //iv/. e"" de langstlevende „ 100000; 5 » » »» 20000.00 lin leren ts zat deze genieten de renten van 2:' "" "" £3M5 StiSl^ffmZ '^iH by overlijden dit kapitaal aan deerven en indien er slechts 1 in leven is. f 60000 ; tcrwij bij ontbinding derzelve het kapit » »43b22.4() lMJLrnnkelnke inschriirers terun/e-rt ""f te'Jlt<-'/-'V.I'-""den tan de oorspronkelijke in-ontvangt deze voor f 1000 gcstortUaal tot de oorspronkeh/ke nesehrijrers hunne erven enz. (Lu 00)spont.iUi.e msuuijios arnge.n schrijvers terugkeert. kapitaal f 100000. [of reglverkrijgenden terugkeert.",http://resolver.kb.nl/resolve?urn=ddd:010077781:mpeg21:a0012:ocr,4,ddd:010077781:mpeg21:p004,De Noord-Brabanter : staat- en letterkundig dagblad,3966
1111778,1851/09/03 00:00:00,1174,ddd:010518409:mpeg21:a0026,http://imageviewer.kb.nl/ImagingService/imagingService?id=ddd:010518409:mpeg21:p004:image&x=2049&y=3609&w=947&h=1174,ddd:010518409:mpeg21,2996,4783,2049,3609,4,". ___«__- _. STOï_I_P'S LIKDOOI*^ /*^___J|S#^^ «ALSEM  die zich de goedig. lif'^^^ni va"" hftt Hooge Koninkl. Wurie""'""ea Schft Ge»eeaimidig Collegium ~tMl\ J^Ksï ||g-_C '""'eft' '! ol>k hier te lande re^'A^ v7ij *^^^}^__*_i.'*>^_i==J_^S bekend en van vele zijden !•'!?. _jge-jegejfW-jf ""*""~f -ST \i^^beriKt:n ontvangen dat zij f*""_ewer»-' **W- ■ 1 %ii"" nrzingeu zoinler de miuste -*jjBwordt' • '.V<^tr"". * de behandeling aanbevolen -°y Sri- (uilp zeker te doea zü»» hoe het gebruikt wordt begeleidt ieder Fle.chje. oeiWl>r' Het Fleschje wordt met eene aanwyzinglioe het gebruikt™ j den voor 60 c. in onderstaande Depots afgegeveo. van's^e^d' Amsterdam Verkoophall. Helvufttslui» . J£'avili fo jma Amersfoort Ferd. Meyer. Hi__delo_-*-""» OvenU* Assen H. P. A. .au Gorcum. Heerenv-»»*' ■ ««^/. Alkmaar I. Brengers &. *^f'! 7KaJe * Apeldoorn üruJTiileinan *$£»'£• ££?*■• Bergen-op-Zoon. fl JW to. rjSuWarde._ .9. p. PMpM/„*. 's Bosch f. I We sch. Middelburg J. C. Kries. Bred.  Wed. ■/•**«-•• _foa_dCke_fdaB  kd Boer ?>■ uda j. €!<«*-*■ Schiedam  Mej. ... B. J-***»""' Croui-._«» . *• lotman. Tiel ƒ. ////«r. Hoe» C» f>ee*_. Utrecht Ferd. Meijer. •_ Hage Sack eu C°. Veendam .v. _.__...<;.. Hnarle.i. J. Larsen. Winsoboteu  ... fVamasii. Harderwijk Wed. C. Ttjheff. Zutphea I. H J. H'a^^' Harlingen P. L. Miraude Pz. Zwolle W. Ulderink Jr. Huoia  L. B. 'Ruitenberg.  ' _.. A u d. KM- .",http://resolver.kb.nl/resolve?urn=ddd:010518409:mpeg21:a0026:ocr,4,ddd:010518409:mpeg21:p004,Opregte Haarlemsche Courant,947
1759808,1851/01/10 00:00:00,1984,ddd:010805247:mpeg21:a0024,http://imageviewer.kb.nl/ImagingService/imagingService?id=ddd:010805247:mpeg21:p004:image&x=1873&y=60&w=887&h=1984,ddd:010805247:mpeg21,2760,2044,1873,60,4,"Iste stuk (Oostersche Volken) sde druk. — 2_stuk (Grir-ken) 4de druk. 3de stuk (Romeinen)r 3de druk. — 4de stuk (Middeleeuwen) 3de Druk sde stuk (Nieuwe Geschiedenis) 2de druk. — — — Gelijktijdig Overzigt der voornaamst* Vorsten van Europa van den jare 800 —1836. In 4 Tabellen op groot drukpapier ƒ 090. — — — Geslacht-tafel der Koningen van Europvan 1500 —1840 en overzigt der Staten regeiendfl Vorsten en Staatsvormen f 050. — — — Voornaamste Gebeurtenissen der Alge* meene Geschiedenis gelijktijdig beschouwd tot 183. f 120. — — — Voortgang der Beschaving zigtbaario de Geschiedenis der Volken f 040. BOTER te Sneek den 31. December 1850 f 3450. Dc prijs der BOTER te Leeuwarden den 3. Jan. 1850 f 3450. De In- en TTitlandsehe ROGGE en TARWE waa dienzelfden dag: Rogge f 17300 het Last. — Tarwe / 8-0 de Mudde. Gorinchem 8. Jan. Tarwe van / 700 tot ƒ 790. Rogge ƒ 5u0 a ƒ 600. Gerst / 330 _ ƒ 420. Haver ƒ 250 _ / 270. Aardappelen ƒ 180 _ J 210. Boter vau 68 _ 72 et. 't poud. Kaas f 1375 _ ƒ 1475 de 50 Ned. ponden WAARNEMINGEN gedaan op het Meteorologisch Observatorium te Utrecht. (Zonnenburg.) . ó Wind- Barom. Ther. Afwijk. Voch- Gcv.l •I -5 riïti_g. kr. Wj O"" F d. temp. ligh. reSen Aanmerkingen. mm mm 7 S z. 1 75369 363 092 0 Bewolkt. 2 z. 1 5287 370+ 3.5 94 0 Zwaarbewolkt. 10 ozo. 0 5170 370 97 o Betrokken. 8 8 z. 1 51_3 426 97 O id. _ wzw. 2 5257 45:)+ 9.7 83 03 Bewolkt 10 zzw. 2 5361 403 91 01 id.",http://resolver.kb.nl/resolve?urn=ddd:010805247:mpeg21:a0024:ocr,4,ddd:010805247:mpeg21:p004,Utrechtsche provinciale en stads-courant : algemeen advertentieblad,887
88140,1851/11/21 00:00:00,113,ddd:010805385:mpeg21:a0002,http://imageviewer.kb.nl/ImagingService/imagingService?id=ddd:010805385:mpeg21:p003:image&x=1865&y=966&w=780&h=113,ddd:010805385:mpeg21,2645,1079,1865,966,4,ADVERTENTIES.,http://resolver.kb.nl/resolve?urn=ddd:010805385:mpeg21:a0002:ocr,3,ddd:010805385:mpeg21:p003,Utrechtsche provinciale en stads-courant : algemeen advertentieblad,780
5407024,1851/07/23 00:00:00,4198,ddd:010786693:mpeg21:a0014,http://imageviewer.kb.nl/ImagingService/imagingService?id=ddd:010786693:mpeg21:p010:image&x=66&y=30&w=1288&h=4198,ddd:010786693:mpeg21,1354,4228,66,30,10,"Hoofd-Ingenieur van den Waterstaat in het ude District aan het Locaal van het Provinciaal Bestuur te Middelburg v/orden Aanbesteed : Het doen van eenige Herstellingen aan 'sßijks Groote Wegen in de provincie Zeeland  met derzelver Onderhoud gedurende de dienstjaren 85i tot en met i 854 daaronder begrepen alle vereischte Materialen. Deze Aanbesteding zal geschieden bij inschrijving en opbod. Het Bestek der bovengemelde Aanbesteding zal  boven en behalve aan het Locaal van het Ministerie van Binnenlandsche Zaken en aan dat van het Provinciaal Bestuur van Zeeland te Middelburg ter lezing liggen op alle zoodanige plaatsen alwaar gewoonlijk de Bestekken van Waterstaats-werken in gemelde Provincie ter lezing gelegd worden. Zullende drie dagen voor de Besteding de noodige Aanwijzing in loco worden gedaan en voorts nadere informatien te bekomen zijn bij den Hoofd-Ingenieur te Middelburg voor het geheele werk en bij de Ingenieurs te Middelburg  Goss Triolen en Breskeps. De Minister van Binnenlandsche Zaken Thorbecre. MINISTERIE VAN MARINE. BERIGT AAN ZBEVARENDEW. De Minister van Marine ad interim  brengt bij deze ter kennis van de Zeevarenden en verdere daarbij belanghebbende het door tussclienkornst van het Departement van Buite .landscbe Z . :en aan hem Minister medegedeelde berigt van de Handelskamer te Breinen betreffende de Betonning van bet Nieuwe Vaarwater op den Beneden-Wezer  waarbij de Zeevarenden met het navolgende worden bekend gemaakt: Onlangs gedane opnemingen hebben aangetoond  dat sedert de laatste bekendmaking van den gden Octohcr 18/(9 de Zandrug de Mellum meerdere diepte beeft verkregen; schepen weike dien rug binnenkomende passeren en zich met eénen O. t. O. en O. Z. O. koers op de Boeispier aan  nader aan den Mellum dan aan de G ton houden zullen daar bij laag water eene diepte van 23 voeten vinden. In het nieuwe Vaarwater aan de Kleine Plaat welke zich van de Witte Ton n°. O 110"" verder Z. Oost opwaarts uitstrekt is eene tweede Boeiton gelegd die op een afstand binnen liet gezigt van de Witte Ton n.Oligt; zij is gelijk deze met een Stang en een Witten Korf voorzien en n . i gemerkt; zij ligt in 4| vadem diepte bij laag water en hare peilingen zijn naar het Miswijzend Kompas : de Witte Ton n"". O  N. W. t. N. ; de RoodeTon n . II  W. N. W. * W. ; de Kerktoren te Wangeroog  W. f Z; de Roode Ton n . 111 Z. t. O. \ O. Den Zeevarenden wordt verder kennelijk gemaakt dat de Sleutelton in stede van den Korf van Riet dien zij tot hiertoe voerde een halfronden Korf van IJzer heeft bekomen welke den geheelen Tonbodem omsluit en de Ton meer dan tot nu toe voor het oog zigtbaar maakt. 's Gravenhage  den 7den Junij lïsl De Minister voornoemd Van Spengler. berigt aan zeevarenden. De Minister van Marine ad interim Brengt bij de/e ter kennis van de Zeevarenden dat volgens eene van den Nederlandschen Consul op het Eiland Malta bekomene mededeeling op order van den Kommandant der Britsche Zeemagt in de Middellandscbe zee door Lord Frederik Kerr konimauderende de Engelsche Oorlo""s-stoomkorvet Scourqe een onderzoek is gedaan naar de Waterdiepte op de GraAams-bank tusschen de Eilanden Panlellaria en Sciacca op de Zuidkust van Sicilië waarbij hel is gebleken dat de tegenwoordige Waterdiepte op genoemde Bank slechts 16 Eng. voelen bedraagt terwijl er redenen hestaan om te vermoeden dat de Bank afneemt eu dat het voor de Schepen welke gezegde wateren bezoeken van het grootste belang is om op de meergenoemde Bank oplettend te zijn hebbende genoemde Lord Fred. Kerr daarop als eene voorloopige aanwijzing eene Roei met eene Engelsche Vlag geplaatst. 'sGravenhage den isden Mei iS5i. De Minister voornoemd Van Sjpeng_er. bkhigt aan zeev.arenden. De Minister van Marine ad interim brengt ter kennis van de Zeevarenden en verdere daarbij belang hebbende  dat volgens eene aan hem door tusschenkomst van den Minister van Buitenland.-che Zaken  medegedeelde bekendmaking van de Koninklijke Zweedsche Administratie der Marine te Sloekholm een Vuurtoren ingerigt voor een Stderaallichl met rever Lères  hetwelk den geheelen horizon verlicht in tien loop dezes jaars zal gebouwd worden op de Scheer Malörn gelegen builen den in gang welke naar Jlaparanda en Tornea leidt geheel in het Noorden der Bottiiische golf. Dit licht zal zigtbaar zijn op eeoen afstand van ruim i\ geographische mijlen. Ten zelfden tijde zal pen groote Vuurtoreningerigt voor een rondgaaml of draaijend Licht met Reverbères van gelijk lichtend vermogen als dat van den Toren van Söderarm worden gebouwd op de Scheer genaamd Stora Fjecleragg  en gelegen -*- mijl N. O. van de Noorderspits of Kaap van Holmo in Norra Quarken buiten Urrëa. Dit Licht moet zigtbaar worden op eenen afstand van 3 a 3{ geographische mijlen. Een nader berigt omtrent den tijd waarop het Licht op deze Vuurtorens zal ontstoken worden zal door eene bekendmaking in de Zweedsche Nieuwst—pieren aan de Zeevarenden worden medegedeeld. 'sGravenhage den 2den Junij iBsi- De Minister voornoemd Van Spengler. berigt aan zeevarenden. De Minister van Marine ad interim brengt bij deze ter kennis van de. Zeevarenden en verdere daarbij belang hebbende dat volgens eene aan hem door den Minister van Buitenlandsche Zaken medegedeelde bekendmaking der Regering van Stralsund het kv .licht van Arcona. geplaatst op de Noordelijke punt van het Eiland Ruyen en verbonden met het Schiereiland Wittow bestaande uit zeventien Lampen met parabolische Lichikaalsers gelegen op de noorderbreedte van 54°/ji' 12"" en lengte beoosten Green wich van 13"" 26' 6"" uit hoofde van noodzakelijke voorzieningen aan de lantaren van den 7den tot den 2sten Julij dezes jaars niet zal ontstoken worden. 'sGravenhage deugden Julij iBsi.",http://resolver.kb.nl/resolve?urn=ddd:010786693:mpeg21:a0014:ocr,10,ddd:010786693:mpeg21:p010,Nederlandsche staatscourant,1288
2092405,1851/09/14 00:00:00,2191,ddd:000020128:mpeg21:a0050,http://imageviewer.kb.nl/ImagingService/imagingService?id=ddd:000020128:mpeg21:p004:image&x=61&y=3292&w=955&h=2191,ddd:000020128:mpeg21,1016,5483,61,3292,4,(5550} Bij onderlinge overeenkomst in dato den Bsten September 1861 is de Vennootschap tusschen de Heeren WILLIAM WILFORD JOHAN ANTON BECKER en FRANCISCUS JOHANNES BREMMER onder de firma Wilford  Hecher (f* Co.  Zeildoek-Fabrikanten  te Delftshaven te rekenen van den Eersten September 11. af ONTBONDEN en laatstgenoemde belast met de geheele vereffening derzelve onder zijne bijzondere Handteekening met bijvoeging voor Likwidatie der firma Wilford Becker fr Co. Wordende dien ten gevolge al degenen  die iets te vorderen hebben van verschuldigd zijn aan ot iets onder zich mogten hebben derzelve firma aangaande verzocht daarvan voor den laatste dezer maand Opgave 'Betaling en Afgifte te doen ten huize van voornoemden Heer FRANCISCUS JOHANNES BREMMER aan de Schiekade wijk 14 No. 366 te Rotterdam. Delftshaven WILFORD BECKER & Co. 12 September 1851. -^A ROTTERDAM M ANTWERPEN. &?Mk» AMICITIA. DAGELIJKSCHE DIENST. Van ROTTERDAM Van ANTWERPEN Maand. 15 Sept.'smorg. 9*|u Maand. 15 Sept. 'smidd. 1 u Dingsd. 16 » i' tt_n Dingsd. 16 » 'snachts li» Woensd.l7 » * 10 » (tussch. 15 en 16 Sept.)* Dond. 18 - » 11 - Woensd. 17 Sept.'smorg. 2i] Vrijdag 19 - 'snachts I*¦ Dond. 18 » » 3 » (tussch. 18 en 19 Sept.) Vrijdag 19 » » 4|» Adres bij JOHs. OOMS Ez. & Co. Boompjes 1 No. 23  en Wolfshoek 2 No. 286. (5225) g ¦jjBÊP'J ./o** VOORLOOPIGE «J^^mfl^ WINTERDIENST JU ER WE DE Te beginnen den lödcn September 1851. Van GORINCHEM: Van ROTTERDAM: Maand. Dingsd. 'smorg. 5_ u dagelijks «les middags ten 2 overige dagen » 6|» ure na aankomst van den in verband met den Spoortrein Spoortrein behalve des Zonvan 9£ ure van Rotlerdam. dags. Behalve des Zondags. Nadere inlichtingen bij de bekende Agenten en bij de Directie aan de Kinderdijk. (5483) T STOOMBOOT STAD ZIERIKZEE. *_. Van ZIERIKZEE: Van ROTTERDAM* Woensd.l7 Sept.'smorg. 4«|u Dingsd. 16 Sept. 'smorg. 7^u Vrijdag 19 »  6 * Dond. 18 » » 9 » Zondag 21 » . _ - __tUrd. 20 - . 11 #,http://resolver.kb.nl/resolve?urn=ddd:000020128:mpeg21:a0050:ocr,4,ddd:000020128:mpeg21:p004,"Nieuwe Rotterdamsche courant : staats-, handels-, nieuws- en advertentieblad",955
40976,1851/07/10 00:00:00,52,ddd:010152784:mpeg21:a0011,http://imageviewer.kb.nl/ImagingService/imagingService?id=ddd:010152784:mpeg21:p004:image&x=1656&y=1180&w=788&h=52,ddd:010152784:mpeg21,2444,1232,1656,1180,4,3&ucv*tcuticn,http://resolver.kb.nl/resolve?urn=ddd:010152784:mpeg21:a0011:ocr,4,ddd:010152784:mpeg21:p004,Bredasche courant,788
64834,1851/07/26 00:00:00,77,ddd:010077766:mpeg21:a0028,http://imageviewer.kb.nl/ImagingService/imagingService?id=ddd:010077766:mpeg21:p004:image&x=99&y=2224&w=842&h=77,ddd:010077766:mpeg21,941,2301,99,2224,4,ADVERTENTIEN,http://resolver.kb.nl/resolve?urn=ddd:010077766:mpeg21:a0028:ocr,4,ddd:010077766:mpeg21:p004,De Noord-Brabanter : staat- en letterkundig dagblad,842
688667,1851/01/28 00:00:00,751,ddd:010077691:mpeg21:a0016,http://imageviewer.kb.nl/ImagingService/imagingService?id=ddd:010077691:mpeg21:p004:image&x=1961&y=3236&w=917&h=751,ddd:010077691:mpeg21,2878,3987,1961,3236,4,"MAAS te GRAVE. DIEZE te 's BOSCH. DABOVEN 1 £ BOVEN f-NDER g § TOMS » *j' « 3 AP. gio. 0. Fe > o 3 o o el. I dm. dm. dro. el. dm. cl. Idrn. dm. dm. Jan.  i ! 25  7 jOB 10 »J » » J> »_ J> »__ IT T""| oo |» V* _!_ _i_ _ü|_i__ irf~|~ «¦ jl ui jl »L iilL_ _ "" <-*-*¦*» * ° _j i. De 0. te 's Bosch is 4 el 11 duim boven AP. Bij de Wed. D. A. A. de ROOY te's Bosch.",http://resolver.kb.nl/resolve?urn=ddd:010077691:mpeg21:a0016:ocr,4,ddd:010077691:mpeg21:p004,De Noord-Brabanter : staat- en letterkundig dagblad,917
5333642,1851/04/11 00:00:00,3686,ddd:010583941:mpeg21:a0033,http://imageviewer.kb.nl/ImagingService/imagingService?id=ddd:010583941:mpeg21:p010:image&x=54&y=112&w=1447&h=3686,ddd:010583941:mpeg21,1501,3798,54,112,10,"LET WEL. «^. oteékende maakt door deze aan zijne geëerde Stad en Landgcnoo-1* ten bekend dat hij van heden af weder een a.in.ang zal nemen met de ZUIVERING van BEDVEDEREN en MATRASSEN door m.ddt-l van Stoom ten huize van Mejufvrouw de Wed. GöCKE in liet Logement Nieuw Duinkerken .o het Schavenck alhier; ook vervaardigt hij M.ATR \SSEN met Stalen Spring veren en inzonderheid voor Wagenkiwcns en verder alles wat tot zijn vak behoort ; van eene civiele en prompte bediening kan men verzekerd zijn. uwarden den 24 Maart 1851. J- BERGER. Fabriek van Binnen- en Buiten Jalonzien  ran AELMANS en DOLK Bijksleveranciers te Rotterdam. Bij den Ondergeteekende zijn even als in vroegere jaren voor dezelfde prijzen als aau de Fabriek BINNEN- en BUITEN JALOUZIEN te bekomen tegen den minst mogelijken prijs en zeer solied bewerkt; ook worden oude Jalouzien geheel en al als nieuw geschilderd en opgemaakt. Leenward.n den 3 April 1851. P. M- KESLER in de Groote Kerkstraat tegenover het St. Anthonij-Gasthuis. FILTR EER-MACHINES. np.c MACHINES tof ZUIVERING van het DRINKWATER welke niet genoeg \y tot ""fbruik derzelve kunnen worden aanbevolen worden steeds vervaardigd en zin ais vroeger te bekomen; zooraede ZINKEN MELKADEN op bestelling bij JAN T. BORN Loodgieter en Leidekker bij de Amelandspijp te Leeuwarden  Wij hebben het genoegen aan de Dames te berigten  dat eene TENTOONSTELLING van MONSTERS en STALEN bestaande uit Fransche Shwals Kanten  Zijden Stoffen Mousseline. Barège enz. kosteloos en zonder verpl.gting tot opdragt van eenige bestelling zal plaats hebben op heden Vrijdag en morgen Zaturdag"" den 11 en 12 April in het Logement de Nieuwe Doelen telkens des voormiddags van 11 tot des namiddags 3 ure. Wij onthouden ons van alle loftuitingen  aangaande de verscheidenheid der Stoffen. Alleen zij gezegd  dat er Monsters der rijke Stoffen die op de Tentoonstelling te Londen zullen prijken  ter bezigtiging worden aangeboden. Heeren Liefhebbers der Jagt kunnen drie fraai geteekende PATRIJSHONDEN (zijnde rekels) bekomen voor 10 Gulden ieder Hond te ontvangen zoodra zij de Moeder kunnen verlaten; de betrekkelijke lage prijs waarborgt de echtheid van het ras waarvoor men trouwens inslaat. Te bevragen bij den Boekhandelaar J. C. KREDIET te Heerenveen. Brieven franco. De ONDERGETEEKENDE verklaart bfj dezen dat zijne Moeder de Wed  gedurende eene reeks vanjaren vreeselijk gesouf freerd heeft aan Maagkramp en daarvoor veelsoortige middelen ook op aanraden van beroemde Geneeshee.cn heeft aangewend welke haar allen slechts eene tijdelijke en spoedig voorbijgaande verligting aanbragten ; — dat de kwaal eindelijk op 62jarigen leeftijd zoo hevig werd dat zij vooral na het gebruik van spijzen door de hevigste smarten gefolterd werd weshalve men voor bet h-houd van haar leven beducht was; — dat bij een der ergste aanvallen hij •Ondergeteekende op vriendschappelijk aanraden van den Heer KLINGER een vGOLÜRERGSCIIEN KKTTING aangekocht heeft welke door de Patiënte is .omgehangen des avonds ten 7 ure met het gevolg dat zij reeds den volgenden nacht geslapen heeft (wat sedert lang niet gebeurd was) en dat zij nu gedurende vele maanden reeds van die felle pijnen bevrijd is en meest alle spijzen en dranken weder zonder aandoening gebruiken kan. De van genoemde kwaal herstelde is volgaarne bereid  persoonlijk ten haren Huize op de te confirmeren al het hiervoren gezegde gelijk daartoe ook sleeds gereed is Rotterdam  28 Maart 1851. De Heeren J. A. KLINGER & C°. te Rotterdam willen gaarne ieder die omtrent de Ziekte en hare genezing nog nadere bijzonderheden verlangt te vernemen  met den Naam en de Woonplaats van de Genezene bekend maken. DE ECHTE KETTINGEN met het Rosahandje zijn in de onderstaande Depots te verkrijgen voor f 180 ƒ 270 ƒ 800 en ƒ 540. Amsterdam Verkoophuis; Akkrum Pieter K de Groot; Assen //. P. A. van Gorcum; Bolsward 5. S. Oosterbaan ; Dokkum A. Schaafsma; Franeker K. Drager; Gorredijk S. G. Zwart; Groningen R. Hartman J. L. Lagro Jr. en C. Rik kers ; Hindeloopen  DaviddeJong; Heerenveen. G. O verdiep en Gebr. Padberg ó> Comp. ; Harlingen  /. P. Mirande Pz ; Meppel U. J. Gelde r man ; Pekel A J. F. Feldbrugge; Sneek P. T. Potma; Veendam S. Savenije; Winschoten G. Wasman. Door liet gebruik der Pillen van Holloway WORDT ELK GESTEL HOE VERZWAKT HET OOK MOGE ZIJN ALS HET WARE GEHEEL HERNIEUWD. De verbazende hoeveelheid dezer voortreffelijke Pillen welke in alle deelen der beschaafde wereld verkocht worden is het beste bewijs van dezelver deugdelijkheid. In geval van verzwakte gestellen zuiveren zij het bloed versterken het ligchaam en hergeven de gezondheid. Lieden welke lijden aan neerslagligheid"" ongesteldheid der zenuwen slechte spijsvertering bedorven maag gal leverziekte aandrang van het bloed naar het hoofd of zelfs vallende ziekte zullen in dit voortreffelijk geneesmiddel een zeker en duurzaam herstel vinden. Zijn op franco aanvrage d contant te bekomen: aan het Hoofddepöt bij dtn Heer J. STRAATMAN te 's Hertogenbosch; J. C. 11. vas HARINXMA  tt Leeuwarden; Wed. H. A. BINKSMA te Harlingen ; M. GAARBEEK te Groningen ; Jl. P. A vas GORCUM te Assen alsmede te Londen Strand 244 Hollowag's Etablissement.",http://resolver.kb.nl/resolve?urn=ddd:010583941:mpeg21:a0033:ocr,10,ddd:010583941:mpeg21:p010,Leeuwarder courant,1447
2459244,1851/07/07 00:00:00,2676,ddd:010805324:mpeg21:a0028,http://imageviewer.kb.nl/ImagingService/imagingService?id=ddd:010805324:mpeg21:p004:image&x=1858&y=1600&w=919&h=2676,ddd:010805324:mpeg21,2777,4276,1858,1600,6,"BOTERPRIJS AAN DE WAAG TE LEYDEN. Zaturdag 5. Julij. Van ƒ 27 tot ƒ 31. GRAANPRIJZEN AAN DE BEURS TE LEYDEN. Zaturdag 5. Julij. Nieuwe Tarwe ƒ 780 tot f 820. Nieuwe Rogge ƒ 580 tot ƒ 620. Gerst f 450 tot / 470. Haver ƒ 350 tot f 400. Paardeboonen f 500 tot / 530. WAARNEMINGBN gedaan op het Meteorologisch Ohservatorium te Utrecht. (Zonnenburg.) .j. h Wind- Uarom. Ther. Afwijk. Vocb- Gev. J 5 rigt.ng. kr. bij 0° F d. temp. tigh. regen Aanmerkingen. mm mm 3 8 nno. 2 7i904 711 069 o Ligt bewolkt. 2 11. 4 5873 718+ 1.8 63 o Bewolkt 10 n. 1 5968 590 90 0 id. 4 8 nnw. 3 5941 64 u 75 0 id. 2 nnw. 3 6974 ü73 — 3.2 66 0 id. 10 nnw. 1 6139 55 S 85 0 Betrokken. 5 8 nnw. 1 6238 690 62 0 Bewolkt. 2 nw. 1 6237 639—8.1 54 0 Ligt bewolkt. 10 wnw. ü 6215 505 91 o Helder. PRIJZEN DER EFFECTEN. AMSTERDAM 5 Julij 1851. volgens de Sociot. tot not OMSCHRIJVING. des ouligatie-Handols. van tot gebL Nederland. Werkel. Schuld. . . 2>/a pCt. 58*/16 58'I 0 58'„ dito dito 3 „ 68V4 dito dito 4 „ 89'/g 895/8 g9B/g Amortisatie Sijndieaat 3Va ~ BS'/4 Handel-Maats. 15 Julij . . . 109 7 Oost-Ind. Eeening. . 4 „ 88 Va Aand. Holl. Spoorweg . . . gga^ Frankrijk; Certificaten 3 „ 53/* Rusland. bij Hope en Comp. .. 5 pCt. 1063/. dito 1828 en 1829. . 5 „ 1045-8 dito dito 1840 ... 4 „ 8934 Certificaten hij Stieglitz 4 „ 8.9 dito Adm. te Lond. . . 41' „ 9815-'!8 99 Polen. Aandeelen 1835 _/7 SPO .. . „ ]49' a Obligatien 4 „ 77 Vt Spanje. Oblig. Ardoin. t 85 5 pCt. 15J/„ 155- n ~"" c 1"" f 51°' 5 "" 155/> 15""'° 155« Onb. Stukkon 5 „ 151/ Obligatien 3 „ 40 <.t Binuenl. Schuld. ...3 „ 35lse 36 36 Ardoin Coup. ..... 83/8 8V„ 8-Vê OOSTENRIJK. Oblig. bij Golt fr Q>. 5 pCt. 81' 8 Ohhg. Metaliek 5 „ 74Vg 75 7B dito dito. N -5 „ 80'/ie 80'/4 80/4 dieo 2V2 „ 3g3/ 39'4 België. Cereilic. bij Rotschild 2'/j pCt. 483/ e BItAZILIE. Geld. 1824 £ 200 .5 pCt. 88Vg 89 Portugal. te Londen 4 „ 341/ ««O * n 34""'/ c 34% Amerika. Mexico Obl. 1837 f 100 5 „ . 31:'/8 Maatsch. van Weid. 75'-2; Haarl.-Meer 10IV; Ween. Aand fl. 250 2u3; Eng. Hen. 1001»; Griek. 4■- unb. Itrecht b' 4 L- 12. ""SÖM'il eo 4 o.nj.-.",http://resolver.kb.nl/resolve?urn=ddd:010805324:mpeg21:a0028:ocr,4,ddd:010805324:mpeg21:p004,Utrechtsche provinciale en stads-courant : algemeen advertentieblad,919
22680,1851/05/15 00:00:00,54,ddd:010152768:mpeg21:a0011,http://imageviewer.kb.nl/ImagingService/imagingService?id=ddd:010152768:mpeg21:p004:image&x=433&y=2613&w=420&h=54,ddd:010152768:mpeg21,853,2667,433,2613,4,£.btfc_;tc...icn.,http://resolver.kb.nl/resolve?urn=ddd:010152768:mpeg21:a0011:ocr,4,ddd:010152768:mpeg21:p004,Bredasche courant,420
1355480,1851/05/17 00:00:00,1442,ddd:010518318:mpeg21:a0016,http://imageviewer.kb.nl/ImagingService/imagingService?id=ddd:010518318:mpeg21:p003:image&x=1957&y=1955&w=940&h=1442,ddd:010518318:mpeg21,2897,3397,1957,1955,4,*#* KOSTSCHOOL VOOR JONGE JUFVROUWEN TE FEENEXBJAI. De Dames COEIJMANS en TenBRUMMELER hare INRIGTING voor Opvoeding eu Onderwijs met pc Mei geopend hebbende nemen de vrijheid dezelve bij deze in de aandacht van Ouders en Voogden aan te bevelen. Inlichtingen zullen gaarue gegeveu worden door : den Hoog-Edel-Gestrengen Heer J. C. Rijk gepd Vice- Admiraal te 'sHage; de Wei-Eerwaarde Heereu/. Broedelet Predikant te Gouda en J. Hazebroek te Middelburg ; den Hoog-Wei-Geboren Heer Mr. //. E. Baron van Ittersum te Wijk bij Duurstede en den Wel-Edelen Heer J. van Oosterwijk Bruin te Amsterdam. Schriftelijke informatien of aanvragen om Prospectussen franco. De Burgemeester der Gemeente Veeuendaal Provincie Utrecht gezien de bovenstaande Advertentie van de Dames COEIJMANS eu Ten BRUMMELER vindt zich in alle deelen vervrijmoedigd het door H. E. opgerigte INSTITUUT aan Ouders en Voogden aan te bevelen. Hij wil dit niet doen- door op de plaats van vestiging welke door hare gezonde ligging en uiterst gemakkelijke communicatie daartoe bijzonder geschikt i's te wijzen ; dit zoude partijdigheid kunnen worden geacht ; maar door de aandacht te vestigen op de Dames oprigteresseu zelve welke door haren stand in de maatschappij geschiktheid en wat Mejufvrouw ten Brunimeler betreft ondervinding en bekwaamheid in het geven van Onderwijs in alle deelen bij hem Burgemeester bekend staan als te kunnen voldoen aan de verwachting dergenen welke hunne Kinderen of Papillen aan die lkmes zullen toevertrouwen. De Burgemeester van Veenendaal HENDRIK van de POLL. Veenendaal 14 Mei 1851.,http://resolver.kb.nl/resolve?urn=ddd:010518318:mpeg21:a0016:ocr,3,ddd:010518318:mpeg21:p003,Opregte Haarlemsche Courant,940
1732040,1851/09/26 00:00:00,3268,ddd:011021457:mpeg21:a0013,http://imageviewer.kb.nl/ImagingService/imagingService?id=ddd:011021457:mpeg21:p008:image&x=581&y=76&w=530&h=3268,ddd:011021457:mpeg21,1111,3344,581,76,8,"UITVERKOOP. Daar ik mijn bedrijf opgeef zoo maak ik hiermede aan het publiek bekend dat ik viyn heden af mijn' wel gesorteerdon voorraad van Kruidenierswaren Levensmiddelen Schoenen Laarzen Klokken Spiegels IJzcr- Hout- Glas- cn Aardewerk Fancy- Katoenen en Wollen Waren Hoeden Petten enz. TEGEN INKOOPSPRIJS uitverkoop. Thans wordt elk huisgezin en voornamelijk de Heeren Logementhoudere Landbouwers en Winkeliers in 't binnenland gelegenheid gegeven om zich het benoodigde goedkoop aan te schaffen. Mogt iemand lust hebben mijn HUIS en WINKEL over te nemen zoo ben ik gewillig een billijk occoord te treffen. De erfpacht van het huis loopt nog 4 jaren met het regt van nog vijf jaren daartoe. Sheboygan 7 Aug. 1851. W. REICHEL. HOLLANDSCHE WINKEL IN HET GItOOT EN KLEIN VAN OTTO SCHUCHT Pennsylvania Avenue tegenover het Postkantoor. Heden heb ik mijn' op nienw ingerigten Winkel geopend en maak het Hollandsche publiek met achting bekend dat bij mij te verkrijgen zijn alle KRUIDENIERSWAREN * PROVISIEN: Koffij Suiker Rijst Grutte Thee Siroop Azijn Olie Kaas cn alle soorten van Specerijen. Goede Cichorei Chocolade en allerhando Tabak Kaarsen Zeep Kruid en Lood Oswego Stijfsel Pijpen Emmeis Waschborden en Tobben. Bezems enz. Verder Kammen Saaijet en Breikatoen Naalden Garen en Petten benevens vele andere artikels. Spek Meel Boter Boonen Erwten Reuzel Ham enz. Ik beloof eene goede en prompte bediening en verkoop mijne waren tegen de goedkoopste prijzen doeh alleen tegen contant geld tegen hetwelk ik alle producten van landbouwers inkoop en de hoogste prijzen betaal. Sheboygan 1 Mei 1851. n 75 SAMUEL CAMP Hoeft W. B. Darling's groote KAGCHEL en BLIK WINKEL overgenomen die thans juist nis vroeger is opgevuld met allerhande soorten van Kagchels en Blikken Waren. Zij die iets van dien aard koopen willen zullen door bij mij te komen ongetwijfeld vinden wat zij noodig hebben en merk dit wel op tegen veel lagere prijzen dan ergens anders het geval is. Fkans is elk uur van den dag gereed om zijne Hollandsche vrienden aan eenig goed artikel hetzij hagcliel of llüncerk te helpen of iets ter reparering aan to nemen; zoo hij verzoekt iedereen hem te komen bezoeken in zijnen ouden winkel eene deur beneden Harvoy 's Store n 74. S. CAMP. J. PAYNE £aar)cn~ Sdiocnmitker Heeft de eer aan de inwoners van Sheboygan en omstreken to berigten dat bij bhjde wezen zal om zijne oude begunstigers in zijnen nieuwen winkel aan Pennsylvania Avenue te ontmoeten en met zoo veel nieuwe begunstigers wenscht kennis te maken als genegen moglon zijn te komen. Mijn werk is van die hoedanigheid dat hetzelve voor ! zulke lage prijzen nergens beter kan gevonden worden terwijl ik borg spreek voor eene goede bediening. J. PAYNE. Sheboygan 10 December 1850. j2n56. SHEBOYGAN FALLS ADVERTENTIES. HOL LANDER 7S AANLEG te Sheboygan Falls. Niettegenstaande het groote werk dat in Sheboygan staat gemaakt to worden door de ""$ 10000 leening"" voor nare haven en de sterke pogingen welke worden ""aangewend om den handel naar dat punt te trekkenis het door een wijsgeerig onderzoek bevonden geworden dat do handels-betrekkingen op de Falls nog onoverschaduwd zijn. Dien ton gevolge maakt J. E. THOMAS aan de Hollanders van Sheboygan County bekend dat zijne banier steeds is uitgestrekt en waarop met groote letters prijkt: ""NEW GOODS'"". Welke Nieuwe Goederen door hunnen landgenoot Arie van Isges altijd tegeu de laagsto en vaste prijzen aan hen zullen verkocht worden en die bestaan in allerhande KRUIDENIERS WAREN MANUFACTUREN MANS-KLEEDER EN LAARZEN SCHOENEN en:. enz. Hij zal steeds voorzien wezen van de voornaamste artikelen die «len landbouwer» benoodigd zijn en wil ten allen tijde zoo met zijne Hollandsche Vrienden handelen dat zijn winkel inderdaad de ""Hollander's Aanleg"" meer en'meer wordt en bij voortduring blijft Shebovgan Falls J. E. THOMAS. 22 «Tulij 1851. n 86. Speciale Bekendmaking- Al degenen diegoedkoope waren willen koopenkunnen ditdoen doorzich aan te melden bij J. SULLY & CO. te öljcboggcm .foils in den Steen en Winkel. Zij kunnen hunne Boter Eijeren Koren Spek en Boonen tegen do hoogste marktprijzen verkoopen en allerhande waren goedkooper krijgen dan in eenige winkel in Sheboygan County. Indien gij wilt komt en ziét! Wij zullen u overtuigen dat het zoo is. j2n2 J. SULLY & Co. LEES DIT NIET. De Oude Winkel en Nienw Geed. J. SULLY & Co„ te Shebovgan Falls willen alle foorten van Manufacturen Kruidenierswaren en Provisien zeer goedkoop verkoopen voor contant geld. Het zal hun aangenaam zijn om hunne kalanten onder de Hollanders met alles wat zij mogten noodig I hebben te voorzien tegen zeer lage prijzen. Zij zullen \ zeer dankbaar voor hunne gunst tot dusverre en zullen zich beijveren om hunne gunst en vertrouwen verder te verzekeren door eerlijk met hen te handelen. Voor KALFS- en KOEHUIDEN wordt contant geld betaald; alle soorten van County producten worden gekocht en da hoogste prijs voor dezelve betaald. Shebovgan Falls J. SULLY & Co. 16 Mei 1850. n. 26. W. H. PAINE : Deputy County Landmeter voor Sheboygan County heeft Kaarten en Landschetsen van gezegde couty t en is daardoor in staat om naauwkeurig te meten. ' Kan gevonden worden in Cole's Kantoor te Sheboygan Falie Wie.—Een iedere gunst wordt vorzooht. n7O.",http://resolver.kb.nl/resolve?urn=ddd:011021457:mpeg21:a0013:ocr,8,ddd:011021457:mpeg21:p008,De Sheboygan Nieuwsbode,530
18768,1851/04/08 00:00:00,48,ddd:010247992:mpeg21:a0028,http://imageviewer.kb.nl/ImagingService/imagingService?id=ddd:010247992:mpeg21:p004:image&x=2248&y=2230&w=391&h=48,ddd:010247992:mpeg21,2639,2278,2248,2230,4,ADVERTENTIEN.,http://resolver.kb.nl/resolve?urn=ddd:010247992:mpeg21:a0028:ocr,4,ddd:010247992:mpeg21:p004,De Tĳd : godsdienstig-staatkundig dagblad,391
3264470,1851/06/23 00:00:00,2515,ddd:010924109:mpeg21:a0018,http://imageviewer.kb.nl/ImagingService/imagingService?id=ddd:010924109:mpeg21:p004:image&x=61&y=1571&w=1298&h=2515,ddd:010924109:mpeg21,1359,4086,61,1571,4,ROOM- EN KOFFIJHUIS DE VINK. Zondag 23 Junij en vervolgens alle Zondagen. CONCERT Onder Directie van den Heer V. von der .'inch van Amsterdam. Aanvang des Namiddags ten 5 ure. Vrij Entree. D. OUDSHOORN. KOFFIJHUIS ZOMERZORG. Op Dingsdag 34 Junij 1851 HET DERDE DER ZOMER-CONOEETEN Onder Directie van den Heer JF. B»U!\'I_!EI. Aanvang des Avonds ten half zeven ure. ~~ WILLER'S HAAR-OLIE. AVie deze EI _. SS-« ___.; naar voorschrift gebruikt mag gerust eene goede uitkomst verwachten. AVij hebben zoo vele bewijzen van hare groeikracht dat wij aan een gelukkig gevolg niet meer twijfelen durven. Onder de vele goede uitkomsten die men ons vergunde bekend te maken  herinneren wij aan die van den Heer BRUA'N v. MAARSEVEEN van den Baron van AVASSENAAR Si. PANCRAS van den Oldenburgschen Dichter KOBBE. Allen hadden zich over eenen even voorspoedigen als wcelderigen groei te verheugen en wel onder de merkwaardigste omstandigheden. AVij hebben voorbeelden gehad dat iemand die nog zeer jong zijn Haar reeds verloren had het na verloop van meer dan twintig jaren in Mannelijken ouderdom door het gebruik van WB___ES_'s 41L.1E terug gekregen heeft. Het voorschrift hoe het gebruikt moet worden gaat bij ieder Fleschje. - De Heer. AVILLER heeft om zijne Olie beter van de nagemaakte Soorten te onderscheiden den vorm zijner Flesschen eenigzins veranderd en op bet glas staat aan de eene zijde: -*• WH-IjKS* . ■ - ■ __._-._JT__UB_M m aan de andere.zyde BEI ZURICH Daarbij zullen ze in het vervolg voor 1' Gulden verkocht worden die vroeger ƒ2 gekost hebben. De Fleschjes van ƒ1 zijn gesuprimeerd en komen niet meer in den handel. leder Fleschje van 1* Gulden beeft een Boekje in het Hollandsen gedrukt met Voorschriften &c. in het Omslag die met eene AVaarschuwing op rosa bandje beplakt is. Ze zijn te verkrijgen : Amsterdam Verkoophuis. 'sHage Sack en Comp. Gouda A. Goedraad. » j. Rensburg. Haarlem J. Larscn. Leyden A. Dirks. » AA'ed. de Lange en van Ek. Utrecht Ferd. Meijer. En in de andere Steden van ons Rijk. AVordt gevraagd tegen 1». Augustus eene ISienstbode i___tss*___P_> van de R. C. Godsdienst goed kunnende Koken en Huiswerk verrigten. Adres met franco brieven onder Letter » bij den Boekhandelaar J. AV. van LEEUAVEN Breedestraat te Leyden.,http://resolver.kb.nl/resolve?urn=ddd:010924109:mpeg21:a0018:ocr,4,ddd:010924109:mpeg21:p004,Leydse courant,1298
486096,1851/08/23 00:00:00,456,ddd:010276209:mpeg21:a0014,http://imageviewer.kb.nl/ImagingService/imagingService?id=ddd:010276209:mpeg21:p002:image&x=2265&y=1620&w=1066&h=456,ddd:010276209:mpeg21,3331,2076,2265,1620,2,In lossing de Kof Adolf Eduard. met grove ENGELSCHE KOLEN voor rekening van H. J. BRONKERS. 215 de STAATS-LOTERIJ. gij H. TRACHSLER Kortendelft G. 14 Debitant in voornoemde Loterij  zijn weder te bekomen Heele en Gedeelten van LOTEN in Koop en Huur volgens Prijs-courant ; waarvan de trekking der Eerste Klasse begint op Maandag den 8 September 1851.,http://resolver.kb.nl/resolve?urn=ddd:010276209:mpeg21:a0014:ocr,2,ddd:010276209:mpeg21:p002,Middelburgsche courant,1066
2471856,1851/09/16 00:00:00,2239,ddd:010073028:mpeg21:a0027,http://imageviewer.kb.nl/ImagingService/imagingService?id=ddd:010073028:mpeg21:p006:image&x=2271&y=85&w=1104&h=2239,ddd:010073028:mpeg21,3375,2324,2271,85,6,"i _____________^_________^ ROOGDUITSCDE SCEIOUWBURG in de Amstelstraat. Mei toestemming van de Wei-Edel Achtbare Heeren Burgemeester en Wethouders dezer Stad zullen de Koninklijke Hollandsche Tooncelisten onder directie van den Heer A. PETERS de eer hebben op te voeren: Om den algemeenen vereerenden bijval Dingsdag 16 Sept. 1851: Eene vierd- Voorstelling van: de Rijke Erfgename  Dramatisch Tafereel in vijf bedrijven getrokken uit den Roman de Zeven Hoofdzonden (dc Hoogmoed) vau Eugène Sue. Om de uitgebreidheid der Voorstelling geen Nastuk. • Dc aanvang ten zeven ure precies. Woensdag 17 Sept.: Eene Familie Tooneelspel naar het Hoogduitse.! (nooit alhier vertoond). SALON DES VARIÉTÉS in de Nes. Dingsdag 16 Sept.: D* Debutante of de Drie Vertrekken vaudeville in 3 bedrijven naar het Iransch. Voorafgegaan door: De Zon en de Noorden Wind vaudeville in 1 bedrijf. Aanvang ten 8 ure. Entree 75 Cents in vertering. j E. DUPORT. SALON DES VARIÉTÉS in de Amstelstraat.Dingsdag 16SepM De Bierbrouwer van Preston of de gelijkende Tweelingbroeders vrolijk* vaudeville in 3 bedrijven naar het Fransch Le Brasseur de Preston. N» hetzelve: De Man kookt den Pot en de Vrouw maakt Verzen nieui.9 vrolijke vaudeville in een bedrijf. Entree 75 Cts. in vertering. Aanvang 8 ure. . BOAS & JUBELS. ___ VAUDEVILLE FRANCAIS. Mardi 10 Septembre: La 2e rep.-». dc: Phüippe drame-vaudeville en 1 acte. Suivi de: Pas de Fuméesan* jeu vaudeville-proverbe en 1 acte. Le spcctacle commenccrapar: Tïrt* date ou Comtdis et Tragédie come'die-vaudeville en 1 acte. 8 heure*. Entree 75 cents sans consommation. Jl. H. WILREMS. FRASCATI. MAANDAG en DINGSDAG 15 en 16 SEPTEMBEB en gedurende de KERMIS alle Avonden: BUITENGEWOON GROOT INSTRUMENTAAL CONCERT uit te voeren door de voornaamste TOONKUNSTENAREN VAN AMSTERDAM onder directie van den Ondergeteekende. WE GROOTE ZAAL welke geheel nieuw gedecoreerd is bied* . tevens een ruim overzigt aan op de GROOTE GALERIJ van het LONDONSCHfI TENTOONSTELLING GEBOUW. BE NIEUWE ZAAL zal ingerigt zijn tot RESTAURATIE. alwaar men zich zal kunnen laten bedienen van koude en warme Soup* RE GOTIIISCI-E ZAAL zal geopend zijn tot het gebruik van all» soorten IJS SORBETS PUNSCH A LA RÓMAINE enz. Entree fl zonder vertering. Aanvang 8 Ure.  Jl. EDUARD STUMPFF. NB. Diploma's zijn de Zondagen gedurende de Kermis niet gangbaar» uitgezonderd de Abonnementen. OOEON. DINGSDAG 16 SEPTEMBER 1851: ~~ VOCAAL EN INSTRUMENTAAL CONCERT door de beroemde Bachsche Concert-Gcsellschaft uit Bonn onder direct-* van den verdienstelijken Orkest-Directeur WENIGMANN. Nieuwe Galop van C. E. Bach Erinnerung an Amsterdam. — Iste uitvoering der Ouvertures van Fra Diarolo en Mose alsook van eene nieuwe groote Potpourri uit Robert le Diable en andere Opera's. — 0? verzoek Abendglocke Koor van Wenigmann. . 8 Ure. Entree/1 gedeeltelijk in vertering. F. TORCDIANA. NB. Zondag 21 Sept.: LAATST CONCERT van bovengenoero» Gezelschap. ZAAI. DE DUIZEND KOLOILUEN. . Door de welwillende toestemming van de Heeren Leden der Socie.ejJ de Gezelligheid zal bovengenoemde ZAAL gedurende de KERM*"" weder voor het Publiek op Heden opengesteld worden en alle Avonde"" SOIREE MUSICALE worden uitgevoerd door de Familie BUZIAÖ Aanvang ten 7\ Ure. Entree vrij. _",http://resolver.kb.nl/resolve?urn=ddd:010073028:mpeg21:a0027:ocr,6,ddd:010073028:mpeg21:p006,Algemeen Handelsblad,1104
1573440,1851/03/24 00:00:00,1639,ddd:010518272:mpeg21:a0023,http://imageviewer.kb.nl/ImagingService/imagingService?id=ddd:010518272:mpeg21:p004:image&x=2037&y=1786&w=960&h=1639,ddd:010518272:mpeg21,2997,3425,2037,1786,6,"V PUBLIEKE VERKOOPING W BOEKEN UI Op Maandag den Sl»'""' Maart 185 J eu volgende dagen zal door en l«ju huize vau W. P. van STOCKUM. Boekverkooper te 'sGravenhage worden verkocht: Eene belangrijke verzameling BOEKEN in verschillende vakkeu van Wetenschap eu Kunst meereudeel» nagelaten door wijlen den Wel - Edelen Heer J. KISSE- LïUS  Lid van den Raad der Stad Dordrecht eu vervolgens op Maandag 7 April: DIVERSE VOOR' WERP ES  in de manier van het Japansch Verlakt viel Paarlemoer ingelegd vervaardigd door den Wel-Edelen Heer Mr. C. N. HUYGENS. De Catalogus is op franco aanvrage ü 20 Cts. verkrijgbaar. - V Bij J. G. BROESE te Utrecht is heden verschenen: HET INVOEReV ÊNAFSCHAFFEN AG MMS EN. ME STAATSHUISHOIDKUNDIGE PROEVE Ë. VAN VOORTHUIJSBKT Jh. Ph. Th. Mag. L. 11. et J. ü. Doctor. 5© Cents. Mede verkrijgbaar: Amsterdam Brinkman Joh. MM ler; Arnhem Stenfert Kroese Nijhojj'- Delft Beets- Dordrecht Blussé en v. Braam  Groningen v.Boekereni Waltere: Gorinchem Noordvij-n en Zn. Gouda v. Goor' 's Hage. Gebr. Belinfante Noordendorp v. Stockuffl'' 's Bosch. Gebr. Muller: Haarlem Kruseman  Leeuwarden Eekhojj Suritiyar . Leyden Jac.Hazenberg CH*-! Middelburg _ Bent hem eu Jutting - Nijmegeu  Thieme ■ Rotterdam ii. Gogh. Kramers v. Reijn Snoeck.",http://resolver.kb.nl/resolve?urn=ddd:010518272:mpeg21:a0023:ocr,4,ddd:010518272:mpeg21:p004,Opregte Haarlemsche Courant,960
1191645,1851/03/15 00:00:00,1365,ddd:010077711:mpeg21:a0012,http://imageviewer.kb.nl/ImagingService/imagingService?id=ddd:010077711:mpeg21:p004:image&x=2002&y=38&w=873&h=1365,ddd:010077711:mpeg21,2875,1403,2002,38,4,"De Notaris J. 11. VAN D E N lIA M residerende te Boxtel zal voor den Wel Edel. Heer P. H. VELSEN wonende te Boxtel op Zijn Edels LANDGOED OU WER KERK te Vught op Maandag den '7e Maart 1851 des morgens om 10 uren te beginnen  Fn bliek Verkoopen: EENE GROOTE PARTIJ J9L.3BET' 3""-__ B -SBES6. _______ -£___. _¦____. -> BESTAANDE IV; 26 Koopen PLANKEN 14 Koopen GRE INE BALKEN RIBBEN en OP S C HE UTEN 3 paar STALDEUREN 18 stuks RAMEN met IJ Z E R D 11 A A D  26 BROEIBAM E N 20000 STEENEN 7000 PA NNEN 12 HOUTEN HEININGEN met daaraan staande VRUCHTBOOMEN een slaande MUUR in Koopen afgesmct eenig HOUTWERK van de BROEIJ E R IJ  alsmede zal nog vooi- afbraak worden Opgeveild een GEBOUW gediend hebbende voor ORANJERIE. Aanwijzing zal gedaan worden door A. K A- P E L  wonende op gezegd Landgoed. (171) GRAANMARKT TE 's BOSCH. Woensdag en Donderdag (2 en 13 Maart. Rogge 5.30 — en 5.65. Boekweit £.40 — en 5.75. Haver hel N. Pond. . 0.05£— en 0.06. Gort Haver- . . . .",http://resolver.kb.nl/resolve?urn=ddd:010077711:mpeg21:a0012:ocr,4,ddd:010077711:mpeg21:p004,De Noord-Brabanter : staat- en letterkundig dagblad,873
5797941,1851/09/11 00:00:00,5251,ddd:010073023:mpeg21:a0025,http://imageviewer.kb.nl/ImagingService/imagingService?id=ddd:010073023:mpeg21:p004:image&x=1173&y=72&w=2164&h=5251,ddd:010073023:mpeg21,3337,5323,1173,72,4,"Hf Alt UITVERKOOP VAN DE ENGELSCHE BAZAAR ONDEE DIKECTIE VAJf ■ (ï. 01 l EMIEIII J  f KORTE HOUTSTRAAT 'SHAGE. Door algeheele kwitering dezer Affaire zal de groote voorraad der fraaiste Gï.ES.EREN van heden af ver onder inkoopsprijzen worden OPGERUIMD en zal men zich zeer bevoordeelen van deze zoo zelden voorkomende gelegenheid gebruik te maken door de kostbaarste Voorwerpen uit de gerenommcerdste fabrieken herkomstig tot spotprijzen te erlangen. HEL HEEDERS EN HANDELAREN op O. en W. Indië alsook HH. WINKELIERS mits bij partij koopende genieten nog een extra rabat. NB. Brieven Franco. _13629) HET lIEÜWE MAGAZIJH K. PUTTENAAR Korte Nieuwendijk het Zesde Huis van de Ilarinnpakkerij N°. 126 beeft de eer het'geachte Publiek te berigten dat hij ruim voorzien is van vele soorten van Mahony MEUBELEN en GALANTERIEN voor onderstaande Prijzen als: Mahony rijk gewerkte Canape'es Malionyhouten Chiffonnières ƒ 30 en hooger Linnenkasten ƒ36 en hooger Mahony Penantkastcn ƒ24 en een groote voorraad Mahony Beuken en Ipen Stoelen van ƒ 3.25 en hooger Mahony Thee- en Eettafels Speeltafels met Medaillons Mahony Canapetafel ƒ 18 Stommeknechts of Aanzettafels Dames Werktafels met Zijden zak ƒ 10 en hooger Vierkante en Ronde Waschtafels Vierkante Schuiftafels met Wasdoek/7 en hooger dito Ronde met Wasdoek Gladde Stoven met Blik iï/5 per Dozijn Mahony Theei.iumcrs met Koperen Banden en Bakken/5.50 en hooger dito Mahony Tbeestovenƒ 4.50 en hooger Penant of Kpiegeltafels van ƒ 24 tot/32 Malionyhouten Bedkastjes/9 dito met Marmer/ 11 Muzijkkastjcs ƒ 12 Eiken Bcdtafels/ 2.75 Stoven metSteenen/2.soMahony Boekenhangers ƒ 2.75 Borduurramen ƒ 1.80 Garenwinders ƒ 1.20 Dames Toilet en Kapdozen ƒ 1.20 en hooger Likeurkelders van vier en zes Flcssrlv-n Schrijf en Reiscasetten ƒ 5 en boogcr Lessenaars/1.50 Mahony Theestoofjea 90 Cv. Nuaikistjes 80 Cts.""lot ƒ2.25 Pijpen.taudaardsƒ 1.20 dito Pijnenladcn f 1 .GO Tabak-Theeen Lepelkistjes 90 Cts. Mahony Tabakspotten/ 1.20 Mahonyhouten Messenbakken/ 1 Handdoekrekjes 75 Cts. en hooger Damborden ƒ1.50 Damschijven 75 Cts. Schaakspelen 90 Cts. Schimmel- Kien-en Dominospelen een groot assortiment Spiegels en Schilderijen met Vergulde en Mahony Lijsten Albasten en Palisauder Pendules alle accuraat van gang Porseleinen en Albasten Bloemvazcn en dito Bloemenmanden Fransche Porseleinen Tiice-crvicseu Devies-Koppen en Kommen van 50 Cts. en hooger Porte-Sigares Beeldjes en Schoorsteenornementen Porseleinen Serviesen met 16Stuks voor ƒ 7.75 Kristallen Konipotten en Roomkommen Wijn- Likeur-. Punsch- en Bierglazen verlakt in onderscheidene dessins Tafel-en Dessertmessen en Vorken Water- en Koffij ketels Strijkijzers 90 Cts. en hooger Brood- Beschuit- en Koflij trommels Koperen Tabakskomfoor van 50 Cts. en hooger IJzeren Parapluistandaard dito van Blik ronde en vierkante Tafel- en Winkellampen eene groote partij Zuinigheidslainpcn met Ballon en Glas voor ƒ 2 goed of terug een groot assortiment; Zilveren en Schildpadden en Stalen Brillen voor zwakke en bijziende gezigten eene groote partij fijne Zeep als Violet Cocoszeep Palmerie en meer andere soorten van Zeepen eene partij beste Eau de Cologne a 90 Cts. het kistje en hooger en meerdere Artikelen tot Geschenken voor dcKermis en huishoudelijk gebruik meer Artikelen te veel om te melden; cene partij beate Waskaarsen voor 60 Cts. a zes iv het pak. Brieven Franco (14276) ""BANDAGES HERNIAIBEB. Les bandages lourds et massifs et souvent de mauvaise qualité qu'on de'livre nux Dames nous ont engage's depuis longtemps a chercher de eonfectionner vn GENRE DE BANDAGES approprie's aux personnes qui doivent les porter. Nous avons re'ussi au dcl'a de toute espe'rance. Nos bandages re'unissent au plus haut d*gré les qualité si cssentielles de parfaite iixite' sur le corps sans I'emploi de'sagrCable dc sous-cuisses de sécurite' de commodite' de legèrete' de sblulité et d'élégance. Fabriques de I'acier le plus lm ils sont d'une e'lasticite' surprenante et d'une exiguitc' tclle que six de ces bandages pè»ent moins qu'un bandage ordinaire. BIONDETTI & WAEHSEGEBS Bandagiites Herniaires  Orthojiédisles (13074) Kalverstraat 40 Amsteedam. Aan HH. LEDEN dei SOCIËTEIT BELLEVUE-CONCORDIA wordt berigt dat uit hoofde van het CONCERT de Tuin BELLEVUE op den 14dcn September aanstaande tot des namiddags vier ure zal zijn G E __ L O T EN terwijl daarentegen CONCORDIA dien dag GEOPEND is. (14323) SCHOUWBÜRG-SIV COWCE.RT-SB.  BKZ. STADSSCHOUWBURG. Donderdag 11 Sept. (N . 10 Abonnem.) Eene derde voorstelling van: Theodora- Violetta of de Bravo van Venetien Romantisch Tooneelspel in 5 bcdi ijven en-6 tafcreelen. (Nooit vertoond). Gevolgd door cene vijfde voorstelling van: Arleguinopae Tentoonstelling te Londen of Pierrot Luchtschiiipcr groot ballet-pantomime in 11 tafercelen. (6 ure.) HOOGDUITSCHE SCHOUWBURG in de Amstelstraat. Met toestemming van dc Wei-Edel Achtbare Heeren Burgemeester en Wethouders dezer Stad zullen de Koninklijke Hollandsche Tooneelisten onder directie van den Heer A. PETERS  de eer hebben op te voeren op Donderdag 11 Sept. 1851: De Rijke Erfgename Dramatisch Tafereel in vijf bedrijven getrokken uit den Roman de Zeven Hoofdzonden (de Hoftgmocd) van Engene Sue en in het Hoogduitsch voor het Tooneel vrij bewerkt door Friedricli Goniarky j naar het van den schrijver dooi aankoop verkregen handschrift met gebruikmaking van den oorspronkelijken Roman vertaald door B. L.. nooit up eenig ander Tooneel ver- 1 tooad. Om de uitgebreidheid der Voorstelling geen Nastuk. 1 De aanvang ten zeven ure precies Prijzen der Plaatsen: Balcon f 2.20; Loge/ 1.50; Parterre/ 1 • Ga-n derij Loge/ 0.60; Gaanderij/ 0.40. ' Militairen en Kinderen betalen half Entreegeld. Het Bureau zal van des morgens 9-3 ure tot het bespreken van Plaatsen geopend zijn. liAÏj__n_ES VARIÉTÉS in de Nea.""_s^_^7Ts^TlÖ' Scheepsjongen vaudeville iv 2 bedrijven naar het Fransch. V» r door: Diana de Liron vaudeville in 1 bedrijf. DSU' Vooralgegaan _ Entree 75 Cents in vertering. .___j^nrfel' ' SALON DES VARIÉTÉS in de A__^^rs_____£__.~~ Eene tweede voorstelling van: De Man kookt rfrnS' Il P ' maakt Verzen nieuwe vrolijke vaudeville in 1 bedrijf. Vooraf ""^ door: De Betcoverde Prins vrolijke vaudeville in 3 bedrijven .„gegaan Entree 75Cts. in vertering. ______ BOA» & JUBELS. Ure° ' i VAUDEVILLE FRANCAIS. Jeudi 11 Scptembre. Pas de Fumée sans feu proverbe vaudeville en 1 acte. Pre'céde' de: Michel et Christine vaudeville en 1 acte. Le spcctacle seraterminc par: Brelan de Troupiers; vaudeville en 1 acte. Entree 75 cents sans consommation. 8 heures. J. R. WILKENS. ffRASCATI. DONDERDAG 11 SEPTEMBER 1851 en gedurende de KERMIS alle Avonden: BUITENGEWOON «ROOT INSTRUMENTAAL CONCERT uit te voeren door de voornaamste TOONKUNSTENAREN VAN AMSTERDAM onder directie van den Ondergeteekende. DE GROS-TE ZAAL welke geheel nieuw gedecoreerd is biedt tevens een ruim overzigt aan op de GROOTE GALERIJ van het wmmm wmmm gebouw. DE NIEUWE ZAAL zal ingerigt zijn tot RESTAURATIE j alwaar men zich zal kunnen laten bedienen van koude en warme Soupés. DE «OT-lISCÜE ZAAL zal geopend zijn tot bet gebruik van alle soorten IJS SORBETS PUNSCH A LA RÓMAINE enz. Entree/ 1 zonder vertering. Aanvang 8 Ure. J. EDUARD SVUMP». NB. Diploma's zijn de Zondagen gedurende de Kermis niet gangbaar uitgezonderd de Abonnementen. ODEON. DONDERDAG 11 SEPTEMBER 1851: In dc door den Heer GROOTVELD prachtig gedecoreerde CONCERTZAAL. VOCAAL EN INSTRUMENTAAL CONCERT door de reeds met roem bekende Bach'sche Concert-Gesellschaftmtllouo onder directie van den Heer WENIGMANN Orkestmeester aan de Opera aldaar. Entree f 1 waarvan 40 Cents in vertering. 8 Ure. HH. Lef en der Zungvcreeinging welke hunne Diploma's niet mogten ontvangen hebben worden vriendelijk verzocht dezelve aan Oijéox te doen nfhalen. ff. TOEtC__.IA.-A. ZAAL DE DUIZEND KOLOMMEN. Door de welwillende toestemming van dé Heeren Leden der Sociëteit de Gezelligheid zal bovengenoemde ZAAL gedurende de KERMIS weder voor het Publiek op Heden opengesteld worden en alle Avonden SOIREE MUSICALE worden uitgevoerd door de Familie BUZIAU* Aanvang ten 7$ Ure. Entree vrij.",http://resolver.kb.nl/resolve?urn=ddd:010073023:mpeg21:a0025:ocr,4,ddd:010073023:mpeg21:p004,Algemeen Handelsblad,2164
2529351,1851/03/04 00:00:00,2643,ddd:010518255:mpeg21:a0023,http://imageviewer.kb.nl/ImagingService/imagingService?id=ddd:010518255:mpeg21:p004:image&x=2019&y=2172&w=957&h=2643,ddd:010518255:mpeg21,2976,4815,2019,2172,4,"V Kjj J. G. vanTERVEENenZOON te Utrecht; zijn nog eenige Exemplaren te bekomen vau H*TOJ__lüDil)l§ AfiMËM-ADffIIMsTRATIËN door V. TEN KATE. VIERDE DRUK. 2 STUKKEN. ƒ 125. En is onlangs van de pers gekomen- HANDLEIDING HUMDIRSenIrHIRDERS mor W. DE GELDER INSI'ECTEUR DER REGISTRATIE TE J.EYDEN. ƒ 150. Dit Werkje bevat zes en twintig verschillende Formulieren voor Huurcontracten aanwijzingen ten aanzien vau het Zegel de Registratie euz. en kan alzoo als een onmisbaar Handboekje beschouwd worden voor allen die gewoon zijn zelf hunne Huurovereeukomsten iv schrift te brengen. *** BÜ alle Boekhandelaren is verkrijgbaar ■ DE BARBIER EX DE HAARSNUDER Scueercnde en Snijdende dj» alle manieren. Luimige Dichtstukkeu \ met Plaatjes. Prijs 25 Cent. V Alom is door DANNENFELSER eu DOiTrMAN~. te Utrecht verkrijgbaar gesteld : SCHOEDLER'S A STRONÜM JE. NAAR HET HOOGDUITSCH BEWERKT DOOR DE HEEREN i % mmm en j. j. althker. MET *? FIGUREN. f 100. ggp° Dit populair geschreven Werkje is reeds op verscheidene Instituten eu Academiën ingevoerd. Ook van de PUI SICA zijn nog eenige Exemplaren; * ƒ 150 te bekomen. ' V H. A. M. EOELANTS te Schiedam heeftvdt^vTTv en verzonden: VIJF HAANDEN. EEN HOEK ÏANb VERTROOSTINfi weg des Tijdens C. VAN SCHAICK. Gr. B°. één Deel met Portret .  . . /"" 440. In Linnen gebonden  4^o Dit Werk  dat alom gunstig ontvangen en beoordeeld is zal de velen die het'nog niet genoeg kennen als Godsdienstig li_.<».M_.  eeue hoogst-nuttige en aangename Lectuur zijn.",http://resolver.kb.nl/resolve?urn=ddd:010518255:mpeg21:a0023:ocr,4,ddd:010518255:mpeg21:p004,Opregte Haarlemsche Courant,957
3395835,1851/03/05 00:00:00,3519,ddd:010518256:mpeg21:a0014,http://imageviewer.kb.nl/ImagingService/imagingService?id=ddd:010518256:mpeg21:p004:image&x=1045&y=1339&w=965&h=3519,ddd:010518256:mpeg21,2010,4858,1045,1339,4,"*#* T E H U U R tegen primo Mei aanstaande: Eene aangenaam gelegene en zeer goed ouderhoudene WONING boven de Oranjerie van den Huize Overbeek te Velp  bij Arnhem met annex Tuintje. Te bevragen bij den Heer E. ENGELBERTS Intendant van Biljoen  aldaar. Brieven franco. *** Alen is voornemens op Dingsdag en Woensdag den llden en 12(len Maart 1851 te beginnen voor den middag te tien ure ten Huize N° 34 in Wijk A aande zuidzijde van de Oudegracht te Alkmaar om kontant geld openbaar te verkoopen: Eenen wel geconserveerdeu INBOEDEL bestaande in mahonijhouten Kabinetten Secretaire ChiffonnièreCommodesVierkante- Ronde- Ovale- Lade- Trumeau- Penant- Dien- en Speel-tafels Canapé Stoelen met trijpte paarden haren en matten zittingen Piano heldere Spiegels Schilderstukken van bekwame meesters Pendule onder Stolp Staand-Horologie Vloerkleeden en Karpetten Ledikanten met Gordynen Bedden en Toebehooren Bed- en Tafellinnen Koper- Tin- Blik- IJzer- Porcelein- Verlakt- Kristal  Glas- en Aardewerk; mitsgaders Goud- en Zilverwerk en verdere kostbaarheden waaronder een snoer Paarlen van twee strengen twee paar juweelen Oorhangers een gouden Horologie een antieke Bierkan met zilveren deksel en voeting oude zilveren Aluntstukken zilveren Kinderspeelgoed en Tafelzilver en hetgeen verder te koop zal worden aangeboden. Alles nagelaten door den Wel-Edelen Heer ARNOLDUS van de VELDE Gz. en al hetwelk op Maandag den 10den te voren van des voormiddags tien tot des namiddags vier ure ter gemelde plaatse door een ieder zal kunnen worden bezigtigd. Zullende het Goud- en Zilverwerk en de verdere kostbaarheden worden verkocht op den tweeden verkoopdag des middags te twaalf ure. *„.* Alen is voornemens op Dingsdag den llden Maart 1851 des voormiddags ten elf ure in de Herberg de Roode Leeuw te Callantsoog in het openbaar te doen verkoopen: Eenige Percelen WEIDL A.ND HOUT en RIETBOSCH te zameu groot 45 Bunders 57 Roeden 80Ellen gelegen aunex deu anderen in Jen Uitlaudschen-Polder tusschen den Uitlandschen-Weg eu den Zijperdijk in de Gemeente Callantsoog Kadastrale Sectie E Nummers 124 tot en met 129 131 tot eu met 140 147 148 eu 149. Breeder bij Biljetten omschreven. Informatien zijn te bekomen ten Kantore vau den Notaris C. SIEMERS te Zype. %* KOORN-MOLEN te BOOGLANB. Men is voornemens op Dingsdag den 25sl<'"" Maart 1851 des middags ten 12 ure bij deu Kastelein Wouter van Dijk onder Amersfoort voor den tijd van zes jaren aanvang nemende 1 Mei 1851 te verhuren: De WIND-KOORN-MOLEN geuaamd DEN HAM staande onder de circa 2500 zielen groote Gemeente 't Hoogland aan den Straatweg nabij Amersfoort met de daarbij behoorende Huizinge eu Stalling voor Paarden en Koebeesten benevens twee Bergen en Tuin en alsdan tevens te verkoopen: Eene NIEUWE MOLENAS inden hals dik 5755 Duim eu 705 El lang liggende in het te verhuren Perceel. Nadere informatien zyn op franco Brieven te bekomen ten Kantore van den Notaris Mr. J. de LOUTER te Amersfoort. V De Notaris G. FREISLICII te Hasselt zal op nader te bepalen dag publiek verkoopen : Een zeer antiek hecht sterk welouderhouden WOONHUIS eu ERF staande en gelegen in de Nieuwstraat te Hasselt Sectie A 308 groot 9 Roeden 30 Ellen waarin eene groote Zaal diverse ruime zoo Beneden- als Bovenkamers eenige met geschilderde Glasruiten groote Zolders  Keuken en waterdigte Kelder; achter het Huis ruime Plaats eene Schuur en groote Tuin  met exquise Vruchtboomen.' Nagelaten door wijlen den Heer Majoor J. B. ROBERT eu Mevrouw M. van WAGENINGEN vroeger door deze en thans door derzelver Erfgenamen bewoond. Zijnde inmiddels uit de hand te Koop. Te bezien elke Maandag van des voordemiddags elf tot des nademiddags zes ure. Informatien bij gezegden Notaris. Brieven franco. _^ DE MAART-AFLEVERING VAN HET bevat: De Titelplaat. — De grijze Vertrooster. — Antwoord op den Oudejaarsbrief van mijn' vriend Theodoor. — De Discipel niet meer dan de Meester. — Alles het uwe. Elke maandelijksche aflevering kost bij inteekening 35 cents.",http://resolver.kb.nl/resolve?urn=ddd:010518256:mpeg21:a0014:ocr,4,ddd:010518256:mpeg21:p004,Opregte Haarlemsche Courant,965
4448204,1851/09/01 00:00:00,2033,ddd:010073013:mpeg21:a0017,http://imageviewer.kb.nl/ImagingService/imagingService?id=ddd:010073013:mpeg21:p004:image&x=46&y=3242&w=2188&h=2033,ddd:010073013:mpeg21,2234,5275,46,3242,6,"s^ PIANO'S VAN ER ARD TE PARIJS EN LONDEN ■'a^-^ groot depot bij H. Rahr te Utrecht. H. RAHR  te Utrecht adverteert dat hij van zijne reis naar Parijs en Londen met een groot aantal uitgezochte PIANO'S uit de Fabriek van denHr. ERARD die op dc Tentoonstelling te Londen de eenige groote medaille ontvangen heeft is teruggckecrel. Dat hij verder heeft medegebragt •en groot assortiment PIANO'S uit de wereldberoemde Fabrijk van PLEYEL _• COMP». en daardoor de Pianisten in de gelegenheid stelt 'de Instrumenten uit deze twee Hoofd-Fabrieken naast elkander te kunnen beproeven en dus volgens eigen overtuiging te kunnen kiezen. Ook aljn voorhanden uit minder bekende Fabrieken OPSTAANDE PIANO'S van 6* Octaaf voor ƒ 350 en hooger. Insgelijks ook INGERUILDE PIANO'S voor geringe prijzen. (13461) AROMATHISCHE OP WELRIEKENDE TOILET-AZIJN v-» JEAN VINCENT BULLY. Dit voorbeeld van TOILET PARFUM vereenigt in zich het aangename bij het nuttige en verdringt daardoor geheel en al de EAU DE COLOGNE te meer daar dat artikel zoo veel slechts en schadelijks heeft opgeleverd. Het Publiek in Frankrijk en in België heeft de meerderheid van zijn Parfum en krachtdadigheid van zijne eigenschappen erkend daar hij voor uitwendig gebruik en Mondspoeling niet genoeg kan worden aanbevolen. » Deze weldadige Azijn weert alle besmetting en stiklucht is onontbeerlijk in Kerken Concerten of andere met Menschen gevulde Lokalen alsook in Ziekenkamers zoowel voor de Lijders als Bezoekers. Hij verspreidt eene aangename frischheid en laat de liefelijkste Parfum achter. Hij is zeer aanbelingswaardig voor Heeren Liefhebbers van Rooken; door met water gemengd zich daarmede den Mond te spoelen beneemt hij onmiddelijk alle achtergebleven Tabakslucht. De Omslag van elke Flacon duidt de verdere eigenschappen aan. Prijs 80 Cts. de Flesch met den naam van JEAN VINCENT BULLY in het glas gegoten en verkrijgbaar bij alle Depothonders der Echte MACASSAR OLIE van de Heeren A. ROWLAND & BONS te Londen. (11636) Voor f 6 in plaats van f 27 WORDEN DE WEINIGE NOG VOORHANDEN ZIJNDE EXEMPLAREN AFGELEVERD VAN: DE BRON onmisbaar Handboek voor alle Standen; bevattende eene Verzameling- van T_/-_cr.-_n... ■_wim.aat.tv__. VERSCHILLENDE PROEFONDERVINDELIJKE KUNDIGHEDEN OVER LANDBOUW TÜINBN B^-^N BTOMGAABDBiT JAB_S^F__»NIJVERHEID. KOOPHANDEL HANDWERKEN HUISHOUDING EN ANDERE WETENSCHAPPEN OPGEHELDERD DOOR MEER DAN 1«00 AFBEELDINGEN EN FIGUREN IN VERBAND ftIAANDE MET DE BOVENGENOEMDE ONDERWERPEN. Ingevolge aanbeveling van Hooger Hand tot algemeen gebruik der Plaatselijke Besturen en voorts tot Nut Gemak en Voordeel van alle Maatschappelijke Standen. Door C. SOETENS. Drie zware Boekdeelen in gr. B°. De Aflevering van dit voor een ieder allezins Nul en' Voordeel aanbrengend BOEKWERK. door Hooger Hand aanbevolen geschiedt te Amstbïi-oam door de GEBROEDERS DIEDERICHS en kan voorts van hen door de voornaamste Boekhandelaren in Nederland ontboden worden echter niet langer.dan tot het einde dezes Jaars zonder Verhooging van Prijs. (13662) ""1-AUX D'AIX-LA-CHAPELLE. SAlSffll_lis_~ Ais-la-Chapclle pos.'ede dans ses sourees thermale sulfareuses d^na lesque'lles le ce'Wbre chimiste M. DE JLIEBIG vient de de'couvrir nnsk dm I'iode et du brome vn moyen the'rapei-tique dontune experience de plus de dix siècle» a démoutré I'efticacité dan. les affections f_out_eu„_ f _„™_..<.7T.al*s les nombreuses affections chroniques de la peau et «e_ membranes muqueuses les scrofules les maladies mereurioll»» _„__ et rhumatismale le nomn - dan- les anciens retes deß „^fc „yphilitiques les affections Mmorrhoidalei et ceriaTni ""/ i - espèce» de*nP°'-°°*l*™ D« eau» fe rugineuses récemment découverte. offrent eucore'des ressources dans dircr.es autres m_l_r. * de la men.truation etc. Des eanx _. rcndre _ux étraDgerB le se*jour dansla villeaussiutilcqu'agreable Tp.k • e$ crom<iucs* L'adm inistration municipale n e »*#*«• »™'d* __s h6teli et des quartier. garnis de toutcs grandeur» des promenade'ehal^F^7 U°U""C""I de* bains élegamment garni- et tres commo  (]e g .^^ Man bloth- pu""^™""1**3""^ diverses cot ections trts interessante* au po.nt de vue W . jourg  la et dans jl PuMique et une Bane de ectnre; oh sont les journanx de tons les pays. un g ressources pour passer agrcablement les Soirees. Aix-la.rh_n.ii Cl*™*u> enfll* ""n b°n opéra de concerts et des bals tres frequents offrent des »«o»«« P° P ics bords du Rhin comme avec la &\JT\T^ """"''S *mii K** de chemini de fer et offre des commumcations aussi rapiaes que iatia. > m_.eii.iquc la France et I'Angletcrre; on .e r.nd en 2 heure. 1. Cologne en 6 heurekßroxelle» en l6h«uW.ftr»eten2ohC«p«kLond«* LE COMITÉ. (f 0312) '",http://resolver.kb.nl/resolve?urn=ddd:010073013:mpeg21:a0017:ocr,4,ddd:010073013:mpeg21:p004,Algemeen Handelsblad,2188
124968,1851/01/11 00:00:00,164,ddd:010332216:mpeg21:a0004,http://imageviewer.kb.nl/ImagingService/imagingService?id=ddd:010332216:mpeg21:p003:image&x=795&y=115&w=762&h=164,ddd:010332216:mpeg21,1557,279,795,115,6,Aanduiding van de natie-vlaggen waaronder de vaart en handel op de haven van Curacao gedurende het jaar 1850 hebben plaats gehad.,http://resolver.kb.nl/resolve?urn=ddd:010332216:mpeg21:a0004:ocr,3,ddd:010332216:mpeg21:p003,De Curaçaosche courant,762
4035721,1851/08/18 00:00:00,3613,ddd:010073001:mpeg21:a0045,http://imageviewer.kb.nl/ImagingService/imagingService?id=ddd:010073001:mpeg21:p006:image&x=35&y=1688&w=1117&h=3613,ddd:010073001:mpeg21,1152,5301,35,1688,6,"(13008) Een ieder wordt GEWAARSCHUWD geen CREDIET te ""verkenen aan de EKWIPAGIE van het Hamburger BARKSGHIP zJOHANNA Kapt. J. C. RöPER gekomen van Havana zullende zulks «onder voorkennis van den Kapitein niet valideren. (13006) E. G. VAN IJSENDIJK H. KNOOPS J. OTTERBEEK \ A. J. B. VAN WAIJENBURG A. A. VAN WAIJENBURG en - A. L. VAN IJSENDIJK Makelaars zullen op Donderdag den 21sten c Augustus 1851 des Avonds ten Half Zeven Ure in den Brakken Grond ] ein de Nes te Amsterdam ten overstaan van een daartoe bevoegd  Beambte aan de Meestbiedenden presenteren te Verkoopen; 204 VAATJES { ««ENTEN. 31 FUSTEN J «""""■»* *■-«. |j*^ | KISTJES PRUIMEDANTEN. Liggende als bij Notitie nader zal worden aangewezen. ""WILLIGE VERKOOPING door H. G. GEERS Gz. 1 op Donderdag den 21sten Augustus 1851 des morgens ten Elf Ure op den Singel bij en op de Torensluis van eene aanzienlijke groote . partij AFBRAAK en HOUTWAREN bestaande in: Balken Dcc; len Rigchels Kouzijnen Deuren Ramen Luiken Trappen Nieuwe fen Oude Metselsteenen 36 voets Juffers Kolders Sehoeijing-Palcn  enz.; voorts een partijtje Wagenschot en cenige KLEINE HOUTWA REN alsmede een compleet WINDAS met zijn BINNEN- en BUITENTOUWEN. Alles afkomstig van gebruik en Amotie of Verbouwing der R. C. Kerk De Tobbn ddaar. Hetgeen daags vo'ór en op den Ver' koopdag te zien zal zijn. (12999) fldlTE CIÏEVR. GLACÉ HANDSCIIOEffI. Op de Leytlschcstraat N°. 18 het 3de huis van de Keizersgracht zijn op heden ontvangen eene uitmuntende partij GLACÉ HANDSCS-OENEN dezelve zijn van het dunste en fijnste Leder en kunnen aangepast worden opdat men zich overtuige dat dezelve niet scheuren a ƒ 1.35 groote ƒ 1.40 Mans ƒ 1.00. Alsnog eene schoone partij supra fijne NAPELS-HE HANDSCHOENEN  COUPE JOUVIN a ƒ 1.30 extra dun Leder Wit Castoor 1 extra dun Leder voor Heeren Dames en Kinderen. (13007) : A -nTllTl_ï'i_^_- Een gevestigd COMMISSIONNAIR in ' ülrijJE. 1 _-£- . SUIKER enz. vraagt vigilante met den Han' del bekende I'EKSONEN om werkzaam te zijn ten Verkoop van genoemde Artikelen voor de Steden Rotterdam Zierikzee Goes Breda Gorinchem Deventer Zwolle Gouda Nijmegen en Utrecht; zullende geene andere in aanmerking komen dan die bewijzen van soliditeit kunnen produceren. Adre3 met geteekende Franco Briefjes onder Lett. A. Z. bij den Kantoorbockvcrkooper A. S. VAN WESTEKHOOVEN Beursstraat N». 10 te Amsterdam. (13002) (13000) Ou demandea Amsterdam une DEMOISELLE INTERNE de mojren age de la Religion Protestante qui parle Ie Francais avcc facilite' habituée a surveiller la jeuncsse en dat d'enseigner Ie piano les ouvrages d'utilités et d-gre'ments. S'adresser par lettres affranchies sous I'initiale B. R. chez Ie libraiie C. G. VAN DER ROST Kal verstraat N. 176. Bij GEBROEDERS DIEDERICHS te Amsterdam ziet liet licht en is voor BB.'. Vrij-Metselaren door de voornaamste Boekhandelaren in het Rijk te ontbieden tot den Prijs van Vijftig Cents eene BROCHURE getiteld: WAT GAF AANLEIDING TOT EN WAT WAREN DE BEWEEGREDENEN VOOR DE STICHTING DER NIEUWE VRLBMETSELAARS-WERKPLAATS POST NUBILA LUX in het O.' van Amsterdam. • TEEKENPLANK voorgedragen in de Jaren 1847 1848 en 1849 in de Lokalen Frascati en Vliedzorg te Amsterdam en Verscheidenheid en Overeenstemming te Rotterdam door den Br.-. M. S. POLAK Litt. Hum. Dr. behandelende de volgende Vier Onderwerpen: I. .WAT IS HET DOEL DER ORDE en welk haar WETENSCHAPPELIJK aan dit doel ge'évcnredigde Standpunt? 11. .DOOR WELKE MIDDELEN TRACHT DE ORDE haar grootscb doel te bereiken; en zijn deze Middelen AL of NIKT doelmatig AL of NIET bestaanbaar in en overeenkomstig met de behoeften van de TEGENWOORDIGE EEUW. 111. «WAAROM GAAT DAN — deze Middelen op zichzdve doelmatig zijnde - des ondanks het GROOTE DOEL VERLOREN ? Waarom kwijnt de K.-. K.'.? IV. .WELKE RESULTATEN leveren deze Bespiegelingen op; en wat KAN wat MOET er tot Opbeuring en Herstelling van de Heil. Orde gedaan worden? Aan alle Welgezinde voor Onderzoek en Waarheid en dus voorliet heil der Orde warme 88.-.; aan allen eindelijk die den waren geest en de wezenlijke strekking van de Vrijmetselaars-Orde — waarover zoo- Teel gedroomd gedweept of getwist wordt — in het algemeen en van de Lo""e P.-- N.*. L.'. in het bijzonder wenschen te leeren kennen wordt deze BROCHURE ten sterkste aanbevolen. (11000) DAGBOEK VOOR BOOM- EN BLOEMK.WEEKERS HOVENIERS EN WARMOEZIERS. T)nor den Schrijver der Nederlandsch* Tuinkunst Winter-Kamer- Bloemtuin enz. Een Deel 18°. groot 485 bladzijden. Prijs ƒ2. _*-__~-___T__-_-> Dit Werkje bevat al hetgeen iedere maand moet verrigt sm-^élaT^ worden in den Moes- Bloem- en Vruchttuin en Boon.. WSa&s gaard in de Oranjerie  koude en warme Kassen tijd van *lf ■""  8"""""" _.„-_.„ van Groenten en Vruchten; over het Kweehet inzamelen van Heesters met schoone en MSC_ïi.%i«-'-«-- TUIN-CATECHISMIIS. 1 Ulll V-UK 3.MU V"" Gebruikers van Tui- Oordeelknndige Raadgevingen ""« L^BaVw-„a* «_ lijst van Blom- Door W.L-",http://resolver.kb.nl/resolve?urn=ddd:010073001:mpeg21:a0045:ocr,6,ddd:010073001:mpeg21:p006,Algemeen Handelsblad,1117
2312289,1851/04/19 00:00:00,2159,ddd:010072890:mpeg21:a0015,http://imageviewer.kb.nl/ImagingService/imagingService?id=ddd:010072890:mpeg21:p004:image&x=69&y=2246&w=1071&h=2159,ddd:010072890:mpeg21,1140,4405,69,2246,6,"Van wege de Erven van den Overste VAN OESFELD in leven Chef van het Trigonomctrische Bureau van den Generalen Staf der Pruisische Armee te Berlijn wordt te Koop gepresenteerd de groote on door de voornaamste Deskundigen hooggewaardeerde Verzameling van cSca aO.OOO _-T.U-_._- VERSCHILLENOE LAND- EN ZEEKAARTEN tot den zeer verminderden prijs van Ca. 5000 Eth. __-. of Ca. ƒ 9000 Holl. Nadere informatien *ijn op fran_o aanvrage onder Lett. I. F. S. te bekomen aan het Bureau Handelsblad. (6238) ""POTTENBAKKERIJ AAN DEN OVERTOOM oDder Nieuwer-Amstel. DF DIRECTIE maakt bekend dat behalve de in deze Fabriek Gefabriceerd wordende VORMEN .en POTTEN ten dienste der Ciiikorra-fmndcriicn ook no? te bekomen zijn alle ioorten van bCHOORSTEEN en KAGCHELPIJPEN DUIKERPIJPEN TEN DIENSTE VAN WATERLEIDINGEN ___ e_z. alsmede alle soorten van FILTREER-POTTEN. Adres aan bovengenoemde Fabriek alsmede bij den Heer P. BOEKEN Lcidschcgracht bij de Prinsengracht N .71 te Amsterdam. -3310) HET"" HUIS ME-W-OOST-E» onmiddellijk grenzende aan het 's Gravenhaagschc Bosch en dc Gemeente VoouuUßG alleraangenaamst gelegen en smaakvol aangelegd waarbij dagelijks de Spoortreinen ophouden ingerigt tot het geven van PARTIJEN DEJEÜNERS  DINERS en SOUPERS is door de aanbouwing van cene NIEUWE 2_-V___-E__SC-IE ZAAL  welke ruim 250 Couvert? kan bevatten thans mede ingerigt tot het geven van groote Partijen. De Plaats met riante Overplaats voorzien van Koepels en V_chrijkc Vijvers zijn ruimschoots en smaakvol met Bloemen en Gewassen beplant en bieden cene alleraangenaamste Wandeling aan. Het ETABLISSEMENT is van STALLING en REMISES voorzien en er bestaat tevens gelegenheid ter bekoming van elegante RIJTUIGEN en goed GEDRESSEERDE RIJPAARDEN. De Ondernemer heeft de eer het Publiek te verwittigen dat voornoemd Etablissement van af heden zal geopend zijn en dat hij alles zal aanwenden om zich de gunst van het geëerde Publiek hem in het verleden jaar ten deel gevallen verder zoo door eene prompte Bediening als zeer civiele Prijzen waardig te toonen. NB. Er zijn mede fraaije GEMEUBILEERDE APPARTEMENTEN bij de maand of langer te Huur. Bestellingen voor te geven Partijen enz. worden ook aangenomen aan de Expeditie-Kantoren van den Ondernemer. (6299) WELGHBBRBBBIIWELIJRS-AAHÏRAAG. Een JONGE WEDUWNAAR meteen Kind uit den fatsoenlijksten kring welke een jaarlijksch inkomen heeft van ƒ 3000 verlangt langs den thans gebruikclijken weg in kennis te komen met eenc DAME  tusschen de 22 en 30 jaren oud ten einde na wederzijds goedvinden een WETTIG HUWELIJK aan te gaan; Hoofdvereischten zijn een redelijk uiterlijk een zacht Humeur en een matig Kapitaal. Van dc heiligste discretie kan men zich verzekerd houden. Reflecterenden gelieven ziek onbeschroomd met Franco Brieven te adresseren onder Lett. W. bij der Boekverkoop»- L. ROMIJN Kalverstraat N°. 205 te Amsterdam. (6232) ÖPREGTE B_WELl._S___V_.A__. Een PERSOON Dertig Jaren oud van de Prot. Godsdienst dl over een klein Kapitaaltje te beschikken heeft en vale Jaren in een fatsoenlijk Beroep werkzaam i» wenschte langs dezen nu gebruikelijken wei in kennis te geraken met cene JONGE JUFVROUW of WEDUWI zonder Kinderen beneden de Vijf en Dertig Jaren die over een Kapi taal van Drie Mille te beschikken heeft. Dames hierop reflecterende ver zockc zich te adresseren mctVrachtvrije briefjes onder Lt. E.S. BureauHan delsblad. Van de stiptste geheimhouding kan men verzekerd zijn. (6240",http://resolver.kb.nl/resolve?urn=ddd:010072890:mpeg21:a0015:ocr,4,ddd:010072890:mpeg21:p004,Algemeen Handelsblad,1071
1922580,1851/02/06 00:00:00,1980,ddd:010518233:mpeg21:a0025,http://imageviewer.kb.nl/ImagingService/imagingService?id=ddd:010518233:mpeg21:p004:image&x=2036&y=2835&w=971&h=1980,ddd:010518233:mpeg21,3007,4815,2036,2835,4,"*** Eene fatsoenlijke Protest. Jufvrouw vraagt bij zich ter Inwoning met vollen Kost enz. met Huisselijk Verkeer : Fatsoenlijke gehuwde LIEDEN of wel eeue DAME alleen met genot van eene vrije Kamer op een aangenaam Dorp aan den Zandweg op Utrecht. Men adressere zich franco bij W. F. STRAMROOD Boekh. te Wijk bij Duurstede Letts. A. B. Bt Stbvuarij - .Hflwmng van MAASBOEKJE VOOR DAMES • HANDWERKEN bevat: Brk_W..rK : Vervolg van het Matje voor een llyacinth-glas. II aakwok; Overtreksel voor een Piauo-laboi.ret. - Dwarse Neiges. - Bracelet in den vorm eener Slang — Chemisette iv broderie anglaise — Kraagje in idem. - Vervolg van het Alphabet in idem. — Vervolg vau het Alphabet in plumetis. — Modes met Mode pi nat. Elke maaudelijksche aflevering kost bij inteekenine""2s cents. s' V Bij den Boekhandelaar FREDERIK MULLER te Amsterdam is verschenen : Met FEBRUARIJ-NUMMER van DE NAVORSCÏÏER. (Volle Vaten bommen niet) EEiN' MIDDEL TOT GEDACHTEN-WISSELING EN LETTERKUNDIG VERKEER TUSSCHEN ALLEN DIE lETS WETEN lETS TE VRAGEN* HEB- ' BEN OF lETS KUNNEN OPLOSSEN. Dit N°. bevat ."".2 groot-octavo Bladz. iv 2 Kolommen gedrukt waarbij uog eene Plaat; vier Aauteekeniugen ; zeven grootere zes-en-tachtig kleinere Vra»en ; honderd zeventien Autwoorden. Voor twaalf Afleveringen betaalt meu slechts /""3 90 IN HET JAAR. ' Ecu uitvoerige BLADWIJZER i 20 Ceuts per vel te berekenen zal dit Werk ten Vraagbaak doen worden — „ Meu ziet wij sparen tijd noch moeite noch onkosten  om ons Blad naar den eisch te maken. Behalve de Plaat waartoe geene verpligting ons drijft schenken wij 12 Bladzijden meer dau het vorige Nummer bevatte. Nn —eris te veel inhoud om te bommen f Dit zeggen wij slechts: Hoe meer iedere Lezer de verspreiding bevordert  hoe zekerder hij wezen kan dat op zijne vrat 6y^aladUCTbl^eu•^' -",http://resolver.kb.nl/resolve?urn=ddd:010518233:mpeg21:a0025:ocr,4,ddd:010518233:mpeg21:p004,Opregte Haarlemsche Courant,971
1657725,1851/10/10 00:00:00,1725,ddd:010518441:mpeg21:a0030,http://imageviewer.kb.nl/ImagingService/imagingService?id=ddd:010518441:mpeg21:p004:image&x=1071&y=3139&w=961&h=1725,ddd:010518441:mpeg21,2032,4864,1071,3139,4,"V VOOR LEESfiEZELSCHAPPEiV is bij den Boekhandelaar J. H. SIÜDRÉ te Utrecht uitgekomen : CECCHINA of de KUNSTRIJDERS. Eene novelle gr. B°. mst gclitogr. Titel en Vignet. . . ƒ 270. DE FAMILIE SNIJENBURG of hetSCHIJN-SPEL DES LEVENS. Satie.-Kom.-Roman door den Schrijver van „de Dienstmeid"" „de Dienstknecht"" enz. gr. B°. met gel. Titel en Vignet. . .  . ƒ 270. V De ERVEN THIERRY &MENSING Boekhandelaren te 's Hage hebben uitgegeven : C. FISCHENDORF Theol. Doet. et Prof. Ord. H. Lips DE EYANGELIORUM 4 POCR YPHORUM ORIGINE ET USU disquisitio historica critica ; uitmakende HET XII<ie DEEL der VERHANDELINGEN VAN HET HAAGSCHE GENOOTSCHAP TOT VERDEDIGING VAN DE CHRISTELIJKE GODSDIENST sedert deszelfs SOjarig bestaan. Prijs ƒ 180. V I^MSÖfITLÉïTESIKIIOE. JOHs. NOMAN & ZOON te Zalt-Bommel hebben alom. verzonden : I. Dr. F. JUNGHUHN REIS van JAVA nam EUROP!A met de zoogenaamde Engelsche Overlandpost in 1848 met 4 gekleurde eu 2 uitslaande Platen royaal formaat . ƒ2 90. 11. D. C. STEUN PARVÊ Het Koloniaal Monopolie stelsel getoetst aan Geschiedenis en Staathuishoudkunde. Nader toegelicht door den SCHRIJVER gr. 8° ƒ 580. 111. HET BESTUUR van der. afgetreden Gouverneur-Generaal J. .1. ROOHUSSEN beoordeeld dcor hel Dagblad de Indiër"". Met Portret en Facsimile royaal formaat ƒ 1.0. TV. PROSPECTUS eener uitgave van het BURGERLIJK WETBOEK voor NEDERLANDSCH INDIË  met Aanteekeningen door Mr. C. A. dk JONGH President van den Rsm.l van Justitie te Batavia. Iv royaal formaat in 2 Kolommen welk werk zal kosten ƒBOO. Prospectus met Proeve van bewerking alom gratis",http://resolver.kb.nl/resolve?urn=ddd:010518441:mpeg21:a0030:ocr,4,ddd:010518441:mpeg21:p004,Opregte Haarlemsche Courant,961
4950972,1851/02/18 00:00:00,3874,ddd:010786148:mpeg21:a0007,http://imageviewer.kb.nl/ImagingService/imagingService?id=ddd:010786148:mpeg21:p004:image&x=56&y=315&w=1278&h=3874,ddd:010786148:mpeg21,1334,4189,56,315,6,"ADVERTE N T I E N. MINISTERIE VAN BINNENLANDSCHE ZAKEN. ** De Provinciale Commissie van Geneeskundig Onderzoek en Toevooiv.igt in Noordholland- residerende te Haarlem herinnert bij deze dat zij weder ha-j Gewone Vergadering houden zal op Woensdag den iaden Maart aanstaande en verzoekt tevens allen  welke dan verlangen toegelaten te worden tot het Heel- Verlos-oi Artsenijmengkundig Examen of tot dat van Tand meester of Droogist  zich vôôr den laalsten dezer maand bij Requt-ste met overlegging van hunne Geboorte-acte en van voldoende Bewijzen wegens hunnen volbragren leerlijd op behoorlijk zegel re vervoegen bij den Ondergeteèkéndë. Haarlem De Provinciale Commissie voornoemd 12 Februarij iBsi. Namens dezelve M. N. Reets  Secretaris. MINISTERIE VAN MARINE; Aanbesteding van Inlandsche Hennep bcnoodiyd bij de Directie der Marine te Amsterdam. De Ministervan Marine voornemens zijnde op den 27ste!] Februarij 1851 bij inschrijving aan de minslaannemei den te doen Aanbesteden de Levering van 35000 ponden Inlandsche Afgeslagen Schilhennep bij de Directie der Marine te Amsterdam voor het dienstjaar iBsi benoodigd  Brengt t?r kennis van degenen  welke mogten genegen zijn deze levering aan te nemen : dat de inschrijvingsbilietten  op gezegeld papier geschreven voor of uiterlijk op den 27sten Februarij iBsi des middags voor twaalf ure franco aan het Ministerie van Marine te 's Gravenhage zullen moeten worden bezorg I ; •dat dezelve eene naauwkeurige opgave moeten bevatten van den prijs voluit geschreven waarvoorde gegadigden de levering van de voorschreven partij Hennep willen aannemen; dat geene iuschrijvingsbiljetten zullen worden in aanmerking genomen welke op ongezegeld papier geschreven zijn waarop zich doorhalingen of veranderingen bevinden of waarin bijconditien zijn gemaakt ; dat dezelve op het adres zullen moeten vermelden het nommer en de benaming v.tn het artikel waarop de inschrijving geschiedt  en verder moeten bevatten de namen der inschrijvers met die hunner borgen en hunne woonplaatsen. De Voorwaarden waarop deze Aanbesteding zal geschieden lijgen ter lezing aan het Ministerie van Marine te 'sGravenhage bij den Direciien der Marine te Amsterdam te Willemsoord en te Vlissingen  alsmede ten burele van den Commissaris des Konings in de provincie Gelderland. 'sGravenhage den i4den Februarij iBsi. De Minister voornoemd E. Lucas. * "" De Minister van Marine van voornemen zijnde op den 25sten Februarij aanstaande onder zijne nadere goedkeuring bij inschrijving te doen Aanbesteden de Levering van : iso Rollen Karldoek n\ 2 van 33 Nedeii indsche ellen de rol  en 1200 Stuks Wollen Dekens. Brengt ter kennis van de gegadigden : dat de biljetten van Inschrijving voor oi' uiterlijk op den 25sten Februarij aanstaande vrachtvrij aan het Ministerie van Marine te 's Gravenhage zullen behooren bezorgd te zijn en zullen moeten bevatten de prijzen voluit geschreven waarvoor de Gegadigden de voorzegde Levering  overeenkomstig de Voorwaarden in de Bestekken van Aanbesteding bepaald  voor één of meerdere termijnen  zouden willen aannemen i.et Karldoek de rol en de Wollen Dekens jrer stuk niet opgave van de Namen  Voornamen en Woonplaatsen van de Inschrijvers en van hunne Borgen; dat de Biljelten die door de Inschrijvers nier nnderfeekend zijn  of waarin"" bijconditien worden voorgedragen  alsmede die welke niet op zegel zijn geschreven  of waarop doorhalingen hebben plaats gehad niet ter mededinging kunnen toegelaten- maar ter zijde zullen gelegd worden ; dat de Bestekken van deze te doene Aanbesteding dagelijks (Zondagen uitgezonderd) v.m tien tur des morgens tot twee uur des namiddags voor de Gegadigden zuilen ler lezing liggen ter Secretarie van het Ministerie van Marine te's Gravenhage en aan de Bureaux van de Dtrictien der Marine te Amsterdam en Ie Vlissingen en dat het Monsterstuk en net Model overeenkomstig welke de Leveringen moeten geschieden  ter bezigtiging voorhanden zijn bij de Directie der Marine te Amsterdam. 's Gravenhage di::i 1 <de.<i Februarij lBsi. De Minister voornoemd E. Lucas. PROVINCIALE GOUVERNEMENTEN. */ De Gedeputeerde Staten van Friesland Gelet hebbende op-art. 8 van het Plan der Negotiatie van drie maal honderd duizend Gulden tot bestrijding van een gedeelte der kosten van den aanleg van den Straatweg van Leeuwarden tot aan de grensscheiding met de Provincie Groningen  goedgekeurd bij Zijner Majesteits besluit va.i den i6den Maart 1829 n° 4 > eil willende vaststellen den dag waarop wegens gemelde Negotiatie zal plaats hebben de een en twintigste Uitloting ter Aflossing in iBsi van een Kapitaal van zeventien duizend Gulden  Hebben goedgevonden en verstaan : -te bppalen  zoo als geschiedt bij deze dat de Uilloting voor de bedoelde Aflossing zal plaats hebben in eene opene Verg adering van Gedeputeerde Slaten die gehouden za' worden op Donderdag den i3den Maart 1851  des middags twaalf ure. En zal deze Resolutie in de Nederlandsche Staats- de Haarlemmer- ",http://resolver.kb.nl/resolve?urn=ddd:010786148:mpeg21:a0007:ocr,4,ddd:010786148:mpeg21:p004,Nederlandsche staatscourant,1278
5162336,1851/11/17 00:00:00,3972,ddd:010060343:mpeg21:a0016,http://imageviewer.kb.nl/ImagingService/imagingService?id=ddd:010060343:mpeg21:p005:image&x=64&y=148&w=2504&h=3972,ddd:010060343:mpeg21,2568,4120,64,148,6,"Men is van meening  ten overstaan van den Notaris \\n'M C. J. van de WATERING te 's Gravenhage in het VEN- j CQtSS DUHUIS DER NOTARISSEN aldaar op HEDEN den 17 i November 1851 des namiddags len 5 „re te veilen op op Maan- ' dag den 24 daaraanvolgende desavonds ten 7 ure te verkoopen: j N°. I. Een WINKELHUIS en ERVE tot alle Affaires geschikt pn waarin thans de handel in Boter Kaas en Melk wordt uitgeoefend staande en gelegen aan de oostzijde van de Boekhorststraat op den boek vandc Katerstraat te 'sGravenhage wijk T  n°. 319 verponding n°. 310 kadaster sectie I n°. 792 groot 76 ellen; bevattende eenen ruimen winkel voorts vijf kamers alle behangen en vau stook plaatsen voorzien keuken grooten kelder zolder en '■ helgeen verder tot cene welingerigte woning vereischt wordt hebbende eeneu afzonderlijken vrijen uitgang in de Katerstraat; zijnde; vier kamers vau hetzelve verhuurd tezamen voor ƒ 4.55 per week ; aatweslagen in de grondbelasting over brt jaar 1851  met ƒ 30. Nu. 2. Een GEBOUW ingerigt tot Stalling en Pakhuis vroeger! ceu Huis pn Erf slaande en gelegen aan de zuidzijde van de Kater- I .slraal. lc 'sGravenhage wijk T n°. 297 verponding n°. 2891 kadaster s eti': I »°. 774 groot 62 ejlen; zijnde verhuurd voor; / 1.75 ie* week; aangeslagen als boven met ƒB. No. 8. Een BLOK van drie HUIZEN en ERVEN met een' groolen S Kelder onder een derzelve staande en gelegen In eene Poort aau de zuidzijde van de Katerstraat te's Gravenhage  wijk T nos. 393 j 394 en 895 verponding n°s. 295 296 en 297 kadaster sectie I n«s. 780 groot 42 ellen 781 groot 10 en 782. groot 14 ellen ; aangeslagen als boven met ƒ 16.14. Alles te bezigtigen  des Maandags en Vrijdags van 10 (ol 2 ure en le aanvaarden bij de betaling der kooppenningen 11°. 1 op I°. Februarij ol' I°. Mei 1853 naar keus des koopers n°. 2 op' JO. Mei en n°. 3op I°. Februarij 1852 ; „n\ len '2 zijn inmiddels UIT DE HAND TE KOOI' terwijl nadere onderrigting le bekomen is ten kanlore van voornoemden Notaris C. ./. van de Watering en Mr. H. van der Haak op den Fluweele Burgwal alwaar in tijds de eigendomsbewijzen en de verkoopvoorwaarden (er lezing zul- ' len liggen. MMen is van meening. len overstaan vnn den Nolaris C. J. vak de WATERING in het VENDUBUISDER NOTARISSEN  IN DE NOBEI.STAAT  le 'sGravenhage op HEDEN den 17 November 1851  des namiddags ten 5 ure te veilen en op Maandag den 24 daaraanvolgende des avonds ten 7 ure te verkoopen : Een hecht goed onderhouden en wel ter nering staand WINKELHUIS en ERVE gelegen aan de noordzijde van het Lange Achterom te 'sGravenhage wijk S n°. 241  verpnnding n°. 287 kadasler seelie F n°. 273 groot I roede 84 ellen; bevattende eenen ruimen winkel zeven zoo boven- als beiicdcnvertrekkeu  keuken kelder en zolders ruime kasten en al wat verder tot cenc welingeri-Tte woning behoort; zijude bij gedeelten verhuurd voor ƒ 440 'sjaars; aangeslagen inde grondbelasting over 1851 met/48.19 ; te aa -'aarden bij de betaling der kooppenningen  met I°. Jauuarij 1852; terwijl het inmiddels UIT DE RAND JE KOOP IS; te bezigtigen Dingsdag en Donderdag van elke week  van II lot 1 ure. Nadere onderrigtingen zijn te bekomen ten kantore van voornoem den Notaris vat de 11 tiicung alwaar iv tijds de eigendomsbewijzen en de verkoopvoorwaarden ter lezing zullen liggen alsmede bij den heer J. IJ. Schlosser in de Nieuwstraat alhier. J&??f\ Men is van meening ten overslaan vnn den Notaris *y^^T t- J- van de WATERING te 's Gravenliage in het VENDUHUIS DER NOTARISSEN IN DE NOBEL■|a STRAAT aldaar op Maandag den 24 November 1851  SjaH des namiddags ten 5 ure ie veilen en op Maandag <■ r-1 ""den 1 December daaraanvolgende des avonds ten 7 ure te verkoopen : Ecu hecht sterk en zeer logeabel HUIS ERVE en grooten TUIN met vele vrnchlboomen beplant staande en gelegen aan de zuidzijde van het Plein te 's Gravenhage met een' vrijen uitgang iv eene pi.ori (laar achter uitkomende iv de Korte Hoiitslraal wijk K n°. 414 verponding n°. 867 kadasler seclie G n°. 412 groot 5 roeden 80 elleu ; bevaltende hetzelve Huis behalve cene groole tuinkamer elf kaniers meerendeels met fraai uilzigt in den tuin en over de tuinen der belendende percelen  behangen eu van stook - plaatsen voorzien 3 kabinetjes of dienstboden-en provisickamerljes 2 keukens zolders binnenplaatsen  groote kelders bergplaats voor brandstollen eu vele andere gemakken toteene weiingerigle woning behoorende; aangeslagen in de grondbelasting over het jaar 1851  niet ƒ 71.40; te zien des Dingsdags en Donderdag vau 12 tot 3 ure en te aanvaarden bij de betaling der kooppenningen den 1 Mei 1852; terwijl nadere onderrigting iste bekomen ten kantore van voornoemden Notaris C. J. van de Watering en van Nr. B. van der Baak op den Fiuweeien Rurgwal alwaar in tijds de bewijzen van eigendom en de voorwaarden der verkooping ter lezing zullen liggen. rd___i__é&-. Jlen is van meening ingevolge bekomene magtiging van W ffl H de 'l""u*isM'mLMls-1Ual*a*""1-s te 'sGravenhage ten o»er| slaan van den Notaris .1. ïï van den BERGH in h t .-WL openbaar iv het VENDUKUIS DER NOTARISSEN. IN DE NOBEÏ-STRAAT aldaar op HEDEN den 17 November lü.il des namiddags ten 5 ure te veilen en op Maandag den 24 daaraanvolgende des avonds len 7 „re te verkoopen: N°. 1. Ee:: bee.it. cv sterk HUIS en ERVE staandeeu gelegen arm de oostzijde van het Lamgroen te 's Gravenhage  wijk M n°. 155 kadaster sectie G nv. 1270; bevaltende een ruim voorhuis of winkel en een groot binnenvertrek twee boyenvertrekken  keuken kelder en zolders; aangeslagen in de grondbelasting over 1851 met °' N . 2. Een hecht en sterk HUISenERVE staande en gelegen aan de oostzijde vanhet Lamgroen te 's Gra venhage wijk M n°. 142 kadastei' sectie G n°. 1259; bevattende tvvee benedenvertrekken zolder met een afgeschoten vertrek keukenen kelder; aangeslagen in de grondbelasting over 1851 mcl ƒ 9.59; zijnde verhuurd voor ƒ1.75 'sweeks. üe voorschreven percelen kunnen met I°. Februarij 1851 worden aanvaard en ziju te bezigligen des Maandags en Donderdags des namiddag* tusschen 2 en 4 ure en nadere informatien te bekomen len kantore van den boyengenoemden Nolaris.",http://resolver.kb.nl/resolve?urn=ddd:010060343:mpeg21:a0016:ocr,5,ddd:010060343:mpeg21:p005,Dagblad van 's Gravenhage,2504
506253,1851/10/19 00:00:00,529,ddd:000020163:mpeg21:a0051,http://imageviewer.kb.nl/ImagingService/imagingService?id=ddd:000020163:mpeg21:p004:image&x=1080&y=133&w=957&h=529,ddd:000020163:mpeg21,2037,662,1080,133,4,STOOHGELEGENBEID van RoTTERDiM naar Batavia via de Kaap de Goede Hoop Voor PASSAGIERS zal legen het einde van October derwaarts vertrekken: het expresselijk daartoe uitmuntend ingerigte Schroefstoomschip Macassar Kapitein K. W. E. Bekgner. Doordien er van de Stoomkracht zal worden gebruik gemaakt stelt men zich voor den Overtogt in betrekkelijk zeer korten tijd  te zullen doen. Adres ten Kantore van den Cargadoor Wm. RVYS J. D.zn. (5851),http://resolver.kb.nl/resolve?urn=ddd:000020163:mpeg21:a0051:ocr,4,ddd:000020163:mpeg21:p004,"Nieuwe Rotterdamsche courant : staats-, handels-, nieuws- en advertentieblad",957
2759408,1851/01/07 00:00:00,2204,ddd:010786112:mpeg21:a0012,http://imageviewer.kb.nl/ImagingService/imagingService?id=ddd:010786112:mpeg21:p004:image&x=1378&y=84&w=1252&h=2204,ddd:010786112:mpeg21,2630,2288,1378,84,4,-nende op den Ham gemeente Aduard vroeger op zijn eigen verzoek onder Curatele gesteld  bij Vonnis der gemelde Regtbank van 3 Januarij iBsi is opgeheven. Groningen den 4den Januarij iBsi. TnuEssiNK v. d. Hoop. Bekendmaking ingevolge Art. 28 van het Wetboek van Koophandel. Bij Notariële Acte in dato den 2den Januarij iBsi  deugdelijk geregistreerd is tusechen de Ondergeteekenden Jan Gardenier en Izaak de Regt Kamerbehangers en Winkeliers wonende Rotterdam aangegaan eene Vennootschap  ten onderwerp hebbende eene Kamerbehangers-Affaire en Winkel welke zullen worden geè'xerceerd inde Hoofdsteeg wijk 11 n°. 98 binnen gemelde Stad  onder de Firma van Gardenier en Compagnie dewelke door ieder der Vennooten zal worden geteekend in alles wat tot de zaken betrekking heeft met uitzondering van het opnemen van gelden als waartoe zulks noodig geacht wordende de particuliere handteekening van beide Vennooten zal worden vereischt. Deze Vennootschap is aangegaan provisioneel voor een tijdvak van Vijfjaren ingegaan den isten Januarij 1851 en alzoo zullendeeindigen den3isten December 185ïechter met dien verstande dat bijaldien de Vennooten elkander niet zes maanden voôr de expiratie zullen hebben gewaarschuwd alsdan de Vennootschap  op denzelfJeii voet gedurende een nieuw tijdvak van Vijf Jaren zal worden gecontinueerd. J. Gardenier. I. de Begt. ** Blijkens Acte op den 28sten December iBso voor den Notaris Jacob Dozy en getuigen  te Zaandam gepasseerd  is de Commissiehandel in Granen uitgeoefend door Vrouwe Anna Margretha Klein Weduwe den Heer Jan Baptist Hachtman deelgenoote in dien Handel wonende te Amsterdam en nu wijlen den lieer Jacob Molenaar Makelaar in Granen  gewoond hebbende te Zaandam onder de Firma van: Wed. J. W. Hachtman en Compie. tusschen Eerstgenoemden en de Kinderen en Erfgenamen van den overleden Vennoot vertegenwoordigd door derzelver Voogd den Heer Arend Molenaar Koopman te Zaandam  Aangehouden en zal onder dezelfde Firma worden Voortgezet en Vervolgd. Deze Vennootschap is aangegaan voor den tijd van Vijf Jaren van i°. Januarij iBsi tot en met 3i December i 855 is staande dien Tijd niet opzegbaar en zal gedurende denzelve ook regtens niet eindigen. Bij overlijden van een der Vennooten zullen de Erfgenamen of Opvolgers met den overgebleven Vennoot de Vennootschap tot het einde van derzelver duur vervolgen. De teekening der Firma geschiedt door Vrouwe de Weduwe Hachtman en door den Heer A. Molenaar door laatstgenoemde met bijvoeging zijner jiarticuliere naamteekening. De Vennooten zullen worden geadsisteerd door de heeren Cornelis Chrisliaan Hachtman te Amsterdam en Jacob Molenaar (Zoon) te Zaandam die in geldelijke zaken te zamen met bijvoeging hunner bi|zondere naainteekeningen voor de Firma kunnen teekenen ; voorde correspendentie de notitien van koop en verkoop is ieders afzonderlijke teekening voldoende. Noch de Vennooten noch de Adsistenten kunnen sclmldpligtige verbindtenissen van geldopnemingen borgtogten of dergelijke aangaan ; geen hunner mag gedurende den loop der Vennootschap eenige onderneming of gemeenschap sluiten of contracteren  over zaken tot het vak der Vennootschap behoorende; ook is bet overdragen aan derden van aandeelen in dezelve of het aannemen van derden als deelgenooten in zoodanige aandeelen  verboden.,http://resolver.kb.nl/resolve?urn=ddd:010786112:mpeg21:a0012:ocr,4,ddd:010786112:mpeg21:p004,Nederlandsche staatscourant,1252
923400,1851/08/29 00:00:00,950,ddd:000020112:mpeg21:a0047,http://imageviewer.kb.nl/ImagingService/imagingService?id=ddd:000020112:mpeg21:p004:image&x=120&y=4592&w=972&h=950,ddd:000020112:mpeg21,1092,5542,120,4592,4,"(5254) Daar de Ondergeteekende door dringende omstandigheden zijne werkzaamheden aan zijn Zoon heeft overgedaan  worden zijne geëerde Begunstigers grootelijks bedankt voor de vele blijken van toegenegenheid  welke hij zoo vele jaren van hen heeft mogen genieten. Rotterdam 28 Augustus 1851 R. DE GRAAFF. Nadere Oproeping. De HOUDERS van het COGNOSSEMENT aan Order over E ÏS""'* Zuhken PEPER alhier van Batavia aangebragt per het Nederlandsch Schip den Mlshout Kapt. P. F. Bijken  gelieven zich ten spoedigste aan te melden ten Kantore van KUYPER VAN DAM en SMEER. __ (524fi) (5245)""])! KEI TEUBEN d. r Assurantie-Haatschappij tegen Brandschade gevestigd te Zutphen maken aan hare AANDEELHOUDERS bekend dat de JAARLIJKMCHE ALGEMEENE VERGADERING zal gehouden worden op Woensdag den ""3iien September 1851  's middags ten 12 ure ten Huize ¦van den eerst Ondergeteekende. G. J. DERCKSEN. Ch. M. HENNY.",http://resolver.kb.nl/resolve?urn=ddd:000020112:mpeg21:a0047:ocr,4,ddd:000020112:mpeg21:p004,"Nieuwe Rotterdamsche courant : staats-, handels-, nieuws- en advertentieblad",972
3456992,1851/02/14 00:00:00,2464,ddd:010583925:mpeg21:a0008,http://imageviewer.kb.nl/ImagingService/imagingService?id=ddd:010583925:mpeg21:p004:image&x=109&y=2761&w=1403&h=2464,ddd:010583925:mpeg21,1512,5225,109,2761,6,Verkoop ecuer Zathe ca Landen onder Oosterlitlcus. De Notaris P. BOLTJES te Grouw zal ten verzoeke van Mr. C. WIERSMA Notaris te Leeuwarden ten gevolge regterlijke authorisatie op Woensdag den 26 Februarij 1851  's namiddags 2 t»i*r ten huize van F H. Zaadsira Kastelein te Oosterlitlens  in één perceel provisioneel verkoopen; Eene vruchtbare en welgelegene ZATHE en LANDEN met HUIZINGE geq. no. 8 SCHUUR STALLING voor 31 Hoorobeesten en 2 Paaiden HIEMINGE groote HOVINGE WATERMOLEN en TUINGROND cum annexis staande en gelegen nabij en onder Ooslerlittens Kadaster Gemeente Baard sectie C nos. 350 852 856 259 §60 362 363 §82 539 en 390 ter gezamenlijke inhondsgrootte van 18 bunder 24 roede 8G el alle beste Greidlanden. Sirijkgeldf 125. Bij U. K. Vollema en Vrouw als mede eigenaren in gebruik ; de Landen na de toewijzing en bet overige op den 12 Mei 1851 vrij te aanvaarden. Conditien te vernemen en Verkoopbilletten te bekomen ten Kantore van de Notarissen voornoemd. Besteding bij geslotene briefjes van het VERTIMMEREN van een gedeelte der VOORHUIZINGÊ en SCHUITR  op de Zathe en Landen onder Dongjum door Jacobus de Faber als huurder wordende bewoond. Bestek en Teekening liggen ter inzage op de Plaats zelve als ook ten huize van J. ROZENDAAL bij de Noorderpoort te Franeker alwaar de briefjes franco moeten zijn ingediend vóór of op Donderdag den 27 Februarij 1851. Aanwijzing zal geschieden op Dingsdag den 25 Februarij bevorens 's middags te 12 uur. Aanbesteding bij geslotene briefjes van het AFBREKEN van het OUDE en het weder OPBOUWEN eener NIEUWE VOORHUIZINGÊ VUURKUT BUITHITS en MELKKELDER onder Ferwerd bewoond door K. A. Ipeij met bijlevering'der benuodigde Materialen; waarvan Bestek en Teekening van af den 17 Februarij e. k. ter inzage zullen leggen op de Plaats zelve en zal tevens op den 24 Februarij door J. G. Rolsma aanwijzing van het werk worden gedaan terwijl de briefjes uiterlijk op den 26 Februarij eerstkomende franco moeten worden ingeleverd bij K. A. Ipeij. Bij geslotene briefjes to huur voor den tijd van 5 aanecnvolgende jaren  in te gaan St. Petri en 12 Mei 1851 : Eene ZATHE en LANDEN gelegen in de Gaastmeer groot II bunder 30 roede Greidland ; bij Sietse Aokes van der Zee in gebruik. De Conditien lign-en ter lezing bij KLAAS HENDRIKS VENEM4 in de Gaastmeer en bij GORIT P. v. d. GOOT Boer te Folsgare en aldaar de briefjes franco in te zenden vóór of on den 5 Maart 1851. v toK HUUR  op 12 Mei 1851 : Een ruimen vcrwulfden KELDER zeer geschikt I voor WIJN aan het water gelegen met vrijen opslag. — Adres bij den eigenaar op do Waezo alhier letter D no. 43. Uit de band te koop OP DF.N 12 MEI 1851 TE AANVAARDEN: Eene beklante HUIZINGE en BAKKERIJ staande en gelegen te Franeker on de Voorstraat. Te bevragen bij den eigenaar P. van SMEDEN te Franeker Brieven franco. Bij toeval uit de band te koop: Een uitmuntende sterke toongevende zes octaafs PIANO-FORTE. Te bevragen bij J. HILARIUS Boekbandelaar in de Weerdt letter G. no. 49 te Leeuwarden. Uit de band to koop: Een overdekt en gewegerd HEKTJALSCHIP in het jaar 1843 nieuw gebouwd groot 67 ton met deszelfs compleeten en nieuwen Inventaris; ter bezi^tieiné en to bevragen bij de firma S. GEERTS » ZOON Scheepsbouwmeester» te Joure.,http://resolver.kb.nl/resolve?urn=ddd:010583925:mpeg21:a0008:ocr,4,ddd:010583925:mpeg21:p004,Leeuwarder courant,1403
2857914,1851/02/10 00:00:00,2661,ddd:010072822:mpeg21:a0036,http://imageviewer.kb.nl/ImagingService/imagingService?id=ddd:010072822:mpeg21:p006:image&x=1165&y=129&w=1074&h=2661,ddd:010072822:mpeg21,2239,2790,1165,129,6,"-Vn?!- TJÏj^-TAf fIT niet het lot van een door den -JlJjJr ah W Ulïha noodlottigen brand vau gisteren Avond 7 Februarij in de Anjelierstraat GEHEEL ONGELUKKIG GEWORDEN GEZIN van eene WEDUWE MET G KINDEREN SOMMIGEN GEHEEL HULPELOOS en waarvan de WEDUWE BLIND ZIJNDE en van alles beroofd hare eenige hoop op de WELDADIGHEID vestigt en zonder Ondersteuning eeno prooi der nijpendste Armoede moet worden wenden de ONDERGETEEKENDEN zich tot U MEDEDOOGENDE STADGENOOTEN! Zondert ook voor deze Ongelukkigen iets van Uwen overvloed af en wij zullen het ten hunnen beste aanwenden. ledere Gift hoe gering ook zal erkentelijk ontvangen worden bij de Ondcrgetcekcnden die met het GEZIN DER WEDUWE TEN VOLLE BEKEND ZIJN. Mr. L. KEYZER Bureau Handelsblad. C. A. SPIN & ZOON Pijpenmarkt. A. VINK TOLLENAAR (2179) Buurtmeesttr in Buurt 00 Afd. 1. ""groot magazijn van in- m mtlakhe MEUBELEN STOELEN SPIEGELS PAARDENHAAR EN SPRINGMATRASSEN en wat eenigzins tot het Vak betrekking heeft KUSSENS voor Scheepskajuiten enz. enz. van PIK Cfc COIHP. Haringcakkerm N"". 9. BAZAR wilden wij eerst gesteld hebben doch scheen ons niet doelmatig toe dewijl al de BAZARS welke wij buiten 'sLands bezocht hebben meestal ook groote Lokalen zijn doch waar de Goederen allen uiteen geplaatst zijn en als wij zulks zoo hadden willen inrigten zouden wij zeker een groot gedeelte der Gebouwen in de Haringpakkerij behoeven want daar de ruimte voor een Tafel is staan bij ons soms 10-12 boven op en in elkander envande plaatsruimte daar tusschen en onder wordt ook nog partij getrokken; zoodanige inrigting zoude te bezwarende zijn en ons geen Massa's MEUBELEN en STOELEN goedkoop kunnen doen verkoopen. Ons Gebouw (hoezeer geheel zoo ruim niet als hot Glazenhuis in Hydepark te Londen) mag zeker onder de ruime Gebouwen in Amsterdam medegerekend worden; doch hoeveel ruimte hetzelve bevat en van elk verlorene hoekje partij wordt getrokken zijn wij toch onzen raad tot berging ten einde; het ware doelmatiger het eenc Stapelplaats van Meubelen Stoelen enz. te noemen. Wij zien ons genoodzaakt buiten dat Gebouw ruimte tot berging te zoeken VOL is VOL en' geen wonder! des Winters staat de Handel nagenoeg stil alles is bijna dood en dan houden wij het leven onder een Legio Ambachtslieden die wij des Winters in het barre Jaargetijde VOLOP hier in deze Stad Werk geven zoo ala wij reeds zoo vele Jaren hebben gedaan daarbij de Massa's Goederen die wij van buiten 's Lands ontvangen moet dit Voorjaar wel een groote Spaarpot worden doch wij hopen al weder op een goeden aftrek want wij moeten het van den GROOTEN VERKOOP goed maken en onzen arbeid en zorgen beloond zien daar wij ons met zeer WEINIGE PERCENTEN tevreden stellen en bij hernieuwing zeggen wij voor de Soliditeit der Goedoren te guaranderen. Men behoeft niet te vragen of wij genegen zijn tot billijke prijzen te Verkoopen neen waarlijk als men de Massa's Meubelen Stoelen enz. ziet zal men wel dadelijk overtuigd zijn er wel MOET worden Verkocht want wij verstikken bijna onder de Massa's Goederen en wij zouden moeten ophouden met te laten Werken en dat kan dat mag niet; wij smukken het niet op zoo als er zoo vele Praal-Advertentien te voorschijn komen; die het anders bevindt dat die ons beschaamd makc. Wij hebbon echter weer goede hoop en verwachting omdat wij zoo goedkoop kunnen en gaarne zoo goedkoop willen Verkoopen als iemand en men ons zelden te vergeefsch naar iets vraagt. Men vindt fijne FRANSCHE BRUSSELSCHE en INLANDSCHE ook rijk met Beeldhouwwerk gedecoreerde SALON-STOELEN TÊTE ii TÈTES MERIDIENNES Voltaires Confortables Sopha's Divans Chaises Long Cleopatra's lit d'Angcs en Fantaisie Meubelen; intusschen vindt men ook Spiegelkasten Salonkasten Garde Robes Secretaires Chiffonnières Cilinder- en andere Schrijf-Burcaux Bonneur de Jours Consoles Trumeaux Etagcres Jardinicres Commodes Buffetten Buffetten dc Salon a Mangcr Buffetten Bibliotheek Buffetten Lavabo Wasch- en Nachtgemakken Nacht-Pedcstallen Gemakken met afsluiting van lucht Linnenkasten Ladetafels Servanten Muettes Mimikes en een Massa TAFELS als Trek- en Coulice-Tafels op 4 6 en 8 Stijlen met Rollen ook op cene Colom en veelal fraai Gebeeldhouwd Salon- Thee- Speel- Dames Werk- Dam- Schaak- Servies- Nacht- Wasch- Canapé- Gerridon- Brei- en vele andere soorten van Tafels; meer dan Zestig verschillende Soorten van Stoelen gegarneerd met Stofnaarjverkiezing in Mabonij Zwitschers Notelaren geel en bruin Kersen Beuken en Ipen Hout ook met O. I. Riet gevlochten Strooen Bicsmatten Schuiftafels Mahonij Randen en Wasdoek geschilderde on Kersen Olmen Eiken Beukon en Mahonij Ledekanten Tuingoederen enz. enz. (2141)",http://resolver.kb.nl/resolve?urn=ddd:010072822:mpeg21:a0036:ocr,6,ddd:010072822:mpeg21:p006,Algemeen Handelsblad,1074
296840,1851/10/14 00:00:00,328,ddd:010518444:mpeg21:a0013,http://imageviewer.kb.nl/ImagingService/imagingService?id=ddd:010518444:mpeg21:p002:image&x=2047&y=3204&w=905&h=328,ddd:010518444:mpeg21,2952,3532,2047,3204,4,"Dk STAATSRAAD COMMISSARIS des KONINGS ix oK 'J VINCIK NOORD- HOLLAND onderrigt zijnde dat op P""_ gezonken is een Vaartuig vermoedelijk eeue Over'ijsselsche P' 7 roept bij deze den onbekenden eigenaar van dat schip op o""* vóór den 25""»- October aanstaande aau te melden met hét _ii het zij dat hij het Vaartuig onmiddelijk zelf zal duen lieten _| dat hij daarvan afstand doet; zullende ingeval op den *.'''' dag geenerlei berigt mogt ingekomen zijn het wrak ten zijne»! worden weggeruimd. Van F. W IJ C \ Haarlem 13 October 1851. y",http://resolver.kb.nl/resolve?urn=ddd:010518444:mpeg21:a0013:ocr,2,ddd:010518444:mpeg21:p002,Opregte Haarlemsche Courant,905
114120,1851/07/09 00:00:00,120,ddd:000020037:mpeg21:a0046,http://imageviewer.kb.nl/ImagingService/imagingService?id=ddd:000020037:mpeg21:p004:image&x=2046&y=484&w=951&h=120,ddd:000020037:mpeg21,2997,604,2046,484,4,Adres bij P. A. VAN ES $• Co. Cargadoors alhier  en bij de Reeders de Heeren DE GROOT ROELANTS #¦ Co. U Schiedam. (3809),http://resolver.kb.nl/resolve?urn=ddd:000020037:mpeg21:a0046:ocr,4,ddd:000020037:mpeg21:p004,"Nieuwe Rotterdamsche courant : staats-, handels-, nieuws- en advertentieblad",951
2776267,1851/08/15 00:00:00,2573,ddd:010072998:mpeg21:a0026,http://imageviewer.kb.nl/ImagingService/imagingService?id=ddd:010072998:mpeg21:p004:image&x=2233&y=93&w=1079&h=2573,ddd:010072998:mpeg21,3312,2666,2233,93,4,"I NATURA ARTIS IÏÏA6ISTRA."" VRIJDAG 1 Augustus 1851  des Namiddags ten3Ure de ONBEKENDE aldaar niet opgemerkt zijnde wordt min■ zaam verzocht met Eigenhandig Schrijven de plaats eener NADERE BIJEENKOMST aan te wijzen onder dezelfde Lettere en aan het- I zelfde Adres. ' (12830) BE GOTHISCHE BOCAAL. Zijne Vaderschap wordt den Heer J. REJNBOUDT door den Heer VAN KEMPEN ontzegd ZEd. eigent zich dezelve volgens Annonce in Persoon niet toe  zoo staat het schoone Kind als van den Hemel naar beneden gekomen een wonder wat den Heer R_JNB©U__T  naar ons inzien het best kan verklaren. Met de uitvoering des BOS-AALS zijn wij het met den Heerv.K» in zoover eens dat dezelve op zijne Werkplaats door een onzer tegerwoordige Stadgenooten is vervaardigd. • Het spreekwoord : »a .oeuvre m connait I'ouvrier"" wordt al te dikwijls ontkend. (12861) A_ste___m 14 Augustus 1851. EENIGE LEGERS. De Betrekking van KASTELEIN en HUISBEWAARDER in het Genootschap Doctrina et Amiciti„ te Amstbedam vacant zullende worden zoo wordt ter vervulling daarvan gevraagd een GEHUWD PERSOON van Middelbaren Leeftijd liefst zonder Kinderen van een goed zedelijk Gedrag welke reeds vroeger als Kastelein is werkzaam geweest en daarvan voldoende bewijzen kan inleveren. Degenen welke hiertoe genegen mogten zijn gelieven zich vóór I. September 1851 met Franco Brieven. te adresseren i bij de Heeren J. W. KERKHOVEN en J. J. C. BIESMAN SIMONS Mede-Bestuurderen van het voornoemde Genootschap wonende de eerste op de Heerengracht bij de Beulingstraat en de tweede op de Keizersgracht bij het Molenpad te Amsterdam. (12859)_ (12806) Een HEER Ongehuwd hebbende zijne betrekking buiten Huis wenschte tegen November aanstaande TE HUREN bij Fatsoenlijke Protestantsche Lieden zonder Kinderen: Eene VOOR!—ASSER met ALCOVE of VOOR- en ACHTERKAMER Gemeubileeri'. Reflecterenden adresseren zich met opgave van Prijs en Plaats onder Lett. W. D. bij den Boekhandelaar C. F. STEMLER hoek Haarlemmerdijk en Singel N°. I alhier. EENE DAME op zekeren leeftijd vraagt tegen Primo November Binnenshuis: TWEE ONGEMEUBILEERDE KAMERS TE HUUR met BEDIENING tegen een Huurprijs van/150a ƒ 200 'sjaars. Adres Bureau Handelsblad onder Lett. IJ. Z. (12791) (12763) Een JONGELING oud 17 jaren ruim 13 maanden in een MANUFACTUUR WINKEL werkzaam geweest zijnde en daarvan de beste infermatien kunnende produceren wenschte zich gaarne in een zoodanigen WINKEL of MAGAZIJN geplaatst te zien. Men gelieve zich te adresseren aan het Bureau Handelsblad Lett. A. P. Z. BADHUIS TE ZANDVOORT. ZATURDAG 16 AUGUSTUS 1851. GROOT INSTRUMENTAAL CONCERT door het MUZIJKGEZELSCHAP TERPSICHORE ouder Directie van den Heer STUMPE _ van Amsterdam. PROGRAMMA. 1. MARSCH POTPOURIE N_u__s. 2. BRANDHOFEN WALZER Labitu-T. 3. HANS JaRGER POLKA Stb__sB. 4. POTPOURIE ANNA BOLENA Donizetti. 5. PICHIEK GALOP Kühnbb. PAUSERING. 1. OUVERTURE NORMA Bkl-ibi. 2. CHARIVARI Z-hleneb. 3. 7de AIR VARIE van de BERIOT voor de Viool voor te dragen door den Jongen Heer J. IBURG. 4. NIÉUWE AURORA WALS L-Bitzkt. 5. FINALE. Aanvang ten 6 ure. ENTREE voor een Heer/ 1. Voor een Heer en Dame/ 1.50. De Entree-Kaartjes zijn mede te bekomen te Haarlem bij J. B. VAN LOGHEM Jdn. NB. De DILIGENCE van den Heer PETERS zal gereed staan aan den Spoortrein welke om 5 ure arriveert en terug op den laatsten Spoortrein naar Amsterdam. (12842) ■ in i i . ii. i . 1.1 _.",http://resolver.kb.nl/resolve?urn=ddd:010072998:mpeg21:a0026:ocr,4,ddd:010072998:mpeg21:p004,Algemeen Handelsblad,1079
2334321,1851/10/23 00:00:00,2409,ddd:010518452:mpeg21:a0019,http://imageviewer.kb.nl/ImagingService/imagingService?id=ddd:010518452:mpeg21:p004:image&x=65&y=1977&w=969&h=2409,ddd:010518452:mpeg21,1034,4386,65,1977,4,"•#» OPENBARE VERKOOPIPTG om contant Geld. J. KUIJK Notaris te Wageningen zal op Dingsdag 28 October 1851 en volgende dagen telkens des voormiddags om 10 ure vóór het Huis aan de Hoogstraat aldaar Letter A N°. 139 aan de meestbiedenden publiek verkoopen: Een' compleeten en goed onderhouden INBOEDEL. bestaande hoofdzakelijk in Mahony Gladhouten en audere Meubelen als: Canapé Secretaire Kabinetten ronde en andere Tafels Speeltafeltjes Stoelen met Trijpen- Paardenharen- Lederen- en Matten-Zittiugeu Spiegels en Schilderijen Vloerklceden en Karpetten  Kagchels en Haarden Ledikanten welgevulde Bedden en Paardenharen Matrassen Tafel- en Bedlinnen Pendules en Klokken een Mangel twee ijzeren Geldkisten Koper- Tin- Blik- IJzer- Aarde- Glas- en Lakwerken en eindelijk ecu PAARD PAARDENTUIGEN RIJTUIGEN KAR PLOEG EEGDEN en verdere ROEREN-GEREEDSCHAPPEN ENZ. ENZ. ENZ. Te zien Maandag 27 October van des voormiddags 10 tot namiddags 4 ure. *«* KAGCHEL-YERKOOPING ln het LOKAAL te HAARLEM. ENGESMET & SARLET zullen verkoopen op Woensdag deu 29st™ October 1851: KAGCHELS HAARDEN SPAAROVENS en IJZERWERK in alle soorten. Donderdag den 30ste"" en volgende dagen HUISRAAD MEUBELEN en INBOEDEL waarbij eene solide Forto- Piano van 6 Octaven door van der Does; voorts het Meubilair Kleederen en Linnen Goud en Zilver nagela ten door wijle Mejufvrouw de Wed. P. van TRIEST al hetwelk in eene bijzondere Kamer te zien zal ziju en acbtervolgeus Donderdag verkocht zal worden. Dagelijks worden Goederen aangenomen. Tweedagm te voren te zien. Dingsdag den 28ten October ten 12 ure* verkooping vau den STRA.^TWEG op het Klooster te Heemstede. *#* Men zal ten huize v_u Aris Koopman aan den Jisperweg in de Beemster ten overstaan van den Notaris CORNELIS BOOM Jr.  OPENBARE VERKOOPING houden op Woensdag den sden5den November 1851 : Van levend VEE HOOI HAVER BOONEN en STROO ■ en op Donderdag den 6lie"" November: Van eenen INBOEDEL onder welke vooral uitmunten eene antieke met Snijwerk mim voorziene extra fraiije KLEEDERKAST  waarop zich bevindt ecu groot Porcelein Stel van drie Potten en twee Bekers; wijders zes groote Japansche Schotels en meer Porcelein en Aardewerk. Te bezigtigen op Maandag den 3dt'"" November des voormiddags. ~*~*~De Notaris J. C. van KESSEL te Rumpt zal namena den Heer G. DRESSELHÜIS  op Woensdag den s*ton November 15.51 voormiddags om tien ure ten Huize van J van Ommeren Wz. te Lienden publiek verknopen: 190 Stuks zware en gave SCHIETWILLIGEN zeer geschikt voor Klomphout staande op de Kleine Blaauwe Kamp onder Ommeren  Gemeente Lieuden  door de nabijheid van den Zandweg en Linge zeer gemakkelijk te ervoeren.",http://resolver.kb.nl/resolve?urn=ddd:010518452:mpeg21:a0019:ocr,4,ddd:010518452:mpeg21:p004,Opregte Haarlemsche Courant,969
2458335,1851/09/17 00:00:00,2585,ddd:010518430:mpeg21:a0021,http://imageviewer.kb.nl/ImagingService/imagingService?id=ddd:010518430:mpeg21:p004:image&x=2033&y=663&w=951&h=2585,ddd:010518430:mpeg21,2984,3248,2033,663,4,"%• BELA N G RIJ R BE R I G T.j leinaud  sedert vele jaren bezitter van een zeker-werJ kend en geheel ousohadelijk bevondeu GEHEIM tej verbetering vau alleWynsoorteu wenscht tegen billijk* vergocdiug hetzelve aau Heeren Wijnhaudelareu af W staau. Ter beoordeeliiig van deu aard eu het effect v* dieu kau meu inzage erlaugeu eei.er solide getuigenis' gegrond op ondervinding uiet alleeu maar zal meu bj proefuemiug tot de volste overtuiging komeu dat ze» de dufste en wansmakelijkste Wijn tot zijne oorspron kelijke eu verbeterde hoedanigheid is gebragt geworden Reflectereuden gelieven zich met franco Brieveu te adr.»1 sereu ouder Lett.A. L. aan deu Heer Directeur vau hf Postkautoor te Oosterhout. *__.* In Doesborgh aau den IJssel te KOOP of te HU VU om dadelijk of later te aanvaarden: Een vet eu aaug'' naam gelegeu HUIS. in de Groote- of Koepoortstraid inhoudende 6 Kamers 2 Zolders 2 Kelders Keukeu e* kleine Tuin met Regeuwaterbak enz. Nadere info? matiëu „rijn te bekomen op franco aanvragen  ouder Lette F. bij de Boekhandelaren A. MONGERS en Zn.  aidaafl V VOOÏI GYMNASIËN M lIVSTIÏIITfiV worden door G. B. van GOOR te Gouda met succes gedebiteerd : BURG (P. VAN DER) EERSTE GRONDBEGINj SELEN dkb NATUURKUNDE strekkende lof LeesboA voor alle standen hoofdzakelijk lot Zelfonderrigt vod Jonge Lieden en tot Handleiding voor Onderwijzers. M'1 3»C tussehen den tekst geplaatste Hou sueê-figureu. Twkkok druk gr. 12vo. Prijs: ingenaaid. ... . .ƒ4 20. „ in g.prest. linnen Band s 4 60. WILLEMIEK (D.) TUDREKENKUNDIG OVE»' ZIGT der voornaamste grieksche en t.ati.inschkoiD* schrijvers teu gebruike bij het Onderwijs in de Gvmu*' siën en andere Scholen. In gr. 1-2vo. . . 'f _%9' WILLEMIER (D.) Epjtomk histori.e roman0' rum i.itïerari.k. Iv usum scliolaalic-e juventutis. 1' gr. 12™ fo.i°' WILLEMIER (D.) KORTE SCHETS der o+* Aardrijkskunde. Eeue Handleiding bij het. Onderwijs •' de Gymnasién en andere Scholen. 2"" druk in gr 12vo/o^""' T. G. SCHRIKKER METHODOLOGIE om »*. ITALIAANSCH- DUBBEL- of KOOPMANS-BOl*' HOUDEN binnen weinig tijds alleen door zich zelve»1 naar den aard en de volmaaktheid uit te voeren ; waarde' een iegelijk hoe ook onervaren zich van deze wete»' schap zonder eeuig ander onderrigt op eene gemakkf lijke en eenvoudige manier kan verzekeren; alles in kor** schetsen duidelijk en bevattelijk voorgesteld. Met e«* beknopt overzigt betrekkelijk het houden van Koopman boekeu volgens het Wetboek van Koophandel ƒ 1.7} STERNK (L.) A SENTIMENTAL JOüRNB* through France and Italy f 07' JOHNSO.W (Dr.) THE HISTORY OF RASSEL^ Prince of Abbissinia. A tale. In gr. 12™ f os GOLDSMITH (Dr.) THE VICAR OF WA# FIELD fQI-KRAMERS Jb. (J.) FKANSCHE LEES- EN Vr# TAAL-OEFENINGEN voor EERSTBEGINNEND^ 1"" Stuk le gedeelte f os' Idem U' Stukje 2"" gedeelte _ oF „ 2« „ l- „ foM „ m» „2* „  Q9",http://resolver.kb.nl/resolve?urn=ddd:010518430:mpeg21:a0021:ocr,4,ddd:010518430:mpeg21:p004,Opregte Haarlemsche Courant,951
1405184,1851/01/23 00:00:00,1408,ddd:010979844:mpeg21:a0013,http://imageviewer.kb.nl/ImagingService/imagingService?id=ddd:010979844:mpeg21:p004:image&x=46&y=3389&w=998&h=1408,ddd:010979844:mpeg21,1044,4797,46,3389,4,"lONINKLUKE HOLLANDSCHE SCUOUWBURG onder directie van den Heer '. JPETERS. Op Saturdag den 25 Januarij 1851: DE NEVEN beroemd oorspronkelijk Blijspel  in vier bedrijven (in een geruimen tijd niet vertoond). Gevolgd door: DE SLUIKERS Blijspel met Zang in één bedrijf naar het Fransch  door den Heer G. van Beek (nooit alhier vertoond). — Aanvang ten zes ure. Verwacht op Maandag den 27 Januarij 1851 eene buitengewone Voorstelling: MOEDEREN ZOON enz. *»* De Ondergeteekende heeft de eer te berigten dat zijne MIT BCBtM.M te Delfshaven aan de Schie  tot heden door hem gedreven  is overgegaan aan den Heer JACOB ANNE MATTIIIAS ""VAN OORDT die deze Zaak op denzelfden voet op zijnen naam en voor zijne rekening zal continueren. Met dankbetuiging voor het genotene vertrouwen  neemt hij de vrijheid den nieuwen Eigenaar bij zijne vroegere Begunstigers aan te bevelen. Delfshaven K VAN DTTK 22 Januarij 1851. K' VAN DJ K' %* In verband met vorenstaande Advertentie  heb ik de eer te bctigten dat de M.BZBIBtUBBVB'BCCtB.B. te Delfshaven aan de Schie tot heden door den Heer lï. ""VAN Dijk. aldaar gedreven aan mij is overgegaan om op mijnen naam en voor mijne rekening op denzelfden voet te worden voortgezet. Ik neem de vrijheid deze Zaak aan het geëerde Publiek aan te bevelen  onder verzekering eener naauwgezette en spoedige uitvoering der orders waarmede men mij wel zal gelieven te vereeren. »*£S*V J- A. M. VAN OORDT.",http://resolver.kb.nl/resolve?urn=ddd:010979844:mpeg21:a0013:ocr,4,ddd:010979844:mpeg21:p004,Rotterdamsche courant,998
2461626,1851/03/14 00:00:00,2517,ddd:000019910:mpeg21:a0051,http://imageviewer.kb.nl/ImagingService/imagingService?id=ddd:000019910:mpeg21:p004:image&x=2031&y=99&w=978&h=2517,ddd:000019910:mpeg21,3009,2616,2031,99,4,Uit de Hand te Koop Een HUIZING  TUIN en ERVE  met eenige verandering er aan te doen  goed geschikt voor Zomaren Winterverblijf staande en gelegen even buiten de Gemeente 's Prinsenhage aan den Steenweg nabij Lisbosch. Kunnende desverkiezende onder goede guarantie de geheele koopsom tegen 4 pCt er op blijven staan. Franco brieven en inzage te bekomen bij Mejuivr. DE GEZUSTERS fVEJiMENBOL te 's Prinsenhage. (1569) Tegen Auguslus oi' INoveinber 1851 zijn van de in aanbouw zijnde panden aan den Schiedamschen Singel nabij den Binnenweg verhuurbaar.' Logeable Moderne WOONHUIZEN met Tuin  zeven Hamer*  Keuken Helder  Zolder en verdere Offices tegen f 800 per jaar. Alsmede ruime BENEDENHUIZEN  met Tuin en Bovenhuizen  tegen f 400. Reflecterenden die genegen zijn voor eenige jaren te huren  kunnen zich met den eigenaar verstaan omtrent de inrigting. Rotterdam 13 Maart 1851. J. VAN SCHAIK. (1577) Delftschevaart 7  287. Tegen primo Mei of eerder wordt te Huur gevraagd: een KANTOOR en PAKHUIS. Adres met opgaaf van Stand en Prijs bij JJ. T. JLENDRIKSEN Kantoor- Boekhandel Hoogstraat G 62. (1576) (1566) De DIRECTIE der Algemeene Vereeniging van Eigenaren lot onderlinge verteaarborging van Geregtskosten tegen gebrekige Huurders te Utrecht gevestigd brengt bij deze ter kennisse van Belanghebbenden  dat zij tot Agent voor do Kantons Rotterdam benoemd heeft den Heer F. L. DE RUYTER te Jiotterdam op de Delftsche Vaart No. 296  bij wien  op franco aanvrage  alle informalien deswege zijn te bekomen. Durvende genoemd.! Directie welke soortgelijke Maatschappij in Utrecht 8 jaar heeft bestuurd en nog bestuurd en waarbij de jaarlijksch e Contributie slechts gemiddeld 40 Cent per Woning heeft bedragen  deze Algemeene Vereeniging gerustelijk aanbevelen aan alle Eigenaren  waardoor zijlieden voor vele schaden worden gevrijwaard en veel beter de Huurpenningen bekomen. Utrecht Namens de Directie 9 Maart 1851. HAVERKAMP PRINS Direct. NB. Wordende in de andere Kantons dier Provincie nog AW EN TEN' gevraagd. Tt intro* Botterüamscijt Courant. De Ondergeteekende Agent van deze Courant voor de Stad Dordrecht heeft in het belang der Geabonneerden  ' de eer te berigten . dat de Courant met den 15den dezer i des morgens ten zeven ure bij hem verkrijgbaar is. Een i ieder die dus op eene spoedige en accurate bezorging wil ; rekenen wordt vriendelijk verzocht zich bij voorkeur tot | hem te wenden. | Dordrecht 11 Maart 1851. (1553) J. B. ZAHN.,http://resolver.kb.nl/resolve?urn=ddd:000019910:mpeg21:a0051:ocr,4,ddd:000019910:mpeg21:p004,"Nieuwe Rotterdamsche courant : staats-, handels-, nieuws- en advertentieblad",978
431320,1851/07/18 00:00:00,820,ddd:011021447:mpeg21:a0001,http://imageviewer.kb.nl/ImagingService/imagingService?id=ddd:011021447:mpeg21:p001:image&x=48&y=775&w=526&h=820,ddd:011021447:mpeg21,574,1595,48,775,4,"THE SHEBOYGAN NIEUWSBODE The only Dutch (or Holland) paper in the United States IS PUBLISHED KVKKÏ KUID.W at the rate of $150 per annum or §100 for six months Payable in advance. JgZ Office: Nearly opposite the New-York Store. TERMS OF ADVERTISING"". (Sixteen lines or less make a square.) Square for 1 week $100 Square 6 months $5.00 „ 2 weeks 125 „ one year 800 Business Cards of 5 Every subsequent sq. 400 i nes or less per an. 5.00 One coluinn.G mo'ths 2000 'Square 3months 300 ~ 1 year 3000 All casual advertisements must bo paid for in advance. JIST* Postmasters throughout the Union are politely requested to act as agonts for this paper. —Letters and Communications to be prepaid. All kinds of blanks for sale AND 3®® WBMI Of even* description in the English Dutch French and German languages neatly and promptly done at the oflicoofthe NIEUWSBODE. J. QUINTUS. Sheboygan Wisconsin. Publisher & Editor. Voor tax lijst en advertentien zie het bij deze Courant behoorende BIJ VOE GSEL.",http://resolver.kb.nl/resolve?urn=ddd:011021447:mpeg21:a0001:ocr,1,ddd:011021447:mpeg21:p001,De Sheboygan Nieuwsbode,526
3630900,1851/12/21 00:00:00,2850,ddd:010786824:mpeg21:a0010,http://imageviewer.kb.nl/ImagingService/imagingService?id=ddd:010786824:mpeg21:p005:image&x=1345&y=71&w=1274&h=2850,ddd:010786824:mpeg21,2619,2921,1345,71,6,"Het Bestek en de Voorwaarden liggen ter lezing: ten Raadhuize dezer Stad ten Kantore van den Ontvanger voornoemd mitsgaders bijden Opzipter der Domaniale Gebouwen G. H. Grauss bij wien tevens nadere informatie te bekomen zijn; terwijl de noodige aanwijzingen in loco op Zaturdag den 27Sten December 85i  des voormiddags ten 10 ure zullen geschieden. De Ontvanger voornoemd W. L. VAN SONSBEECK. OPENBARE AANBESTEDING. De Eerstaanwezende Ingenieur te Hellevoetsluis zal onder nadere goedkeuring van den Minister van Oorlog in het openbaar Aanbesteden : Het verzwaren en onder profil brengen van de Facen van Bastion I te Hellevoetsluis. Deze Aanbesteding zal geschieden den 24sten December 85 des middagsten 2 ure in het Logement van N. J. Kruijskamp te Hellevoetsluis alwaar van den igden December iBsi het Bestek zal liggen. Inlichtingen kunnen worden verkregen bij den Eerstaanwezenden Ingenieur te Hellevoetsluis.- OPENBARE AANBESTEDING. De Eerstaanwezende Ingenieur te Zutphen zal onder nadere goedkeuring van den Minister van Oorlog in het openbaar Aanbesteden: Het Herstellen van den Kisidam voor he Fort Bretagne te Doesburg. Deze Aanbesteding zal geschieden den 23sten December 85 des morgens ten elf ure in het Logement de Hollandsche Tuin bij Weenink te Zutphen  alwaar het Bestek van den jgden December zal liggen. Inlichtingen kunnen worden verkregen bij den Eerstaanwezenden Ingenieur te Zutphen en bij den Opzigter van Fortificatien te Doesburg. OPENBARE AANBESTEDING. Het Hooge Maasdijk-Collegie van Stad en Lande van Heusden c. a. zal ten overstaan van den Heer Ingenieur van's Rijks Waterstaat in Noordbrabant op Dingsdag den 23sten December 85 des voormiddags elf ure'ten Herberge van J. C. van Eijk te Heusden publiek Aanbesteden : Het Daarstellen van eenen Grindweg met de Leverantie van de daartoe benoodigde Grind van af de stad Heusden tot en met den Banne van Veen hebbende eene uitgestrektheid van 8033 ellen en zulks over den Hoogen Maasdijk langs en in de nabijheid der rivier de Maas gelegen. Zijnde de Bestekken daarvan ter inzage van de Gegadigden overgebragt te 's Gravenhage in het Zuidholiandsche Koffijhuis te Utrecht in den Nieuwen Bak te Gorinchen in den Hooiwagen en bij den Heer Lindeman aan de Waterpoort te Hardinxveld inNde Drie Snoeken te Werkendam bij Bretz te Giessendam in het Begthuis te Sliedrecht in het Regthuis  te 's Hertogenbosch in het Nêerlandsch en Brabandsch Koffijhuis te Zalt-Bommel bij van Driel  te Heusden ten Herberge van van Eijk  op de Korenbeurs en bij Verhoeckx aan de Wijksche poort zoomede bij de Heemraden Jiskoot te Veen  C. B. Vos en J. van Andel ie Wijk. Zullende daags vóór de Aanbesteding aan te vangen des voormiddags ten tien ure van af de stad Heusden van het in dezen bedoelde Werk aanwijzing in loco door den Dijkbode van gezegd Collegie gedaan worden. Het Ilooge Maasdijk-Collegie voornoemd H. C de Jongh  Dijkgraaf. Ter ordonnantie van hetzelve De Secretaris  V. G. A. 8011. * * Het Bestuur der Hollandsche Sociëteit van Levensverzekeringen  opgerigt in den jare 807 adverteert dat van "". Januarij 852 dagelijks ten Kantore van gemelde Sociëteit op de Heerengracht bij bet Koningsplein n°. 83  te .Amsterdam  zal gevaceerd worden ter Betaling der Gewone Jaarlijksche Uildeeling  verschenen den 3isten December 185 l  over bet door de Aandeelhouders bijeengebragte Fonds. De Directeur P. Langerhuizen.",http://resolver.kb.nl/resolve?urn=ddd:010786824:mpeg21:a0010:ocr,5,ddd:010786824:mpeg21:p005,Nederlandsche staatscourant,1274
8890809,1851/01/18 00:00:00,4280,ddd:010786122:mpeg21:a0005,http://imageviewer.kb.nl/ImagingService/imagingService?id=ddd:010786122:mpeg21:p003:image&x=40&y=89&w=2603&h=4280,ddd:010786122:mpeg21,2643,4369,40,89,6,"*J* De Minister van Marine Brengt bij deze ter kennis van de Scheepvarenden en verdere daarbij belang hebbende dat in den loop van dat jaar het Groot-Scheepsvaarwater langs het Hoofd van Ooltgensplaat tot op eene breedte van naauwelijks eene Halve Kabellengte zoodanig is vernaauwd dat voor een Zeeschip met 4-0 à 5o palmen diepgang alle oplettendheid wordt vereischt  om dat puntte passeren terwijl door hetzelve immer moet worden gebruik gemaakt van het oogeoblik van Hoog Water als wanneer aldaar geene meerdere diepte dan 54 a 56 Palmen gevonden wordt en de vloed alsdan dwars over de gronden naar het zoogenaamde Hellegat trekt. Deze naauwe Passagie wordt daarenboven veeltijds belemmerd door Binnen-Vaartuigen de Zeeuwsche Stroomen bevarende welke bij menigte aldaar eene veilige Ankerplaats zoeken  zoodat Zeeschepen of Zwair Geladen Binnenschejien niet zonder gevaar van belangrijke Ongelukken te Veroorzaken of te bekomen  aldaar kunnen Passeren. Ten einde de Scheepvaart in het algemeen voor dusdanige gevaren vrij te waren is er order gegeven om op liet Hoofd van Ooltgensplaat  Twee Waarschuwings-Borden te doen plaatsen  waarvan één gerigt naar het Zuiden  en één naar het Noordoosten met de woorden : Waarschuwing om in hel Groot-Scheepsvaarwater alhier niet te Ankeren. Het wordt mitsdien aan de Schippers van Binnenschepen aanbevolen om ter voorkoming van Ongelukken  deze waarschuwing in acht te nemen. Wanneer het bij onderzoek mogt blijken  dat deze Borden op eene geschikte wijze aan den Licht-Opstand te Ooltgensplaat zullen kunnen bevestigd worden  zal zulks op die wijze geschieden. 's Gravenhage den i4den November iBso. De Minister voornoemd  E. Lucas. Aanbesteding van Ruwe Eiken Houtwaren ten dienste der Marine benoodigd over iBsi. De Minister van Marine voornemens zijnde op den 2isten Januarij iBsi bij inschrijving aan de minst aannemenden te doen Aanbesteden de Levering van de onderstaande Eiken Houtwaren voor de dienst der Marine te weten : te Amsterdam: N°. i. Eiken Balken; » 2. Dito Krommers; » 3. Dito Knieën ; te Willemsoord: rt 4- Eiken Balken ; » 5. Dito Knieën ; Brengt ter kennis van degenen welke rnogteo genegen zijn deze leveringen aan te nemen ; dat de Inschrijvings-Biljetten  op gezegeld papier geschreven voor ieder Bestek afzonderlijk ingerigt voor of uiterlijk op den 2isten Januarij lBsi  des middags voor twaalf ure  franco aan het Ministerie van Marine te 's Gravenhage zullen moeten worden bezorgd ; wordende hierbij de gegadigden indachlig gemaakt  dat het voor hen genden is te achten om niet tot den laatsten dag te wachten met het inzenden hunner Inschrijvings-Biljetten daar het in den laatsten tijd meermalen is voorgekomen dit inschrijvingen te laat zijn ontvangen en dus niet zijn Kunnen worden in aanmerking genomen ; dat dezelve eene naauwkeurige opgave moeten bevatten van de prijzen  voluit geschreven waarvoor de Gegadigden de Levering van ieder der voorschreven Artikelen willen aannemen ; dat de Inschrijvings-Biljetten welke op onge/.egeld papier geschreven ?ijn  niet in aanmerking zullen genomen worden  noch ook die  waarop zich doorhalingen of veranderingen bevinden gelijk almede geene bij-condition in aanmerking zullen worden genomen; dat dezelve op het adres zullen moeten vermelden het nommer en de benaming van het Artikel  waarop de Inschrijving geschiedt en verder moeten bevatten -de-namen der Inschrijvers met die der Borgen en hunne woonplaatsen. Wordende den Gegadigden hierbij opgemerkt dat de Bestekken eenige wijzigingen hebben ondergaan. De Voorwaarden waarop deze Aanbesteding zal geschieden  liggen ter lezing aan het Ministerie van Mirine te 's Gr.ivetih ige  bi| de Directten der Marine te Amsterdam Willemsoord Hellevoetsluis en Vlissin;;en alsmede ten Burele van de Commissarissen des Konings in de onderscheidene provinciën des Rijks. 's Gravenhage den 7den Januarij i3si. De Minister voornoemd E. Lucas. MINISTERIE VAN FINANTIEN. Rijks-Stoomsleepdienst op de Waal tusschen Rotterdam en Lobitk. Januarij iBsi. Uren van Vertrek. 5 Zondag 'snamidd. ten 2\ ure. 19 Zondag 's namidd. ten 2J ure. 7 Dingsdag 'svoorm. » 6| » 21 Dingsdag'svoorm. » 6 » 8 Woensdag » » 61 » 22 Woensdag » » 6 » 10 Vrijdag » » 6é » 24 Vrijdag  » »6| » 12 Zondag » » 8 n 26 Zondag » » 8 » i 4 Dingsdag » » 10 1» 28 Dingsdag » » io » i 5 Woensdag » » 11 » 29 Woensdag » » lij » 17 Vrijdag's namidd. » 1 » |3i Vrijdag 'snamidd.» l » Kantoren van Inschrijving : te Rotterdam bij C. L. van Craenenbroeck; te Dordrecht bij den Havenmeester; te Gorinchem  bij den Ontvanger der Rhijnvaartregten; te Kossum  bij den Loods-Bakenmeester; te Tiel bij den Ontvanger der Rhijnvaartregten. De Algemeene Lijst te Rotterdam wordt gesloten des avonds ten acht ure vôôr den dag der afvaart. GEREGTELIJKE AANKONDIGINGEN. *** Op beden den zestienden Januarij achttien honderd een en vijftig ten.verzoeke van Petronella Cornelia Rijnveld Huisvrouw van Felix Marie Joseph Caudron zonder beroep wonende te Rotterdam bij vonnis van de Arrondissements-Regtbink te Rotterdam van den twintigsten September achttien honderd vijftig  behoorli|k op de expeditie geregistreerd magtiging bekomen hebbende tot kosteloos procederen domicilium kiezende ten Kantore van den Procureur Jan Jurie Scheffer  in den Oppert wijk 6 n*. 227 te Rotterdam en die voor de Requirante zal occuperen en uit krachte van een vonnis van gemeble Regtbank van den eersten November achttien honderd vijftig mede behoorlijk op de expeditie geregistreerd  waarbij aan de R quirante verlof is verleend om haren na te mei Jen Man bij Openbare Dagvaarding op een termijn van drie maanden op te roepen  Heb ik Johannes Brakkee Deurwaarder bij dé Arrondissements- Regtbank te Rotierdam wonende aldaar in den Oppert wijk 6 n\ 30 behoorlijk gepatenteerd bij aanplakking Gedagvaard : voornoemden Felix Marie Joseph Caudron mijn Exploit doende aan het Parket van het Openbaar Ministerie bij meergemelde Regtbank en aldaar mijn Exploit doende sprekende met den Edel Achtbaren Heer Mr. J. H. W. Swellengrebel Officier vm Justitie die het origineel voor gezien heeft geteekend om te Compareren op Woensdag den dertigsten April aanstaande des voormiddags ten Elf ure ter Teregtzitting van de Arrondissements-Regtbank te Rotierdam gehouden wordende in het Geregtsgebouw aan het Haagscue Veer aldaar; —ten einde te hooren concluderen: aangezien de Eiscberesse op den vierden Februari] achltien honderd vijf en dertig te Cheribon met den Gedaagde is in het Huwelijk getreden ; aangezien zij in Februarij achttien honderd negen en dertig met denzelve uit Oost-Indie naar Nederland is teruggekeerd ; aangezien alstoen haar Man van Rotterdam naar Harderwijk vertrokken is tot verkrijging van zijn paspoort en zij sedert dien tijd niets meer van hem vernomen beeft ; aangezien er alzoo meer dan tien volle jiren verloopen zijn zonder dat eenige tijding van des Gedaagden leven of dood is ingekomen ; aangezien de Eiscberesse vermeent er in dezen grond bestaat tot het vragen van magtiging tot het aangaan van een ander Huwelijk  dat bij Vonnis dier Regtbank  bij niet-verschijning des (ïedaagden  verstek tegen hem zal worden verleend en voor het profijt daarvan verlof tot eene tweede Dagvaarding op gelijke termijn en wi|ze als bij laatstgemeld Vonnis is omschreven  ten einde nadat de termijn der derde Dagvaarding zal zijn verstreken zonder van zijn aanwezen te doen blijken zal worden geconcludeerd tot magtiging der Eiscberesse tot het aangaan van een ander Huwelijk  en met condemnatie van den Gedaagde in de kosten van den processe. En heb ik Deurwaarder exploiterende als voren hiervan gelaten kopij en wijders gelijk afschrift aangeplakt'aan de voorname deur der vergaderzaal van meergenoemde Regtbank alsmede aan het Huis der Gemeente alhier en doen plaatsen in de Staats ■ courant gelijk mede in de Nieuwe Rollerdamsche Courant. De kosten zijn in debet twee gulden vijf en zeventig cents. J. Brakkee  Deurwaarder. Gezien door ons Officier van Justitie  heden den loden Januarij iBsi (get.) Swellengrebel. ** Aan de Belanghebbenden bij en de Schuldeischers van de Nalatenschap van Marcus of Marlinus Winter Sergeant bij de depót-compagnie van het eerste regement vesting-artillerie overleden te Delft op den 2den September iS'tg wordt bekend gemaakt. dat deze Nalatenschap op den 2den Januarij jl. door zijne Erfgenamen onder het voorregt van Boedelbeschrijving is aanvaard. De voornoemde Belanghebbenden en Schuldeischers worden mitsdien Opgeroepen om op den agsten Ja- I nuarij aanstaande 's .middags ten 12 ure te Compareren ten Kantore ■ van den Advocaat Mr. D. Polak Daniels te 's Hage (Spuistraat wijk S. n"". 7) welke alsdan in zijne hoedanigheid van Gern.igligde der voormelde Erfgenamen Rekening en Verantwoording van zijn Beheer dier Nalatenschap zal afleggen en aan de Schuldeischers hunne pretensien voldoen voor zooverre zij geene Betaling van den Curator dezer vroeger Onbeheerde Nalatenschap mogten genote» hebben.",http://resolver.kb.nl/resolve?urn=ddd:010786122:mpeg21:a0005:ocr,3,ddd:010786122:mpeg21:p003,Nederlandsche staatscourant,2603
3146344,1851/11/22 00:00:00,2876,ddd:010276248:mpeg21:a0016,http://imageviewer.kb.nl/ImagingService/imagingService?id=ddd:010276248:mpeg21:p002:image&x=2241&y=2161&w=1094&h=2876,ddd:010276248:mpeg21,3335,5037,2241,2161,2,2lsde STAATS-LOTERIJ. BÖ H. TRACHSLER Kortendelft G. 14 is in de sde Klasse 1 ide Trekking getrokken op No. 6930  een PRIJS van ƒ 1000. Devies. Dit weinigtje te wagen Zal mijn niet beklagen. VERKOOPING op Woensdag den 26 November 1851  asn het Verkoophuis op het Koorkerkhof bij .7. Montanari van eene partij Mahonijhouten en andere MEUBELEN  bestaande in Buffetten Commode  Kanapé  Stoelen met zwarte Zittingen en andere Theetafels Penant-Spiegels en Schilderijen en wat meer zal worden gepresenteerd. Maandag 24 en Dingsdag 25 dezer voor een ieder te zien. ]}e Notaris P. van de Graft zal op Woensdag den 26 November 1851 des morgens 10 ure op de Hofstede bevorens bewoond geweest door A. Woutermans gelegen onder de Gemeente van MELISKERKE publiek presenteren te verkoopen  ruim 200 stuks Olmen  Essen  Abeelen en NOTEN BOOMEN ; waaronder velen geschikt voor Werkhotit ; mitsgaders eene partij KAPHOUT. HOUTVERKOOPING den 9 December 1851 op de Hofstede ARENDS RUST bewoond door .7. Louwerse As. onder de Gemeente van Serooskerke ; breeder te adverteren. HOUTVERKOOPING den 23 December 1851  op de Hofstede HET HUIS GAPINGE gelegen onder Gapinge ; nader te adverteren. Xe pachten de HOFSTEDE Bouw. en Plantlust in de Heer Jans- enSoelekerkepolders  Eiland Noord-Beveland met de nombre van circa 91 Bunders BOUW- en WEILAND. Te bevragen bij den Heer P. Dumon Tak  in de Bogaardstraat alhier. JTven als in den vorigen Winter te bekomen ROLPENS  gerookte WORST en dito HAASJES ; is ook voorhanden puik Vet RUNDVLEESCH; alles geregeld naar den Marktprijs. Is ook voorzien van Gezouten VLEESCH. Middelburg A. DE ZEEUW  12 November 1851. Vleeschhouwer op de Vlasmarkt. Versche gespeende In!. OESTERS bij Lameyn Penningh. ]^ij .7. van Boven te RILLAND is van stonden aan een grondig in zijn Vakervaren WAGENMAKERS KNECHT benoodigd. STOOÏJ AGTKtf. varende in het Beurlveer tusschen de Steden Middelburg Rotterdam en op alle daar tusschen gelegen Plaatsen. november 1851. VAN MIDDELBURG: \ VAN ROTTERDAM: *Zondag 23'smorg. 4 ure I Zondag 23'smorg. siure * Dingsdag 25 5 — j Dingsdag 25 6i — * Woensd. 2(5 5!-— I Woensd. 26 • 61.— 'Vrijdag 28 7 — | Vrijdag 28 ■ 8 — * Zondag 30 7 — | Zondag 3°» 8-J— trf=> De AFVAART-LIJSTJES voor November en December zijn gedrukt en voorhanden in de Boekwinkels van de Weduwe C. Jongkindt & Zoon en de Gebroeders Abrahams.,http://resolver.kb.nl/resolve?urn=ddd:010276248:mpeg21:a0016:ocr,2,ddd:010276248:mpeg21:p002,Middelburgsche courant,1094
1684890,1851/07/05 00:00:00,1930,ddd:000013073:mpeg21:a0011,http://imageviewer.kb.nl/ImagingService/imagingService?id=ddd:000013073:mpeg21:p004:image&x=1866&y=560&w=873&h=1930,ddd:000013073:mpeg21,2739,2490,1866,560,4,ADVERTENTIËN. (1852) Een JO\tEM\ft  ***4S_> den 4den rang bezittende  geëxa'•^A**» mineerd in het Fransch de beginselen der Engelsche en Hoogduitsche Talen kunnende onderwijzen wenscht daar hij van goede Getuigschriften voorzien en sedert 3 jaren aan verschillende Instituten werkzaam geweest is aan cene goede INRIGTING geplaatst te worden  waar lijd tot eigene oefening overblijft. Reflectcrenden gelieven zich franco te adresseren onder Letter G aan de Boekh. Kemink & Zoon te Utrecht. MIS- en INADRUK. (1853) Het geëerde publiek wordt bij dezen beleefdelijk gewaarschuwd geene boekjes meer te koopen onder den titel: „Verstrooide Mijmpjes uitgegeven door zekeren L. P. van der Eist; — daar deze nadrukkcr en de Rederijkers-Kamer hierin volstrekt niet gekend heeft eu bovendien incomplete bundels in het licht zendt. Utrecht De Secretaris der Kamer 2 Julij 1851. Hellendoorn. (1854) Bij BROESE & COMP. te2?rafeis uitgegeven en alom verkrijgbaar : HANDLEIDI.VG bij de beoefening dek. ENGELSCHE TAAL  vooral ook ten dienste van hen  die zich tot de lessen aan de Koninklijko Militaire Akademie wenschen voor te bereiden. Door Dr. J. J. DE HOLLANDEB. Lector aan genoemde Akademie. Eerste afdeeling : Spraakkunst f 080. Tweede afdeeling : Leesboek f 080. Deze Tweede afdeeling bevattende een gemakkelijk Leesboek is ook afzonderlijk verkrijgbaar onder den titel : READFVG LESSONS FOR THE USE OF SCHOOLS; consisting of Extracts from English Prose Writera. Compiled by Dr. J. J. DE HOLLANDER.,http://resolver.kb.nl/resolve?urn=ddd:000013073:mpeg21:a0011:ocr,4,ddd:000013073:mpeg21:p004,"De Nederlander : nieuwe Utrechtsche courant : (staatkundig- nieuws-, handels- en advertentie-blad) / onder red. van J. van Hall",873
2763484,1851/06/06 00:00:00,4816,ddd:010518334:mpeg21:a0016,http://imageviewer.kb.nl/ImagingService/imagingService?id=ddd:010518334:mpeg21:p003:image&x=102&y=113&w=2845&h=4816,ddd:010518334:mpeg21,2947,4929,102,113,4,"*£* Meu verlangt op eene Looijerij iv Gelderland een LEERLING  waar gewoon en tuigleder vervaardigd wordt. Adres Letter C bij den Boekhandelaar D. J. HASPELS te Nijmegen. *„* Aan een Algemeen Kautoor der Registratie Zegel en Successie in eene Arrondissements-Hoofdplaats Provincie Zuid-Holland wordt gevraagd: Een EERSTE KLERK ervaren in het vak tegen een Salarisgeëvenredigd naar zijne kundigheden. Adres onder Letter 8. bijde Boekhandelaars A. KLOOTS en C°. te 's Hage.' Brieven franco. V BOBKHISI% » _K M $ . het bewerken van Kantoorboeken in den grond verstaande  kunnen op zeer aannemelijke voorwap.nJen worden geplaatst. Adres onder de Letters A. L. C. aan J. H. KNOOP Donkere Sparen te Haarlem. ** Er wordt zoo spoedig mogelyk gevraagd: Een bekwaam BOEKBINDER het Vergulden magtig Protest. Godsdienst en liefst ongehuwd. Adres Brieven franco onder Letter Z bij deu Boekhandelaar J. K. de REGT te Middelburg. %* IJf TASTE BETREKKINGwordt verlangt: Eene JUFVROUW vau goede afkomst en godsdienstige brave beginsels welke goed kan voorlezen in het Hollandsch en ten minste nog eene andere der moderne Talen j verders eene goede gezondheid genietende en bedreven in alle Handwerken van smaak fotru£TLS^rNYHOFF' «oekhandelaa; V Eene JUFVROUW en reeds in eene dergelijke betrekking werkzaam o-eweest zijnde zag"" zich gaarne geplaatst als Huishoudster of Jufvr. van Geselschap. Hierop reflecterende pelieve SmS ""TV °Dder Lettw W' biJ de Wed. 11. ME 11 EX . Boek.handelare.se te Zwolle. Brieven franco. %* Eene JUFVROUW van de Protestantsche Religie zag zich gaarne geplaatst om de behulpzame hand te bieden in een Huishouden waar zij niet alleen alle vrouwelijke Handwerken het omgaan met de Wasch enz. maar ook de opleiding en verplegiug van Kindereu op zich zou kunnen vemen. Bovendien zou zij  des verlangende aan de Kinderen de beginselen der Fransche en Engelsche Talen kunnen onderwijzen. Alle vereischte informatiën en getuigschriften zulleu gegeveu worden als men zich adresseert aan het Postkantoor te Schoonhoven onder de Letters T. J. P. *** Marktmeesteren der Stad HAARLEM brengen ter kennis van alle degenen welke verlangen op de aanstaande JAARMARKT binnen deze Stad invallende op den 2_*ten Junij 1851 met hunne Kramen of Tenten voortestaan dat de Loting zal plaats hebben op Vrijdag den 27sten Junij aanstaande des namiddags teu vijf ure op het Raadhuis dezer Stad eu dat de belanghebbenden zich vóór den 16J!"" Juuij e. k. aan Marktmeestereu voornoemd moeten adresseren met vrachtvrije Brieven waarbij de grootte der Kramen en Teuten met Nederlandsche maat wordt opgegeven; zulleude de bedoelde Kramers moeten voorzien zijn vau eene verklaring van het Gemeente-Bestuur hunner woonplaats ten bewijze dut zij inlanders zijn daar zij bij gebreke van dieu ten aanzien vau het Patentregt als vreemdelingen zullen moeten worden beschouwd. *.* Gedurende de Zomerniaaudeu zal de ondergeteekende weder dagelijks voorzien ziju van IJS als ook Rnwof Water-US altijd voorhanden hebben en recommandeert hij zich verder aau zijne geëerde Begunstigers. J. A. van dkr WAAG Confiseur-Cuisinier  op het Verwulfl te Haarlem.",http://resolver.kb.nl/resolve?urn=ddd:010518334:mpeg21:a0016:ocr,3,ddd:010518334:mpeg21:p003,Opregte Haarlemsche Courant,2845
1703350,1851/08/22 00:00:00,1793,ddd:010518399:mpeg21:a0015,http://imageviewer.kb.nl/ImagingService/imagingService?id=ddd:010518399:mpeg21:p003:image&x=48&y=2675&w=950&h=1793,ddd:010518399:mpeg21,998,4468,48,2675,4,"Broodzetting voor de Stad Haarlem  22 Augustus 1851. duiver ttngebuild roggenbrood.- 3 ned. pond 31 % cents ; dito 2 n. P- 21 e. ; dito 1 ti. p. 10% c. ; dito 50 lood 5% c. — Fijn gebuild *«rim;%brood-. In.p. 6 oneen 48 cents; dito In.p. 32 c.; dito 'r> lood 24 c.; dito 5 oneen 16 c.; dito 25 lood Bc. Het bovengaande gebuild tarwenbrood rondom korst en hardgebakken wor. e""de _al op de 1 p. 5 o. vijf lood ligter mogen wegen voor het """"bakken. — Ongebuild tarwenbrood: 1 n. p. 50. 32% c.; dito 1 ""'• p. 21% c.; dito 75100 d 16% c.; dito 50. 11 c.; dito 25 lood *■% c. — Tarweabroods-bolhm wegende 15 lood 5 cents. Klein M:'ttebrood wegende 14 lood  5 et. *** Nok is voor deu door brand ongel ukkigen landbouwer _. '»an (je. Voort te Eersel met opregten dank ontvangen : vanN. N. tut Nijmegen een coup. groot ƒ 618% ; van 8. uit Eindhoven eon coup. gr. f 297 ; door d». van Rhijn  te Chaani van eenige christelijke meusehenvriendeu  ƒ 80; door d». R. O. Aitton  te Zevenbergen  van een lid zijner gemeente een muntb. gr. ƒ10; bij <t. _._.__ ie Utrecht vau een' jongeling onder letter 1. een coup. gr. f 123%; bij den/. de helft eener gift van N. aan 't Nieuwew P '.f ■'"": van '' u' • k-' te Amst*' /2 '• cloor da- v-L- Schuller te noordgmiwe van eeniXe meuschenvriendeii in miintbb. ƒ 20 en «an den kerkeraad der H. gem. te Valkenswaard ƒ 5. J. I.EUDS Pr. te Hoogeloon en Eersel. *** _ *ENN I S G ..rY~7~ÏTG: l)e Voorzitter van den Gemeente-Raad van Haarlem »&b-|_4i_r.r._iTri-ir_ïï- Ue Voorzitter vooruoemd Haarlem DX BR[T VN KOPS ' den 21st'"" Augustus 1851. *..._. V Eenige Kiezers te Haarlem brengen ter kennis van hunne Mede-Kiezers dat zij een Reglement van Orde hebben ontworpen vastgesteld en geteekend voor eeue X_ez».s-vereeniging binnen deze Stad onder den _aam van - Orde en Eensgezindheid"" van welk Reglement hetgeen bereids door ecu aanzienlijk aantal Kiezers ondert.ekend is onder anderen ook op dezer Stads-Doelen een gssehreveu exemplaar voor ieder Kiesgeregtigde ter inzage en onderteekeniug liggen zal op Vrijdagen Zaturdag 22 eu 23 dezer. Degenen die dit Reglement ten blijke huuner goed- Keuring en deelneming hebbeu ouderteekend  zullen nader worden opgeroepen tothet vaststellen van een Bureau. Haarlem 21 Augustus 1851.",http://resolver.kb.nl/resolve?urn=ddd:010518399:mpeg21:a0015:ocr,3,ddd:010518399:mpeg21:p003,Opregte Haarlemsche Courant,950
3104556,1851/01/17 00:00:00,2843,ddd:010072799:mpeg21:a0023,http://imageviewer.kb.nl/ImagingService/imagingService?id=ddd:010072799:mpeg21:p003:image&x=2237&y=2461&w=1092&h=2843,ddd:010072799:mpeg21,3329,5304,2237,2461,4,"(743) Tegen Maart April of Mei verlangt men te Amsterdam of ia eene der Provincie-Steden ter overname cene zindelijke nette AE™ FAIRE welke door eene Vrouw kan worden waargenomen en waartoe een Kapitaaltje van p. m. ƒ 1000 _ 1500 vereischt wordt en welke Affaire minstens een inkomen van ƒ 10 a 15 per week oplevert voor hetwelk moet geguarandeerd worden. Hierop reflecterenden gelieven zich te adresseren met franco Briefjes onder de Letters D. A. E. bij da Boekhandelaars MANUEL en SCÏILENCKER Kalverstraat over don Heiligen Weg te Amsterdam. (530) Op een der beste Standen van Hoorn wordt UIT DE HAND TE KOOP gepresenteerd: Een ruim Gebouwd HUIS met vijf Verdiepingen en Zolders van 60 Voeten waarin sedert 25 jaren de Tabaks- Affaire is uitgeoefend en zeer geschikt voor verdere uitbreiding alsmede voor andere Affaires voor plus minus ƒ 3000. De WINKEL-GOEDEREN en verdere GEREEDSCHAPPEN kunnen naar verkiezing er bij overgenomen worden. Nadere Informatien zijn te bekomen op Franco Brieven geteekend P. bij den Boekhandelaar P. J. PERSIJN te Hoorn. (185) Een Protestantsch JONG MÉNSCH uit den fatsoenlijken stand oud 25 jaren een geruimen tijd werkzaam in eene sedert meer dan i; eeuw bestaande gunstig bekende en goede resultaten opleverende WIJN-AFFAIRE  in eene der voornaamste Geldersche Steden bevindt zich in de gelegenheid deze dadclyk op zeer aanneembare conditien te kunnen overnemen doch daartoe geen voldoend Kapitaal bezittende zoekt hiertoe een DEELGENOOT in staat over minstens2oMille te kunnen beschikken zullende hiervoor echter het meest in aanmerking komen lemand van nagenoeg denzelfden leeftijd  geschiktheid bezittende en lust gevoelende tot het doen van Binnenlandsche Reizen voor deze Zaak terwijl er alleen op eigenhandig geschrevene en geteckende Brieven regard zal worden geslagen. Nadere informatien bij vrachtvrije Brieven onder de Letters B. C. D. by den Boekhandelaar VIEWEG te_Nijmegen. _______ "" MEN VRAAGT in eene soliede gevestigde HANDELSZAAK hier ter Stede: Een STILLE of MEDEWERKENDE COMPAGNON die p. m. over/3- a ƒ 4000 kan beschikken; van de soliditeit kan men zich overtuigen. Hierop reflecterenden gelieven zich te adresseren BureatiHinihdidil^^ ""7779) Een fatsoenlijk jong mensch door eenige jaren ondervinding zeer geroutineerd in het vak van Manufacturen wenschte zich zoodra mogelijk als REIZIGER voor eenig Handelshuis te engageren of als WI-IKELBEDIENDE verplaatst te zien kunnende van geschikt-en bekwaamheid de beste bewijzen produceren. Hierop reflecterende adresscre men zich met franco brieven lett. X bij de Heeren SCHALEKAMP VAN DE GRAMPEL en BAKKER te Amsterdam. NIEUWE GOEDKOOPE MUZIJK U_i; CENT DE PAGINA. De Muzijkale Correspondentie te 's Gravenhage maakt de Muzijkale Wereld opmerkzaam dat een Leerling of Liefhebber die gewoon is Jaarlijks/ 12 aan Muzijk te besteden thans dezelfde Werken OVERDRUK worden aangeboden builen Inteekening en dus naar keuze  voor ƒ4 en bij Inteekening voor den spotprijs van ƒ 2. In dc voornaamste Steden van het Rijk zijn Depots gevestigd onder anderen te Amsterdam bij L. ROMIJN; te Rotterdam bij S. VAN REYN SNOECK; te 's Gravenhage bij de Erven DOORMAN; en voorts bij alle Correspondenten en Postkantoren zijn CATALOGUS a 5 Cts. en PROSPECTUS alsmede van de ORGEL-MUZMK op Franco aanvraag te bekomen en worden bestellingen aangenomen. (536) _£_ Door Overdruk wordt dc Plaatdruk volkomen gekopieerd. ""VOOR LEESGEZELSCHAPPEN. ; De Boekhandelaar J. F. VAN DOBBEN te Haarlem heeft uitgegeven en alom verkrijgbaar gesteld: REIZEN EN LOTGEVALLEN VAN PAUL PORTER INSPANJIE 1 NIEUWE TOGTEN OP MIJN STOEL DOOR EEN NEEFJE VAN KLIKSPAAN 1 Deel gr. 8». met Vignet/ 3.— (645) f Bij J. J. SLINGERLAND Boekhandelaar te 's Gra; venhage is van de pers gekomen en aan de ' Inteekenaars verzonden: I. De le en 2e Aflevering van de HANDLEIDING bij het LMN-  BOUW- en MEETKUNST-G TEEKENEN en bij het geven van - ONDERWIJS in de WISKUNDE door P.D.SCHEFFELAAxt I Fortificalie-Opziqter. „ Druks en Het Werk zal waarschijnlijk in 12 Aflev. ieder van J/- v* _^ 3U4 Platen Compleet zijn; de prijs Per j„ï» ihan-len zal Bij de 3e Aflev. welke over de Leer der ü™""L_crt worden gevoegd. benevens den Titel eene Inleiding bevattende „fJVEn[|>E of MEi 11. VERVALBOEKJE voorH*W»^N gCHULD ingerigt ten . MOREE VAN OPENSTAAND TE GO£__ncjc„ > enz> &gt «._ fc dienste van Kooplieden Wmkeher» ___ dien __.£ - Dit Boekje is het gemakkelijke _ > p - taan is geschikt voor vier Jare"" f .u« jmuiu  lechts 80 Cts. y*°t",http://resolver.kb.nl/resolve?urn=ddd:010072799:mpeg21:a0023:ocr,3,ddd:010072799:mpeg21:p003,Algemeen Handelsblad,1092
18377,1851/05/10 00:00:00,47,ddd:010248010:mpeg21:a0021,http://imageviewer.kb.nl/ImagingService/imagingService?id=ddd:010248010:mpeg21:p004:image&x=1305&y=1924&w=391&h=47,ddd:010248010:mpeg21,1696,1971,1305,1924,4,ADVEffiNTIKA.,http://resolver.kb.nl/resolve?urn=ddd:010248010:mpeg21:a0021:ocr,4,ddd:010248010:mpeg21:p004,De Tĳd : godsdienstig-staatkundig dagblad,391
3506534,1851/04/11 00:00:00,2459,ddd:010583941:mpeg21:a0024,http://imageviewer.kb.nl/ImagingService/imagingService?id=ddd:010583941:mpeg21:p007:image&x=1491&y=2798&w=1426&h=2459,ddd:010583941:mpeg21,2917,5257,1491,2798,10,Te Spannum voornaam RoeJgoed op 3 maanden crediet. SW. HOEKSTRA Cand.-Notaris te Wommels gedenkt ten overstaan van o een bevoegd Ambtenaar op Woensdag den 16 April 1851 'smorgens 9 uur ten huize en verzoeke van de Wred. Folkert Tjipkes IJpma  Boerin onder Spannum bij boelgoed de posten van ƒ 20 en daarboven tegen voldoende borgstelling op 8 maanden crediet die daarbeneden a contant te verkoopen: Een zeer uitmuntend BESLAG VEE BOERENREEUW en GEREEDSCHAPPEN als: 29 stuks puik best Hoornvee waarvan 17 melke- en kalve- 2 beste vetteen 2 vare Koeije: 4 Rieren  4 lloklingen 1 zwart langstaart Merriepaard mak en in alle tuig bereden 18 Schapen met en zonder Lammeren eenige Zuipkalveren. 1 beste moderne Kapwagen met raam en dissel 2 Hooiwagens waarvan 1 beslagen 3 Aardkarren waarvan 2 nieuwe 1 Kam met koperen hoep 1 Kaaspers met steen 6 Melkvaten 48 houten Aden 2 Boteraden waarvan 1 en 2 Brokaden  beide met koper beslagen 12 koperen Emmers 10 houten Dito 1 Handketel 1 Koekmolen 1 Emmerbank  1 Sleeptrog 2 Kretten en Mestplanken  1 Tijme 2 Kruiwagens 1 Draagbernj  1 Sleeptrog 2 Ladders 1 Vleeschvat  1 Slijpsteen 4 Tobben Booitsen Troggen Zuipvalcn 2 Ilooiroeden 1 llooilep  dubbele en enkele Zijllen 1 Slede Harken Vorken Grijpen eu verdere Gereedschappen. PAARDENTUIG: 2 dubbele Gereiden 1 Chaisgereid en Hoofdstellen alles zoo goed als nienw 2 Wagen- en 1 Chaiskussen  2 Paardendekken. — Eene partij gerookt SPEK en VLEESCH. MEUBELEN en HUISGERADEN als: 1 Bureau 1 Staartstukklok 1 Tafelklokje zijnde eene Repetitie 1 Bed en Peluw 1 Schoielbank 2 Tafels 1 Kagchel diverse Stoelen Koper- Tin- Blik- IJzer- Glas- en Aardewerken en hetgeen meer zal worden aangeboden. Geene Hakblokken noch Koekdisschen zullen worden toegelaten. Boelgoed op Makkum onder Bozum. SW. HOEKSTRA Canó.-Nntari» tn Wommels gedenkt op Woensdag den • 23 April 1851  des morgens ten 9 ure ten huize en verzoeke van Gerben Minnes Bruinsna Boer onder Bozum  ten overstaan van een bevoegd Ambtenaar bij boelgoed tegen contante betaling te verkoopen: Een best gezond BESLAG VEE BOERENREEUW en GEREEDSCHAPPEN  als: 83 «tuks Hoornvee waaronder: 28 melke- en kalve Koeijen 1 dito vare en 6 Hoklingen 2 Kalvers I best bruin Merriepaard (mak en in alle tuig bereden.) 1 kromzijdige Chais 1 Bolder wagen 2 heilagen Hooiwagens 2 Aardkarren 1 Kaasketel 1 Kam met koperen hoep 1 nieuwe Kaaspers met steen 1 Sleeptrog 1 Thijme 1 Bindiladder 5 Melkvaten 87 houten Aden 1 Boteraad met koperen beslag 3 Brokaden 11 koperen en 6 bouten Emmers 4 Kaasvaten 1 Perstob 1 Tob 1 Kret en Mestplanken Schalen en Evenaar 4 Ziiiptonner. 1 lli.oiroede dubbele en enkele Zijllen Harken Vorken Grijpen en verdere Gereedschappen 1 paar Wagenriemen Paardentuig 1 Geweer eenige Hekpalen en Hekken  1 Karnmolen. Ongeveer 6000 Ned. ponden best HOOI eene partij gerookt SPEK. MEUBELEN als: 1 Stoeltjeklok Tafels Stoelen 1 Slaapbank 1 Staandijzcr Koper- Tin- Blik- IJzer- Glas- en Aardewerk en hetgeen meer '.il worden aangeboden. — Geen Hakblokken noch Koekdisschen zullen worden toegelaten. Het BOELGOED bij SIJBREN R. SIJBRANDIJ Boer onder Oosterend staat gebonden te worden op Woensdag den 30 April 1851  's morgens 9 uur. Te Wommels met 12 Mei 1851 voor 1 of meerjaren te huur: ! ftrtte KAMEft KEUKENTJE BLTTHUIS en SCHUUR gelegenaar.de Trek vaart te Wommels; te bevragen bij S. W. HOEKSTRA Cand.-Notaris aldaar. Te koop hij J. D. Rooda te Heeg: Twee beste nieuwe KARNMOLENS een van 3 el 553 stree- (12 vt ) en een van 2 el 980 streep (10 vt.) diameter ; eene APOTREKERS-KAST 2 el 664 streep ('J vt.) boog en breed ; een GANZENROER met percussion slot. Brieven franco.,http://resolver.kb.nl/resolve?urn=ddd:010583941:mpeg21:a0024:ocr,7,ddd:010583941:mpeg21:p007,Leeuwarder courant,1426
9776178,1851/07/21 00:00:00,3952,ddd:010060288:mpeg21:a0017,http://imageviewer.kb.nl/ImagingService/imagingService?id=ddd:010060288:mpeg21:p006:image&x=94&y=138&w=2525&h=3952,ddd:010060288:mpeg21,2619,4090,94,138,6,"Mt_t zal op Maandag  den 11 Augustus 1851 des nainid- | f^__rS dags ten vijf ure in het VENDUHUIS DEK NCTAïstISeEEN IN HE NOBE__.STF.AAT te 'sGravenhage publiek veilen en op Maandag den 18 daaraanvolgende des avonds teii zeven are aldaar finaal verkoopen: A. Het aan de Zeestraat te 's Gravenhage gelegen WII--..KMS PAStK op den kadastralen legger derzeive gemeente bekend sectie X n°. 3776 als Weiland groot 1 bunder 80 roeden 10 ellen; 3777 als Weiland groot 2 bunders 86 roeden 90 ellen ; 3778 als Weiland groot 60 roeden 10 ellen; 3779 als Weiland groot 43 roedei» 80 ellen; 3730 als Vijver groot 28 roeden ; 8781 als Weiland groot 2 bunders I roede 20 ellen; 3782 als Weiland groot I bunder 7 roeden 00 ellen; 8733 als Tuin van vermaak groot 4 bunders 53 roeden 60 ellen; 373 i als Water groot 28 roeden 80 ellen; in de grondlasten  over den jare 1331 aangeslagen tot/ 171.86. B. De nabij hetzelve Park te 'sGravenhage gelegen MATVKCJE en KKF  op den kadastralen legger dezelve gemeente bekend sectie A u°. 3797 als groot 42 roeden 70 ellen welke perceel tot deu jure 1853 vrijdom van grondlasten wegens gebouwd geniet en wegens ongebouwd  overden jare 1851 is aangeslagen met/5.70 en C. Dj na te melden aan de Oostzijde van voorschreven Willem» Park eu lor weerszijde van jjrnielde Manege staande en gelegen HUIZEN eu EB VEN met Tl INEN als: N°. I. EEN hevalt-odeß kamers en twee kabinetjes; kadastraal bekend sectie A n°. 378 S . -.root 8 roeden 60 ellen  verhuurd tot ultimo April 1832 voor ƒ 1200 'sjaars. N°. 2. EEN bevattende 3 kamer kadastraal bekend sectie A n°. 3737 groot 2 roeden Büellcn verhuurd tot ultimo April 1852 voor ƒ 500 'sjaars. N°. 3. EEN bevattende 7 kamers kadastraal bekend sectie A n°. 3738 groot 3 roeden 8 ellen verhuurd tot ultimo April 1852 voor ƒ 750 'sjaars. Ne. 4. EEN bevattende 7 kamers kadastraal bekend sectie A io. 3788. groot 5 roeden 10 elien verhuurd kot ultimo April 1852 voor ƒ 750 'sjaars. N°. 5. EEN bevattende 7 kamers kadastraal bekend sectie A ii°. 3790 groot 4 roeden 60 ellen verhuurd tot ultimo October 1851  voor ƒ 700 'sjaars. N°. 6. EEN bevattende 8 kamers eu twee kabinetjes kadastraal bekend sectie A. n°. 8791 groot 8 roeden 58 ellen verhuurd tot ultimo April 1832 voor ƒ 1200 'sjaars en een jaar oplie mits vóór 1 December 1831 decla rende. N°. 7. EEN bevattende 5 kamers; kadastraal bekend sectie A n°. 8792 groot 2 roeden 90 ellen verhuurd lot ultimo April 1852 voor / 300 'sjaars. N°. 8. EEN bevattende 7 kamers kadastraal bekend sectie A n°. 3798 groot 5 roeden 22 ellen verhuurd tot ultimo October 1851  voor'/ 700 'sjaars. N°. 9. EEN bevattende 7 kamers kadastraal bekend sectie A n°. 8794  groot 3 roeden  24 ellen . verhuurd lot ultimo April 1833 voor ƒ 850 'sjaars. N°. 10. EEN bevallende H kamers kadastraal bekend sectie A n°. 3793 groot 2 roeden  95 ellen  verhuurd tot ultimo April 1852 voor""/' 500 'sjaars. N'°. 11. EEN bevattende 8 kamers en twee kabinetjes  kadastraal bekend sectie A n°. 3796 groot 3 roeden 90 ellen verhuurd lot ultimo April 1832 voor /' 1200 'sjaars. No. 12. EEN bevattende 8 kamers en twee kabinetjes kadastraal bekend sectie A n°. 3703 groot 8 roeden 90 ellen verhuurd lot ultimo October 1351  voor/ 1200 'sjaars. N°. 18. EEN bevallende 5 kamers kadastraal bekend sectie A. n°. 3799 groot 2 roeden 96 ellen verhuurd tot ultimo \p_il 1332 voor/300 'sjaars. N°. 14. EEN bevattende 7 kamers kadastraal bekend sectie \ n°. 3800 gi-in I- 5 roeden 80 ellen verhuurd tot ultimo April 1852 voor ƒ 700 'sjaars. S°. 13. EEN bevattende 7 kamers kadastraal bekent) seeti.* \ n. 3801. groot 5 roeden 27 ellen verhuurd lot ultimo 18.12 voor /' 700 'sjaars. N°. 16. EEN bevallende 5 kamers kadastraal bekend seeti A n°. ÏBÓ2 groól 2 roeden 92 ellen; verhuurd tot ultimo April 1832 voor /' 500 'sjaars. No. 17. EEN bev at lende 8 kamers en twee kabinetjes kakaslraal | bekend sectie A n°. 8803 groot o roeden. 70 ellen; verhuurd tot ullium ipril i-':>~. voor ƒ 1200 '.-ja.ir*. N°. |8. EEN' bevallende 7 kamers kadasti aal bekend sectie A n^. 3804 «rooi i roede.! 63 ellen; verhuurd tot ultimo April 1832 vnnr  050 'sjaars. \n. 19. EEN bevattende 7 kamer» kadastraal bekend sectie A n°. 3895; gr«v' '""'• roede» 13 ellen; verhuurd tot ultimo A>iil 1832  voor /' 700 'sjaars. N°. 20. EEN bevattende 7 kamers kadastraal bekend sectie \ n\ .1306 groot 3 roeden 10 ellen; verhuurd tot ultimo April 1852 vnnr ƒ .00 'sjaars. N°. 21. EÉN bevattende 8 kamers kadastraal bekend sectie A. r\~. .807 ("".pii<i 2 roeden 32 ellen; verhuurd tot ultimo April 1852  voor / 300 's jaar.. on Ne. 22. EEN bevallende 8 kamers en 2 kabinetjes kadastraal bekend sectie A n°. 3308 groot 9 roeden 90 ellen; verhuurd tot ultimo April 1832 voor/ 1200 'sjaars: terwijl al de iv dezelve huizen aaiiwczi.-'.e kamers zijn behangen gestukadoord van stookplaatsen sommige'«iet marmeren] schoorsteenmantels voorzien en •il dc huizen overigens bevallen-de domestiekenkainers keuken met wel- en regenwater  kelder  zolder sommige derzeive m>g provisie- mansel- eu andere kamern en verdere Int fatsoenlijke woningen vereisclite office»; genietende gemelde pw.c_.en vrijdom van grondlasten ween- gebouwd te weten noi. 8 4 B 9en 11 tot den j_re 1835°»«. 126 7 8 10 12 13 14 15 16 17 18 en J& tot den jare 18-iu en n""-. 20 21 en 22 tot den ju-re 18.7; en zijnde dezelve wegens ongebouwd over tien jare til-il iv ite grondlasten aangeslagen als: r°. I niet /' 1.10 n°. niet/ t). n°. 3 met /Ü.G7 ii^>. 4 mat/ G.68 n°. i. met / 0.62 n. _ me» ƒ 1.1-i n°. 7 met ƒ 0.39 n"". 8 met/ 0.70 w°. 9 met ƒ 0.70. nc. II) met j J.-lü n°. II met ƒ 1.1- n°. IJ met/1.19 n\ r:_ met/ 0.40 n°. 14 met ƒ 0.71 n°. iö met/0.705 n°. 10 inetfO.3» tP. 17 met/ 1.16 n . 18 mot/ 0. 02 n°. 19 met/ 0.88 u°. 2i> met ƒ O.GB n°. 21 met ƒ 0.88 en n°. 22 met/ 1 *_. Het Park en de Manege _.iju le bezigtigen des Maandags Dingsdags en Vrijdags van iedere week des middags van 12 uit 4 ure en tle gemelde llukcn en Erven kunnen bezigtigd worden des Dingsdags en Vrijdags vau iedere week des middag» van 12 tot 2 un- mits wat liet Park betreft voorzien van een door na te noemen Notaris af te geven toegangbiljet (litiedaiiige ook verkrijgbaar zijn bij den Tuinman Polderdijk aan liet Nachtegaalspad te sGravenhage) en wat de Huizen aanbelangt na dat alvorens in-let tal zijn gevraagd. Nadere onderrigting te bekomen en de koop voor waarden te lezen ten kantore van den Notaris Mr. U. EY.SSi_.LL Mis.  te's Gravei.hagr. *#* Men zal op Woensdag den 80 Julij lüol  des morgens ten tien ure en volgende dagen aan liet Venduhuis der Notarissen in de Nobelstraat te 'sGravenhage ten overstaan van den Nut.ris Mr. M. EYSSELL Mz. verkoopen JAPANSCHE FRANSCHE en andere PORSELEINEN  waaronder Tafel-  Tliee- eu Dejeuner-se.---\ ie.scn  Jajiansclie Kabiiietstellen Porseleinen Albasten en Kristallen Vazen Marmeren Bronzen en andere Deelden en Groepen  Spiegels en Platen Pendules Gir.uidoles en Dranehes Cliineesrli verlakte Kamerschermen  Ebbenhoiiten en gebeeldhouwde ..asten  een Biljard twee Hiiisorgels  cene I'iaiio-l'orle Canapés Stoelen Tafels Mangel  Pers twee fraaije Deventersche Tapijten  koper-. Glas- en Aardewerk  en verdere Goederen. Alles des Maandag* eu Dingsdags vóór de verkooping te bezigtigen van des morgens it u tien tot des na middags ten tl iie me. *** OPENBARE VRIJWILLIGE VERKOOP!aG. De Notaris L. C. DYXHOORN residerende te Overschie ais last hebbende van zijnen principaal  is van meening op Vrijdag den 2o Julij 1831  des voormiddags ten 10 ure  in de Herberg de Vergulde Valk te Overschie in het openbaar te veilen en up Vrijdag den 1 Augustus daaraanvolgende mede des vooruiiddiijjs ten 10 ure ter plaatse voormeld te verkoopen: Eene kapitale  hechte sterke en bijronder goed gesitueerde BOÜWMA-SSWWXISi3*» . bestaande in WOONHUIS K.OESTALLL.G voor 60 beesten P .ARDE.NST ALLING  .V AGENSCIIUüI.  HOOIBERG ERF en WERF staande en gelegen binnen den Dorp* Overschie tegenover den Rotterdamschen Rijweg  alsmede vier partijen extra best en wel toegemaakt WEI- of HOOILAND  r__sp_.«-tivelijk gelegen iv den Nieuw- of kleinpolder en in den Boven of llot.g Zestienhovensehenpoldcr  binnen de gemeente Overschie voormeld  en le zamen i'root of veri>n;jeldeiide voor ruim 14 bunders. Alles t« anuvaarden met Kersmis van dezen jare 18.1 en dagelijks tot den dag der veiling voor ieder te bezigligen ; terwijl inmiddels nadere informatien te bekomen zijn ten kantore van boveiigenoeniden Not.ni. Dyxhoorn. *#* 0[» Maandag den 11 Ing.stnsl 851 en volgende dagen zullen in de Stads Bank van Leening alhier worden verkocht allo onafgelotte PANDEN  beleend in de maanden DisCï-MSEF- ia*. E3f JAU-JAE-IJ --SSO. Voorts wordt bekend gemaakt dat de afgifte van hel overschat der verkochte Handen beleend in October en November 1849 met hetgeen alsdan nog vttti de vroeger verkochte Panden  beleeutl sedert den 1 Junij 1848  voorhanden is beginnen zal den 20 Augustu* 18_1. • * By vonnis vau de Arrnndissementa-Rcgtbank ie sGravenhage tusschen SOPHIA MAIICLS vam VRIESLAND huisvrouw vau JACOB u_ VRIES wollende te 's Gravenhage als eischeresse en denzelvcn Jttcob de Vries Graveur mede wonende te sC.ravcnhage als gedaagde den 27 Jnnij 18-1  bij verstek genezen eu den 10 Julij daaraanvolgende beteekend is verklaard dat d.-.lvo eehlclieden zijn gescheiden van tafel en bed met al dc gevolgen dauraau door de wel verbonden. De Procureur vo .- <.:t; eischeresse geoccupeerde hebb-:i.'c. V. J. EYSSELL. I |1)1 \  dtn 19 lnlij. De Gr_.i_ul__- is rcrkocbl vnur f 27 _ / 31. niIJ.FT . dfit 17 lnlij. We B-lei 's .et-Wijt: Gra.bulcr / -'J a/33; 2uc qiu!it.-i» / 07 _. f 29 het vieid.. S c nis n * ■  d.n 18 Julij. !..„.-v.T  h^i Kederlaiidiche *»i. «t»""*lel (tisi f 14 r.n j n..dtr 'e _t-1cr.1.'|.-...'1 « ■ ' I'>--5 ' ''ei-*'"".. Btt:_?w.s»*«tï.a!i* vw Ks''_*'s-;_T_.r. Te A._STtKII»tt. '/.titiirdng. ien 19 Jlil.j IR6I. N.usio.v'tiii*.'' . u>rk. Scblild 'i.\ pCI. SR 'J ; dito 'lilt. 1844  3 pUI. C 93 ; dilt. dilo |K 44 4 'nl'.l 9*>fil Anittrtisail.^yi.di.-.oal A. pl_. lil' ; (t_nde!m_«_ltch«pph 4 pl'.t. .08-' o I 'lefti!»..' 184-4 4 pC». 89Ji A-ndt^lrn llijnt.nurwe.z 4j pi;.. tli{. |c„ Holl-nd.ehê dilt. —"": H_arlel»»eri__«l o pCI. \M%; »st«» CertifiiaSen t\ |.U. 48.; dit_ RothsL-hild '2. Nl t. 4_J  . s«J»nuUJ« ■ '.«rlihwNa 5 pl'.t. _3§ dn .i pCt bo_ ; ïSuHI i\ 4- e Coieip. 6 fCU 106* *«■> rüi.^ 105)  _M_h. „p •i brootboek 6 pt__ — Cert. «n dito t» p'l. 67j |; » ert. dH H..1...;; Ad..». . ;» „i-t _. Hg Uil 5 pCt. 95|j dnt. 1840. bg Uept en C 0*.. 4 pi... 895; <■'""> 1842  b'ü _»_.<._:_* 4 pC. 89. PaniMss. Lotaa '8112 f~ ■ _.» _it. bg Arimns _ * t. I_t dito H 510 5C1. ISfJi «-bc.-.» M« dit. d f.t. lÖ_)| C0.i. Arehn.it M_i ti.et.tve 3 pCt. 40$ s Kin-ten). 3 pCt. 3t>» : l'«»»ve / V.i ; b.i.g-«ieldr bch.ild hu roavßau. W Londen 5 pCt. 34« I -i« « . «i. 34A . -tlpCl. - ()„..;»u_ B.„k S PCt. - ; dito 4 „;.- ;MeUlek 6 Ct .8. dttt ij pCt. 40}; dit rnt_ AmrteiiUni 6 pCS 82« ; Aand. rf 500 b-J RttthschtU f _ d0 _■__• dilo 1839 f —; iY*.!_____ie Ct-mlio .I** » t»Ct. — ; dito Rothtehild _» pt_. —; I'oolschi  Aandeelen /— ; dito 1836 / K9J.",http://resolver.kb.nl/resolve?urn=ddd:010060288:mpeg21:a0017:ocr,6,ddd:010060288:mpeg21:p006,Dagblad van 's Gravenhage,2525
1890968,1851/09/25 00:00:00,1912,ddd:010979950:mpeg21:a0019,http://imageviewer.kb.nl/ImagingService/imagingService?id=ddd:010979950:mpeg21:p004:image&x=1045&y=2986&w=989&h=1912,ddd:010979950:mpeg21,2034,4898,1045,2986,4,V PAND HOLLAND vroeger MAGAZIJN «OM LEVENSMIDDELEN te jUtEWjESMAWmUH. TE BIJÏÏJB voor matigen Prijs Kioimc en Luchtige GRAANZOLDERS aan het Water gelegen. Te bevragen bij H. VAN BORK te Rotterdam. en C. METZELAAR. te Delfshaven. V OPENBARE VRIJWILLIGE VERKOOPING. De Notarissen S AND ER en PAATS residerende te Rotterdam  als last hebbende van hunnen Principaal  zijn van meening op Woensdag den 8 October 1851 des namiddags ten vief ure  in het Locaal voor Publieke Verkoopingen aan de Gelderschekade te veilen en aan den meestbiedende of eerstmijnende te vctkoopen : Een hecht sterk en zeer wel gelegen HUIS ACHTERHUIS BOYENWONINGEN KELDERS en ERVE staande en gelegen aan de nootdzijde van de Hoogstraat  op den oosthoek van en in de Naauwe Kerksttaat  te Rotterdam  oud wijk G  11.° 419 nieuw wijk 7 n.° '66  Kadaster sectie K n.s 1331 en 1332. Over anno 1851 in de Grondbelasting aangeslagen op de som van f 92. 50 en belast met eene Recognitie groot / 15 's jaars; doende in diverse Percelen aan Huur f 10(13. (30 in het jaar. Te aanvaarden 1 Januarij 1852. Nadere informatien zijn te bekomen ten Kantore van de gemelde Notarissen  aan de Hoogstraat  en zal het' te Veilene twee dagen vóór en op den dag der Veiling op de gewone uren  kunnen worden bezigtigd. De DIRECTIE maakt bekend  dat door haar zullen geveild worden te Botterdam op Donderdag den IC October lltal  des namiddags ten één ure  in dc Concertzaal in de nierstraat de navolgende hoeveelheden BIN I) R OT T I N G  als : 50865 Bossen liggende te Rotterdam 69489 dito „ „ Amsterdam met diverse Schepen regtstreeks van .lava aangebragt. De verkoop zal geschieden in Kavelingen zoo als die in de Notitie worden aangewezen. De Directie geeft de verzekering dat zij  vóór den t Maart 1852 geene andere dan de bovengemelde partijen Bindrotting aan de Markt zal brengen. De Notitlcn met de Vcilconditicn zullen in tijcl s worden uitgegeven Amsterdam den 3 September 1851. DE MONCHY President. GOUDSWAARD Directeur fungA Secretaris,http://resolver.kb.nl/resolve?urn=ddd:010979950:mpeg21:a0019:ocr,4,ddd:010979950:mpeg21:p004,Rotterdamsche courant,989
4389621,1851/07/25 00:00:00,3111,ddd:010583971:mpeg21:a0006,http://imageviewer.kb.nl/ImagingService/imagingService?id=ddd:010583971:mpeg21:p003:image&x=66&y=2157&w=1411&h=3111,ddd:010583971:mpeg21,1477,5268,66,2157,4,"Vee Hooi eu Granen. De aangaven hiervan ter inschrijving bij de Onderlinge Brand-Assurantie-Sociëteit over de voormalige Kantons Franeker Bolsward en Dronrijp moeten geschieden vóór den 1 Augustus e. k. ; waartoe gelegenheid is des Maandags in de Prins te Franeker; des Donderdags in de Wijnberg te Bolsward  en Zaturdag den 26 dezer te Balfweg ouder Dronrijp; telkens des voormiddags 10 tot 12 ure. Namen* de Gecommitteerden Achlum den 5 Julij 1851. DRAISMA db VRIES Boekh. ad int. Mr. C. WIERSMA Notaril te Leeuwarden zal op Zaturdag den 2 Augustus 1851  's namiddags 4 uur  ten huize van Tuilenera op de Bonte Koe onder Jelsum provisioneel presenteren te verkoopen: 1. Eene in den jare 1820 nieuw gestichte HUIZINGE geq. no. 48 met ruime SCHUUR VUURHUT HIEMINGE HOVINGE en verder toe- en aaiibehnoren  staande en gelegen in den hoek van den Grindweg en Corjumcropwcg Onder Cornjum  kadastraal bekend Gemeente Jelsum sectie B nos. 525 a en 5256 ter grootte 29 roede 60 el. 2.. 1 bunder 87 roede 90 el zeer uitmuntend GREIDLAND onmiddelijk aan de Huizinge aldaar gelegen  Kad. Gemeente Jelsum  sectie B  no. 526. 3. 85 roede 80 el dito GREIDLAND de Froske Ferme mede aan den Grindweg aldaar gelegen Kad. Gemeente Jelsum sectie B no. 528 eu 4. 1 bunder 78 roede 80 el best GREIDLAND mede onder Cornjum ten westen vanden Grindweg gelegen Kad. Gemeente Jelsum sectie A no. 133. Alles in gebruik bij de Wed. Johs. Simrnes Binnema  en te aanvaarden: de Huizinge c. a. den 12 Mei 1852 eu de Landerijen op den 12 November aanstaande. Conditien te vernemen en Billetten te bekomen ten Kantore van den Notaris voornoemd. De Notaris G. BAKKER in de Schrans bij Leeuwarden  zal op Zaturdag den 26 Julij 1851  des namiddags 8 uur in na te melden Herberg in het openbaar veilen en provisioneel presenteren te verkoopen : 1. Eene onlangs nieuw gebouwde HUIZINGE HERBERG en WINKEL met prompto SCHUUR STALLING en ruim ERF cumaunexis alnog ongenummerd zeer geschikt en ter nering staande en gelegen aan den algemeenen Rijdweg de Rooda Schuur onder het behoor van Augustinusga  ten Kadaster bekend gemeente Drogeham sectie C no. 568 Huis en Erf groot 13 roede 40 el. ï. Eene nieuw gebouwde HUIZINGE TAPPERIJ en KUIPERIJ mede nog ongenummerd staande en gelegen nabij voorgaand perceel aan de Surhuisterveenster Vaart onder Augustinusga kadastraal bekend als boven sectie C en behoorende tut no. 569 — nader uit te meten. 8. 47 roede best GREIDLAND gelegen als voren in sectie C nummer 569. 4. 1 bunder 28 roede 90 el best BOUWLAND gelegen onder Harkema Opeinde kadastraal als voren sectie D no. 234. 5. 1 bunder 30 roede 60 el best BOUWLAND mede aldaar kadastraal als voren  sectie D  no. 233. De perceelen sub 1  3  4 en 5  bij 3larten Pieter Boekstra en Vrouw in eigen gebruik eu het perceel sub 2 in huur bij . . ca» Sinderen ; Te aanvaarden : Het lste perceel den 12 November 1851. Het Bde 4en sde perceel na het rispen der vrucht in dit najaar en Het 2de perceel den 12 Mei 1852. Conditien te vernemen en Billetten verkrijgbaar ten Kantore van den Notaris. De Notaris J. A. SCHAAFF te Stiens zal op Zaturdag den 2 Augustus 1851 des namiddags 8 uur ten huizo van den Kastelein /'. J. Boogstra te Sliens finaal verkoopen : 11320 BOUWLAND staande met WINTERGARST ; gebod is per 36* r. /""251. 14520 DITO KLAVERLANÜ; waarop alsvoren geboden is. . ■ . -283. 183 00 DITO WEIT; waarop alsvoren geboden is -261. 14350 DITO HAVER ; waarop alsvoren geboden is -278. 22570 DITO BOON EN ; waarop alsvoren geboden is -250. 14080 DITO VLAS; waarop alsvoren geboden is -250. Alles gelegen in den Zuidhoek onder Vr. Parochie om en nabij de Huizinge duor do Wed. N. J. Andtinga bewoond. 22220 GREIDLAND aan den Hoogendijk onder Stiens ; waarop per 36J roede geboden is - 431. 08640 BOUW onder Stiens achter Sevenster's Terp staande met KOOLZAAD ; alsvoren geboden - 426. Do Bouw na het rispen der vrucht het Klaverland 1 September en de Greide 12 November e. k. te aanvaarden. VERKOOPING van BOEKEN. De Notaris A. A. LAND te Franeker zal ten verzoeke van den neer E. IPPIUS FOCKENS Boekhandelaar aldaar op Maandag den 11 Augustus 1851 en volgende dagen telkens te beginnen 's namiddags ten 3 ure ten huize van "" Soc'eteithouder de Jager te Franeker in het openbaar en naar plaatselijk gebruik ter verkoop aanbieden : bene zeer belangrijke verzameling BOEKEN voornamelijk betreffende de Algemeene- en Vadcrlandsche Geschiedenis Regtsgdeerdheid  letteren  Geneeskunde  en» ent.",http://resolver.kb.nl/resolve?urn=ddd:010583971:mpeg21:a0006:ocr,3,ddd:010583971:mpeg21:p003,Leeuwarder courant,1411
70283,1851/05/07 00:00:00,67,ddd:010072904:mpeg21:a0019,http://imageviewer.kb.nl/ImagingService/imagingService?id=ddd:010072904:mpeg21:p002:image&x=2256&y=5014&w=1049&h=67,ddd:010072904:mpeg21,3305,5081,2256,5014,4,AOTEItTEWTTgEW.,http://resolver.kb.nl/resolve?urn=ddd:010072904:mpeg21:a0019:ocr,2,ddd:010072904:mpeg21:p002,Algemeen Handelsblad,1049
2767936,1851/01/16 00:00:00,2836,ddd:010518215:mpeg21:a0015,http://imageviewer.kb.nl/ImagingService/imagingService?id=ddd:010518215:mpeg21:p004:image&x=1048&y=2075&w=976&h=2836,ddd:010518215:mpeg21,2024,4911,1048,2075,4,*** In het beste gedeelte der Stad Wijk bij Duurstede bij toeval te HUUR: Eene sedert vijf jaren nieuw gebouwde HEEREN-HUIZINGE waarin zijn: beneden 2 Kamers Keuken en Kelder; boven 2 Kamers een Kabinetje en Provisie-Kamer meest alle behangen en gestukadoord een ruime Droog- en Tjirfzolder en verder voorzien van alle Gemakken ; een lief TUINTJE met Leivruchtboomen eu een' afzouderlijkeu uitgang aau de Straat. Prijs ƒ 180. Te aanvaarden 1 Mei 1851. Te bevragen bij den Heer C. van DAM te Wijk bij Duurstede. Brieven franco. \* Den eersten Mei 1851 of vroeger is te HUUR voor ƒ 60— 's jaars: Een HUIS staande iv het midden van het Dorp de Hoeven tusschen de Dorpeu Etten en Oudenbosch  Provincie Noord-Braband waar eene Roomsche en Gereformeerde Kerk en eene School ziju. Dit Huis heeft eeue Voorkamer met eene Stookplaats en een Vertrek waardoor men vaar boven eu naar den Kelder gaat; daarop volgt de Keuken. Boven ziju twee groote Kamers. Tusschen het Huis endeSchuuriseenßleekje en des verkiezende een Buitentuin. Tot laatstleden Mei heeft er een gepensioneerd Kapitein  met een talrijk Huisgezin elf achtereenvolgende jaren in gewoond. Adres ouder Letter 11. met gefrankeerde Brieven aau de Boekhandelaars BROESE &' COMP. te Breda. '< *#* Te HUUR wordt aangebodeu: Een riant gelegeu OPTREK voorzien van alle Gemakken des verkiezende met Koetshuis en Stalling voor twee Paarden  liggende onder Bloemendaal iv de nabijheid vtfußiederode. Nadere informatien kunnen franco bekomen worden bij den Heer N. van de STADT Heerengracht bij de Korsjespoortsteeg te Amsterdam. »#* UIT DE HAND TE ROOF: Eene kapitale HOFSTEDE gelegen tusschen Leyden en Woerden met 34 a 42 Buuders WEI- en HOOILAND. Te bevragen met franco Brieven onder Letter A. bij deu Boekhandelaar G. B. van GOOR te Gouda. %* OPENBARE VERKOOPING VAN MANUFACTUREN ETC. Teu verzoeke van den Heer PIETER GEERKEGriffier van het Kantongeregt te Purmerende in betrekking als benoemd Curator in de onbeheerde Nalatenschap vau wijlen F. J. KEIJER in leven Winkelier in Manufacturen te Purmerende zal op Donderdag den 23sten Januarij 1851 des voormiddags ten 10 ure precies te Purmerende in de Peperstraat aan de Woning geteekend Sectie C. N°. 192 door het ministerie van den te Purmerende standplaats hebbenden Notaris JOHs. EIJKEN in het openbaar worden ter verkoop aangeboden: Eene partij MANUFACTUUR-GOEDEREN LEDER gemaakte LAARZEN en SCHOENEN MANSKLEEDEREN en hetgeen meerder te voorschijn zal worden gebragt. De Goederen kunnen den dag vóór dien der verkoop ten huize voormeld wordeu bezigtigd des nademiddags van 2 tot 4 ure. *** LOGEMENT te JMERSFOORT. Meu is voornemens om op Zaturdag deu 25*teB Januarij 1851 den inzet en veertien dagen later zijnde Zaturdag den Ssl(n Februarij 1851 de finale toewijzing te doen plaals hebbeu van het vau ouds bekende LOGEMENT genaamd : DE rERGULDE ZjrJAiï met STALLINGEN enz. staande le Amersfoort iv de Utrechtschestraat. Informatien zijn op franco Brieven te bekomen ten Kantore van den Notaris M . J. de LOUTER  aldaar.,http://resolver.kb.nl/resolve?urn=ddd:010518215:mpeg21:a0015:ocr,4,ddd:010518215:mpeg21:p004,Opregte Haarlemsche Courant,976
1005360,1851/01/27 00:00:00,1136,ddd:010805254:mpeg21:a0001,http://imageviewer.kb.nl/ImagingService/imagingService?id=ddd:010805254:mpeg21:p001:image&x=63&y=1069&w=885&h=1136,ddd:010805254:mpeg21,948,2205,63,1069,4,De GEDEPUTEERDE STATEN der provincie Ulrecht Maken bij deze aan de belanghebbenden bekend  dat de goedgekeurde Begrooting der enkel provinciale en huishoudelijke inkomsten en uitgaven dezer Provincie voor de dienst van 1851 in het provinciaalblad van dit jaar onder No. 8 is geplaatst; en dat daarvan tegen betaling der kosten exemplaren verkrijgbaar zijn gesteld bij de Gouvernementsdrukkers L. E. Bosch en Zoon te Utrecht Utrecht den 7 Januarij 1851. De Gedeputeerde Staten voornoemd S. van HEEMSTRA. Ter ordonnantie van Dezelven C. W. MOORREES. De persoon van Coenraad Stratemeijer laatst woonachtig te Groningen en Lucas Blankers uit de stad Wijk bQ Duurstede worden opgeroepen zich ten spoedigste aan te melden aan het Bureau der Nationale Militie en Schutterijen ten Stadhuize. utrecht den 25. Januarij 1851. Ter Ordonnantie van Heeren Burgemeester en Wethouderen der Stad Utrecht I. A. A. BAM.,http://resolver.kb.nl/resolve?urn=ddd:010805254:mpeg21:a0001:ocr,1,ddd:010805254:mpeg21:p001,Utrechtsche provinciale en stads-courant : algemeen advertentieblad,885
7282919,1851/04/29 00:00:00,5212,ddd:010072897:mpeg21:a0026,http://imageviewer.kb.nl/ImagingService/imagingService?id=ddd:010072897:mpeg21:p003:image&x=71&y=81&w=3293&h=5212,ddd:010072897:mpeg21,3364,5293,71,81,4,"UIT DE HAiNU TE KUOP: Eene BROOD- en KOEEi BAKKERIJ staande en gelegen in  een florissant Dorp in Noord-Holland. — lemand hiertoe inclinerende i adressere zich met gefrankeerde brieven onder Lett. M. bij A. BREEMAN Nieuwe Hoogstraat N°. 10 te Amsterdam. (6850) (6469) GERd. DUURING A. C. DALEN A. VAN BINSBERGEN. i J. KOLFF J. F. SAUERBIER LEONARD L. JACOBSON J. SINDER AM L. J. PLEMP VAN DUIVELAND C. SUERMONDT Ju. en J. BOON Makelaars te Rotterdam zullen op MORGEN Woensdag I 30 April 1851 onmiddellijk na afloop der aangekondigde THEE-VEILINGEN in het Notarishuis aldaar Veilen: ' 134/4 Kisten Uxim THEE gemerkt Horalio. Aanvoer 1845 liggende te Amsterdam in Entrepot. Regten ƒ 20. i (6940) P. SUBIESE en Th. J. VAN CAMPEN Makelaars zullen op Woensdag den SOsten April 1851 des Voormiddags ten 10. Ure precies voor het Huis in de Doelenstraat NB. 17 Verkoopen: Mahonijhouten en andere MEUBELEN waarbij: sierlijk bewerkt Mahonijhout Ledikant Glasbuffet Heeren- en Damestoiletten Tafels prachtige AMEUBLEMENTEN waarbij uitmunt: Een antique rijk met bloemen ingelegd garnituur van 6 Stoelen en 1 Fauteuil dito Porceleinkast en Tafel rijk vergulde Schoorsteenpendule  Candelabres Pronkvazen Lusters Lithograpbien in vergulde Lijsten met Glazen Carcellampen Speelkandelaren gebloemde New-Brusselsche en andere Tapijten exquise fluweele en neteldoeksche Staatsiegordijnen en laatstelijk eenig Japansch gekleurd O. I. Blaauw en Saksisch Porcelein. Alles behoorende tot den Inboedel van den naar elders vertrekkenden CONSUL-GENERAAL VAN FRANKRIJK. HEDEN van 10 tot 4 Ure voor een ieder te bezigtigen. (6965) Men is van meening op Dingsdag 20 Mei 1851 des Middags ten 12 <7rn ten Herberge van F. NIEÜWENHOF genaamd Landzigt onder Heemstede bij OPENBARE VEILING door den Notaris J. DOLLEMAN te Verkoopen: N\ 1. Eene kapitale Hl HSMANS- of ROEREN WONING waarin Stalling voor 24 Koeijen en 3 Paarden en ruimen Kelder met Wagenliuizen Hooiberg Karnmolen en Varkenshok mitsgaders TUIN en TEELGROND gebezigd wordende voor de Hyacinthen-Teelt; voorts met de daarbij behoorende en weltoegemaakte WEI- of HOOILAN-* DEN gelegen in den Sehouwbroekerpolder. Alles aan den anderen bijzonder gunstig gesitueerd in de Gemeente Heemstede aan den Binnenweg en deKraijencsiCrvaart nevens de Hofstede Bronslee zeer nabij de Stad Haarlem Kad. S. A. N°. 78 381 382 383 384 385 386 387 388 389 390 391 394 395 616 618 619; groot 20 Bunders 29 Eoeden 28 Ellen.— N». 2 TWEE DAGLOONEKSWONINGEN onder een Dak met ERF staande nevens de voormelde Boerenwoning Kad. S. A. N°. 613 en 614 groot 03 Roeden 22 Ellen. De Perceelen zullen eerst ieder afzonderlijk geveild tn daarna gecombineerd in slag worden gelegd. En zullen de Bewijzen van Eigendom en Veilconditien 3 dagen vóór den Verkoopdag des Voormiddags ten Kantore van den genoemden Notaris te Heemstede ter visie liggen alwaar inmiddels nadere informatien te bekomen zijn. Na afloop dezar Veiling zal worden overgegaan tot de OPENBARE VEESiIiIUR van het Stuk WEILAND gelegen tegenover de Heerenhuizing van de Hofstede Bi onstee onder Heemstede Kadastrieel groot 1 Bunder 71 Roeden 20 Ellen waarvan de Voorwaarden in voege als boven ter visie zullen liggen. (6932) P. C. DE GIJSELAAR J. MINNE en H. F. STRAATMAN Makelaars zullen op Maandag den 12den Mei 1851 op gewonen tijd en plaats Verkoopen: N°. 1. Een Hecht Sterk HUIS met afzonderlijk verhuurd wordende BOYENWONINGEN in de Kerkstraat bij de Hoogte van den Kadijk  N"". 6604. — N"". 2. Een DITO met nieuwe Voorgevel BOVEN- en BENEDENWONINGEN op de Korte Prinsengracht bij de Haai-lemmerhouttuinen O. Z. N"". 1537. — N"". 3. Een binnen weinige jaren nieuw gebouwd WTNKELUUBS met BOYENWONINGEN inde Vinkestraat bij de Dommerstraat N°. 2179. —N°. 4. Een DITO met BOYENWONINGEN in de le Tuindwarsstraat bij de Anjeliersstraat N°. 4273. — N°. 5. Een veel vertimmerd DITO in de Egelan) tierstraat tusschen de le. en 2e Dwarsstraat N«. 3702. Breeder bij Billetten. De Veilconditien zullen op den gewonen tijd ter lezing liggcn> a™: N°. 1 ten Kantore van den Notaris J. L. KABEL en N°. 2 3 4 en ö bij den Notaris H. W. CRAMER J.W.Zn. HEDEN MIDDAG TEN VW ö» «gjgS GELEERDHEID waarbij folio Bijbels mei y voor v. _ i Palm in quarto enz. overige GODGELEERHI?  WOENSDAG: EOMANSm* Bijbel en verdere Sch-? WER"" . KEN in octavo waarbij v. ~ *^___ Schriften Bijb. Magazijn Christel. Album M (7QQ7) J KONINKLIJKE AKADEMIE VAN BEELDENDE KUNSTEN. Aan de KWEEHELINGEN en LEERLINGEN wordt berigt dat de Zomer-Werkzaamheden wegens bijzondere omstandigheden eenen aanvang zullen nemen op Vrijdag den 2den Mei aanstaande en zulks op de gewone dagen en uren; wordende do KWEEKEHNGEN en LEERLINGEN met den meesten ernst uitgenoodigd zich alsdan aan het Lokaal te bevinden. (6963) Amsterdam Namens de Rand van Eestuur 25 April 1851. J°. Rfl V.:.^!- Secretaris. BELANGRIJKE VERKOOPING VAN HEESTERGEWASSSMLOEiEN TTE Aï__'_EßßPAi?_. . Op Vrijdag den 2den Mei 1851 des Morgens ten Half Elf Ure zal in het Wapen van Bern aan het Spui alhier ten overstaan van den Heer B. D. BEETS publiek worden Verkocht: Eene groote Sortering schoone eu mildblóeijende EEE! voor den Tuin waaronder vele klimmende en groen blijvende GEWASSEN enz. benevens eene rijke kwantiteit in Bloem zijnde PLANTEN. Breeder bij Billetten vermeld. Alles op Woensdag en DoxDEgDAG voor een ieder te zien. (6925) Tï? Wfl_■ f? ■ H«0000 METÖELSTEENEN van & *_. _T II _T . verschillende soort IUÜÖ Last GROVE BRIK^SJBN. Te bevragen bij den Aannemer Oude-Beursplein op het Rokiii te Amsterdam. (6991) (6935; Een JIOKfi EJUBTSCHEK zijnen leertijd voleindigd hebbende zag zich gaarne op een KANTOOR liofct in Granen handelende hetzij alhier of in cene der Provinciesteden geplaatst. Reflecterende gelieven zich met Franco Brieven onder Lett. V.D. H. Bureau Handelsblad . ■ een COMMISSIONNAIRS-KANTOOR wordt gevraagdeen '?¥ van circa 16 jarigen ouderdom voor het Loopwerk en eenige andere Kantoorwerkzaamheden. Adres Franco Lctt.Z. Bureau Handelsblad. (7022) Twee SKARTENSSAKEKSKNECHTS. hun Werk verstaande eu VAST WERK bégcerende kunnen dadelijk ceplaatst worden. Adres bij den Boekhandelaar G. D. BOM op het Water N°.3o. .JUFVROUW L. B. HEs. Gcêcrden van don 27sten dezer is mij in orde geworden en ik verheugde mij over deszeMs inhoud. Ware dezelve toestemmend geweest dan zoude ik er geene notiti"" van genomen hebben. Lk verzoek UE. dus id om nog ceneh Brief met het gewone Adres op dé bewuste plaats af te halen waarin ik UE. mijn gedrag verklaren alsook iets belangrijks mededeclcn zal. Trek Uw woord bid ik U in en kom nog eens ter op d_n afgesproken tijd. (7011) • De Onders-eteekenden hebben de Eer het Geachte Publiek te berigten' dat zij continueren met den KTTVERKOOP van ECHTE KANTEN en KANTEN GttEBEBïEN  als zijnde Kap- en Cornet-Kanten zwarte en witte Kanten  Ncigcs Blondes Mutsen  Kanten en Cuipur-lvraagjes  Manchetten Volcns van Aplication Bruxelles Slippen Benhes Demivoiles enz. alsook rijn zij nog ruim gesorteerd in antieke Kanten zijnde Point d'Alencon Point d'Angletcrre Point Bruxelles Slippen Berthes en Kraagjes.- GE3B. STADL Warmoesslraat sde Huis van de St: Jansstraat N°. 28. __ NB. Oude Ouderwetsche KANTEN alsook KERK- en KLOOSTERKANTEN worden hier tot de hoogste Prijzen Ingekocht en zonder eenige provisie getaxeerd. (6933) IA6IIIJI DE KEÏZERSKROOI. RWÈ'SiE es L'PïïSANN bebben de eer aan hunne Begunstigers en het geëerde Publiek te berigten dat hun MAGAZIJN in MANUFACTUREN op Heden VERPLAATST is van den Nieuwendijk bij den Dam naar den Nieuwendijk bij de Kapelsteeg N°. 91 zich verder in de gunst van het geëerde Publiek aanbevelende. (6960) E. il CROISSANT. Heerengraclit bij de Heisteeg: N°. 136. Heeft de eer de Dames te berigtetr dat zij uit Parijs heeft ontvangen de mÖ©EL L E 51 der KÖEÖEN en BSïJTSEN voor het SAI-OEN. (6995) ~ . Ml-KASTIIMIIS van goede ■ Getuigenissen voorzien Werk begeerende kunnen zich vervoegen bij Jt. SCStöNE_KER '-'' ■'.' ~--c_b^£A (6882) Nes N°. 87. Ty ¥¥ ¥T ¥ O LEES- en HANDBOEK voon alle STANDEN ti Ulo. uitgegeven door De eerste aflevering hiervan 80 bladz. in gr. Bvo. is voor 70 Cents en een Berigt. kosteloos alom verkrijgbaar gesteld door J. B. WOLTERS en de Erven C. M. VAN BOLHUIS HOITSEMA te Groningen. (6811) PIAI\OFOETi_- en Al UZ IJ K-MAGAZIJN en (6838. BIBLIOTHEEK van T... J. ROOTHAAN. Hofleverancier van 11. M. de Koningin iler JSederlanden enz. Opvolgervan JACOBS ECK & IEEESVRE. Te Amstekdam Singel N°. 483. In het Magazijn zijn voorhanden de volgende Werken van: En. BE ffIARTÓG op. 16. Barcarolle voor Pianoforte . f 1.40 » 17. Tarentelle Fantastique. . . » 1.80 • » 18. Fantaisic sur Don Juan . . » 2.— » 19. La Calabraise Tarentelle. . » 1.50 » 20. Poesies musicales inhoudende: _T°. 1. Chant d'Amour. . . » I.— » 2. Les Confidenccs . . » I.— » 3. LTnquiétude ...» I.— » 4. Le Retour . . . . » 1.40 » 5. Le Chant du Gondolier. » 1.40 » 6. Sur I'Oce'an. . . . » 1.40  21. Sonate Symphonie. . . . » 3.— » 22. bis L'Amorosa . ...» 1.20 Album de Chant in e'le'gauten Band . » 5.—",http://resolver.kb.nl/resolve?urn=ddd:010072897:mpeg21:a0026:ocr,3,ddd:010072897:mpeg21:p003,Algemeen Handelsblad,3293
3034436,1851/08/29 00:00:00,4805,ddd:010518405:mpeg21:a0023,http://imageviewer.kb.nl/ImagingService/imagingService?id=ddd:010518405:mpeg21:p003:image&x=105&y=66&w=2879&h=4805,ddd:010518405:mpeg21,2984,4871,105,66,4,"__Alft£-?l___L- i OPENBARE VERKOOPING""Tan __mi_É__l__M_.i t vcormah-;e hooge en vrije HEERrrrrv'rsa"":irv'___ H-o*-»""«0*-»""« l)e gezamentlyke Erfgenamen zijn voornemens op Donderdag den &m Octob. 1851 en volgende dagen telkens te beginnen des morgens teu 10 ure in het __. len'mat teT.n±f' r^P«üvelijk door de Notaris NIJHOFI'. gevestigd te Arnhem eu 8. IHIEBOUT van ZUIJDAM gevestigd te Terborg op hoogen te doen inzetten en 14 dageu daarna te wèteiop Donderdag den lüd«' dierztlfde maand en jaar eu volgende dagen terzelfder plaatse telkens te beginnen terzelfder uur bij toeslag aan de meestbiedendeu ia Percelen en Massa's te verkoopen : De voormalige hooge en vrije HEERLIJKHEID WISCH te Terborg Arrondissemt-ut Zutphen mi t uitgestrekte regten van JAGT eu VISSCHERIJ  bestaan de in: solide en ruim Kasteel met 2 antieke Torens Paardenstallen Remises Tuinmanswoning Veestallin ' gen en Schuren schoon Park met zware opgaande 800 men Vijvers Tuinen Broeijerijen  Boomgaarden Hak hout uitgestrekte Bouw- Weide- en Veenlanden  Koorn- Wind- en Rosmolens acht groote Bouwplaatsen bii al' le welke zware Eiken- en andere opgaande Boomen en Akkermaalsbosschen  vele dier Bouwplaatsen zeer „ schikt tot het aanleggen van Buitengoederen en uit"" oefening tevens van den Landbouw » alles e-elee-en „1; de Gemeente Wiscb als onder Etten - J/^IZ tnZ b-emeenten Ambt Doetinchem en Zelhem het uitlestrek te voor een groot gedeelte reeds met veel succes ont gonnen GOED DE MEINTERT en NIJMANShTi' Di. bestaande n: Jagershuis met Bosschen van nagaand eu Hakhout Pachthoeven Bouw- Weide- ... Heidegronden ; al het bovengenoemde ter 'grootte vn ongeveer 1100 Bunders; voort aanzienlijke Ti nl"" [Pootregten. ZuUende de daartoe geteekSnde op^anS Boomen vooraf terzelfder plaatse afzonderlijk worden geveild op Maandag den 29sten Sept. 1851 eu volgende dagen met regt van naasting door den Kooper van den Ondergrond. En op Woensdag den Bslen8slen October 1851 des morgens ten 11 ure op het Stations-Gebouw van den Rijn-Spoorweg te Arnhem bij inzet en 14 dagen daarna zijnde Woensdag den 22stel dier maand terzelfder uur eu plaatse  by toeslag insgelijks in Percelen en Massa's: De iv de Provincie Utrecht Gemeente Amerongen  nabij Amerougen gelegene VASTE GOEDEREN HETKOLLAND DÉSPIEGELENBERG DE LEUSDENSCHE AKKERS en HET SECRETARISBOSCH bestaande in: Bouwland Weiland Boomgaard Lanen en Bosschen vau Esschen en ander Hout Elzen Hakhout eu Rietland of Water te zamen groot ongeveer 50 Bunders met Faisanten- Jagt. Gemakshalve voor de liefhebbers zijn alle deze zeer aanzienlijke meestal rentgevende zeldzaam in veiling voorkomende Goederen nader gespecifieerd met aanduiding der Hoofd-Voorwaarden bij gedrukte Lijsten verkrijgbaar voor zooverre het getal toereikende is bij de opgenoemde Notarissen tegen betaling van 50 Cents ten behoeve vau de Armen. De Kaarten zullen respectivelijk ter visie liggen én gelegenheid ter aanwijzing gegeven worden: van de Goederen ouder Amerongeu bij den Heer Rentm. De RIDDER te Amerongen en van het Goed Wisch enz. enz. bij deu Heer HORSTING  Rentm. van Wisch op Rekkum Ambt Doetinchem eu zulks vau af den 15d™ August. na welken tijd ook voli.dige informatien hij de genoemde Notarissen en bij voorschreven Rentm*. omtrent de Titels van Eigendom en de Veilings-Voorwaarden zullen te bekomen zijn gelijk ook eerst van dien tijd af aan de voorbedoelde gedrukte Lijsten verkrijgbaar zullen zijn j alles op/ra. .Co aanvrage. De bezigtigiug van het Kasteel en Omgevingen kan vau stonden af geschieden mits voorzien van een Toegaug-Biljet door de voornoemde Notarissen af te geven. Het aanzienlijke Mobilair en de Bibliotheek  op het Kasteel enz. voorhanden zal binnen korten tijd na den toesla""; ook in het openbaar worden verkocht.",http://resolver.kb.nl/resolve?urn=ddd:010518405:mpeg21:a0023:ocr,3,ddd:010518405:mpeg21:p003,Opregte Haarlemsche Courant,2879
1265803,1851/12/04 00:00:00,1309,ddd:010518488:mpeg21:a0021,http://imageviewer.kb.nl/ImagingService/imagingService?id=ddd:010518488:mpeg21:p003:image&x=1980&y=2639&w=967&h=1309,ddd:010518488:mpeg21,2947,3948,1980,2639,4,"kieowejaars-qeschenken!'' De ERVEN LOOSJES te Haart™ dMtem __ HET HUISSELIJKE LEVEN DOOR HI.T CHRISTENDOM GEHEILIGD Vii naai het Hol duitschdoorl ZBINGLI. GB°.Z7ZE^J Een Boek ook bijzonder geschikt tot Geschenk aan dezulken die het uitmuntend Werk van Mus r__LLl_. „Pligf en roeping der Vrouw"" hebbeu gelezen. Voorts zijn bij hen te bekomen de >leuw.»e Werkjes voor Geschenken aan «le Jeugd met fraaije flaatjes; alsmede de Jaarboekfes voor 1852. E RAT O ■ lIIAtfWI-AIHAIAB ::;v! VOOR lUctl.-inbs Schooucti 1852. ** ZESTIENDE JAARGANG. Prijs ƒ 1 75. K  Versierd met GEDaiÏHTENat|eH 1? * rJ^el Sto««»r«v«re». UJiDICHTEN van de Heeren Clavarean. — AlberdUak Thym- Gewin. - Tatum Znbli. _ Wljsmaii-^Zr Schefrelaar Klots - Lublink Weddik.-Dorbeck.-£*! °™«--^-ferL-v. Someren.-Den Beer Poortuyaeï- Dr. .y/._ __fy£. — Brouwer enz. y",http://resolver.kb.nl/resolve?urn=ddd:010518488:mpeg21:a0021:ocr,3,ddd:010518488:mpeg21:p003,Opregte Haarlemsche Courant,967
3879030,1851/04/18 00:00:00,2666,ddd:010583943:mpeg21:a0016,http://imageviewer.kb.nl/ImagingService/imagingService?id=ddd:010583943:mpeg21:p006:image&x=31&y=22&w=1455&h=2666,ddd:010583943:mpeg21,1486,2688,31,22,8,»» GECOMMITTEERDEN van den POLDER van BÜÏNS WIUSÜst BA Af JUS en DRONRIJP roepen de Ingelanders of belanghebbenden van dien I DLCER op hij A. M. vas MEER .n de Herberg te Huins op Zaturdag den IJ April 1851 des namiddags ten drie ure om hunne Rekening over het verloop>-n •dienstjaar mcdp op te nemen en naar welhevinding te sluiten  en eenen nieuwen GECOMMITTEERDEN te benoemen voor den aftredende en eindelijk te besluiten <rf men die laaglanden welke nu vijf jaren bij provisie in den Polder «ijn geweest er nu va_t in op te nemen. De Gecommitteerden van den Polder T. R. WIJNIA Boekhouder. Het POLDERBFSTUUR van den Grooten Noordwolder Veenpolder in Ilemelumer Oldephaert en Noordwolde roept bij deze op alle Ingelanden in den genoemden Polder om te verschijnen op Vrijdag den 25 April 1851 des morgens te 10 uur ten huize van Hendrik Foekes van der Wal Tapper te Oudega ten einde te aanhooren een door genoemd Bestuur te doen voorstel tot het aanvragen hij het bevoegde gezag eener wijziging in het bestaande Polder* Reglement daartoe strekkende dat de verschillende kavels in dien Polder worden vereenigd tut één kavel of polder en osa alsdan deswege hun gevoelen mede te doelen. Oudega Het Polder-Bestuur voornoemd den 12 April'lBsl. E. vas ASBECK Ter ordonnantie van Hetzelve J. MEINESZ Secretaris. »e INGELANDEN van den nienw aangelegden POLDER onder Delfstrahuizen worden bij dezen verzocht bijeen te komen op Dingsdag den 6 Mei e. k. 's morgens 11 uur ten huize van D. Vlieg bij Vierhuis onder Delfstrahuizen ten einde :  19.l9. Op te nemen de Rekening der Commissie belast met die bepolder.ng; 2°. Een Polder-Contract vast. te stellen en B°. Poldermeesters te benoemen. De niet verschijnenden zullen geacht worden het gevoelen en de handelingen der meerderheid van aanwezigen te deelen en goed te keuren. Namens de Commissie W. J. v. n. MEER. Het POLDER-BESTUUR van Oostdongeradeel brengt hiermede ter kennis van dc daarbij belanghebbende Landeigenaren  dat het Kohier voor de Polderen Zijls-om.slagen  in deze Grietenij is vernieuwd en ingrrigt overeenkomstig de kadastrale grootte der Landerijen enz. ten einde vervolgens dienovereenkomstig de bedoelde omslagen to doen plaats hebben ; wordende alzoo ieder belanghebbende uilgenoodigd zijne bezwaren welke hij ten dezen mogte vermcenen te hebben vóór den 25 April e. k. schriftelijk te doen kennen en in ie dienen bij den Zijl- en Polder-Ontvanger te Metslawier ten wiens huize het bedoelde Kohier ter visie en inzage is gelegen tot en met den 25 April 1851 's voormiddags van S toi 12 uren. Namens het Polder-Bestuur voornoemd D. M. MELLEMA Boekh. SCHARVERHURIN G flan der Vijf Deelen Zeedijken Dingsdag den 22 April e. k. des namiddags ten 8 uren precies in de Herberg bij Dijkshoek  van de beweiding in 1851 van: 10 HOKKELINGSCHARREN voor 6 maanden. 4 tot den 1 Augustus. 4 ENTERSCHARREN voor 6 maanden «p het Werp of Buitenland bij Dijkshoek. Zaturdag den 26 April e. k. des namiddags ten 8 uren precies in de Herberg e Zur ich  van de beweiding in 1851 van: 20 KOESCHARREN voor 6 maanden. 24 2 op den Slaperdijk bij Znrich en de landen in de Zuricher Bird. Geen Hoorn vee zal op deze Scharren worden aangenomen afkomstig van Stallen of uit Weiden in welke gedurende dit of het vorig jaar de Longziekte heeft geheerscht. Op den 26 April e. k. zal te Zurich nog verhuurd worden de VISSCHERIJ in de Dijksvasrt van Sottrum tot aan Steen 57.,http://resolver.kb.nl/resolve?urn=ddd:010583943:mpeg21:a0016:ocr,6,ddd:010583943:mpeg21:p006,Leeuwarder courant,1455
1187973,1851/07/08 00:00:00,621,ddd:000020036:mpeg21:a0052,http://imageviewer.kb.nl/ImagingService/imagingService?id=ddd:000020036:mpeg21:p004:image&x=2062&y=3924&w=1913&h=621,ddd:000020036:mpeg21,3975,4545,2062,3924,4,"LONDONER-AUSSTELLUNG. LE- PALAIS DE CRISTAL. ILLUSTRIRTE ZEITUNG der GROSSEN LONDONER AUSSÏKLLUNG; erschcint 1 mal wöchentlich wabrend der ganzen Exposilion die nngefahr 6 Monate dauern wird. Die Zeitung enthiilt 16 Druckseiten in deffl Format der Französischc Illustrafion. — Abonnemcnts-Prcls : 25 Francs. Diese Zeitschrift von einem Französischen Comité redigiH erscheint unter dein Schutze der Französische Commission und besehaftigt zich hauptsacblich met der Exposition; sic wird Dessins alles dessen bringen was die Ausstellung interessantes hat. Ein Abonnement dieses Elattes kan denjenigen welche durch Geschafte zurückgehalten die Reise nach Londen ersetsen. Die Collection der vcrscliiedenen Numinern wird einen schonen illustrirten Band bilden welche ein treuen Spiegel dieses grossartigen Unternelijnens sein wird. Ausstellcr welche sich auf das „PALAIS DE CRISTAL"" abonniren haben 15 Linien Insertionen frei. Man abonnirt in ganz Deutschland in den Post-Bureaux; in Paris bei GEBRiiDER SUSS Place de la Bourse 31  sowic bei der Compag. Centrale d'Annonces 20 Rue dc la Banque. _^ (3341)",http://resolver.kb.nl/resolve?urn=ddd:000020036:mpeg21:a0052:ocr,4,ddd:000020036:mpeg21:p004,"Nieuwe Rotterdamsche courant : staats-, handels-, nieuws- en advertentieblad",1913
2276862,1851/03/02 00:00:00,2357,ddd:000019898:mpeg21:a0040,http://imageviewer.kb.nl/ImagingService/imagingService?id=ddd:000019898:mpeg21:p004:image&x=2041&y=110&w=966&h=2357,ddd:000019898:mpeg21,3007,2467,2041,110,4,jjgfe Openbare Vrijwillige i££2» VERKOOPING. De Notaris JAN VAN DER HOOP JAC.Zn. residerende te Rotterdam als lasthebbende van zijne Principalen  is voornemens om op Woensdag den 19den Maart 1851  des namiddags ten 4 ure in het Locaal van Publieke Verkoopingen  aan de Geldersche Kade aldaar  in het openbaar te veilen en te verkoopen: No. 1. Een hecht sterk en wel gesitueerd HUIS BOYENWONINGEN en ERVE staande en gelegen aan de noordzijde van de Prinsenstraat te Rotterdam wijk 9 No. 141  kadaster Sectie L No. 136. Aangeslagen in de grondbelasting over 1851  tot / 26.68. Verhuurd in diverse Perceelen tezamen voor f 332 in het jaar. No. 2. Een hecht en sterk HUIS  BOYENWONINGEN en ERVE  staande en gelegen aan de Doelsloot aan het Haagsche Veer te Rotterdam  wijk 6  No. 393 kadaster sectie I No. 101. Aangeslagen als voren tot/23 62. Verhuurd in diverse Perceelen te zamen voor f 250 in het jaar. No. 3. Een wel aangelegden TUIN met exquise Vrucht- en andere Boonien en vele Gewassen KOEPEL en ERVE  hebbende een bijzonder fraai Uitzigt over den Goudschen Rijweg en in den Wafellaan  gelegen en staande op den Hoek der Mannenlaan en aan den Goudschen Rijweg te Rotterdam wijk 13 No. 359 kadaster sectie E Nos 11 12 13 14 15 e i 16. Aangeslagen als boven tot/ 21.31. Kunnende dadelijk worden aanvaard. No. 4 Een wel aangelegden TUIN met deszelfs Bepoting en Beplanting  HUIZING  voorzien van vele Gemakken  KOEPEL en ERVEN genaamd Welgelegen  geschikt voor Zomer- en Winterverblijf gelegen en staande in de Tuinderslaan  te Rotterdam wijk 15 No 63 kadaster sectie B No. 2344 geheel en Nos. 1092 en 2343  beide gedeeltelijk. Aangeslagen als boven tot /14 90. Kunnende dadelijk worden aanvaard. Inmiddels zijn nadere informatien te bekomen ten Kantore van den genoemden Notaris en zullen de' te veilen Perceelen twee dagen vóór en op den voormiddag van den dag der veiling kunnen worden bezigtigd mits voorzien zijnde van Permissie-Biljetten daartoe door den gezegden Notaris af te geven. (1301) VERKOOPING van MEUBELEN HUISSIERADEN enz. VAN MARLE en DE SFLLE zijn van meening  ten overstaan van de Notarissen DALEN en LAMBERT op Vrijdag den 7den Maart 1851 op de gewone uren aan het Venduhuis aan deVlasmarkt te Rotterdam publiek te verkoopen: gemaakte JUWEELEN gemaakt GOUD en ZILVER PORCELEIN GLAS en VERLAKTWERK gemaakte LIJNWADEN KLEEDEREN BEDDEN DEKENS MEUBELAIRE en andere GOEDEKEN KOPER TIN enz. daags te voren van 10 tot 4 ure voor een ieder te zien. (1315),http://resolver.kb.nl/resolve?urn=ddd:000019898:mpeg21:a0040:ocr,4,ddd:000019898:mpeg21:p004,"Nieuwe Rotterdamsche courant : staats-, handels-, nieuws- en advertentieblad",966
3301392,1851/09/05 00:00:00,2616,ddd:010786731:mpeg21:a0011,http://imageviewer.kb.nl/ImagingService/imagingService?id=ddd:010786731:mpeg21:p005:image&x=1342&y=97&w=1262&h=2616,ddd:010786731:mpeg21,2604,2713,1342,97,6,"reaux van het Grootboek der Nationale Schuld gevestigd te Amsterdam te weten: Op het Vijfde Bureau: Voor de kapitalen ingeschreven onder Letters A tot en met K. Op het Zesde Bureau : Voor de kapitalen ingeschreven onder Letters L tot en niet Z. 's Gravenhage  den i2den Augustus iBsi. De Minister voornoemd Van Bosse. V De Militaire Intendant belast met het toezigt over de Garnizoens- Bakkerij te 's Gravenhage brengt bij deze ter kennis van de daarbij belang hebbende dat doorhem op Woensdag den Zeventienden September iBsi des middags ten twaalf ure ten zijnen Burele Lange Beestenmarkt Wijk V N°. 388  Publiek zal worden Aanbesteed de Leverantie van : Zes Lasten Jarige Roode Tarwe  Zes dito dito Zeeuwscbe Tarwe Drie dito dito Zeeuwscbe Rogge ; Zullende de Voorwaarden  waarop voorschreven Aanbesteding zal geschieden  van heden tot den dag van Aanbesteding ter lezing liggen zoowel op het Bureau van hem Intendant als in voornoemde Garnizoens- Bakkerij  van des morgens tien tot des middags twaalf ure. 's Gravenhage den 4den September iBsi. De Militaire Intendant W. Craau. NEDERLANDSCHE HANDEL-MAATSCHAPPIJ. %* De Directie maakt bekend dat de Specerij-Veiling der Maatschappi van iBsi zal gehouden worden te Amsterdam op Donderdag den gden October iBsï en bestaan uit de volgende hoeveelheden : 996 Vaten Notenmuscaat liggende te Amsterdam; i' 339 » dito » » Rotterdam; 375 11 Foelie » » Amsterdam; 462 11 dito i' "" Rotterdam; gB3 n Amboina-Kruidnagelen »' ' » Amsterdam; 354 dito » » Rotterdam; 97cw' 1 Fardeelen Java-Kaneel » » A.rnt'rdam; 6 Zakken dito » » idem; 657/ i Fardeelen dito » » Rotterdam; 9 Zakken dito » » idem; 3849 Balen Peper » » Amsterdam; 252 i 11 dito » » Rotterdam; 31 Kisten Nolenzeep » » Amsterdam; 23 » dito » » Rotterdam; ."" "" _ „ . \ Kancel-Olie » » Amsterdam. inhoudende 125 flesschen J De Verkoop zal geschieden bij Kavelingen: de Notenmuscaat Foelie en Kruidnagelen elk van twee Vaten — de Kaneel Peper Notenzeep en Kancel-Olie zoo als die bij de Notitien zullen worden aangewezen. De Directie geeft de verzekering dat zij voor den 1 sten September i 852 geene andere dan de bovengemelde Specerijen zai aan de Markt brengen. De Monsters zullen op Donderdag den aBsten Augustus e. k. verkrijgbaar zijn en de Notitien met de Veilconditien in tijds worden uitgegeven. Amsterdam 18 Augustus iBsi. De Mokght President. Goudswaard Directeur loco Secretaris. V* Commissarissen van den Straatweg tusschen Rotterdam en Hillegersberg zullen op den I7den September iBsi des namiddags ten vijf ure in de Herberg het Wapen van Holland te Hillegersberg ten overstaan van den aldaar gevestigden Notaris van den Berg in het openbaar Aanbesteden : Het Bestralen van 22 Boeden 6 Ellen Weg. Nadere Inlichtingen zijn te bekomen ten Kantore van genoemden Notaris.",http://resolver.kb.nl/resolve?urn=ddd:010786731:mpeg21:a0011:ocr,5,ddd:010786731:mpeg21:p005,Nederlandsche staatscourant,1262
24244,1851/06/08 00:00:00,58,ddd:010152775:mpeg21:a0012,http://imageviewer.kb.nl/ImagingService/imagingService?id=ddd:010152775:mpeg21:p004:image&x=430&y=3161&w=418&h=58,ddd:010152775:mpeg21,848,3219,430,3161,4,3frtftt?tctttf'ctt,http://resolver.kb.nl/resolve?urn=ddd:010152775:mpeg21:a0012:ocr,4,ddd:010152775:mpeg21:p004,Bredasche courant,418
2658690,1851/05/06 00:00:00,2061,ddd:010786213:mpeg21:a0012,http://imageviewer.kb.nl/ImagingService/imagingService?id=ddd:010786213:mpeg21:p004:image&x=169&y=135&w=1290&h=2061,ddd:010786213:mpeg21,1459,2196,169,135,4,"DEPARTEMENT roon db ZAKEN oèb ROOMSCH-KaTHOLÏJKB EEREDIENST. De Minister van Bnitenlandsche Zaken voorloopig belast met het Bestuur van het Departement voor de Zaken der Roomsch-Katholijke Eeredienst herinnert bij deze de Belanghebbenden dat de termijn  tot het indienen van de vorderingen ten laste van het zoo even genoemd Departement over het jaar iBso volgens de wet van den Bsten November iBis (Staatsblad n°. si) met den 3os(e»i Junij aanstaande zal zijn verstreken  en dat alle Schuldvorderingen welke niet voor dat tijdstip zijn ingediend zullen worden gehouden voor verjaard en vernietigd. 's Gravenhage den isten Mei iBsi. De Minister voornoemd Van Sonsbeeck. MINISTEBIE VAN OORLOG. ** De Minister van Oorlog belast ad interim met het bestuur van het Departement van Marine brengt bij deze ter kennis van alle Officieren  Ambtenaren en verdere belanghebbenden dat alle stukken requesten enz. betreffende de zaken der Marine voortdurend moeten worden ingezonden onder het adres : » Aan het Departement van Marine"" ; en bijaldien dezelve van geheimen inhoud of persoonlijk voor hem Minister zijn bestemd zal terzijde op het adres dienen te worden gesteld het woord Geheim  of: Voor den Minister. 's Gravenhage den 2isten April iBsi. De Minister voornoemd Van Spengi.er. openbare aanbesteding. Eerste Fortificatie-Inspectie. — Utrecht. Ingevolge magtiging en onder nadere goedkeuring zal door den Eerstaanwezenden Ingenieur te Utrecht in het openbaar worden Aanbesteed : Het doen van Herstellingen aan Metsel- en Timmerwerken van de Lunetten op de Houtensche Vlakte bij die stad. Deze Aanbesteding zal geschieden Vrijdag den i6den Mei iBsi  des voormiddags ten elf ure in het Koffi|huis de Nieuwe Bak te Utrecht; alwaar het Bestek van den achtsten Mei ter lezing zal liggen. Inlichtingen zijn te bekomen bij den Eerstaanwezenden Ingenieur te Utrecht. OPENBARE HERBESTEDING. De Eerstaanwezende Ingenieur te Grave zal onder nadere goedkeuring vanden Minister van Oorlog in het openbaar Herbesteden: i°. Het Eenjarig Onderhoud van 's Rijks Militaire Gebouwen en Metsel- en Timmerwerken te Grave; 2°. Het Eenjarig Onderhoud van de Fortificatie-Aardewerken aldaar. Deze Herbesteding zal geschieden den Bsten Mei iBsi des morgens ten elf ure in het Logement de Eenhoorn te Grave alwaar vanden isten Mei de Bestekken zullen liggen. Inlichtingen kunnen worden verkregen bij den Eerstaanwezenden Ingenieur te Grave.",http://resolver.kb.nl/resolve?urn=ddd:010786213:mpeg21:a0012:ocr,4,ddd:010786213:mpeg21:p004,Nederlandsche staatscourant,1290
2205700,1851/03/25 00:00:00,2300,ddd:010518273:mpeg21:a0019,http://imageviewer.kb.nl/ImagingService/imagingService?id=ddd:010518273:mpeg21:p003:image&x=1033&y=1423&w=959&h=2300,ddd:010518273:mpeg21,1992,3723,1033,1423,4,"%* In eene der Steden van Zuid-Holland vraagt men tegen I°. Mei aanstaande als BEDIENDE 'meene Droogistdffaire: Ecu Jongeling niet beueden de IC jaren oud /an de Protestantsche Godsdienst. Van goede getuig■ichrifteu voorzien  adressere men zich met ƒ?•«»_) Blieven  ouder Let. M bij den Boekhandelaar J. B. van LOGHEM Jr.  te Haarlem. *#* ER WORDT GEVRAAGD ' bij eenen Genees- Heel- en Verloskundige ten Platten Lande iv de Provincie Utrecht: Een fatsoenlijk JONGELING uiet beueden de vijftien jaren om zich te bekwamen in de genoemde vakkeu tegen betaling van twee honderd Gulden 'sjaars voor Kost Inwoning en het Onderwijs. Men gelieve zich met gefrankeerde Brieven te adresseren onder de Letts. H. G. bij den Boekhandelaar B. DEKEMA te Utrecht. *** lEM.\ND het Receptereu kundig wenschte geplaatst te worden bij een' Stads-Chirurgijn of Plattelands- Heelmeester in de nabijheid eener Clinische School alwaar gelegenheid bestaat die te bezoeken. Adres met franco Brieven onder Letter A. bij den Boekhandelaar A. M. E. van DISHOECK te Zierikzee. *** Op een; aangenaam vrolijk aan den Straatweg en Trekvaart gelegen Dorp in de Provincie Utrecht bestaat voor een fatsoenlijk jong Mensch of voor iemand het Buitenleven verkiezende eu ziju' ledigen tijd nuttig en aangenaam wenschende te besteden bij een' Ontvanger der Rijks Accijnsen aan wiens Kantoor meerdere admfuistratiën zijn toegevoegd de gelegenheid tot opleiding zoowel bij het administratieve als in verband eener practische beoefening van het KOOPMANS- of ITALIAANSCH-BOEKHOUDEN. Een en ander tegen tegemoetkoming op nader te bepalen voorwaarden. Adres met franco Brieven onder Lett. X. Y. Z. bij de Boekhandelaars A. F. BLANCHE & Cow.. te Utrecht. *„* Iv eene der voornaamste Steden vau Overijssel verlangt meu  iv eene Tabaks-A faire tegen 1 Mei: Ecu LEERLING van de H. Godsdienst om in genoemd vak te worden opgeleid. Adres franc o onder Letter K. hij deu Boekhandelaar D. J. WjLTERDINK te Deventer. V Een fatsoenlijk JONGELING"" van de lI.IT/m. 21 jaren sedert twee jaren in den Boek- en Papierhandel Bindertj en Lmïéerfabrijk werkzaam geweest ziinde en later voor eenen nitge.reiden Boekhandel eene reis naar België en in ons Land gedaan hebbende za- zich KJ ffr™ef±B""llitMude' als *«ikomend BEDIENDE of REIZIGER geplaatst kuuneude vau zit gedrag eu sohditeit de beste getuigenissen produceren Brieven franco onder Lett. 8. bij deu Boekh.TJEENK WILLINK te Zwolle. v ****«& V Met Mei vraagt fegen ruim L ift der voornaamste Logementen van de Provincie Overijssel ; Een lllllisl-NlaClll en eeue bekwame KEUKENMEID. Adres met franco Brieven onder Lett. Z bij den Boekh. J.A.C. van der MEER te Deventer.",http://resolver.kb.nl/resolve?urn=ddd:010518273:mpeg21:a0019:ocr,3,ddd:010518273:mpeg21:p003,Opregte Haarlemsche Courant,959
2842327,1851/07/03 00:00:00,2591,ddd:010072957:mpeg21:a0025,http://imageviewer.kb.nl/ImagingService/imagingService?id=ddd:010072957:mpeg21:p004:image&x=2263&y=87&w=1097&h=2591,ddd:010072957:mpeg21,3360,2678,2263,87,4,"VAN AMSTERDAM NAAR BATAVIA zal inden loop dezer Maand Vertrekken: Het Snelzeilend Campagne BARK-CHIP GELDERLAND Kapt. H. DE WIJN varende eenen GE'èXAMINEERDEN DOCTOE. en zijnde uitmuntend ingerigt voor Passagiers. Adres voor Goederen en Passage bij G. W. VAN BARNEVELD KOOYi U-Gracht N°. 25. (10657^ CORK STEAIVI SHiP COMPANY. ROTTERDAM EN LIVERPOOL in directe verbinding met de stoomschepen naar N E W-YORKenBOST©** | Het nieuw gebouwd en snelvarend STOOM-SCHROEFSCHSr! GANNET Kapt. D. SULLIVAN Vertrekt van ROTTERDAM naat LIVERPOOL Dingsdag 8 Julij. VRACHT Iste Kajuit £ 1.5.0. Nadere informatien bij de Agenten Ph. VAN OMMEREN te Kotter- I dam en W. WILSON & SON te Liverpool. (10627) TfïfiMl 1 AffIWEM. AMIGITIA. (10263) DAGELIJKSCHE DIENST. Van Rotterdam. Van Antwerpen. Vrijdag 4 Julij _Morg.lO_- ure. Vrijdag 4 Julij 's Morg. 2§ ure>; Zaturdag 5 > » 11 » Zaturdag 5 » » 3_. » Maandag 7 » 's Nachts 1 » Maandag 7 » » 5. » j (tusschen 6en 7 Julij.) Dingsdag 8 » » 6_ » I Dingsdag 8 » 'sMorg. 2_ » Woeusd. 9 » » 7 » Woensd. 9 » _ 3 > Adres bij JOH. OOMSEz. & C. Boompjes 1.23 en Wolfshoek 2. 286. . ""jfcfes- HARDDRAVERIJEN K^|*f% TE WADDÏNXVEEN. -S-3-^-tS-VSSrr Op Vrijdag den Uden Julij 1851 des Voormiddag! ten 10 Ure door Paarden die nog nimmer een Prijs gewonnen hebben en des Namiddags ten 3 Ure door Paarden die van Zessen klaar zijn. Alles bij Biljetten breeder omschreven. (10279) _ j Bij A. HOOGEJNBOOM Boekverkooper in de Reestraat ziet heden het licht: De tweede vermeerderde Druk van A. L. BOESER EERSTE REKENBOEKJE Verzameling van Voorstellen ter toepassing van de Hoofdreg. van geh. ben. Getallen U ƒ 0.12 J. Het groot debiet van dit in den smaak van vele HH. Onderwijzers vallende Werkje maakte een 2den druk binnen het jaar noodzakelijk ofschoon de oplage van den lsten druk vrij aanzienlijk was. Het 2de Rekenboekje van denzelfden Schrijver wordt ook met goed succes gedebiteerd. (10581) W-ïffiITVOOU6ENEESKIINDI6B ERVARING. Daar het 2de Nommer van dit voor eiken Practiserenden Genees- . Heel- of Verloskundige zeer belangrijk Tijdschrift hetwelk zich zoo geheel onderscheidt van de overige in ons Vaderland verschijnende Ge' neeekundige Schriften ter Perse ligt worden zij die zich op hetzelve zouden willen Abonneren ten dringendste uitgenoodigd zich ten spoedigste aan den Uitgever of aan mij hetzij onmiddellijk hetzij door hunnen Boekhandelaar of Postkantoor te adresseren ten einde zoo noodig de . oplage daarnaar te kunnen regelen. Dit Tweede Nommer zal door de daarin geplaatste beschouwing over den toestand der THERAPBIE gelijk die thans is en niet behoorde te zijn niet minder dan het Eerste de aandacht verdienen van hen die zich nog met Practische Geneeskundige Studie bezig houden. (10598) A-BT--DAM 1 Julij 1851. J. S. DE HAAS Boekhandelaar. (10505) Door DANNENFELSER en DOORMAN te Utrecht is uitgegeven : DB AFBEELDING GEGOSTDHEERDER OPTOGT. gehouden op 25 Junij jl. door HH. Studenten der Utrechtsche Hoogeschool  bestaande in Acht keurig geteekende Platen en eene uitmuntend gegraveerde VERZAMELPLAAT. Prijs: Zwart/9 Gekleurd/12. DE VERZAMELPLAAT AFZONDERLIJK ƒ 1. Voorts: ACHT ZANGEN BIJ DE MASKERADE door A-J*. C.K.IÏE-HEHL Medisch Student Opgedragen aan Utrechts Schoonenf 0.50.",http://resolver.kb.nl/resolve?urn=ddd:010072957:mpeg21:a0025:ocr,4,ddd:010072957:mpeg21:p004,Algemeen Handelsblad,1097
24054,1851/05/18 00:00:00,57,ddd:010152769:mpeg21:a0012,http://imageviewer.kb.nl/ImagingService/imagingService?id=ddd:010152769:mpeg21:p004:image&x=425&y=1713&w=422&h=57,ddd:010152769:mpeg21,847,1770,425,1713,4,Slime trtenttcn.,http://resolver.kb.nl/resolve?urn=ddd:010152769:mpeg21:a0012:ocr,4,ddd:010152769:mpeg21:p004,Bredasche courant,422
1938604,1851/11/22 00:00:00,2011,ddd:010518478:mpeg21:a0015,http://imageviewer.kb.nl/ImagingService/imagingService?id=ddd:010518478:mpeg21:p003:image&x=1025&y=84&w=964&h=2011,ddd:010518478:mpeg21,1989,2095,1025,84,4,"I *#* Men verlangt voor eene Burgerschool eenen ONDERMEESTER van den 3<>™ Rang Pr. G. mede geëxamineerd voor de Fransche Taal; tegen Kost Inwoning Bewasschen enz. en ƒlOO- Salaris. Adres met franco Brieven  onder Letters P. H. aan den Boekhandelaar H. LAGERWEY te Dordrecht. *** J. BARNOUW openbaar Onderwijzer te Rozenburg Z. H. vraagt ten spoedigste op billijke voorwaarden : Eenen ONDERMEESTER van eenigen Rang. Brieven franco. *** In eene Stad in N.-Holland verlangt men voor eene School van 25 a 30 Externes en zonder Avondschool : Een beschaafd JONGELING van den 2** of ■3Ae"" Rang die een goed Rekenaar zij eene grondige kennis van de Fransche Taal bezit en niet onervaren is in het Engelsch of Hoogduitseh. Brieven franco onder de Letter R. nan de Heeren GEBR. BELINFANTE Boekhandelaars te 's Gravenha^e. ** In eene Apotheek waar theoretisch en praktisch onderrigt gegeven wordt vraagt men een LEERLING of lemand die eenigen tijd in de Apotheek is werkzaam geweest en zich wenscht te bekwamen ook is er gelegenheid tot onderrigt in de Genees- Heel- en Verloskunde. Rrieven franco onder Letter P. bij S. ALTER Boekhandelaar Lijnmarkt te Utrecht. *** EenCANDIDAAT^NQTARIS tevens bekend met de werkzaamheden van een Gemeentebestuur ruim acht laren op een en hetzelfde Kantoor werkzaam geweest en van goede getuigschriften voorzien wenschte gaarne op een Notarieel- of Administratief-Kantoor te worden geplaatst. Adres franco Brieven onder Letter X. bij den BoekverkoopCTßjL SCHEURLEER te 'sGravenhage. *** Op een Buiten in de nabijheid van 'sllertogen- StoÏ'^ men' om dadeliJk & dienst te treden: Een R-UüiMJiR van de Hervormde Godsdienst goed met twee Faarden kunnende rijden en tevens in staat om Huiswerk te verrigten Tafel te dienen  enz. Alleen zij die van goede getuigschriften voorzien zijn kunnen in aanmerking komen. Adres onder.Letter Z. bij GEBR. MULLER Boekhandelaars te 's Hertogenbosch. Brieven franco. "" % i 1 cc"" zeer talrÜk Huisgezin verlangt men tegen bebruanj aanstaande eene fatsoenlijke JUFVROUW van de Protestantsche Godsdienst gewoon aan het volledig behandelen der Wasch en bekwaam in Mazen en Naayen. Men wordt verzocht zich te adresseren met gefrankeerde Blieven onder Letters A. 8. aan de Boekhandelaars A. F. BLANCHE en COMR te Utrecht.",http://resolver.kb.nl/resolve?urn=ddd:010518478:mpeg21:a0015:ocr,3,ddd:010518478:mpeg21:p003,Opregte Haarlemsche Courant,964
3690612,1851/09/25 00:00:00,3307,ddd:010073037:mpeg21:a0023,http://imageviewer.kb.nl/ImagingService/imagingService?id=ddd:010073037:mpeg21:p004:image&x=54&y=1149&w=1116&h=3307,ddd:010073037:mpeg21,1170,4456,54,1149,4,"_>fll' '_""..-Q __i> Is het Nommer dat getrokken heeft de TWEE GE' !* ''{OO BREIDE OEK.E_._S welke te bekomen zijn bij den ij- w w Heer HENRY NORD Coiffeur Salon de la Renaissance !c« ;hbrandtsplein N. 87. "" ..'r. Ondergeteekende betuigt langs dezen weg het Geëerde Publiek •' \\t-.n hartelijken dank voor de veelvuldige gunst hem gedurende deze itais te beurt gevallen; hij twijfelt niet of de soliditeit zijner Goede-1 -Ji -it-zal hem tot verdere aanbeveling «trekken. ï4991) DE BOER. P~~ DAGUERREOTYPE ORÏRETTEN. LAATSTE VERBETERING (1851). Gekleurd of Zwart — Frappante Gelijkenis — Nette Afwerking. — Billijke Prijzen ■— Gemaakt door: EDUARD FKANCOIS. BOTERMARKT J_- 29 bjj de Reguliers-Dwarsstraat. — Uitmunde Schoone »;« DAGUERREOTYPE TOESTELLEN. r- xVaarbij er zijn die van op de Tentoonstelling te Londen. — Bijzon/ * muntten deze uit door hunne Glazen (objectifs). Des verkiezende het . 'i/(>ndig Onderwijs er bij. — Brieven Franco. (14706) . MAGAZIJN VAN PIANO'S .'i-1—- bij ZWEERS _ C°.  .lverstraat by de Munt 128 Amsterdam; op nieuw ontvangeneenige i;i/•.*__■__©_» uit de voornaamste Fabrijken. (15003) . -tr '———— ————— . . I%ro Êi }-* ude Winner. De Houder van gemeld Nommer kan  ![\ A JTk tegen vertoon van hetzelve het SCHILDERIJ. ontvangen ten Huize van den Ondergeteekende rfttke zich verder minzaam in de gunst van het Geëerd Publiek recomt i £ndeert. M. H. VAN HASSELT Hoofd-Depothouder van Inlandsche ' 't-i' Gebreide Goederen Spui Wijk 5 N\ 391 Rotterdam. :'J i '""Ifc Geene RONDVENTERS van deze Fabriek loopen langs de : > i y Huizen. (15004) 'j !""_en Fatsoenlijk JONGELING 21 jaren oud vier jaren op een ■('ANTOOR werkzaam geweest zijnde met de Fransche en Duitsche alsmede met het Koopmansboekhouden bekend en de beste in! kunnende produceren wenschte gaarne op een KOOPMANS[i_ANTOOR geplaatst te worden. Adree onder Lett. A. S. bij de Boek..'. _delaars J. H. GEBHARD fr C\ Leliegracht by de Keizersgracht ;ji\ p. 16. (14994) !})'s_ G. VAN IJSENDIJK H. KNOOPS J. OTTERBEEK A. J. ]:K VAN WAIJENBURG A. A. VAN WAIJENBURG en A. L. I•!. |_.N IJSENDIJK Makelaars zullen op Dingsdag den 30sten Sepj|' :piber 1851 de» Avonds ten 6 Ure in de Witte Zwaan ten overstaan Ijn een daartoe bevoegd Beambte aan de Meestbiedende presenteren te irkoopen: 14 BOTEN KRENTEN.  108 VATEN ROOD ROZIJN. 50 KISTEN GECONFIJTE GEMBER. ïif. En 100 KISTEN GENUA OLIE. ' i. Liggende als nader bij Notitie zal worden aangewezen. (14827) ■ f OPENBARE VEILING VAN SCHILDERIJEN 'rider Directie van H. J. VAN WISSELINGH Kunsthundelaar 'ifslke ten overstaan van den Heer J. GOLDSMIT Deurwaarder zal Orden gehouden op Vrijdag den 26» ten September 1851 des Middags ■ ;Vn 12 Ure in de Bovenzaal van het Logement Hof van .Berfyn N"". 4 ' _• het Water alhier alwaar de SCHILDERIJEN tot den Verkoopdag .n 10 tot 4 Ure des Namiddags en des Avonds van 7 tot 10 Ure Voor 1 _n ieder te zien zullen zyn. (14951) 'r( . -LA. B. VAN DER VIES Makelaar zal op Dingsdag 21 October 1851 •Jss Morgens ten 10 Ure in den Brakken Grond te Amsterdam Ver'-bopen: Eene Partij TAPIJTGOEDEREN waaronder de Goederen tit het Magazijn van den Heer J. H. SMAALE Jimion welke door of i' m gevolgen van de Brand op 4 September 1851 (ontstaan in het aan 1 'ienoemd Magezijn belendend Perceel) zijn beschadigd geworden be'Jjatande in Deventer Smirnsche Gevelouteerde Engelsehe en Schotschc ""'iAPIJTEN Gedrukte Jaspe' en Hairen VLOERKLEEDEN Vene;.laansche en Jiispé LOOPERS Schotschc Wollen en Hairen KARPETTEN Smirnsche en Gevelouteerde HAARD- en SOPHAKLEEDJES ' i'afelkleeden Meubel-Damasten enz. Breeder bij Notitie te bezigtigen i':!aturdag 18 October en volgende Dagen alsmede op den Verkoopdag 'a den Brakkan Grond. (15002) r;""( A. B. VAN DER VIES Makelaar zal op Dingsdag2l October 1851 ii Morgens ten 10 Ure in den Brakken Grond te Amsterdam Veri-oopen! Eene PARTIJ WOLLEN KATOENEN LINNEN en __.._._.-_ -MANUFACTUREN in diverse Sorteringen. Breeder bij (2otitie te vermelden en daags vddr en op den Verkoopdag in den \f3rakken Grend te zien. (1*001) i V (13769) P. L. POSTHUMUS en J. J. BOLDOOT Makelaars zullen (^p Dingsdag den 30sten September 1851 des voormiddags ten 10 ure. _ het Lokaal voor Publieke Verkoopingen door Notarissen genaamd i iet Oudezyds Heeren-Logement ten overstaan van den Notaris J. G  '?OUW verkoopen-.Verschillende soorten van K.AGCHELS enVUUß%%£__%&£AftSP* 'ELLEN STEENROLENEMIHERS tt(Hli\ via _ui \__ enz. Breeder by Notitien omschreven en Maan-L»K voor den Verkoopdag voor een ieder te zien.",http://resolver.kb.nl/resolve?urn=ddd:010073037:mpeg21:a0023:ocr,4,ddd:010073037:mpeg21:p004,Algemeen Handelsblad,1116
3193034,1851/03/28 00:00:00,3302,ddd:010518276:mpeg21:a0019,http://imageviewer.kb.nl/ImagingService/imagingService?id=ddd:010518276:mpeg21:p004:image&x=110&y=92&w=967&h=3302,ddd:010518276:mpeg21,1077,3394,110,92,4,"V HAGEL-VERZEKERING. Aan allen die daarbij belaug mogten hebbeu wordt bij deze ter kennis gebragt dat de Nederlandsche Algemeene Brandverzekering-Maatschappij te Tiel ook tegen eene vaste Premie zonder betaling van inleggelden voor HAGELSCHADE verzekert: Granen Zaden Erwten Boouen Aardappelen Tabak en alle andere Gewassen  hetzij dat deze Vruchten nog in groei ziju of reeds in schoven of hoopen op het Land liggen ; allééu van Vlas en Hennip duurt de verzekering slechts zoolang als zij wortelvast zijn; alsmede Boomkweekerijen  Boomgaarden Weilanden Broeikasten en alles wat door hagelslag kan vernield worden. . Zij die van deze eenige in ons Rijk bestaande Assurantie willen gebruik maken  kunnen deswege nadere inlichtiugen bekomen ten Kantore van den Correspondent der genoemde Maatschappij W. J. ELSENHORST in de Anegang te Haarlem. *#* PUBLIEKE VERKOOPING OP TEXEL. ZUNDERDORP&C0. en CONINCK WESTENBERG & C°. Scheeps-Agenten te Texel zijn van meening op Maandag 31 Maart e. k- 's morgens 11 ure tedeCockstiorp op Eijerlaud ten overstaan van deu Notaris Mr. WILLEM BOK publiek te verkoopen: De TUIGAGIE geborgen van het aldaar gestrande Nederl. Kofschip Richard Kapt. H. B. Engelsman van Newcastle naar Kampen bestemd geweest bestaande uit: 22 (deels nieuwe) Zeilen 4 Aukers 2 Kettingen  1 Kabeltouw  zware Trossen Lier gekapt staand en loopend Want Rondhouten Koks-Commaliewaut en wat verder zal worden gepresenteerd. Nadere informatien zijn op franco aanvrage te bekomen ten Kantore van bovengenoemde Scheepsagenten ca deu Makelaar W. J. HIPPE BOK te Texel. "" *#* OPENBARE VERKOOP VAN SCHAPEN  KOEIJEN EN PAARDEN  BOUWGEREEDSCHAPPEN EN WERKTUIGEN. Op Dingsdag den lst™ alpril 1851 des voormiddags ten tien ure aan de Bouwhoeve genaamd Meijendal in de Duin-ontginning onder Wassenaar zal worden overgegaan tot den verkoop van eene uitmuntende kudde iniandsclie SCILiPEN uit het Leieester volbloed-ras veredeld  bestaande uit ruim drie honderd stuks en voorts van KOEIJEN  PAARDEN  BOERENWAGEN  WERKTUIGEN en GEREEDSCHAPPEN zoo als breeder bij Biljetten is omschreven. Nadere inlichtingen zijn te bekomen bij den Notaris C. J. SCHIEFBAAN te 's Gravenhage en bij den Opzigter A. GREUP op de Bouwhoeve woonachtig die daags voor de verkooping aanwijzing zal doen en dien dag zoo wel als ten dage der verkooping de voorwerpen ter bezigtiging zal stellen. ~*^* HOUTVEILING welke gehouden zal worden door H. G. GEERS Gz. Ondernemer van Publieke Verkoopingen op Dingsdag den lstCT April 1851 des morgens te elf ure op de hoogte van. den Kadijk aan het einde op de Werf de Groote Leeuw te Amsterdam bestaande in eene schoone partij van c». 250 stuks Wezelsche EIKEN PALEN of BERGROEDEN tan 10 tot 13 Ellen lengte en van 20 tot c*. 40 Duimen gemiddelde dikte. Te bezigtigen op den ogsten en 3isten Maart e. k. van des morgens 10 tot des namiddags 3 ure. Gegadigden eenig onderrigt begeerende k unnen zich vervoegen bij bovengemelden op den O. Z. Voorburgwal bij de Armsteeg N°. 140 teaAmsterdam. 7 De Notaris Van STRYEN te Wijk bij Duur- Ji stede is voornemens op Donderdag den 3den alpril 1851 des voorm. ten 11 ure inlietßegt-^JlsLp. huis te Doorn in'het openbaar te veilen en ■^$$j&. te verkoopen: ■ Een kapitale sterke welbetimmerde en voor 18 jaren geheel nieuw gebouwde achtkante STEENEN WINDKORENMOLEN zeer wel beklant en een ruim bestaan opleverende met deszelfs gaande werk vaste en losse Gereedschappen; benevens welingerigt WOONHUIS WAGENSCUUUR. BERGeu verder GETIMMERTEN met aanhoorige ERVE TUIN- BOUW- en BOOMGAARD-LAND ; te zamen groot 1 Bunder 40 Ellen allergunstigst gelegen iv de Gemeente Doorn aan den Straatweg van Utrecht op Arnhem. Te aanvaarden 1 Mei 1851. Breeder bij Biljetten en nader onderrigt ten Kantore van voorn. Notaris. Brieven franco.",http://resolver.kb.nl/resolve?urn=ddd:010518276:mpeg21:a0019:ocr,4,ddd:010518276:mpeg21:p004,Opregte Haarlemsche Courant,967
4131637,1851/10/30 00:00:00,3941,ddd:010077807:mpeg21:a0016,http://imageviewer.kb.nl/ImagingService/imagingService?id=ddd:010077807:mpeg21:p004:image&x=1049&y=50&w=1881&h=3941,ddd:010077807:mpeg21,2930,3991,1049,50,4,"BUITENGEWONE HOEDANIGHEID DER ZALF en PILLEN van HOLLOWAY TOT HET GENEZEN VAN OUDE WONDEN EN Vier jaren geleden kreeg lhomas Watkins katoenspinner te Manchester eene zware wonde aan den arm door een slag van een der werktuigen van het fabriek. Gedurende een geruimen tijd was hij onder de behandeling der geneesheeren van het ziekenhuis welke allen van gevoelen waren dat niets dan het afzetten van den arm het leven des lijders kon behouden en daar hij deze bewerking niet wilde ondergaan werd hij voor ongeneesbaar verklaard. Toen raadden hem zijne vrienden aan eene dosis pillen en zalf van llolloway te koopen welke na weinig weken tijds de wond deden genezen en den zieke na een zoo langdurig lijden geheel herstelden. DOOSJES PILLEN a ƒ090 ƒ210 ƒ330/770 ƒ1550 ƒ2350. POTJES ZALF a f 090 ƒ 210 ƒ330 ƒ 815 ƒ 1590 ƒ2390. Zijn op franco aanvragen a contant te bekomen bij H. van ben GOORBERGH te Breda ; bij J. P. VERLINDEN te Bergen-op-Zoom en bij J STRAATMAN Hoofddepothouder te 's Bosch alsmede te Londen Strand 224 HOLLOWAY'S Etablissement. JAARMARKTEN. (October.) Vught 6. b; Budel 6. j; Hee.e 6. b; Dinther 7 b; Eindhoven 7. b ; Eersel 8 b; Geldrop 8. b; Best 11. p. b; Berlicum 13. b; Tilburg 13. j; Eersel 14 b; Geffen 14. b. Heusden 16. b; Ginneken 20. b;  Herpen 20. b; Oosterhout 20. j; Vlijmen 20 l. 1.. ( Re.nen 21. b; St. M. Gestel 21. b; Liempte 22. b' \ Kaatsheuvel 22. b; Bergep 26. b; BUdel 27. b; I Boxtel 27. p. b ; 's Bosch 27. p. b; Son 27. b; Aarfo- Rixtel 28. j; Dongen 28. b; St. Oedenrode 2s. b? Ravenstein 28. b; Son 29. b; Empel 30. b; Vegbel 30. p. I; Grave 31. b; Megen 31. j. SCHEPEN IN LADING TE JtOTTERDA». Ne w-Vos*. Mede voor passagiers bel Amerikaansch gekoperd fregatschip Alkmaar kapt. J P. Barry. Adres teil kantore van Hudig en Blokhuyzen. New-York. Mede voor passagiers het Hanoversch gekoperd barkschip Esperance kapt. A. Mennen. Adj«» ten kantore van Hudig en Blokhuyzen. New-York. Het extra sneheilend Pruissisch hart» schip Martin Friedrich kapt. J E. Krafït. Adres ten kanlore van Kuyper van Dam en Smeer. Valparaiso. Mede voor passagiers het sneheilend Nederlandsch gekoperd barkschip de Beurs van Rotterdam kapt. W. C. Veenslra. Adres ten kantore van Kuyper van Dam en Smeer. MARKTBERIGT. 's Bosch 23 en 29 Oct. Rogge ƒ565 ƒ600; Boekweit ƒ435 ƒ485; Haver. N. P. ƒ006 ƒ006' Eindhoven 27 Oct. Rogge N. M. ƒ 548; id. Boekweit ƒ460 ; id. Haver geene; Bogge N. P. ƒOO73/ ; Boter id. ƒ050. Rotterdam 27 Oct. Tarwe Jarige Witte Zeeuwsche Vlaamsche Overmaassehe en Flackeesche met redelijken aanvoer en tot 20 cents lager slepende afgegaan. Goede en puike van?/690 tot ƒ 740 ; mindere van ƒ640 tot ƒ680. Nieuwe tamelijk aangevoerd en mede 10 cents lager; de puikste van ƒ790 tol ƒ820 en de overige van ƒ720 lot / 780. Poolsche met meerder handel 157/2 p. Jarige Witbonte ; 155 159/2 p. oude ""dito ƒ270 ƒ290. Roode soorten tot vorige prijzen met (weinig omgang 164/2 p. Jarige Hooglandsche Kleefsche ƒ260 ƒ263; 170/2 p. dito Bovenlandsche /260; 165 166 ItJSIÈ p. Nieuwe Bovenlandsche Ris ƒ270 ƒ272 ƒ285. Rogge. Nieuwe en Vlaamsche ging door ruimer toevoer en mindere behoefte tot 10 cents lager traag af; de puikste en droogsle van ƒ610 tot ƒ640; mindere en Overmaassehe van ƒ560 tot ƒ6 per mud ; andere soorten met kleinen handel 150/2 p. j. Fransche ƒlB4 en 148/2 p. Memel ƒ176. Gerst. Nieuwe Zeeuwsche Vlaamsche Overmaassehe en Flackeesche met iets meerder aanvoer en tot vurige pryzen met graagte opgeruimd van ƒ460 ƒ490; Zomer van ƒ440 tot ƒ465 per mud. Haver ais voren wel afgaande. Nieuwe Zeeuwsche Overmaassehe en Inlandsche Korte van ƒ290 tot ƒ350; Lange van ƒ230 lot ƒ3 per mud. Boekweit ging bij tamelijken toevoer |ot staande pryzen vrij wel af; op 140/2 p. nieuwe Noord-Brab. naar kwaliteit van ƒ152 tot f 157; nieuwe Vlaamsche ƒ150: oude Fransche ƒl3O ƒ132. Schiedam 28 Oct. Moutwijn. per ried. vat zonder fust f 1175. Jenever per ned. vat zonder fust f 1525. Amst. Proef per ned. vat zonder fust f 1650. ZoDder de belasting.",http://resolver.kb.nl/resolve?urn=ddd:010077807:mpeg21:a0016:ocr,4,ddd:010077807:mpeg21:p004,De Noord-Brabanter : staat- en letterkundig dagblad,1881
2220650,1851/03/06 00:00:00,1150,ddd:000019902:mpeg21:a0042,http://imageviewer.kb.nl/ImagingService/imagingService?id=ddd:000019902:mpeg21:p004:image&x=80&y=102&w=1931&h=1150,ddd:000019902:mpeg21,2011,1252,80,102,4,"_______ ..IlMl.-.L-lIH-1.111. LONDON & ROTTERDAM. De MAALSTOOMPAKKETTEN VERTREKKEN met PASSAGIERS en GOEDEREN  ZATURDAG 8 MAAKT '_ morgens 7 ure | WOENSDAG 12 MAART 'smorgens 9 ure. Voor Vee en andere Goederen de GIMAjYjVE Kapitein Goodbüen vertrekt ZATERDAG MOKGEN ten 9 ure. (4836) inlichtingen bij de Agenten W. SMITH & P. A. VAM ES. "" Il 01 I ER» AM EN LON DEN VOOR GOEDEREN EN VEE. Het nieuw gebouwd en tot vervoer van PASSAGIERS uitmuntend ingerigt en Snelvarend Stoomschip MAGNET Kapitein Ths. Colyer Vertrekt van ROTTERDAM naar LONDEN Zaturdag den Bsten Maart. VRACHT: lste Kajuit £ 1. Heen en terug __ Ï.10.0. Adres ten Kantore van PII . VAN OMMEREN. <1402>",http://resolver.kb.nl/resolve?urn=ddd:000019902:mpeg21:a0042:ocr,4,ddd:000019902:mpeg21:p004,"Nieuwe Rotterdamsche courant : staats-, handels-, nieuws- en advertentieblad",1931
3772531,1851/01/02 00:00:00,4765,ddd:010518203:mpeg21:a0018,http://imageviewer.kb.nl/ImagingService/imagingService?id=ddd:010518203:mpeg21:p004:image&x=100&y=110&w=1892&h=4765,ddd:010518203:mpeg21,1992,4875,100,110,4,"*ff* Een Nederlander reeds 25 jaren in Londen ter woon gevestigd  wenschte zich  gedurende zijn verblijf van circa 3 maanden iv Nederland op billijke voorwaarden  aan eene Familie te verbinden ten einde eenige LEERLINGEN in de Engelsche Spraakkunst tt volmaken. Nadere informatien te bekomen per franco Brieven onder Letter bij J. H. en G. vanHETÈREN Boekverkoopers Hartenstraat N°. 28 te Amsterdam. *ff* Men wenscht te engageren  voor eene talrijke Dagen Kostschool: Eeueu bekwamen SECONDANT vau de Prot. Godsdienst om met den Patroon eu twee andere Seeoudants werkzaam le zijn. Brieven franco onder Letter Z. bij J. ue RUYTER Boekverkooper te Amsterdam. *#* Voor eeue Brandwaarborg-Maatschappij worden gevraagd solide AGENTEN  die uitgebreide relatiën hebben  bijzonderlijk bij den Landbouwenden staud. Reflecterenden gelieven zich te adresseren  met franco Brieven onder Letters B. W. M. bij den Boekh. W. .1. RAADGEEP te Doetinchem. *ff* Een Burger-Jongeling vau de Hervormde Godsdienst zoekt tegeu I°. Februarij a. s. of eerder eeue plaats als TUINMANS-KNECHT bij voorkeur daar waar hij met Boomen eu Bloemen te doen heeft; in deu Groenten-bouw is hij niet onervaren. Adres bij deu Boekhandelaar A. SCIIAAFSMA te Dockum. *fff Aau de geïnteresseerden in de Sociëteit van Eigendom der Plantagien de Dageraad eu la Persévérance grdegen iv de Kolome Suriname wordt geadverteerd dat gedurende de maand Januarij 1851 des Dingsdags eu Vrijdags des morgens van 10 tot 12 ure teu Kantore der Directie op de Keizersgracht bij de Heereustraat N°. 350 te Amsterdam  ter visie zal liggen EEN VERSLAG met en benevens de REKENING eu VERANTWOORDING wegens gemelde Sociëteit gesloten .31 December 1849 door Heeren Commissarissen geapprobeerd. \* De ondergeteekende maakt langs dezen weg bekend dat. hij zich alhier gevestigd heeft als HUISSCHILDER GLAZENMAKER ENZ. Hij beveelt zich zijnen Begunstigers aau. belovende eene prompte en civiele bediening. BERM"". RETEL. Overveën 1 Januarij 1851. V TapS-OaN ALRESPEYRËS onderhoud zouder reuk of pijn te veroorzakendeFonte■nellen zijnde gedurende meer dan 35 jaren door de Geneeskundige School te Parijs voorgeschreven ; lllaartrekkende Pleisters om zich binnen eenige uren een Fitsel te -rekken ; Taf om de Ponteiiellen te ververscheu ; Zuinigheids Compressen die de voorkeur boven de Linnen verdienen ; verbeterde Arm- en Beenbanden van Gom-Elasliek en Plated. Men adressere zich aan hetHoofd-Deput van Holland bij den Heer F. E. van Santen Kol ff of bij de volgende Heeren Depöthouders: J. A. Peeters te Alkmaar; 6. B. Kok te Amersfoort; F. Romeyn te Arnhem; J. J. Verbinden te Bergen op Zoom; van den Goorberg te Breda ; L. G. Smeenk te Deventer ; van Wageningen  te Dordrecht; P. J. B. Schultze te Gorcum ; J. Mouton en Zonen te 's Gravenhage; P. H. N. van Wermeskerken te Groningen; D. Klinkert te Haarlem ; J. Straatman te 's Hertogenbosch : de Wed. J. Bos Az. te Hoorn ; O. A. van Tricht te Leyden ; G. Grossier te Maastricht; Bluecke de Liguy te Middelburg ; J. IJ. Coenen te Nijmegen ; de Wed. van Rijssel en Zoon te Tholen; A. J. Paassen te Tiel; A. P. Milius te Utrecht; J. 11. Ochtmans Johsz. te Zierikzee; D. J. Muntendam te Zutphen. Geld en Brieven franco. V Te HUUR: De BUITENPLAATS genaamd ZUIDHOORNT bestaande iv een zeer logeabel Heeren-Huis Koepel Paardenstal Koetshuis en Arbeiderswoning ; alles gelegen aan de Oostzijde van den Delftscheu Straatweg  aan de Hoornbrug nabij 's Gravenhae;e. Te bevragen bij de Boekhandelaren de ERVEN THIERRY & MENSING aldaar. V HOUTVERKOOPING van eeue groote partij zwaar en welig gegroeid EIKEN- ELZEN- ESSCHEN- en BERKEN HAKHOUT omtrent deu Huize Berg en Daal ouder Voorhout op Dingsdag 7 Januarij 1851 des voormiddags ten tien ure. *.ff HOUTVERKOOPING ten overstaan vau deu Notaris' E. H. GERAERDS THESINGH  te Hazerswoude: Den 7de"" Januarij 1851 te Koudekerk in de Bosschen van Poelgeest 's morgens ten 10 ure vau eene aanzienlijke partij: zwaar ESSCHEN en eenig ELZEN HAKHOUT en 8 WILGEN BOOMEN. Betaaldag 1 Mei 1851. Den lO**'""'! Januarij 1851 te Beutliuizen  vau eene aanzienlijke partij WILGEN HAKHOUT eu 40 opgaande WILGEN BOOMEN. Contant. Den IC*"""" Januarij 1851 te Koudekerk op den Huize den Tol 's morgens ten 10 ure van 35 opgaande POPULIEREN BOOMEN zeer geschikt voor Werkhout eu eene aanzienlijke partij ESSCHEN eu ELZEN HAKHOUT. Betaaldag 1 Mei 1851. Zijnde mede UIT de HAND te KOOP c. 10 Bunders BOSCHLAND met welwassend Elzen eu Esschen Hout beplaut gelegen iv den Rietveldschen Polder onder Hazerswoude. Bij gemelden Notaris te bevragen.",http://resolver.kb.nl/resolve?urn=ddd:010518203:mpeg21:a0018:ocr,4,ddd:010518203:mpeg21:p004,Opregte Haarlemsche Courant,1892
4105366,1851/08/02 00:00:00,3722,ddd:010072987:mpeg21:a0021,http://imageviewer.kb.nl/ImagingService/imagingService?id=ddd:010072987:mpeg21:p004:image&x=2248&y=77&w=1103&h=3722,ddd:010072987:mpeg21,3351,3799,2248,77,6,"ZWAMMERDAM  26 Julij 1851' Met innig welgevallen zagen eenige Inwoners van Zwammerdam et .leszelfs omtrek den steeds toenemenden bloei van het alhier gevestigd' -INSTITUUT voor JONGE HEEREN van den Heer Jl. RUNE»' BERG. Dezer dagen gaf een gehouden Examen weder het voldingends"" bewijs van Jen onverflaauwden ijver en de doelmatige zorgen van de» verdienstelijken Onderwijzer. Een Dertigtal Leerlingen gaven ieder in hunne Klassen bewijzen v*l groote vordering in de Vakken waarin zij onderwezen waren; terwijl d' heerschendc toon duidelijk aanwees wat eene goede en doelmatige Of voeding b't\ de Jeugd vermag. Het is uit hoogachting tot den He* RIJNENBERG en prijsstelling op zijnINSTITUUT.dat wij met vertrouwe aan OUDERS en VOOGDEN deze INRIGTING van OPVOEDING e ONDERWIJS durven aanbevelen. (12077j_ HUM! VVÏÜI lEMAND in den Handel ervaren wenseb AooUlllil I iEJ. zich in eene of andere Handel- of Fabriekzaak ook Administiative Onderneming te ASSOCIËREN of als DIREC TEUR eener Winstgevende Zaak geplaatst te worden. Hij is in sta»1 behoorlijken Borg te stellen of ook eenig Kapitaal te fourneren. Aanbie' dingen worden verwacht Franco onder Lett. L. D. R.bij A. HOOGEN' BOOM Boekhandelaar in de Reestraat te Anisterdam. (12046)^ GEEI GRIJZE HAREN MEER. Het EAU CHANTAL  het eenige door de Chemie goedgekend Artikel om het Haar en den Baard oogenblikkelijk in alle kleuren te verwe' zonder het minste nadeel en L'EPILATÓIRE CHANTAL m' hetwelk men oogenblikkelijk alle overtollige Haren verdrijft zijn te i men it ƒ 3 elk Artikel bij J. P. RIETSCHI Amstel N». 122. (903») I"" IJI CIT) AT) IADATIi1 decorces d'orangcs amères Toniq* LUi ijiftUl L_lllU_U____ an'i-nerveux en régularisant les fon«' tions digestives de I'estomac et des intestins guérit les maladies nerveU' ses faciiite et rétablit la digestion de'truitla constipation guérit la disf rbée et la dyssenterie les gastrites gastralgies pre'vient la langueur "" de'périssement abrège les convalescences. 3 fr. le flacon. On <_ vitera W contrefa^ons en exigeant les cachet et signature Laraze. Dép6t chez H. H. ULOTH Pharmacien a Amsterdam. (9713) DE VOOR GENEESKUNDIG GEBRUIK TE LOFFODL*. IN NOORWEGEN BEREIDE DORCHE-LEVERTRAAN Scheikundig onderzocht door Dn. J. DE JONGH is thans verkrijgbaar■ I te Amsterdam; bij J.RUYSTiiz Apoth. Bloemmarkt N°. 226 en bij W; J. VAN HULSTEYN Apoth.; Warmoesstraat N°. 109; Arnhem bj J. A. C. OTTERBEIN Apoth.; Amersfoort bij C. B. KOK Apo* Alkmaar  bij H. TOUSSAINT Lector in de scheikunde ; Assen bij F. GOSSELAAR Apoth.; Apeldoorn bij BRUNO TIEDEMAN ; Bi* da bij A. J. VAN DE GOORBERGH Apoth.; Bergen-op-Zoom b'J P. J. VERLLNDEN Apoth.; Bommel bij P. C. VAN ANROOY Apotï-i Brock in Waterland bij C. SOMBEEK Apoth.; Brummen bij C. B<> ME Apoth.; Boxmeer bij J. G. HERMANS; Culenborg bij A. KA?' TEYN; Deventer bij G. J. BöHMER KEYSER Apoth. j Dordrecbd bij W. SILLEVIS. Apoth.; Delft bij D. J.COCKUYT Apoth.; Doei' burg; bij D. WILMERESTK Droogist; Dockum bij J.B. WALTEBi Apoth.; Doetinchem bij P. COOPS; Dragten bij E. J. VAN DE» MEULEN Apoth.; Enkhuizen by DE KONING ROLDANUS Apotb-t Edam by J. HOOLAVAN NOOTEN Apoth.; Eindhoven bij W. & SMITS ek ZOON Apoth.; Franeker bij J. H. VAN DER MEULEïfi Apoth.; 'sllage bij de Wed. J. E. SCHUT Droogist Spui; Groningen bij *• H. KUILENBURG Apoth.; Gorinchem bij A. ALERS Rijks-Arts de' Iste Kl. en Droogist; Gouda bij P. VAN DER HEYDEN Apoth.» Grave bij A. L. VAN DEN HOUTEN Apoth.; Gorredijk bij S. ö' SWART Apoth.; Goes bij B. VAN ASPEREN VERVENNE Apoth;. Haarlem bij D. VEEN en COMP. Droogisten ; 's Hcrtogenboch bij Ï' LUYCKX Apoth.; Harlingen bij H. A. BRINKSMA Apoth.; Hoort. kij L. SCHUYT BEST Apoth.; Heerenveen  bij N. DORNSEEFFEN. Apoth.; Helmond bij G. DE RUYTER geneesheer; Hilversum bij P' VAN DER SMAN genees- heel-en vroedmeester; Hoogereen pf' vincie Drenthe bij JAN ZWIERS JZOON; Joure by Df' WEHLBURG; Kampen bij RAMHORST Apoth.; Koog aan de Zaan. bij J. VEEN Hz. Apoth.; Leeuwarden bij dc Wed. DRAISMA en VAJ> KENBURG  Apoth.; Leyden bij N. SANDERS Apoth.; Leydschendani. bii A. F. VAN LEEUWEN geneoehear; Maastricht bü J D. HOLJ> MAN HEINTJES Apoth.; Middelburg bij n. A. FitASER ; Maassluis bij A. S. TISCHAUSER Apoth.; Meppel bij K. DE VRIES Apoth-i Maarssen bij W. DOLMANS ; Nijmegen bij N. ABELEVEN en ZOONt Apotheker; Nieuwediep by L. JELGERSMA Apotheker; Nykerk bil! N.VAN DIERMEN; Naaldwijk bij E. J. VAN STADEN; Oorf-j burg bij Dr. H. A. CALLENFELS; Purmerend bij P. MAKKES. Apotheker; Putten (Gelderland) bij Dr. P. J. SMID; Rotterdam bi) C.A. KOP Apoth. Hoogstraat en G. J. W. SNABILIE Apoth.. Groote Markt; Roermond bij L. PITAFFE Apoth.; Rozendaal bij F.* j KRUGER Genees-Heel- en Verloskundige; Schiedam bij B.Cu. MAÏ'i Droogist; Sneek hij J. TBITSMA JOHA Apoth. Schoonhoven by Doe»' WOLFF; Tiel bij M. L. POST Apoth.; Utrecht bij 11. VAN DORSSEJft Apoth.; Venlo by P. J. H. METZ Apoth.; Vlaardingen bij J. J' HAVERDROESE Apotheker; Venray by A. V. ESSER Apothekeri Vlissingen bij BEBELAAR in het Commissie-Kantoor; Woerden! bij J. L. VERMANDE; Weesp bij J. F. VLAMING KIEBERT Apotb'i Wageningen bij de Wed. BÜHNE kn VAN KRIEKEN Apoth.; Wa»l' wijk bij C.F. VAN DER KLOKKE Apoth.; Warmond bij P.J. HE>' STERMAN Geneesheer ; IJselstein  bij M. J. VAN DE KASTEELEfIi Apoth.; Zwollebij S. enA. JACOBS deze zy'n voorts Hoofd-Depótko«'l ders voor Twenthe ; Zutphen by F. W. STRUBEN  Apoth.; Zierikze«i. bij S. G. NAUTA VAN DER GRIJP Apoth.; Zaandam bij J. DY#' HOFF Heel- en Verloskundige; Zeyst bij C. F. KRAEPELIEU ApotW Zevenbergen bij J. J. F. PENNINK. Bij al deze Depothouders is ook Gratis voor ecu ieder verkrijgbaart_\ steld: EEN WOORD OVER DE OORZAAK der zoo vs»* waargenomen wordende werkeloosheid der LEVERTRAAN alsmed' over de Middelenter wegneming derzelve  gevolgd door eeneßEßED*' NEERDE OPGAVE DER ZIEKTEN waartegen de LEVERTRAAN »•* vrucht kan worden aangewend door Dn. DË JONGH. . De Prijs der Scheikundig onderzochte DORCHE-LEVERTRAAN is 85 Cents het Fleschje. Op regtstrecksche aanvrage aan De. DE JONGH voor Gasthuiz** Diaconien Armen-lnrigtingen enz. wordt dezelve tegen een aanzienlij' Rabat en wel genoegzaam voor eigen kosten geleverd. Zoodanige aanvr'"" gen moeten echter zijn geteekend door Bestuurders  Directeurs of Reg»9' ten van gezegde Liefdadigheids-Inrigtingen. 'sGravenhaoe 1 Aug. 1851. (10874) __",http://resolver.kb.nl/resolve?urn=ddd:010072987:mpeg21:a0021:ocr,4,ddd:010072987:mpeg21:p004,Algemeen Handelsblad,1103
2096200,1851/01/22 00:00:00,2350,ddd:010805252:mpeg21:a0035,http://imageviewer.kb.nl/ImagingService/imagingService?id=ddd:010805252:mpeg21:p004:image&x=1873&y=1894&w=892&h=2350,ddd:010805252:mpeg21,2765,4244,1873,1894,4,"WAARNEMINGEN gedaan op het Meteorologisch Observatorium te Utrecht. (Zonnenburg.) . c Wiui)- __roui. Tlier. Ah ijk. ;Voch- Gc»-■._Jr.gii B.kr. -') O' F-. rcm.jligh. reK.i Aanmerkingen. mm p ""min l. 8 zzw. 1 768641316 100 0 Betr.; zw. mist. 8 z. 1 6814 354— 1.5 100 o id id 10 zzo. 1 6682313 ||00 0 Ligt betr.; mist. 20 8 zzo. 1 6479j297 98 o Betrokken• id 2 _zo. l 6247|327— 0.9 92 0 id.; nevelig. 10 z. 2 5842 32.0 95 0 Bijna helder. PRIJZEN DER EFFECTEN. AMSTERDAM 20 Jan. 1851. volgens de Societ. tot nut OMSCHRIJVING. des Obligatie-Handels. van tot gebl. Nederland. Werkel. Schuld. . . 2Va pCt. 56"" 57>/„ 56*/ dito dito 3 „ 66'"".„ 67 66'""/» dito dito 4 „ 87' Vu 87V 87»/ Amortisatie Syndicaat 31/ „ 89 V» 89 'A Hiindel-Maats. op resc. 4/2 „ 109 Leen. Rhijn-Spoorweg 4'/ „ 93 ""4 Leen. Holl. Spoorweg. 4'/_ „ 9&1/ FRANKRIJK. Certificaten 3 ~ 53i/4 535/ 58i/. Rusland. bij Hope en Comp. .. 5 pCt. 105'/» dito 1828 en 1829. . 5 „ 104'/! dito Cert. 1831 & 1833 5 „ 94 q^ Certificaten bij Stieglilz 4 „ 86 dito Adm. te Lond. 41-<1 „ 9434 ™ Cerutic. van Assign. . 6 „ 65% Polen. Aandeden 1835 fl 500 ... . / 144'/i Denemarken. Geldl. te Londen ... 5 „ 98t/4 98VS 98'/« Pruissen. Aaudeeleu 1832 . . . . f 213 Stanje. Oblig. Ardoin. i 85 5 pCt. 11'». « n f 510 ö „ 12V„ 12% |2!# Onb. Stukken 5 „ il1/ 1IV4 Obligatien 3 „ 39'/"" 3.3.- Binnenl. Schuld. ... 3 „ 33»/ 3_'/i9 33V» Ardoin Coup 75/ g 7'A 7*'/i« Oosten k)jk. Oblig. Metaliek .... 5 „ 7o74 70V dito dito. N. ..... 5 „ 76 76'; T6'/| -ito 2'/ „ 3781B 37^ België. Certific. bij Rotscldld 21/ „ *1% 47V. Portugal. Oblig. 5 pCt. thans 4 pCt 35 35 '/_„ 35 ' » ""* ""* J«% Geld. 1824 f 100 . 5 pCt. 89'/4 Amerika. Mexico Obl. 1837 4 100 5 „ 33'/4 33„ S3«/_  J-.ru Geldl. 1849 thims 4/3 pGt. 77 Louisiana ..__. 6 „ :96V Utrecht -4j l>. K. HO-c 11 ca « o_»p.",http://resolver.kb.nl/resolve?urn=ddd:010805252:mpeg21:a0035:ocr,4,ddd:010805252:mpeg21:p004,Utrechtsche provinciale en stads-courant : algemeen advertentieblad,892
3834162,1851/01/24 00:00:00,2727,ddd:010583919:mpeg21:a0011,http://imageviewer.kb.nl/ImagingService/imagingService?id=ddd:010583919:mpeg21:p004:image&x=1528&y=59&w=1406&h=2727,ddd:010583919:mpeg21,2934,2786,1528,59,6,"Verkoopiag van Taste Goederen ie Auguslinusga. Wvo Notaris G. BAKKER in de Schrans onder Huizura bij Leeuwarden m IJ) op Zaturdag den 8 Februarij 1851  des namiddags 2 uur precies in de ller' hem- van Eehe Fokkinga te Augustinusga in het openbaar bij provisioue| toewijzing presenteren te verknopen: 1 ""3 bunder 99 roede 10 el (naar naam en faam 12 pondem.) vruchtbaar BOUW- en WEILAND genaamd de Leijen zeer gadig gelegen te AngnJJ tinusga kadastraal gemeente Dn.gehain  sectie C nos. 207 208 209 e„ 210 ■ en zulks in 4 perceelen behoudens regt van zamenvoeging. * 9* roede 60 el best WEILAND aldaar sectie C no. 85 en B.' Eene HUIZINGE met SCHUUR ERVE en verder AANBEHOOREN aldaar seotie C  nos. 879 en 880 groot naar meting 29 roede 20 el. Te aanvaarden: de Landen vrij van huur terstond na den palraslag en de Iluizinpe als in levenslange huur bij Jakobus Gaëlis van der leen en Vrowc eerst na doode dier Echtelieden. Inmiddels zijn dese Vastigheden tot 4 dagen vóór het tijdstip der veiling UIT DE HAND TE KOOP op Vourvvaarden ten Kantore van den Notaris voój eegadieden  te vernemen. OPROEPING. Een ieder welke eene wettige vordering heeft ten laste GERHARDUS J. COU. PERUS te Augustinusga wordt uilgenoodigd daarvan aaugave te doen (met productie van rekening of bewijs) ten Kantore van den Notaris BAKKER* in de Schrans onder Iluizuni vóór den 8 Februarij e. k. en zulks franco. Op den VI Mei e. k. te huur voor een lieer Dame of klein Gezin: Een aangename en moderne INTREK boven den Koekbakker IJpma bij de voormalige Vrouwenpoort te Leeuwarden ; alsmede Eene ruime HUIZINGE met TUIN et. KOESTALLINGEN ctim annexis zeer geschikt voor Koemelkerij en Tapperij of dergelijk bedrijf staande achter de Hoven bij en onder Leeuwarden. Adres ten Kantore van den Notaris BAKKER  in de Schrans bij Leeuwarden V E 11 K O O P I N G. f\e Notaris 0. B. OEBERIUS te St. Anna-Parochie zal op Maandag den 3 Jr Februarij 1351 des namiddags ten 6 ure in de Herberg der Weduwe Z"". A. Wassenaar aldaar na bekomene regterlijke magtigiug. finaal verkoopen: 1. Eene HUIZINGE gekwot. no. 285 met ERVE BLEEK TUIN en een afzonderlijk gebouwd HUISJE staande aan de smalle zijde van het Oostend ie Sint Anna-Paroehie ten Kadaster bekend sectie A nos. 213 en 556 groot 3 roede 56 el; bij W. A. Tanja c. s. bewoond ; waarop geboden is/ 1339. 2. Een stuk best BOUW- of GARDENIERSLAND gelegen aan het Hoogpad onder Sint Anna-Parochie ten Kadaster bekend sectie C no. 874 groot 1 bunder 38 roede 50 el; bij Arjen J. de Grijs c. s. in gebruik; waarop per circa 92 roede geboden is ƒ 885. 3. Een stuk DITO gelegen aldaar ten Kadaster bekend sectie C no. 366 groot 1 bunder 62 roede 50 el ; als voren in gebruik ; waarop per circa 92 roede geboden is ƒ 803. 4. Een stuk DITO gelegen aldaar ten Kadaster bekend sectie C no. 864 groot 2 bunder 1 roede 60 el; als voren in gebruik ; waarop per circa 92 roede geboden is ƒ 901. Alles nagelaten door wijlen de Weduwe Corns. K. de Jong. — Te aanvaarden : het Huis c. a. den 12 Mei 1851 en het Land na het rispen der vruchten in 1852. ff\e Griffier J. J. HEEP te Holwerd g.g.  zal ten overstaan van den Notaris &9 B. IJPMA aldaar op Zaturdag den 1 Februarij 1851 des namiddags ten 4 ure precies ten huize van de Weduwe Heeringa Kasteleines te Holwerd bij finale toewijzing aan de meestbiedenden presenteren te verkoopen: Eene kostelijke ZATHE en LANDEN aan den ouden Dijk onder Holwerd Groot Munnekehuis met de daarbij gevoegde 6 perceelen in den Oosterpolder aldaar te zamen groot 28ij bunder zoo BOUW- als GREIDLANDEN ; benevens eene HUIZINGE en ERVE aan de Voorstraat te Holwerd en eene BANK in de Kerk der Hervormden aldaar; toebehoorende aan de Erven van de Weduwe Sjoerd P. de Groot aldaar; raeerendeels Sint Petri en Mei 1851 vrij te aanvaarden; waarop geboden is te zamen ƒ 8741175.",http://resolver.kb.nl/resolve?urn=ddd:010583919:mpeg21:a0011:ocr,4,ddd:010583919:mpeg21:p004,Leeuwarder courant,1406
5524891,1851/12/31 00:00:00,5263,ddd:010073134:mpeg21:a0019,http://imageviewer.kb.nl/ImagingService/imagingService?id=ddd:010073134:mpeg21:p003:image&x=1147&y=59&w=2203&h=5263,ddd:010073134:mpeg21,3350,5322,1147,59,18,"DOOR BIJZONDERE OMSTANDIGHEDEN biedt men aan: EENE HANDELSZAAK tot welker voortzetting voornamelijk de geschiktheid tot BINNENLANDSCHE REIZEN vereischt wordt. — Ter nadere inlichting vervoege men zich met gefrankeerde Brieven onder Letter P. A. Bureau Handelsblad. (20162) _______ UY A _T_- TK KOOP wordt aangeboden voor ƒ 480: _""*""*s____P JT__A__ Va Eene uitmuntende schoone Opstaande £E«#*_is PIANO met Oblieke Snaren uit een der beroemdste Paï___ rijsche Fabriekcnalsmede een Vierkante Bespeelde PIANO met Metalieke Plaat a ƒ 160 voor de deugdzaamheid wordt Vijfjaren ingestaan. Te bezigtigen bij Mcjufvrouw FROSHHARDT op de Lange Have N\ 750 ten huize van de Wed. AENWEG en ZOON Boekhandelaars te Schiedam. (20125) J*Q ""f TTI Tl TB. Singel tusschen de Schoorsteenvegers- en XIXJi Jt Ü ■ . Raamsteeg N°. 88 berigt het Geëerde Publiek dat zijn Fabrielt en Magazijn voorzien is van alle soorten van Geweven of Gebreide GOEDEREN» als: Kousen Sokken Borstrokken Pantalons met of zonder Voeten alsmede Tooneclcostumes welk alles volgens opgegeven Model iv Wol of in Katoen vervaardigd wordt en alleen ten zijnen Eabrieke kan vervaardigd worden. Daar hij ruim Tien Jaren bij de Heeren G. W. VON SCHMIT en ZOON als Eerste Bediende  is werkzaam geweest en voor Vijf Maanden geleden door de honteuse behandeling) van zijnen Patroon zich verpligt heeft gezien zij» ontslag te nemen en om die reden bovenstaand Fabriek en Maga.ijn Geopend heeft zoo beveelt hij zich minzaamst aan. (Zie Handelsblad van 19 December.) (20172) Men verlangt voor eene JONGE DAMIi b_ Fatsoenlijke Protestantsche Lieden tegen P°. Februarij 1852: •. ONGEIUE LDILEEKDE hlHIll"". (liefst Zij- en .Binnenkamer) waarb. tevens gelegenheid tot vrije gebruikmaking der Zcidcr op cene Gracht in het midden dezer Stad. Adres met opgave van Huurprijs onder Lett. 0. bij den .Boekverkooper J. C. SPIJKER Az. Eeguliersplein N"". 4; bij welke gelegenheid tevens een MEISJE gevraagd wordt voor Boodschappen van 9 tot 3 ure. (20340) Door omstandigheden wordt ter overname aangeboden : Eene FABRIEKMATIGE AFFAIRE welke voor uitbreiding vatbaar en op een fatsoenlijken stand gelegen is naar verkiezing met Februari. of Mei e. k. te aanvaarden. Brieven franco onder Lett. C. D. Bureau Handelsblad. (20108) Bij de Uitgevers J. G. VAJN TERVEEJN en ZOON"" te Utrecht en hunne Correspondenten  zijn voortdurend Exemplaren te bekomen van de KLEINE GEDICHTEN VOOR KINDEREN. door Mr. HIERONYrMUS VAN ALPHEN. Nieuwe uitgave met g.kleurde Plaatjes in Linnen en Verguld op Snede .... ƒ 2.40. Hoe welgevallig deze onnavolgbare Gedichtjes der Jeugd voortdurend zijn blijkt overtuigend hieruit dat in minder dan vier Weken na de verschijning van deze uUgave van dezelve meer dan DEHZEND EXEMPLAREN gedebiteerd werden. (20008) Bij den Boekverkooper EEKMA te Leeuwarden is verschenen WAT BEEFT DE TWEEDE KAMER GEDAAN TEN OPZIGTE DER RIJKS-POLITIE ? a 25 Cente. Is niet algemeen maar bij de navolgende Boekhandelaren verkrijgbaar gesteld: J. H. en G. VAN HETEREN J. H. VAN RESTEREN en J NOORDENDORP te Amsterdam; Js. Az. NIJHOFF te Arnhem; 11. P A. VAN GORCUM te Ass°n- K. FUHRI en J. M. VAN 'T HAAIT t. 'sHage; R. J. SCIIIERBEEK en P. VAN WICHERENHz. teGronin gen; A. C.KRUSE MAN te Haarlem*; GEBR. MULLER te 's Hertogen . boscb; P.H. VAN DEN HEUVELL te Leyden; VAN BENTHEMe 1 JUTTING te Middelburg; J. E- THIEME te Nijmegen; H. V. VAI GOGHte Rotterdam ; A. F. 81-ANCHE & C. en W. F. DANNENFKL SER te Utrecht en W. E. J. TJEENK WILLINK te Zwol). (20009) DE EERLIJKE VINDER van een VROUWENZAK e.m merkt N°. 76  waarin is een ZILVEREN KNIPJE een pa. r GOUD^'h KNOPPEN een paar ROODE BELLETJES een GOUDEN DOEl^rj SPELD en twee SLAAPMUTSJES wordt vriendelijk verkoel i ombiüi) aan een arm Dertienjarig Weesmeisje terug te geven welke het he. ng^ VERLOREN  gaande van de Iluidenstraat langs de Aj^flenmarl naar den Haarlemmerdijk zullende goed Beloond worden. AuiC3 ondi'r* Lett. F. bij den Boekhandelaar C. L. VAN LANGENHUYSE_-. Siugi bij de Beulingsluis te Amsterdam. (20158) 3n' — ■ ' *—~ * -: ■ aa* De EERLIJKE VINDER van een GOUDEN HOEPEI ïiING  voor de Helft bezet met Twee Rijen Brillanten die Zondag jl. des Vooiier middags is VERLOREN geraakt wordt verzocht dezelve terug tebex0 zorgen aan het Bureau Handelsblad om daarvoor de Volle Waarde d«  verkiezende te ontvangen. (20182) je. Voor de menigvuldige blijken van hartelijke belangstelling ondervon ' den van Vrienden Bekenden en Onbekenden.bij den nabijzijnde B_i AF*. D 3°' op Zaturdag Avond 11. betuig ik ook uit naam mijner verdere Hui» genooten bij deze hiervoor MIJNEN INNTGSTEN DANK. -P: Amstbrdam 31 December 1851. Wed. A. ANDRIESSEN £et (20179) Gehore» VAN VOORST. MEIVSCHLÏEVEIXDE STADGEDOTEft thu^ LIEDEN den ouderdom van ruim 80 Jaren bereikt hebbende en dooi ehet grootste gebrek zich in de droevigste omstandigheden bevindende ;el roepen uwe Hulp in Menschlievcnde Stadgcnooten tot leniging van hun. nen diep ongelukkigcn toestand. r- De Ondergeteekenden belasten zich gaarne met het ontvangen dei t Liefdegiften en het geven van Inlichtingen. s- H. C. VAN DER VELDEN  Wccsperstraat N. 7«. n J 20173) .1. KOBUS Jn. We esperstraat. N°. 79. _>t CIT VA TOTO VITFB s IWr' broodbakker .e . ü. liitmlULlJtin. KALVERSTRAAT bij het; BURGERWEESHUIS heeft de eer zijne geachte Begunstigers te herig- f ten ruim voorzien te zijn van verschillende soorten KLEINGOED en tevens bij hem Heden en Morgen (NIEUWJAARSDAG) Versche ] TULBANDEN in verschillende grootten zullen gereed zijn alsmede * en ten allen tijden de van ouds bekende BESTELLEN of KRUIDEN* ' BESCHUIT. (20144) . Bil 1 Dir'Tl.D'ï in het LOOTSJE op de Nieuwmarkt ! DlO A. IlHllLllO het sde Huis van de BarndesteegN"".29 is verkrijgbaar SIROOP DE PUNCH per Flesch 90 en 100 Ct. de Ha3ve 50 Ct.; Jamaica RUM per Kan 90 Ct.; Fransche BRANDEWIJN 50 en 60 Ct.; beste Schiedammer GENEVER 45 Ct.; Onver sneden 50 Ct.; Oude Roode WIJN 50 Ct.per Flesch; ESSENCE DE BISSCHOP 20 Ct. het Flescbje alles beste kwaliteit. (20189) AnPUlinn UDDTPf De Ondergeteekende berigt aan UJCIÖ i Juli D_j_\l UT 1 . zijne Geëerde Begunstigers  dat hij op heden eene groote partij Texelsche en Engelsche OESTERS ontvangen heeft welke zeer groot en blank van Stuk zijn versche groote CASTANJES 13 Cents de 5 Ons; groote Zeeuwsche AARDAKERS en fijne Engelsche SPROT. C. VAN LAAR en ZOON (20159) Beguliersbreestraat bij de Botermarkl. /•Pl'ïrr__JÏl.S! BUBTCT Be<ite eroote CASTANJES al 5 LAMAlldllJlJ DMlHll. Cents de 5 Ons; Engelsche SPROT a 10 Cts. het Bosje fijne Winter-HARING a/l de 25Stuks Engelsche Bokkens asoen 60 Cts. het dozijn; China'sAppelen4o enso Cts. het dozijn Citroenen 80 Cts. het dozijn zijn te bekomen bij C. DE MOOY adres Damrak of Water N-.86. Brieven Franco. (20187) Af | 171 \J?nijl_)l _ All.!. BC welke de n""""-ste waarde hechten /-l-LEI Ill_Ul_nLAllUl_lli3_ aan hunne onafhankclijkheidworde:: verwezen naar: NEERLANDS VRIJHEID BEDREIGD te Utrecht bij O v. d. POST J*t. ten einde van hunne gezindheid aan de TWEEDE KAMER te doen blijken VOOR HET TE LAAT IS. (20157) ■ WORDT GEVRAAGD: EcnelUlN van een gezond Gestel drie maanden oudkraams of jonger van goede Getuigenis voorzien  cm DADELIJK in dienst te treden. Adres bfl denKruijerSANDA Groenenburgwal over de Engelsche Kerk. i20!88^ Tegen FEBRUARIJ e. k. worden bij TWEE HEEREN al? HUISBEWAARDERS gevraagd MAN en VROUW van de Proti'tnnteche Godsdienst niet te Oud de Vrouw in staat te kunnen Koken opdat wanneer zulks nu en dan verlangd wordt zij daartoe de gesehiktbeid heeft. Met franco brieven onder Lett. A. gelieve men zich te adre'-'eren bij de Boekhandelaars BLIKMAN fr SARTORIUS Dam N°. 23. 0178)",http://resolver.kb.nl/resolve?urn=ddd:010073134:mpeg21:a0019:ocr,3,ddd:010073134:mpeg21:p003,Algemeen Handelsblad,2203
1946500,1851/03/25 00:00:00,2290,ddd:000012987:mpeg21:a0015,http://imageviewer.kb.nl/ImagingService/imagingService?id=ddd:000012987:mpeg21:p004:image&x=1894&y=1061&w=850&h=2290,ddd:000012987:mpeg21,2744,3351,1894,1061,4,"ADVERTENTIE IV. BELANGRIJKE VERKOOPING VAN HEESTERGEWASSEN. JM Op DONDERDAG deu 27. MAABT sfhStjSf* ISSI des morgens ten 10 ure zal aan «|F ''d STA DS-VENDUHUIS op de Maria- Plaats alhier  publiek worden verkocht: ""™t=^rr"" eeue groote kwantiteit zware ENGELSCHE HEESTERS  vele groen blijvende klimmende en treurende GEWASSEN  welke door schoone groei- en bloeiwijze bijzonder uitmunten. (1664) Alles iaags te voren aldaar ie zien. (1005) De Boekdrukker 11. JT. Cclderman to Meppel zal in het laatst dezer maand verzenden: HET DEEDE NUMMEE VAN DE MAANDELIJKSCHE LEERREDEN ONDER REDACTIE VAN Th. »E WITH Leeraar ier Christelijk Afgescheiiene Gemeente • . le Beetg/iM. Deze Leerrede van F. A. Kok  Leeraar der Chr. Afgescheidene Gemeente te Schoonhoven handelt over Jezus lijden in Getlisémané. Bij dat nommer zal ook verzonden worden i DE lste AFLEVERING VAN HET BIJBLAD ORGAAN VOOR DE CHR. AFCES. KERK. Bestellingen worden alom aangenomen. (1GG0) Bij H. HöVEKEB en verder alom bij alle Boekhandelaren des Bijks worden inteekeniugen aangenomen op HET ZENDELINGSBLAD VOOR DE JEUGD doob F. M. LOOMAN. De voornaamste gebeurtenissen welke betrekking hebben tot uitbrdding van het Christendom onder de Heidenen worden in dit Blad vermeld en door doelmatige lloutsneêplaten opgehelderd. leiere. Maani verschijnt een Nommer. Prijs per Jaargang f 1.20.",http://resolver.kb.nl/resolve?urn=ddd:000012987:mpeg21:a0015:ocr,4,ddd:000012987:mpeg21:p004,"De Nederlander : nieuwe Utrechtsche courant : (staatkundig- nieuws-, handels- en advertentie-blad) / onder red. van J. van Hall",850
3381718,1851/12/08 00:00:00,3233,ddd:010073110:mpeg21:a0012,http://imageviewer.kb.nl/ImagingService/imagingService?id=ddd:010073110:mpeg21:p002:image&x=2268&y=2086&w=1046&h=3233,ddd:010073110:mpeg21,3314,5319,2268,2086,4,"IN DE AFGELOOPENE 2ir STAATS-LOTERIJ •___* zijn ten Kantore van de Wed. M.C.CANTER & J.N.TÖÏ*I*^1*^ Beursstraat bij den Dam N"". 9 da volgende KAPITALE PRIJZEN en PREMIEN gev»K "".'•'SS : : : '/.1(W0'.pre.mi: : : : :<S • HO2O lg ■ 8950 » »$ » 13366 » *S_ » 1421 «*_ » 278 Premie »»$ • 10091 S » 14035 • »KÖ » 8141 ..."" • ' 2. ' 8864 » JS 113 . i*s • 12978 » l^jji. En N°. 19642 8261 10408 2207 19076 7412 11582 15278; % 9139. 454 11491 8182 7481 8915 8925 1374 7155 ieder/™ En zijn aan bovengemeld KANTOOR HEELE en GEDEt^u-' van LOTEN voor de Eerste Klasse en Doorgefournecrd voora"""" sen volgens Plan voorde 216 de LOTERIJ te bekomen. Ss» De Trekking zal beginnen Maandag 5 Januarij 18*f_____J- Voor een eenig HEKU wordt met Februarij e. k. gevraag1): Jrf' -.-GEMEUBILEERDE KAMERS voorzien van Vioe^irf; Gordijnen en de noodige Gemakken met de volle Kost en Bei1 op eene der Stadsgrachten bij Prot. Lieden met opgaaf van ""..s_s) Huurprijs  adres Bureau Handelsblad onder Lett. A. V. ' -WORDT GEVRAAGD in eene gevestigde ZAAK * pl. * Koopmans-Goederen en Gereedschappen eene waarde heeft va""l.tllt'l 25 Miile een medewerkend COMPAGNON dio eenig KaO!__ aanbreugen en zich met de Administratie wil belasten. Alleen op e'f|.iiK dig Onderteekende franco brieven met vermelding van het aan te Kapitaal zal regard geslagen worden. Adres Lett. H. 8. bij J- ViÖ*-^) VAN 11ETERÉN Boekverkoopers Hartenstraat N. 28 all______W__*""j; Une Maison considerable en Modes dans une des principale6 .jjJIP Royaume de'sirc trouver une DEMOISELLE comme PRE""? f_s OEfRIÈRE. Elle doit parfaitement connaitre son e'tat en C^t»*f' et Bonuets et être munie de certificats ou temoignages qu*'' tiiif ouvrage et ta moralité. Si Ion trouYe une persoue capable T-ibf* sera satisfnisant. S'adrcsser sous les Initiales M. A. 11. chez l*3uy3') L. F. J. HASSELS  Blaauwburgwal N . 10. _>% I On demando dans vn INSTITUT pour de Jeunes Dci^^l* Amsterdam versie mois de Janvier prochain: Uuc SECON™ J'l%; de la religion Protestante. La connaissance parfcite de la lanSJJ^jjA' caise cot avant tout requise. S-dresser lettres affranchie» cher f^ fr REUDLER Libraires Kalverstraat. TOR NÏEDWJAAnS-GESCHENK|S> gj_y>^=c^'~* TWEE buitengewoon schoone Opstaande PlAj*.t\iVU ' 7 Octaaf uit eene der voornaamste Parijsche I.» .^n"" worden TE KOOP aangeboden onder Fabrickuprijzen. Te hei' 2 J. J. ALLGaUER N. Z. Achterburgwal N. 85  achter het Po»*Bp PS« Voor de deugd dezer Piano's wordt 5 jaren gegnarandj_e__l__%~-**]j-tóv^Bi Koor gelegenheid is TE KOOP eene prachtige b^g --r^-Pt opstaande PIANO 6. Octaaf voor een extra L» 8 _'•*•*• %""-**____in Pulisanderhout en met schriftelijke Guarantie*»"" r_ K 3__ jaren betzelve is slechts Acht Maanden Bespee'""%j.P vragen bij den Boekh. C. L. VAN LANGENHUYSEN Sing^'j^ OüfDEN-POMADE.^ Dagelijks bijna ontvangt DE ONDERGETEEKENDE nieu*£ _„ f* van de uitmuntende weiking zijner SiR-IDEN-POMAl»*''' pel"" zeer onlangs oiitvftigen de Heeren MULDER en DOLMAN***' houders te 's Gravenhage onderstaanden Brief.  JÉP1' DELFT 9 Octobe** Mijne llkbbsh! . _»* d Ik twijfel niet of' het zal U aangenaam zijn te vernemen ___rr  het gebruik van slechts 2 Flcschjcs KRUIDEN-POMADE ïlf beb J_%. had te bespeuren dat mijn HAAR in groei zeer toenam j* #e**^ mede blijven voortgaan en thans heb ik als vroeger mijn P-.-^t J%*i terug; ik kom weinig in de Stad. anders zoude ik monde' a mijh dank betuigen dien Gij nu bij deze ontvangt en indie van dienst kondc zijn kunt UEd. aan deze publiciteit geven y-faW^ Gij zulks noodig acht met enz. Geteekend 3. VAN D*j* __0otj? Deze Brief en menigvuldige Verklaringe» die ongevra»» .^ o*> schillende Personen zijn afgegeven berusten ter inzage by > getcekende. d»{ ttfi Nog dezer dagen had de Ondergeteekende het genocg*. _nigd<*_. GOBERT alhier hem hare bijzondere tevredenheid net o[. het krachtdadig herstel dat deze KRUIDEN-POMADE haar in zeer korten tijd had te weeg gebragt. ttnof^ii^ G. VIANEN Spui te Amsterdam. Eigenaar en u» 1 Prijs ƒ 1 het Fleschje; dc Fleschjes worden Verzegeld wc Gebruik Verkocht; de Naam van den Eigenaar staat in aie &(# ( Nijmegen Gebr- Swemmelaar. 'sHage Mulder en vou r Breda Jufvr. Wierx Folla. Groningen E. G. Ii»»"" 'tt_. Leyden Mej. Caldenburg. _^caX .* - Hoorn L. B. Ruitenberg. Edam G. E. ISchrede*. . Leeuwarden S. P. Postma. Haarlem J. P. Karthaui** ^ 's Bosch F. L. WeUch.",http://resolver.kb.nl/resolve?urn=ddd:010073110:mpeg21:a0012:ocr,2,ddd:010073110:mpeg21:p002,Algemeen Handelsblad,1046
2248708,1851/01/13 00:00:00,1043,ddd:010072794:mpeg21:a0015,http://imageviewer.kb.nl/ImagingService/imagingService?id=ddd:010072794:mpeg21:p004:image&x=96&y=4251&w=2156&h=1043,ddd:010072794:mpeg21,2252,5294,96,4251,4,"MAATSCHAPPIJ VAN ONDERLINGE LEVEHSVERZEKERÏNfiTGEVESTIGD TE AMSTERDAM ' waarvan de grondslagen en berekeningen zijn goedgekeurd bij Koninklijke Besluiten vanSJunK IR47N« 90. 28 Januari) 1848N\10 en 10 JanuarrJ 1849 N«. «7. Definitief in werking getreden 1 M„rt i«4B Mdaum^ lnaa Bij deze Maatschappij kunnen gesloten worden de navolgende VERZEKERINGEN als- ' Wïlke M °TtrliJden *"" Ve""ekerde""°P JedW SeralaanzijneErvnofßegtverkrijgenden 1v* n^K MoVerlPen *<*««*««•* *™ « het *_ nogMn leven 4. _«_.__ 1 ""* °'eriÜden *"" berden bij het aldan nog in leven zö„ van r.SaïïSSK'ÏÏS.™ JAAR""JKSCHE *E*™> «*• *—* mj denver „„op-ingaan en door den Verzekerden tot liSoSr^ _f_ ™ het «enot ingaat zoodra de Verzekerde den tevoren __^?dSB?'SS™ °P Fran°9 aßnVrage Grat"" TWkrÜgbaarten *""*» d» ""^B* op deLeliegraeht btf deKeizersgracht NMOI _____ÜZ____ a! s. tobßT""""** DE TIJD voor 1851. Gemakkelijk te betalen! vnfiß 10 CENTS SSSs_Ï_Ao__*_s_?ï_S_s!SS___^__u__.<_^<ie <^l 6 Ce-**™°> -.telkensmet van BOEKEN en PLATEN van circa 8000 S_W «SBrnM* """" L°T' *""* VMI/ 1075 * UITLOTING van B« formaat  STeÉndRUKPEAAT Tpn^Elke Aflevering van DE TIJD bevat 40-50 pagina's f™Vl?f%tl staat het Portret van den Zendeling 6ü __L_W In _JW 9^?BTRBT' kCUrig Me»gelwerk «» allerlei Nieuws van den dag. In C^^EK VAN EEN REGTER. In Aflev ï komt „V • S komt eenc Plaat Scvolg<l naar ROCHUSSEN) bij een Tafereel uit het vai jb jj in Afle^^-3 komt eBn nieuw Portret van JENNY LIND met Tekst van FREDERIKA BREMER enz. Bik kan nu voor zien zeiven i»_ lIJU „„chaffen door de gemakkelijke cngoedkoope wijze van betaling. (74)",http://resolver.kb.nl/resolve?urn=ddd:010072794:mpeg21:a0015:ocr,4,ddd:010072794:mpeg21:p004,Algemeen Handelsblad,2156
1556852,1851/06/18 00:00:00,1726,ddd:010805316:mpeg21:a0003,http://imageviewer.kb.nl/ImagingService/imagingService?id=ddd:010805316:mpeg21:p003:image&x=952&y=37&w=902&h=1726,ddd:010805316:mpeg21,1854,1763,952,37,4,ADVERTENTIES. Provinciaal Geueotsiiop van Utrecht. BEKEIVDMAKIIVG. (4 916) /. De Griffier bij het Provinciaal Geregtshof van Utrecht maakt bij deze bekend dat door het Hof ingevolge de artikelen 17 en 18 van de wet op de Regtcrlijke Organisatie in het beleid der Justitie mitsgaders artikel 11 en volgende van het Reglement N°. 1  vastgesteld bij Koninklijk Besluit van den 14. September 1838 N°. 36 de dagen der gewone teregtzittingen  gedurende de vacantie-maanden Julij en Augustus van dit jaar zijn bepaald: voor spoed vereischende Burgerlijke- en Handelszaken op den 3 8 17 22 31 Julij en den 5 14 19 en 28 Augustus des morgens te half elf ure en voor Criminele zaken en Correctionnele appellen op den 4 71821 Julij en den 1 4 15 18 en 29 Augustus des morgens te tien ure. Utrecht De Griffier voornoemd den 16 Junij 1851. H. M. BEECKMAN. (4916) %* De Burgemeester van Ruwiel brengt ter konnisse van de daarbij belanghebbenden dat de HOUTEN BRUG nabij Ter Aa in den weg van Overholland naar Ter Aa gedeeltelijk moet worden vernieuwd en dus die weg voor 14 dagen wordt afgesloten in te gaan met Maandag den 23. Junij 1851 zoodat gedurende dien tijd de passage zal worden verlegd over den weg van de Vinkeveensche Zuwe door Ouda naar den grooten weg der eerste klasse n°. 3 bij Breukelen  en omgekeerd. Ruwiel den 17. Junij 1851. De Burgemeester voornoemd JAN van den ANDEL.,http://resolver.kb.nl/resolve?urn=ddd:010805316:mpeg21:a0003:ocr,3,ddd:010805316:mpeg21:p003,Utrechtsche provinciale en stads-courant : algemeen advertentieblad,902
1749304,1851/10/13 00:00:00,1948,ddd:010805368:mpeg21:a0017,http://imageviewer.kb.nl/ImagingService/imagingService?id=ddd:010805368:mpeg21:p003:image&x=957&y=2335&w=898&h=1948,ddd:010805368:mpeg21,1855,4283,957,2335,4,PUBLIEKE VERPACHTING ti mmmm nijensodl (5964) V °P Woensdag den 15 October 1851  des avonds ten zes ure in het regthuis aldaar is men voornemens te verpachten voor den tijd van drie jaren ingaande 1. November aanstaande HET REGT TOT HEFFING DER BRUGGELDEN aan de Vechtbrug  te Breukelen niet de daarbij behoorende Brugmanswoning waarin tevens eene Tapperij uitgeoefend wordt. Nadere informatie te bekomen bij den Burgemeester te Breukelen Nijenrode. VERKOOPING VAtTdUFFEL GASTORiNE BUKKING EN ANDERE LAKENSTOFFEN. (5965) *** Men zal op Dingsdag 14 October 1851 des voormiddags ten 10 ure ten kantore van het stads-venduhüis alhier publiek en om kontant geld verkoopen: Eene groote en aanzienlijke partij duffel  castorine  buxking en andere lakenstoffen in verschillende couleuren en van de nieuwste soorten; en het geen verder zal worden aangeboden. — Te zien Maandag 13 October van des voormiddags 10 tot des namiddags 4 ure. VERKOOPING VAN! IJZERWERK ■J_j§jr (596 6) %* Men zal op Donderdag 16 jMI October 1851  des voormiddags ten üenure-i ten kantore van het Stads-Venduhüis  aan de Mariaplaats te Utrecht publiek verkoopen: Eene groote partij Maaslrichtsche Deventersche Creveldsche en andere moderne Kagchels en Haarden Fournuizen Haardstellen Kolenbakken Potten en andere Ijzerwaren. De bij te voegen artikelen worden van heden af aangenomen terwijl alles daags te voren van 10 -i ure zal le zien zijn.,http://resolver.kb.nl/resolve?urn=ddd:010805368:mpeg21:a0017:ocr,3,ddd:010805368:mpeg21:p003,Utrechtsche provinciale en stads-courant : algemeen advertentieblad,898
1536906,1851/01/16 00:00:00,1591,ddd:010518215:mpeg21:a0014,http://imageviewer.kb.nl/ImagingService/imagingService?id=ddd:010518215:mpeg21:p004:image&x=1061&y=475&w=966&h=1591,ddd:010518215:mpeg21,2027,2066,1061,475,4,"*#* AANBESTEDING. Op Donderdag deu dertigsten Januarij e. k. des middags ten 12 ure  zal onder nadere approbatie in het Gemeentehuis te Hoogeveen bij inschrijving en opbod worden aanbesteed: Het Bouwen van eene KERK PASTORIJ en SCHUUR met de levering van alle de daartoe benoodigde materialen  in het Hollandsche Veld Gemeente Hoogeveen. Het Bestek en Voorwaarden waarnaar opgemelde Besteding zal plaats hebben zullen  van af den 18de"" Januarij e. k. ter lezing voorliggen: te Assen aan het Gouvernementshuis en in het Logement van Hofsté; te Hoogeveen  aan het Gemeentehuis en in het Logement het Rotshuis; te Meppei in het Heeren-Logement; teSmilde in de Feenhoop - te Coevorden in de Koppelpaarden - te Zwolle bij Schuijer buiten de Kamperpoort; te Dedemsvaart bij de Wed. Steenbergen. De aanwijzing in loco zal worden gedaan den dag voor de Besteding des voormiddags; terwijl nadere informatien zijn te bekomen bij den Heer fungerenden Hoofd-Ingenieur in Drenthe te Assen en bij den Heer Mr. A. 11. WITSENBORG te Hoogeveen. *#* PUIKE CIIINA'S-APPELEN in uitnemend goeden staat versch van Palermo aangebragt  met de Gezina Kapt. Schut bij uitslijting of bij partij buitengemeen billijk te Koop Wijnstraat Wijk 2 N°. 12 te Rotterdam. *** In 'sGravenhage is tegen I°. Mei aanstaande te HUUR of te KOOP: Een KAPITAAL DUBBEL HUIS gelegen op een' der aanzienlijkste standen voorzien vau al wat tot eene roijale Woning behoort met groote Tuin benevens ruim Achterhuis thans bevattende onderscheiden spatieuse Vertrekken met Stookplaatsen doch vroeger tot Stal en Koetshuis ingerigt geweest eu des verlangd  weder daartoe te appropriëren. Brieven franco onder Letter L. bij deu Boekverkooper P. IL NOORDENDORP te 's Gravenhage.",http://resolver.kb.nl/resolve?urn=ddd:010518215:mpeg21:a0014:ocr,4,ddd:010518215:mpeg21:p004,Opregte Haarlemsche Courant,966
2527857,1851/01/17 00:00:00,1789,ddd:010583917:mpeg21:a0003,http://imageviewer.kb.nl/ImagingService/imagingService?id=ddd:010583917:mpeg21:p002:image&x=64&y=3397&w=1413&h=1789,ddd:010583917:mpeg21,1477,5186,64,3397,8,"De BRIEF postmerk Leeuwarden 'T 5  inhoudende ƒ 40 in Muntbilletten is bij . . V wel ontvangen. GRIETMAN u ASSESSOREN vak MENALDUMADEEL i Convoceren bij dezen ten verzoeke van Kerkvoogden  de Hervormde Floreenpligtigen van het dorp Engelurn om te compareren op Dingsdag den 28 Januarij e. k.  des voordetniddags ten elf uren in de Kerk aldaar ten einde Kerkvoogden te magtigen tot den aankoop der Huizen c. a. staande ten gemelden Dorpe en kadastraal bekend in de Gemeente Deinum sectie A nos 26 en 606. G. F. Br. thob SCHWARTZENBERG ts HOUENLANSBERG. Menaldum  Ter ordonnantie ran dezelven  den 14 Januarij 1851. A. G. vak DALSEN FONTEIN.' GRIETMAN ei» ASSESSOREN vau MENALDUMADEEL: Convoceren door dezen de Hervormde Floreenpligtigen van het dorp Berlicum om te compareren op Donderdag den 80 Januarij e. k. des voordemiddags ten elf uren in de Kerk aldaar ten einde in overweging te nemen en te besluiten omtrent het door den Schoolonderwijzer gedaan verzoek  om bij een eventueel ontslag als zoodanig levenslang het vrije gebruik der Onderwijzers- Woning te mogen blijven behouden. G. F. Br. thor SCHWARTZENBERG sa HOUENLANSBERG. Menaldum Ter ordonnantie van dezelven den 14 Januarij 1851. A. G. vau DALSEiN FONTEIN.' GRIETMAN bh ASSESSOREN vak HEMELUMER OLDF.PiIAERT eu NOORDWOLDE roepen op door dezen ten gevolge van een ingekomen schriftelijk verzoek de Floreenpligtige ingezetenen van den dorpe Hemelum om te verschijnen in de Kerk aldaar op Dingsdag den 28 Januari) 1851  voormiddao-s ten elf uren ten einde op te nemen en na weibevinding te sluiten de Rekeningen des Floreen-ontvangers van dien dorpe met Sint Petn 1850 verschenen ingesloten en daarna om voor dat zelfde dorp eenen nieuwen FLOREFtM-ONT VANGER te benoemen. Koudum  Grietman en Assessoren voornoemd den 14 Januarij 1851. E. vau ASBEC*. Ter ordonnantie van dezelven J. ALBARDA GERLSMA Secret YERHÜRIN G op Maandag 27 Jannarij 1851 's voormiddags elf uur in de Koslerij der Hervormde Gemeente te Sneek  van : a. Elf bunder 22 roede 50 el GREIDLAND te loïng_; thans in huur bij IVatze Sjoerd» Postma. • b. Zeven bunder 54 roede 80 el DITO in de Gee.iws-Mirldelhem onder IT«--brechtura; thans bij Douwe Jan» Boschma in huur. Alles behoorende aan de Kerkvoogdij der voormelde Gemeente en i_ ~. i n n . ■ fnv i | ""-1' t. ddll* vaarden St. Petri IBal.",http://resolver.kb.nl/resolve?urn=ddd:010583917:mpeg21:a0003:ocr,2,ddd:010583917:mpeg21:p002,Leeuwarder courant,1413
7046800,1851/09/16 00:00:00,4819,ddd:010979946:mpeg21:a0016,http://imageviewer.kb.nl/ImagingService/imagingService?id=ddd:010979946:mpeg21:p003:image&x=47&y=54&w=2983&h=4819,ddd:010979946:mpeg21,3030,4873,47,54,4,TEN vau'luscriptic (OrigineelVa 5 pCt. .Vierde Serie ieder Biljet a 500 Zilver Koebels Kapitaal genummerd (ter regter hand) als volgt: 0 5037 1081)2 15492 £0839 25394 30220 35247 d 2 5044- 10938 15490 20861 26416 30507 35294 128 5077 11033 155117 '2ÓBOB 25555 30598 35314 132 5091 11079 151187 -20808 25(124 30632 35319 230 5222 11125 15745 20070 2571Y 30(175 -35338 303 5344 11137 15837 21008 25731 30720 35446 449 5353 11263 15885 21034 25739 30750 35513 452 5355 11270 15883 21000 25706 30801 35519 534 5304 11-325 15970 2101)2 25812 30813 35610 543 5376 11416 10017 21186 25819 30810 35024 514 5100 11503 10241 21214 25813 30917 35862 555 5167 11053 10212 21219 25808 30951 35892 091 5173 11055 10200 21235 25897 30908 35896 715 5504 11087 10312 21275 25900 30974 35921 718 5511 11090 16337 21337 25915 31002 35938 819 5043 11700 10307 21380 25922 31010 35955 822 5056 11722 16113 21480 25938 31055 30009 828 5732 11745 10437 21189 25900 31080 30038 858 5703 11818 10547 21510 25903 31100 30050 903 5807 11855 10005 21550 20004 31100 30052 1003 6824 11800 10009 21680 20119 31180 30077 1011 5818 11802 10730 21722 20332 31327 30079 1093 5808 11910 10773 21730 20318 31405 30096 1097 5928 12078 10820 21740 20178 31400 30114 1276 5941 12147 10869 21756 20483 31495 30199 1292 0013 12238 10927 21758 20535 31522 30253 1311 0072 12290 17034 21783 20504 31501 30300 1321 0102 12310 17054 21805 20585 31080 30350 1389 0128 12305 17079 21900 20011 31728 30359 1419 0150 12370 17177 21937 20707 31712 36361 1446 0102 12418 17202 22052 20708 31777 36411 1515 0222 12474 17213 22005 20790 31787 30188 1589 6298 12500 17217 22084 20803 31792 30551 1009 0350 12512 17325 22199 20811 31797 30038 1023 0435 12516 17353 22208 20812 3182!) 30095 1625 0437 12504 17357 22265 20815 31900 30724 1041 0488 12590 17547 22290 20873 31974 30733 1095 0189 12592 17503 22298 20908 32044 30773 1873 0493 12039 17595 22337 27010 32000- 30803 1888 0507 12066 17014 22371 27081 32004 30824 1904 0510 12095 17021 22408 27097 32247 30875 »929 0584 12097 17070 22474 27105 32250 30920 1945 0749 12709 17701 22541 27133 32295 36983 1962 0751 12744 17749 22655 27220 32309 37021 201) 6798 12764 17807 22666 27275 32337 37058 2039 0840 12773 17834 22712 27287 32342 37009 2051 0872 12777 17879 22721 27292 32372 37166 2100 0887 12784 17892 22824 27331 32409 37333 2141 0893 12791 18020 22841 27395 32180 37474 2180 0971 12871 18036 22847 27105 32498 37482 2198 0992 12897 18054 22868 27124 32519 87544 2310 7015 12910 18159 22809 27151 32550 37577 2327 7130 12921 18211 22874 274/ il 32500 37627 2308 7184 12928 18241 22897 27179 32694 37032 2389 7180 12937 18309 22950 27554 32095 37001 2423 7199 12998 18300 22981 27031 32872 37002 2500 7211 IIJOO2 18182 22998 27735 32972 37717 2527 7231 13112 18501 23132 27744 32981 37X12 2552 7238 13122 18529 23103 27749 33018 37819 2553 7317 13120 18543 23180 27750 33024 37801 2580 7380 13104 18589 23201 27813 33039 37875 2018 7383 13165 18001 23320 27840 33010 37945 2031 7384 13234 18045 23338 27888 33121 37972 2035 7397 13281 18055 23300 27953 33153 38012 2078 7435 13298 18082 23375 27907 33100 38087 2809 7430 13324 18711 23381 27982 33217 38088 2880 7503 13377 18731 23410 28005 33218 38117 2897 7529 13137 18758 23420 28092 33222 38207 2925 7530 13440 18838 23447 28099 33233 38235 3027 7539 13471 18921 23596 28123 33251 38239 3047 7022 13505 18927 23603 28125 33264 38303 3088 7005 13574 19027 23609 28142 33321 38397 3134 7073 13587 19070 23028 28190 33325 38403 3156 7083 13015 19073 23081 28356 33331 38177 3100 7928 13046 19090 23709 28439 33403 38499 3251 7955 13668 19159 23732 28463 33408 38593 3271 8000 13092 19233 23803 28407 335*78 38599 3330 8099 13786 19300 23816 28479 33590 38059 3336 8245 13850 19351 23820 28543 33594 38666 3386 8259 13851 19392 23826 28621 33655 38090 3410 8281 13871 19394 23873 28033 33811 38090 3129 8322 13880 19102 23891 28043 33847 38708 3415 8340 13881 19140 23977 28001 33852 38750 3503 8351 13890 19511 24021 28779 33886 38754 8535 8302 13905 19624 24030 28784 33977 38764 3034 8375 13926 19631 24002 28787 33980 38797 3057 8398 13904 19038 21085 28817 31053 38819 3081 8417 13981 19043 24101 28919 34071 38813 3771 8496 13987 19652 21178 28951 34101 38878 3791 8673 14002 19702 24192 28975 84189 38882 3882 9172 14011 19714 24221 29032 3119! 38897 3887 9332 14077 19744 24247 29005 34200 39026 3911 9338 14111 19748 24296 29107 31281 39126 3973 9300 14155 19844 24345 29120 34295 39227 3979 «Jfjoo 14243 19848 24350 29132 34325 39239 4000 9019 11257 19910 24304 29153 31331 39288 1021 9718 14328 19954 '21389 29176 34368 39316 1027 9811 14464 19905 24106 29184 34436 39320 1028 9851 14523 20052 24483 29194 34521 39433 4093 4)879 14538 20083 24497 29300 31552 39472 4095 9912 14543 20086 21539 29327 34619 39474 4200 9953 14591 20133 21552 29330 34028 39498 4209 9955 14030 20149 24041 29338 31051 39503 4331 9909 14775 20251 21075 29317 31708 39517 •1447 9988 14790 20203 21724 29149 34701 39539 4402 10083 14807 20204 24713 29496 34709 39564 4476 10103 14873 2027-4 24762 29520 34819 39567 4480 10118 14878 20324 24773 29704 34825 39586 4535 10210 14902 20358 24781 29705 3-1881 39021 4547 10220 14915 20359 24828 29714 34901 39085 4021 10172 14910 20375 24852 29726 31905 39701 4704 10278 14970 20452 24911 29789 31933 39703 ■4724 10294 15015 20457 24914 29849 35103 39704 4734 10335 15033 20532 24974 29904 35118 39732 4759 10199 15039 20570 25052 29909 35132 39770 4802 10581 15079 20026 25117 30030 35153 39777 4879 10017 15116 20745 25174 30043 35170 39778 4890 10007 15342 20760 25210 30007 35176 39869 4917 10073 15433 20780 25293 30150 35184 39935 4952 10735 15455 20782 25321 30189 35230 39939 5020 10700 15472 20821 25380 Diegene dezer Biljetten welker Aflossing niet in de maand November 1851 bij de Commissie van Amortisatie lvoornoemd ingevorderd wordt zullen ook aan dezelve ..i . \.mmmmmmmm*mmmmmm gende termijnen van Rente-Betaling bepaaldelijk in de maanden Mei en November; terwijl echter het genot van Interest voor deze 9G5 Biljetten  in ieder geval  den Eersten November 1851 Oude Stijl ophoudt. V De Heeren HOPE & Co. KETVVICH & VOOMBERGII en Wed.W. BORSKI brengen ter kennisse van de Houders van Certificaten hunner Administratie gevestigd op Originele Blljcttcavan Inscriptie Aex Russische Leening e\de Serie rentende Vijf ten Honderd in Zilver Roebels dat van de gezamenlijke Biljetten  uitmakende liet fonds dezer Administratie te St. Petersburg 590 STUKS UITGELOOT zijn om in de maand November aanstaande aldaar te worden Afgelost  met 500 Roebels voor ieder Biljet; dat dien ten gevolge onverwijld  ten overstaan van den Notatis Mr. J. COMMELIN en Getuigen eene WJET' LOTJE JWG zal geschieden van even zoo veel Nummers der door hen Uitgegevene Certificaten ieder van eene gelijke Som van R. 500  en waarvan de Nummers nader na afloop der voormelde Uitloting zullen worden bekend gemaakt. Amsterdam den 13 September 1851. DERDE EXAMEN n PRIJSUITDEILUG van de muziekschool uitsluitend voor <S)ttbcvuri js op bc {Hand^ovUj zal gehouden worden op Woensdag den 24 September 1851  des avonds ten zes ure  in de Zaal tot Nut van 't Algemeen in den Oppert. F. T. VAN GE L DJI R. V SCHOUTEN en AMBACHTSBEWAARDERS van COOL SCIIOONDERLOO en BEUKELSDIJK alsmede van OOST-BLOMMERSDIJK brengen bij dezeter kennis van Ingelanden  dat het iW«*«>eOfIiTWERPKEGLEMENT voor het Hoog Heemraadschap van Schicland van heden tot 18 September eerstkomende  van des voormiddags tien tot des namiddags twee ure ter inzage zal liggen in de gewone Vergaderkamer van gemelde Besturen in het Gebouw der Arrondissements-Regtbank te Rotterdam. Ingelanden welke deswegens eenige aanmerkingen hebben  gelieven dezelve vóór of op dien dag schriftelijk franco aldaar in te zenden. Rotterdam den 18 Augustus 1851. Schouten en Ambachtsbewaarders voorn. P. G. J. HOOG VAN TER AAR Vt. Wordt gevraagd tegen November aanstaande eene TWEEDE- of WERKMEID van de Protestantsche Godsdienst  goed kunnende Linnen- Naaijen en met de Wasch omgaan en van goede Getuigenissen voorzien. Adres Kruiskade  n.° 57. *ien llccp* van gevorderden leeftijd MM M 7 vralgt tegen den eersten Mei  Twee w ' GEMEUBELEERDE KAMERS met Kost Bediening en Gezellig Verkeer. Opgave vanSrand en Prijs onder letter N bij de Boekverkoo°pers M. WIJT en ZONEN.,http://resolver.kb.nl/resolve?urn=ddd:010979946:mpeg21:a0016:ocr,3,ddd:010979946:mpeg21:p003,Rotterdamsche courant,2983
2206146,1851/02/05 00:00:00,2454,ddd:010805258:mpeg21:a0022,http://imageviewer.kb.nl/ImagingService/imagingService?id=ddd:010805258:mpeg21:p004:image&x=977&y=1776&w=899&h=2454,ddd:010805258:mpeg21,1876,4230,977,1776,4,TUSS. HEN DE DORPEN DRIEBERGEN EN DOORN ■___.____: __-_J-LJ-__ fajuuuit (3660) *jf* en terstond te aanvaarden een zeer aangenaam gelegen BUITEX  geschikt voor Zomer- en Wiutervurblijf met Tuin een halve bunder Bouwland Stal en verdere gemakken. Nadere informatie by den Notaris VAN SCHERMBEEK te Utrecht. ________——_________________________- .__. _____ ____C BCJ ___JJ____ (3661) %* het Buitenverblijf genaamd CITIO te Doorn; aldaar te bevragen bij den rentmeester H. v. ENGELENBURG. (3662) •/ Een JONG MENSCH de namiddagen ter zijner dispositie hebbende zag zich gaarne belast met het bijhouden vau Boeken of wel met eenig Copieerwerk. Hierop reflecterende adresseré men zich bij franco brief Lett. V. E. aan het bureau dezer Courant. NATIONALE i¥SSLITSE. PLAATSVERVANGERS. NUMMERVERWISSELAARS. (3 66 3) *»* Dewijl anderen die vroeger in mijne dienst waren en daaronder de Heer P. D. C. Luca niet meer voor mij ondergeteekende werkzaam zijn zoo is het noodig - dat ik JAN SCIIE RV ï bekend i_ake  dat ik in het huis Wijk G No. 469 op de Vuilesloot te Utrecht voortga met het bezorgen van plaatsvervangers eu nummerverwisselaars voor de Nationale Militie. Daar mijn vader en ik gedurende veertig jaren onafgebroken dit beroep hebben uitgeoefend is het niet uoodig eenige aanprijzing omtrent onze bediening hier bij te voegen. J. SCIIERFF. OESTER BËRIGT (3664) V A. VAN BROEKHUIJZEN in de Lijnmarkt te Utrecht heeft heden aangekregen eene extra partij versche blaoke groote Zeeu WscSie Texelsclie en Engelsche Oesters j vette gerookte 'Winterzalm Engelsche Bokking en dito Sprot Spaa__SC_ie CaStangeS  Suiker zoete Cinaasappelen  Citroenen  opregte Bergsche Anehovisch fijn zoute Bootsmans Winterharing fijne en dito gemarineerde beste blanke gebeukte Leng- en Rond-Stokvisch en alle soorten van Minerale Wateren echt Pilnaur en Saitschitzer Bitterwater en fijne Eugelscbe Bieren.,http://resolver.kb.nl/resolve?urn=ddd:010805258:mpeg21:a0022:ocr,4,ddd:010805258:mpeg21:p004,Utrechtsche provinciale en stads-courant : algemeen advertentieblad,899
966735,1851/09/01 00:00:00,1023,ddd:010518407:mpeg21:a0029,http://imageviewer.kb.nl/ImagingService/imagingService?id=ddd:010518407:mpeg21:p004:image&x=2065&y=3839&w=945&h=1023,ddd:010518407:mpeg21,3010,4862,2065,3839,4,"V Willer's Haar-Olie. Wie deze lIAAR-OLIË naar voorschrift gebruikt in»?..' rust eene goede uitkomst verwachten. Wij hebben zoo vele be*N. van hare groeikracht dat wij aan een gelukkig gevolg nie' . twijfelen dur»en. Onder de vele g.edts uitkomsten  die nie"". vereunde bekend te maken herinneren wij aan d:e van den *. BRUIJN v. MAARSEVEEN  van den Baron Van WASSBr-f^ St. PANCRAS van den Oldenburgschen Dichter KOBBE. ■*- hadden zich over eenen even voorspoedigen als weelderigen Sro \\ verheugen  en wel onder de weikwaardigste omstandigheden» .- hebben voorbeelden gehad dat iemand die reeds als I_'n Haar verloren had het na verloop van meer dan twintig j*__t' mann. lijken ouderdom door het gebruik van Wild-""*' OL.ÏÈ terug eekiegen hreft. . Het voorschrift hoe het gebruikt lunet worden gaat bij ' Flescbjc. „ l)c Heer WILLER heeft om .ijne Olie beter van de ""»*.. -08. soorten te onderscheiden  den vorm zijner Flesschen eenigz|TlS anderd en op het clas staat aan de eene ziide: _.•»* K.WILI.GR „ .  .. HARUfHI* M aan de andere zijde: rei ZUBICH Daarbij sullen ze in het vervolg voor 1 % Gulden verkocht den die vroeger ƒ 2 gekost hebben. De Flesehjes vau / 1 ■*- *"" suprimeerd en kom; n niet meer in den handel. imnd»1 leder Fleschje van iy Gulden heefteen Boekje in bet Holl» gedrukt met Voorschriften &c. in het Omslag dat roet e. Ne fc sclinwiiig op rma bandj.; beplukt is. Ze. -/.ijn te verkrijgen VERKOOP lïl.IS en de bekende Depots. __J~7:7—< TTHailrkmbtjTC-I_7~EN~_iCHËiTE bn 'I ONE ■",http://resolver.kb.nl/resolve?urn=ddd:010518407:mpeg21:a0029:ocr,4,ddd:010518407:mpeg21:p004,Opregte Haarlemsche Courant,945
3958650,1851/08/08 00:00:00,2778,ddd:010583975:mpeg21:a0013,http://imageviewer.kb.nl/ImagingService/imagingService?id=ddd:010583975:mpeg21:p006:image&x=47&y=2235&w=1425&h=2778,ddd:010583975:mpeg21,1472,5013,47,2235,6,VERKOOPING var eeue BAKKERIJ te WEIDUM.— Be Notaris P. BOLTJES te Grouw zal ten verzoeke van den Beer R. BLOEMBERGEN SANTEE Deurwaarder te Leeuwarden ten gevolge autorisatie van de Arr. Begtb. te Leeuwarden op Woensdag den 18 August os 1851 des namiddags ten 3 uur ten huize van S.Bangma Kastelein te Weidurn onder uitloving van strijk- en verhooggeld  provisioneel verkoopen : Eene hechte en voor eenigen tijd vernieuwde HUIZINGE met de ERVE van dien staande te Weidurn waarin sedert ettelijke jaren eene welbeklanie Bakkerij is uitgeoefend ; thans in gebruik bij B. IJ. de Vries en vrij te aanvaarden op den 12 Mei 1852. Breeder bij Billetten omschreven  welke met inlichting der verkoops-voorwaarden zijn te vernemen ten Kaulore van gemelden Notaris. YERKOOPING vau cc™ ZATHE en LANDEN oude» RINSUMAGEEST de Bonderd genaamd. — Be Notaris P. BOLTJES te Grouw zal op nader ie bepalen dag en plaats verkoopen: Eene uitmuntende ZATHE en LANDEN nabij de Dokkumer Ee onder Rinsumageest de Bondera.genaamd ; thans in gebruik bij S. D. Hellinga groot 38 bunder 20 roede alles Greidland; te aanvaarden op Petri en Mei 1852. EENE BE E TJALK. De Notaris D. de VRIES zal op Woensdag den 13 Augustus 1851  des nademiddags om S „ren in het Tolhuis le joure publiek verkoopen: liet ten jare 1848 van de Werf der Scheepsbouwmeesters Simon Geerts en Zn. te Joure nieuw uitgehaalde HEK'I JALKSCHIP genaamd de Vrouw Eeke groot 76 ton met deszell's algeheel oompleeten en besten INVENTARIS zoodanig als bevaren is geweest door wijlen Schipper Jelle S. Atema en thans is gelegen aan de Werf van boyengen. Bouwmeesters bjj wie hetzelve inmiddels UIT DE HAND TE KOOP is. ZEGT BET VOORT. Mb. J. HANEKUIJK Notaris te Harlingen. zal op Woensdag den 13 Augustus 1851 provisioneel en op Woensdag den 27 Augustus 1851 finaal telkens des avonds ten 7 ure precies in het Heeren Logement van ü. Uinnema aldaar  publiek presenteren te verkoopen : 1. Eene STALLING met HOOIBERGPLAATS c. a. staande en gelegen in dc Scheerstraat te Harlingen  aldaar gequotd. wijk D no. 2 Kadaster sectie A no. 707; thans verhuurd aan Jacob E. Blanksma tot den 12 Mei 1855. 2. Eene plek GRONDS c. a. gelegen in de Sint Jacobistraat te Harlingen aldaar gequotd wijk C no 136 Kadaster sectie A no. 2326 ; nu verhuurd aan L. Boekers tot den 12 Mei 1857. 8. Eene WONING c. a.  to Harlingen aan de Stads Vesten aldaar gequotd. wijk H no. 148 Kadaster sectie A no. 1908; thans verhuurd aan F. Wilkes tot aan den 12 Mei 1852. Nadere Informatien te bekomen ten Kantore van den Notaris HANEKUIJK voornoemd. De Notaris MANN  te Workum zal op autorisatie van de Begtbank te Sneek in het openbaar op den 13 Augustus 1851 feilen ten Societeithuize van' Loickering te Workum en den 27 dier maand finaal ten huize van Schotanus aldaar telkens des avonds 7 nor presenteren te verkoopen: Eene uitmuntende KOOPMANS HUIZINGE. met EKF en grooten TUlNcnm annexis staande en gelegen op een der beste standen van Workum aldaar kadastraal bekend in sectie A nos. 7 en 8 met eene totale iohoudsgrootte van 18 roede 54 el ; bewoond en gebruikt geweest door wijlen de Weduwe W. T. Faber en onmiddelijk na de finale toewijzing to aanvaarden ; alles breeder bij Billetten omschreven. Ycrkoojuug te Sexbierum. De Cand.-Notaris WITHOLT to Sexbierum zal. ten overstaan van den Notaris STEENSMA  op Zaturdagen den 9 Augustus 1851 bij de provisionele toewijzing en den 16 derzelfdo maand bij de finale pa Iraslag telkens des namiddags te 5 uren ten huize van den Kastelein Zaaqsma te Sexbierum wat het eerste perceel betreft op autorisatie der Regtbank  publiek bij strijk'- en verhooggeld present' ren te verkoopen : 1. Een WINKELHUIS en ERF no. 9 te Sexbierum; bij Tjerk van Dijk en Riemer Bibma in huur voor ƒ 50. 2. Eeoe HUIZINGE en ERF aan de Pielersbiernmer Taart onder Sexbierum aldaar gekwoteerd met no. 134; bij Joris Frielema en Willem Bleeker in huur voor ƒ 52 in het jaar. Beide perceelen den 12 Mei 1852 te aanvaarden. ÏjVn INTREK te BI DR : bestaande in twee Kamers en eene Slaapkamer met m fraai uitgezigt in de Schrans bij Leeuwarden den 12 November aanstaande te aanvaarden le bevragen bij C. BOK MA aldaar.,http://resolver.kb.nl/resolve?urn=ddd:010583975:mpeg21:a0013:ocr,6,ddd:010583975:mpeg21:p006,Leeuwarder courant,1425
1009812,1851/03/10 00:00:00,1634,ddd:010247980:mpeg21:a0035,http://imageviewer.kb.nl/ImagingService/imagingService?id=ddd:010247980:mpeg21:p004:image&x=1637&y=1783&w=618&h=1634,ddd:010247980:mpeg21,2255,3417,1637,1783,4,Anker. Flesch. Drey Madera C. ... ƒ6O ƒ 1.50 ii ii .... „ 80 / 2.00 Spaansche Wijn . . . . „ 50 „ 1.25 o ii ¦ • • • o 60 ii 1.50 Malaga le qie' . . . . „ 40 u 1 00 // ii .... ii 50 „ 1.25 Constantia „ — i 4.00 Tintwijn . „ — „ 4 00 Kruidewijn „ 40 u 1.00 Moselwijn „ 32 „ 0.80 iiodenhéimer Rhijnwijn „ 30 ;/ 0.75 Laubenlieiiner „ „30 // 0.75 1842 / „32 „ 0.80 Niersteiner / „ 36 „ 0.90 llutlesheimer „ „ 40 „ 1.00 Scharlachberger „ „ 40 „ 1.00 MarcobrunnerHooliheim. 50 n 1.25 Liehfraumilch n „ 60 i l 50 Geisenheimer „ „ 60 n 150 Rauentiialeißergw.r/ „ 80 u 2 00 lludeslieïuH-r u u t 80 „ 2.00 Johannesberg. n u „ —/ 3.00 Steiberger Cabinetwijn „ — (/ 4.00 Cognac Brandewijn A. „ — „ 1 .Oij b „ B. „ — „ ].25 ii ii oude C. „ — „ 1.50 Cogn.Brand heel oude D. ? — „ 2.00 Witte Fransche Bwiju A. „ — „ 0.60 (/ Barcelona. . . B. „ — „ 0.70 ii ii C. „ _ „ 0 80 Voorloop van u ~ n 1.20 Armagnac ? — (/ 0.80 Jamaica Rum Arac. . . „ — „ 100 Siroop de Punscli van Rum ? 1.10 ii o of Arak „— „ 1.20 // II n — ;/ 1.40 Slemp Sirop ? — „1.10 Limonade /'•¦¦..„ — / 0.90 1 Extr. d'Absiut Suisse . . „ — „ \ .60 jßirschenwasser ••../ — ? 1.60,http://resolver.kb.nl/resolve?urn=ddd:010247980:mpeg21:a0035:ocr,4,ddd:010247980:mpeg21:p004,De Tĳd : godsdienstig-staatkundig dagblad,618
3279088,1851/04/19 00:00:00,3056,ddd:010072890:mpeg21:a0018,http://imageviewer.kb.nl/ImagingService/imagingService?id=ddd:010072890:mpeg21:p004:image&x=2272&y=2144&w=1073&h=3056,ddd:010072890:mpeg21,3345,5200,2272,2144,6,"KOIIDWATER GBBBES-INRIGTIH6. LAUBACH BIJ COBLENZ. Dit sints 1841 in vollen bloei zijnde ETABLISSEMENT is liet ;ehecle jaar tot ontvangst van hen die zich door deze hoe langer-°8 neer bekend wordende geneeswijze willen herstellen geopend; gelegefl lan het aangenaamste en pitoreske gedeelte van den Rhijn £ uur vall _oblcnz en Stolzenfels biedt hetzelve bij eene gezonde zuivere Be.8"" ucht een zeer aangenaam en afwisselend Verblijf. Dekostcn zijn bi_-lc' nen betaalt naar gelang der Kamer voor Kost Inwoning Baden» Medische Behandeling enz. in eens Th. 10 a 13 Pr. Ct. of ƒ 18 & "" tfed. Ct.per week; jaarlijks wordt hetzelve reeds met andere Vrcerna?"" ingen door \e_su_u_l_uclo Hollanders bezocht. Nadere informatien 0 e verkrijgen op Franco aanvragen bij den Geneesheer vau d___ _n™ 2' ing den Heer Doctor PETRI of bij den Inspecteur den Heer HEIS. (6284) Li W AM. JL __> _______• bet Schwartzwald zijr/'vc-ortduend in alle Soorten als: Bommen Dubbele Enkele Halve Kwart-0 :n Raampjes enz. tot de minst mogelijke prijzen te bekomen. Win^"" iers genieten bij groote Partijen nog een extra Rabat. «S. HARTMAN!. (6233) Plantage Middellaan N°. -9- __ STUIF TSF_ÏP Het BEST_ÜR der MAATSCHAPPIJ **! iHUWII- ZSNI4-MSJNEN van den Ouden Berg M juik heeft dit nieuwe FABRIEKAAT in verschillende Sortering** > jij de Ondergeteekenden verkrijgbaar gesteld alwaar Monsters en aa_* vijzing van het gebruik zijn te bekomen. Amsterdam 31 Maart 1851. SURIE & LBNGEMA--» (5276) Oude Schans _.». 15. VENTE POUR SORTIR D'INDIVISION D'üN SUPERBE HOTEL a LiÈGE. Le Jendi 15 Mai 1851 _ 10 heures du niatin lc Notaire PAQÜ. ixposera en vente publique aux enchères en son e'tudc rue Sonver»1.11 Pont a Liege LE VASTE HOTEL _.\_NBE_IBOURG . cl' levant PRÉFECTURE sis _ Liège avcc grande Cour deux portcs cochet. lonnant: I'une sur le quai de la Batte I'autre sur la place St. Barthclcß""' ;r.s beaux Salons dont I'un tout Tapisse' en Glaces grandes remise» ** -curies Fontaine et tout ce qui est necessaire au Service d'une gr__ue naison; il peut sans frais être divise' en deux grandes habitations distinct<* On peut dans Fcntretemps I'acquérir de gre'-h-gré avec facilite' ""e paiement en s'adressant au dit Notaire. (47____)_. PAPIER D'ALBBSPBYRBS. l&£^i3£S& MMrs. les Piiarmacicns Dépositaires de France et de I'Etrangcr. Depßl* plus de 30 Ans ce Papier est toujonrs recommandd comme lc meil'oo' e'pispastique pour I'entretien facile régulier et inodorc des VESBCA* TOIRES. Pour _vitcr les contrefacons nuisiblcs et dangercuses lf' personnes dont les Vesicatoircs iront mal sont priées dc s „dresser direc* tement _ Mn. ALBESPEYRES. (fU2l]_. •■__ 1 VERKOU-- HEDEN. Griep Hoest en aan- B_ I_llTl_ f... «ocningen der Borst. De Professoren der Ge* _____ __.___a\_'_-- nceskundige Faculteit hebben de doeltrcfTen-' heid van dc SIROOP en de PATE van NAFK tegen deze Ongesteldhedcß officieel geconstateerd. — Depot te Amsterdam bij Mcjufvr. TENBACb' Banketbakker en den Heer B. ADAMA eenige Dc'p.thouders. Mcfl hoede zich voor dc namakingen en overtuige zich dat elk artikel af kon*' stig zij van het HUBS B-ELANGB-ENIKR te Parijs. (62_2)__. JE DONNE 20000 Frs. _ qui prouvera que les milliers de certificats quej'aire^s dc person-f* honorablcs ctdont mon prospectus donne vn speren sont faux et dc'ponf"" vvs de foi lesquels attestent que par mon EAU ©E LOB elles se .-.* fait repousscr et cpaissir la chcvelure sur de 3 t.tcs chauves n:_me dept""' plus de 25ans. Ainsiplusde têies degarni__ de cheveux pourvn qu'on -■>"" la contrefacon en s'adressant _moi LEOPOLO LOB Chimiste _ P_r_» rue Saint Honoré N .281 oh lon trouve des flacons d'EAU BE L©_» a 5 et 10francs dont vn suffit pour regenérer les cheveux eten arr-tf* la chflte. On exp-die. (Affranchir). (4191^. 7~~Z~~ . . NAAR BATAVIA IK y«» lig' m Lading en zal vermoedelijk in April Vertrek' __AMrM_t _-n! Het snelzeilend gekoperd Twcedeks BAR**"" JföMÉfL SCHIP VAN DEU WERF Kapt. B. VAN DE*» *^-iaigE_J--C^ PLAS bijzonder ingerigt voor Passagiers. Adres by <«_i__**i__--_*ic-' de Reeders BOISSEVAIN fr C. en bij de Kar.»"" doors F__DER KINDEREN en ZOON te Amsterdam. (4782)___ NAAR NEW-YORK zal 3 Mei e. k. ver* Jil|isi_ trekken: Het Snelzeilend Gekoperd NEOERL. BVI-K' gMBB__ SCHIP »EENSGEZINDHEID"" Kapt. K. HAASNOOÏ. MBHW""™hebbende bijzonder ruime en gemakkelijke Inrigting-0 voor Passagiers. Adres voor Passagiers en Goederen bij de Cargadoor* WEIILBURG & 15i.KUI.ER en B. D. BOSSCHER Alhier -fl WAMBERSIE & CROOSWIJCK te Rotterdam. (G 248) (VERVOLG DER ADVERTENTIEN ZIE BIJVOEGSEL.)",http://resolver.kb.nl/resolve?urn=ddd:010072890:mpeg21:a0018:ocr,4,ddd:010072890:mpeg21:p004,Algemeen Handelsblad,1073
2129229,1851/01/15 00:00:00,1977,ddd:010072797:mpeg21:a0024,http://imageviewer.kb.nl/ImagingService/imagingService?id=ddd:010072797:mpeg21:p004:image&x=2267&y=87&w=1077&h=1977,ddd:010072797:mpeg21,3344,2064,2267,87,4,"i^™S ™* Voi'hrt gebr_ik binnen^ dieS daarennoven d° a^3eil«n» verwarmend als de VILTSCHOE*i bevorderen. ' Zljne Porositcit eene geregelde transpiratie help» gcvoer1inv^r &*■« en Vilten Zolen beide Soorten weder met VILT Klluren metkl °n' Vrouwe» en Mannen in lichte en donkere Am„erdam vl ""e D. '° dessins Sedrnkt en in het effen zwart voorhanden' veiKoophuis. Kampen Mej. M. Vooght. Alkmaar J. Bronaerfr'L'Uegr- ?<»Yoréen J- Savenye. Assen H. p. aTp„°Z' Leyden A. Dirk». Almelo T. J a'7l' Leeuwarden A. Steingrover. Arnhem Tikkel * J' Rekkers. 1 Bergen-op-Zoom' CW v . Muldelburg J. C. Kries. . e v oom uh. Veraart. Meppel H. Geerligs. ! 's Bosch F. L Wekcb^18 Monnikendam P. de Boer Pz. - Breda Wed. WierW t- u Nijmegen Gebrs. Swemmelaar. Delft'J. T. Waguer? w- ' _A W*- Deventer D. L Jonker * r. Nieuwe Diep T. Groen. Dordrecht J.VethJr * ' ?«**!__ Gebr. Polak. Doetinchcm W• T -r ""  Roermonde J. J. Romen. ' Dokkum j' oP-_ï%epi Rotterdam J- A. Klinger en C | Franeker K. Drager. ' Schiedam Mej. A. B. Roepius. ' Gfonincen r rw ' Thiel L. Ulfelder. l -ronmgen G. Cop.nga. _ - Maas_ ' Gorinchem H. Boder8;. Utrecht Ferd. Meijer. ' Goes.J.Bouwens. y Vlissingen L.F. v. Hilst. [ Gouda A. Goedraad. Veendam S. Savenye. ' -sHage Sack en C» Wagemngen G. A. Stork. 1 Haarlem w.i j.k T„ Winschoten G. Was„san. . uaarlem Wed.JeLange en v. Ek. Wijk bij Duurstede Wed. C. Zorfl- Harlingen L. P. Mirande TV Weesp Gez. de Klerk. Harderwijk wéd GTiiL;r Zutphen J. H. A. Wansleven. Hoorn ij. _. Bnt^_._ghoo- - '. Verkoop- _ Heereuveen Gebr. Padberg * O *' V' F i/ _ . Hmdelopen David de Jo&* °J 'AA v' %f4ffs/1 5l) tergen Voe?^""^ T™^d«7H___«t_le_ Kolenbakken terstoven Voetzakken roode Chemisch cenrenarcerde HAARZOL^ gen oo_df„ _f.Z-riCh' ""f6 VILTEM die even alfdeV ■ foonen o dc ™nWgCdragCn 70>""<i^ Voeten warm houden en W  '.""""Pen ""P de puntige scherpe keijen zeer verzachten. H-r2T)«TegenMeieT-k' 'L 0 deze Stad voor Twee DAMES t_ WOIW-fr ""SÊ. E? .B""VEMOUISofONGEMECBILEEBI^ Ge 2e4)RDei°NDERGEÏEEKENI>E verwittigt zij»« nnntnl Tiain""ao-i-u-vT Jr?„„ *-MIES heeft aangeschaft alsmede J_ 1 zich no?wt^L ' SA™^N en ZIJDEN DOMINO'S. I*f van Zrilr _ïï_2i NIe™e««STUMES  daar ik van alle Sto* ! Publfek __rJ. :T > ?Z? Toorzien ben- Mij in de gunst van het Ge*** I Publiek aanbellende teeken ik: J ÜE<U. Dienaar '- ■======-________-____-__ M' SAQIII' _-",http://resolver.kb.nl/resolve?urn=ddd:010072797:mpeg21:a0024:ocr,4,ddd:010072797:mpeg21:p004,Algemeen Handelsblad,1077
234867,1851/01/14 00:00:00,237,MMWFA01:000177002:mpeg21:a00001,http://imageviewer.kb.nl/ImagingService/imagingService?id=MMWFA01:000177002:mpeg21:p00001:image&x=271&y=1537&w=991&h=237,MMWFA01:000177002:mpeg21:p,1262,1774,271,1537,2,Advertentie Men gelieve acht te geven op de in liet hoofd der Courant geannonceerde prijs der Advertentiën welke om den wille van alle belanghebbenden met 1°. dezer verminderd en thans zeer goedkoop is gesteld.,http://resolver.kb.nl/resolve?urn=MMWFA01:000177002:mpeg21:a00001:ocr,1,MMWFA01:000177002:mpeg21:p00001,Hoornsche courant,991
27720,1851/09/06 00:00:00,77,ddd:010276215:mpeg21:a0013,http://imageviewer.kb.nl/ImagingService/imagingService?id=ddd:010276215:mpeg21:p002:image&x=1524&y=2878&w=360&h=77,ddd:010276215:mpeg21,1884,2955,1524,2878,2,Cï boert et-tmt.,http://resolver.kb.nl/resolve?urn=ddd:010276215:mpeg21:a0013:ocr,2,ddd:010276215:mpeg21:p002,Middelburgsche courant,360
2614456,1851/05/10 00:00:00,2392,ddd:010276165:mpeg21:a0019,http://imageviewer.kb.nl/ImagingService/imagingService?id=ddd:010276165:mpeg21:p003:image&x=2294&y=2589&w=1093&h=2392,ddd:010276165:mpeg21,3387,4981,2294,2589,4,Mejufvrouw J. P. GERNLER geb. JORENS  heeft oiitvangen de nieuwste Modes van Strooijen en Zijden DAMES-HOEDEN MUTSEff en MANTILLES ; recommandeert zich minzaam in de attentie. OPREGTE EXTRA FIJNE ENGELSCHE MOSTERDBLOM in gesloten Pakjes _ 90 Cts. te bekomen bij .7. Lagter  Laiigenburg Wijk C. No. 105. Middelburg  9 Mei 1851 Door toeval eene KEUKENMEID  tevens Huiswerk venigtende en van goede Getuigenissen voorzien benoodigd adres bij den Boekhandelaar E. Hendrikse. Jn een Burger Huishouden wordt gevraagd een bedaard ordentelijk DIENSTMEISJE; adres bij den Boekverkooper E. Hendrikse. IVJet half Mei eene MEID benoodigd bekwaam voor Pot eu Huiswerk ; adres bij de Uitgevers dezer Courant. Eene Burger DIENSTMEID met Poten Wasch kunnende omgaan  benoodigd ; adres bij de Uitgevers dezer Courant. Terstond een BOODSCHAPMEISJE benoodigd bij M. Lairct Langendelft. Pen LEERLING en LOOPJONGEN benoodigd bij 11. F. J. Mahutte  Apotheker te Vlissingen. Terstond een SMIDSJONGEN benoodigd bij A. van de Water  Noordbrug. LA BELLE FVE. (GROOTEN ABEELE). Op Zondag den 11 Mei des namiddags ten vijf ure  bij gunstig weder HüORIT-MUZIJK door het sde Regement. STOOIJACTEN. varende in het Beuitveer tusschen de Steden .Middelburg Rotterdam en op alh daar tusschen gelegen Plaatsen. mei 1851. VAN MIDDELBURG: I VAN ROTTERDAM.- Zaturdag 10's morg. 6] 11 re | Zaturdag 10'smidd. 12 ure Zondag 11  g — Zondag 11 1 __ Dingsdag 13 0£ — Dingsdag 13's morg. 4 — 1 Woensd. 14 ioi — Woensd. 14 5 1 Donderd. 15 . 11 — Donderd. 15 s^-— Vrijdag 16 . n|—- | Vrijdag 16 6 — Zaturdag 17'smidd. 12 — | Zaturdag 17 j — Zondag 18 12J— I Zondag 18 7! — Dingsdag 20'smorg. 2 — [ Dingsdag 00 9 — [Tj= De AFVAART-LIJSTJES voor de maanden Mei en Junij zijn gedrukt en voorhanden in de Boekwinkels van de Weduwe C. Jongkindt & Zoon en de Gebroeders Abrahams.,http://resolver.kb.nl/resolve?urn=ddd:010276165:mpeg21:a0019:ocr,3,ddd:010276165:mpeg21:p003,Middelburgsche courant,1093
377104,1851/12/16 00:00:00,392,ddd:010518510:mpeg21:a0019,http://imageviewer.kb.nl/ImagingService/imagingService?id=ddd:010518510:mpeg21:p003:image&x=1994&y=3008&w=962&h=392,ddd:010518510:mpeg21,2956,3400,1994,3008,4,"V Une Demoiselle de VEglise. Wallonne ét ant sur Te pomt de quitter une familie des plus resjtectalles oa die a termine une éducation soignée désirerait se voir replaeée en qualitéde GOUVERNANTE EXTERNE versie mois uh™ Proch""ia- EUe enseigne parprincipes les langue* Hollaitdaise Francaise et Anglaise et en out re le piano le dessin et les ouvrages de mam. Pour de plus amples informations  ou est prié de vouloir bien s'adresser franco sous les initiales M. T. chez Monsieur A E C Vaat SOMEREN a Zutphen. AIV",http://resolver.kb.nl/resolve?urn=ddd:010518510:mpeg21:a0019:ocr,3,ddd:010518510:mpeg21:p003,Opregte Haarlemsche Courant,962
2470300,1851/07/25 00:00:00,5610,ddd:010771655:mpeg21:a0005,http://imageviewer.kb.nl/ImagingService/imagingService?id=ddd:010771655:mpeg21:p004:image&x=1115&y=73&w=2045&h=5610,ddd:010771655:mpeg21,3160,5683,1115,73,6,"JL__j_¥lBÊBTEDl_¥C. • Op VKIJDAG den lsten Augustus 1851  des namiddags te 3 uur zal door de DIRECTIE van het SCHOUWER. ZIJLVEST t.n Huize van de Weiw. L. E. MARRENGA te Weke onder nadere: goedkeuring van HH. GEDEPUTEERDE STATEN dezer Provincie  worden overgegaan tot de opt-nbare A>inbe-itedinï van het BIOITWE.V van eene WAA_SI_A_-§Wt.„Il« ie Schoutver - zijl met liigleverins vande daartoe benoodigde MAT_____A__l__._. Het Besiek hiervan zal van heden ut' ter lezing liggen ten Huize vun Aanbesteding voornoemd en bij den Waarman te Schouwurzijl terwijl verder Aanwijzing ter plaats zal gedaan «orden des voormiddags te 10 uur op den dag van Aanbesi .ding. WEHE'2S Julij fB5l. De Directie van het Schouwer-Zijlvest : E R. FEDDEMA. Ter ordonnantie van Uezelve: J. WATERBOLK Secretaris. "" *** l_r__fïiiMK«'ri_:«S van de W-r_._OJE.R- B__.H__C brengen door deze ter openbare kennis  dat ~ uit hooide van de vernieuwing der I_.I_AI""BÏSIHS liggende in den (*_-___<-weg over het D warsdiep te »FX_._»_3 __■_-_.___: de PASÜIGIE met PAARDEN  RIJTUIGEN en VEE aldaar geen plaats kan hebben van Ma» ii f las den _<!«-■_ Augustus a.s. 's morgens te G uur  tot Katurdag deu Kaden Augustus daaraanvolgende 's avonds te 7 uur; zullende zooveel doenlijk de Scheepvaart worden opengehouden. De Dijkrei/ters voornoemd: J. T. SCHURINGA. L. J. EERK.ES. BERIGT MN DEN ÏlAÏEL •» *'at te ondergeteekenden door voor de X'ITIiItSBUR- .____.__ «Toojviioo_r. Wg£ M[s*-4'rSCMtylM>M*_rj Zjn benoemd „Is MKI»_K-A«_h_l_f. TKW met de Heeren VAUT O_PE_.'S XOKKN alhier voor derzelver STOOM- of SCHROEFBOOTEN varende van hier op Londen eiken SHaturdag mor. gen  en term/ naar hier iederen Woensdag morgen. _»K HO„ kapt. JOHN MANNING vertrekt SHatiirdag ilen 26gten Julij  en beeft goede inrigiing tot vervoer van Passagiers. Ter verzending van GOEDEREN of VEE verzoeke men zich te adresseren aan de ondergeteekenden of opgenoemde Agenten. Harlingen 19 Julij 1851. J. & S. WIARDA. ÉTen overslaan van Mr. JÏ. _V. _£""_________  Noiaris te Groningen zal op MAANDAG den 28sten Julij 1851  des avonds te 7 uur ten Huize van den Kastelein H. PIEK  buiten de Apoort - te Groningen publiek worden verkocht: Een sterk en wélgebouwd OVEItDEUT TJALHSC-_-._P._fl- genoemd DE VROUW CORNELIA groot 24 Tonnen met kompleten INVENTARIS zoodanig als hetzelve van den 22sten dezer in bei lloendiep voor de Behuizing van Verkoop ter bezigtiging zal liggen. — Om dadelijk te aanvaarden.",http://resolver.kb.nl/resolve?urn=ddd:010771655:mpeg21:a0005:ocr,4,ddd:010771655:mpeg21:p004,Groninger courant,2045
8512724,1851/06/20 00:00:00,4846,ddd:000012044:mpeg21:a0011,http://imageviewer.kb.nl/ImagingService/imagingService?id=ddd:000012044:mpeg21:p004:image&x=1098&y=35&w=2063&h=4846,ddd:000012044:mpeg21,3161,4881,1098,35,4,"beslaande uit HUIS SCHUUR HO F BOOMGAARDEN en BOUWLANDEN Sectie A. Nummer 141 tot 150 211 en 212 tezamen groot 1 B. 45 R. 10 E.; in huur bij GERRIT SCHUTMAN die de aanwijzing zal doen. Slaande op f 2050. Nadere informatien ten Kantore van genoemden Notaris. A fat iR lt_Tr' J' A' VAN ROIJEN> yM s^¥k-- Notaris te Zwolle zal op téMk'^^Mr 'Z\-4j- .7rAs Maandag den SOsten Junij 1851 des middags om 12 uur ten huize van S. van der VEEN te Vollenhove publiek verkoopen: 10. Een kamp BOUWLAND DE SCHAREKAMP genaamd  gelegen aan den Grindweg nabij Vollenhove inde Gemeente Ambt Vollenhove Sectie B. No. 527 groot 18.51 R. 10 E. in huur bij A. HER ZE VOORT. Slaande op /' 1350. 2°. Een kamp BOUWLAND gelegen aan de Schaarweg in de Gemeente Ambt Vollenhove Seclie G. No. 372 groot 28.67 R. 20 E. in huur bij TEUNIS MO O IWEE R. Slaande op / 2800. Nadere informatien ten Kantore vau genoemden Notaris. _\\4 ft_\i_\ 1WÏ1'- J' A' TAN ROIJEN> Notaris te ¦fl^flff -¦--- Zwollcza\opMaandag den SOsten Junij fl fl 1851 des middags om 12 uren ten huize van S. van der VEEN lc Vollenhove publiek verkoopen: 10. Een HUIS ERFenTUIN DE MOESPOT genaamd  gelegen nabij de Rlokzijlerdijk in de gemeente Ambt Vollenhove Seclie B No. 474 groot 1 11. 48 E. No. 545 groot 4 R. 70 E. No. 546 groot 13 R. 40 E. Slaande op / 1500. 2. Een kamp LAND gelegen bij de Moespotsteeg in de Getneente Ambt Vollenhove Sectie G. No. 4 groot 2 B. 3 R. 30 E. Staande op f 2275. Aanwijzer G. ISRAËL. Nadere informatien ten Kantore van genoemden Notaris. MlklMr. W. S. van der GRONDEN Nolaris ™M (e Zwolle zal op Dingsdag den 2istcn Junij aanstaande des middags te 12 uur in het ODEON te Zwolle publiek doen verkoopen : Een kapitaal zeer ter nering staand HUIS en WIS ERE staande in de Luttekestraat te Zwolle en strekkende langs het Groote Kerkhof aldaar Kadastraal Sectie F. No. 1819 groot Eene Roede Zes Ellen gedeeltelijk bewoond door den Mr. Zadelmaker VERD 1 E R. Staande op f noo.— Te aanvaarden met I. November aanstaande. Te bezien Dingsdags e.k. 's morgens van 10 tot 12 uren op vertoon van een Kaartje van den Notaris. MPtSZ&r"" Efr- Wl S' yA* der'GRONDEN ¦^[y^fSa -¦--¦ Nolaris te Zwolle zal op Woensdag den 2dcn Julij 1851  's namiddags te 4 uur ten huize van den Bakker BARNEVELD in Haerst bij den straatweg tusschen Zwolle en de Ligtmis wonende publiek in perceelen VERPACHTEN: Het GHASGEWAS van ongeveer 33 Bunders HOOILAND een gedeelte van de HAERSTER HARKTE uitgemaakt hebbende. Aanwijzer BEREND MEULINK Brugwachter aan de Nieuwe Vaart aldaar wonende. ___ ïNe Nolaris N ILA N T  zal ten ver_sT^4sr^ ** -«ke van den Heer GRE YEN t-&**-->-5---' op Dingsdag den 2islcn Junij 1851 'savonds om ft ureu aan DE BIERTON te Schelle VERPACHTEN:  Onderscheidene perceelen RuitendiiKsehe HOOILANDEN. gelegen in Schelle bij de Steenfabriek vau den Heer G R E V EN. Aanwijzer JACOB van OLST aldaar. De Notaris MUL E R T te Ommen zal op Vrijdag den 27 *f*^Jp[aTiMf^ Ju""V 1851> des voormiddags om '""-^ffal- 10 nur  ten huize van J. H. VENEBRUGGE te Heemse gemeente Ambt Hardenbergh publiek verkoopen: Het tiendvrij Boeren Erve „HET JACOBS"" genaamd gelegen in de Buurschap Rheze onder de gemeente Ambt Hardenbergh iv de nabijheid der rivier de Vecht en de grindweg van Ommen naar Hardenbergh bestaande in HUIS SCHUUR SCnA P E NHO K en daarbij behoorende GAARDEN- BOUW- HOOI- en WEIDELAND groot ongeveer 1§ Bunders benevens HO Bunder WOESTE tot alle cultuur geschikte GRONDEN benevens een en een vierde WHAARS-AANDEEL op den RHEZERHARS. Staande bij inzet op f 11875.00. Nadere ioformatien ten kantore van den Notaris ¦ »?wSjrS_i f|e Notaris G. KLUV E R S te Bellen§ÉlSX__jJö ""^ doorn zal opVrijdag den 21stcnJunij 1851 des voormiddags te 11 uren  len huize van A. MIDDENDORP in den Ham publiek doen inzetten en 8 dagen later finaal verkoopen : Een perceel NEEN«BOND groot 8 B 31 R. 90 E. Een dito dito groot 28.39 R. 20 E. Een dito dito » 1»87» 50 » Gelegen in de gemeente den Ham en het eerste in de nabijheid van het geprojecteerde kanaal van Daarle naar den Bardenberg. Men verlangt voor den 1 Julij aanstaande twee bekwame SMIDS KNECHTS. Adres franco Drukker dezes. •€_ÏS»M_ï \\\yr-\ ffiMet Augustus het op goeden sland gelegen LOGE-*¦¦• MENT & STALLING van ouds gereno meerd en genaamd DE KOELE in dc Sassenstraat alhier. Te Devragen bij Drukker dezes. Brieven franco. gMM| M?en klein Gezin verlangt alhier TE HMUR: t-i E-OS ecu beknopt net ingerigt HEEREN BggÜ-ii HUIS  liefst met eenen Tuin. B_VM_t_^M Adres onder Letter Z. bij deu Boekband. W. E. J. TJE E N K WILLINK. MfcéZS*?2* ïle Gepatenteerde NACIIT-4y^2p_ MM WERf&EHS JAN WILLEM van UNEN op de Nieuwstad en WILLEM KNOL op het Eiland beide te Zwolle woonachtig biedeu zich vriendelijk tot den ingezetene Burger dezer slede aan om huune SECREET-PUTTEN kosteloos te ledigen. DILIGENCE ONDERNEMING VAN C. M. RURGERS & CIE. k-W«JftV~ fNIENST tusschen ABNHEH over APELDOORN naar S^W^^^^^. 'T LOO ZWOLLE en DEVEN-1-"" TER met geheel nieuwe en fraai ingerigte Diligence voorzien van Coupe' en ruime Springveeren Zittingen. leder morgen om 10 uren in DE PAAUW in verbinding met de derde Spoortrein naar AMSTERDAH om nog van daar per Nachtdiligence van den Heere P. C. KOENS te kunnen doorreizen naar HAARLEM LEUREN 's HAGE en ROTTERDAM in onmiddelijke Correspondentie met de Diligence onderneming van D. BRONKHORST naar NIJMEGEN alsmede den volgenden dag met de Diligence onderneming naar VENLO ROERMOND SITTARD en MAASTRICBT en voorts naar Ll7A' BRUSSEL enz. De Prijzen der Plaatsen zijn : Van ZWOLLE naar BATTEH 35 Ct. naar BEERDE 80 Ct. naar JUPE f 1.05 naar VAASSEN f 1.30 naar APELDOORN f 1.80 naar 'T LOO f 1.80 naar DEVENTER f 2.55 naar ABNBEU f 3.10. NB. Nadere informatien le bekomen bij TENTHOF in DE PAAUW. NIEUWE GOEDKOOPE MUZIJK alen li Ct. de pagina IN PLAATS van 9—IO Ct. JNcze uilgave is de juiste Copie van de gewone *-* kostbare Plaafdruk-Huzijk. deze wordt na voorafgaande Chemische bereiding op lithographische steen gelegd en daarop overgedrukt en alzoo volkomen overeenkomstig de plaatdruk; daarna geschiedt het afdrukken op de gewone wijze van Steendrukken. De kosten van het graveren en den aankoop der tinnen platen alzoo vervallende zal het geen verwondering wekken dat deze Muzijk ofschoon aan de Plaatdruk gelijk niet het ZESDE GEDEELTE daarvan kost. Meer dan 500 diverse werken zijn in aO maanden reeds uitgegeven en worden maandelijks met 30 a 40 van de nieuwste zoowel als klassieke stukken vermeerderd zoo voor Xang als Piano en andere instrumenten. Buiten inteekening naar keuze kost de pag 3 Cents en alzoo nog niet het DERDE gedeelte der prijs van de gewone Muzijk. Men onderzoeke en oordeele I Depots Catalogus en Prospectus ook van Orgcl-lluzijk zijn voorhanden bij TJEENK WILLINK Boekh. te Zwolle bij A. J. van den SIGTEN HORT en G. BROU W E R te Deventer bij A. van BEVERWIJK te Kampen bij J. WORP Organist te Almelo en 3. B. CRAMER Organist te Delden. Voorts bij alle Postkantoren worden bestellingen aangenomen. HOLLOWaY'S ZALF EN PILLEN. Het ïs eene ontegensprekelijke daadzaak  dat de pillen van Holloway een buitengewoon weldadig ginccsmiddel zijn. In alle gevallen van bedorven maag  aandrang van het bloed naar het hoofd  van gal  van hoofdpijn  leverkwaal  enz. is er geene medicijn hekend  welke zoo oniniddelijk hulp verschaft als deze vermaarde pillen wier bijzondere eigenschappen regtstreeks op de hooldorganen des levens werken  zoodat geene ongesteldheid van boyengenoemden aard aan derzelver weldadigcn invloed kan weerstaan. Daarom ware het raadzaam voor al diegenen welke tot diergelijke ziekten aanleg hebben  om op dezen tijd van het jaar  eenige dosis daarvan te gebruiken  welke alle kenleekenen daarvan zullen wegnemen en hun volle gezondheid en kracht zullen wedergeven.",http://resolver.kb.nl/resolve?urn=ddd:000012044:mpeg21:a0011:ocr,4,ddd:000012044:mpeg21:p004,"Provinciale Overĳsselsche en Zwolsche courant : staats-, handels-, nieuws- en advertentieblad",2063
958070,1851/12/28 00:00:00,745,ddd:010786829:mpeg21:a0009,http://imageviewer.kb.nl/ImagingService/imagingService?id=ddd:010786829:mpeg21:p005:image&x=1330&y=35&w=1286&h=745,ddd:010786829:mpeg21,2616,780,1330,35,8,steradeel zullen in tegenwoordigheid van een Commissaris uit het Collegie van Gedeputeerde Staten van Friesland op Zaturdag den i7den Januarij i 852 des voormiddags 10 ure in den Posthoorn te Dokkum bij in schrijvingen opbod eerst in Perceeien en daarna in Massa Aanbesteden: Het Aanleggen eener Aardebaan hoofdzakelijk langs de bestaande wegen door de gemelde gemeenten benevens het Begrinden derzelve  met de Leverantie van alle daartoe noodige Materialen ; over eene gezamenlijke lengte van 3883 i ellen. De Aanwijzing zal plaats hebben op Maandag den i2den Januarij en volgende dagen bevorens aanvangende des morgens ten 9 ure aan de Brug te Hijum. De hiertoe betrekkelijke Bestekken zullen  behalve in de Logementen langs den te besteden Weg in onderscheidene Provinciën ter lezing liggen op alle zoodanige plaatsen alwaar gewoonlijk de Bestekken van belangrijke Waterstaatswerken ter lezing worden gelegd—terwijl Gegadigden zich tot het verkrijgen van Bestekken kunnen vervoegen ter Secretarien der meergemelde Gemeenten.,http://resolver.kb.nl/resolve?urn=ddd:010786829:mpeg21:a0009:ocr,5,ddd:010786829:mpeg21:p005,Nederlandsche staatscourant,1286
1121206,1851/01/15 00:00:00,1277,ddd:010805249:mpeg21:a0018,http://imageviewer.kb.nl/ImagingService/imagingService?id=ddd:010805249:mpeg21:p004:image&x=971&y=2985&w=878&h=1277,ddd:010805249:mpeg21,1849,4262,971,2985,4,"-_.i iït_""^?*'d__'®_hP*""i_W_-s»ls_^r*_ (3455) *»* GENEZING van eene aanhoudende scheelen nerveuze of zenuw hoofdpijn door de pillen van Holloway. De heer Smith te Lainbeth  in de Thomasstraat woonachtig was sedert vele jaren lijdende aan zenuwhoofdpijnen waardoor zijne ligchaamskracht zoodanig werd geschokt dat er weinig hoop tot herstel was. Deze kwaal verijdelde alle pogingen van onderscheidene zeer ervarene geneesheeren welke zoo het schijnt verkeerdelijk als eene aandoening der ruggegraat beschouwden  onder welker behandeling de ziekte nog toenam. In dien wanhopigen toestand en als een laatste middel nam hij zijne toevlugt tot de pillen van Holloway die hem binnen eenigen tijd volmaakt deden herstellen. Door het vermeerderd debiet zijn de prijzen als volgt: Doosjes Pillen _ f 090 f 210 ƒ 330 f 775  ƒ 1550  f 2350. Potjes Zalf _ ƒ 090 f 210 f 330 enz. Ziju op franco aanvragen „ contant te bekomen bij deD Heer A. P. Miliüs te Utrecht bij den Heer G. C. T. van de Roemer te Amersfoort en bij den Heer J. Straatman Hoofd-Depóthouder te 's Hertogenbosch alsmede te Londen Strand 244 Holloway. etablisement. 1——__hb__.-",http://resolver.kb.nl/resolve?urn=ddd:010805249:mpeg21:a0018:ocr,4,ddd:010805249:mpeg21:p004,Utrechtsche provinciale en stads-courant : algemeen advertentieblad,878
2810295,1851/10/29 00:00:00,1285,ddd:010073071:mpeg21:a0022,http://imageviewer.kb.nl/ImagingService/imagingService?id=ddd:010073071:mpeg21:p004:image&x=48&y=2786&w=2187&h=1285,ddd:010073071:mpeg21,2235,4071,48,2786,4,'ALGEMEEN VERKOOPHUIS VAN MODERNE KLEEDINGSTUKKEN Kalverstraat N». lil bij de Heilige Weg. Naar ieders keuze kan men aldaar van de minste tot de beste soorten NAJAARS- en WINTER-KLEEDINGSTUHKEN in . gereedheid vinden of des verkiezende voor dezelfde prijzen aangemeten krijgen; de bewerking benevens de buitengewoon lage prijzen zijn  reeds genoegzaam gunstig bekend dan dat dezelve verdere aanprijzing behoeven. J. EBERS. (16797) AL DE DRÏMAmHEWERKËN VAN A. LOÖSJESZr. NIEUWE UITGAVE IN EEN DEEL ROIJAAL OCTAVO p. m. 700 Bladzijden voor ƒ2.25 in plaats van f 5.75. j Inhoudende: Charlotte van Bourbon Frank van Borselen en Jacobi van Beijeren Louise de Coligny Huig de Groot en Maria van Reigersbergen  Johan de Witt Arnold Geesteranus en Susanna van Oostdijk; de Aflevering geschiedt in netten Cartonuen Band door <I. H. VAN DER BEEK j Voorburgwal bij de Pijlsteeg N*. 204 te Amsterdam. Alwiar nog weinige Exempl. te bekomen zijn van de volgende Werken allen van LOOSJES: I. LEVEN VAN BLOMMENSTEIN 4 dln. met PI. Prijs/13 voor/5.75. IL HILLEGONDA BUISMAN 4 dln. post form. Prijs ƒ 7.20 I voor/2.50. 111. SUSANNA BRONKHORST 6 dln. post form. Prijs/10.80 voor/3.30. IV. ZEDELIJKE VERHALEN Prijs f 1.80  voor/—.90. V. REINOUD JAN VAN GOLSTEIN TOT SCHERPENZEEL 4 dln. met PI. Prijs/ 14 voor/5.50. VI. DE LAATSTE I ZEETOGT VAN DE RUITER 2 dln. Prijs/ 8 voor ƒ2. VIL DE VIER TIJDPERKEN VAN DEN DAG met PI. Prijs/ 2.20 voor f—.ls. VIII. DE GEEST DER GESCHRIFTEN VAN LE FRANCQ VAN BERKHEY. Prijs/2.40 voor/-.75. . Een paar Exempl. zijn nog voorhanden van: I. HISTORIE VAN SARA BURGERHART 3 dln. Prijs/4.50 voor/1.50. HLT^a 11. GESSNER'S Werken door Mejufvr. POST 3 dln. met PI. Zakform. Prijs/ 7.50 voor/ 2.40. 111. DE NIEUWE CAMERA | &**&*& QBSCURA BLOEMLEZING OP HET GEBIED VAN GODSDIENST EN ZEDEKUNDE. Prijs/ 1.50 voor/— .75. (16762) .«axEu^AcoN vinaIGRE DE TOILETTE ™xr»S.ACOK AROIIATIQII ET APiMÉPBITip Di JEAN VINCENT BULLY. RUE SAINT HONORÉ N°. 252 ii PARIS. Ce VINAIGRE Brevetc' en 1809 et 1814 type des Vinaigrcs de Toilette remplace aujourd'hui I'Eau de Cologne dont I'usage a e'té reconnu pernicieux pour la peau. H doit son immense succes et sa supériorité sur toutes les imitations auxquellcs il a donné naissance aux soms consciencienx avec lesquels il est prepare' — a la suavite de son parfum- — a la réalité de ses propriétés hygicniques pour rafraichir et embellir la Peau — pour les soms délicats de la Toilette des Dames — pour les bains générauxde locaux — pour assainir les appartement» combattreles influencese'pidémiques etc. (15631) Chez tous les Dépositaires de VHuilt de Macassar dt Mess. A ROWLAND & SÖNS.,http://resolver.kb.nl/resolve?urn=ddd:010073071:mpeg21:a0022:ocr,4,ddd:010073071:mpeg21:p004,Algemeen Handelsblad,2187
5011821,1851/07/25 00:00:00,4833,ddd:000012054:mpeg21:a0011,http://imageviewer.kb.nl/ImagingService/imagingService?id=ddd:000012054:mpeg21:p003:image&x=2113&y=38&w=1037&h=4833,ddd:000012054:mpeg21,3150,4871,2113,38,4,".fijy^^-» IV' ondergeteekende DIREC T E L' R •_s!fcSi^#--» der OverijMselsclie Onderlinge Brandwaarborg- Maatschappij voor €2«bouwen geeft bij dezen te kennen aan de Deelgeuooten dat door hem op Vrijdag den 1 sten Augustus e. k. des morgens te elf uur ten zijnen huize alhier zal worden gedaan KcKening- en Verantwoording wegens zijn beheer over het met Ultimo Junij jongstl. geëindigd Maatschappelijk Jaar; wordende de Deelgenooteu uilgenoodigd  om des verkiezende daarbij tegenwoordig te zijn: alles overeenkomslig Art.'il des Reglements. Zwolle den 2' Julij 1851. B. J. va.n SONSBEECK. l/__7 M^~~ MW gchen de ondergeteekenden. be¦M^*'—¦**'---' slaan hebbende onder de Firma Wed«. BARBIERS en C'». tot het uitoefenen eener STEENDRUK KER IJ  en de Handel in STEENDRUKWERK SCHRIJF- en KANTOOR-BEHOEFTEN is op HEDEN on I honden en de Wede. B A IIBIE R S geb. MEIJER I N K  met de Liquidatie vau de Zaken dier Firma belast. Zwolle 1» Julij 1851. Wed. BARBIERS geb. MEIJERINK. W. J. UUR T S. KUN- en IJSSEL- "" STOOMBOOT- MAATSCHAPPIJ Dienstregeling beginnende met den lsten JUK IJ 3858. Tusschen AMSTERDAM. KAMPEN  ZWOLLE DEVENTER en ZUTPHEN dagelijks behalve 's Zaturdags. Vertrek van AMSTEBDAM 'smorgens 7 ureu. » » KAMPEN 'smiddags circa 121 » » ZWOLLE » » 1 » » DEVENTER »namidd. G». 5 » Vertrek van ZUTPHEN 's morgens om ft » .. DEVENTER » » 1 » » ZWOLLE » i 0 m » » KAMPEN » » 10 » Tusschen AMSTERDAM en KEULEN. Van AMSTERDAH ZONDAGS en DONDERDAGS l 's morg. 7 uren. fclVan KAMPEN ZONDAGSen DONDERDAGS's midd. § 1 12J ureu. ïï<Van ZUTPHEN ZONDAGS en DONDERDAGS 'sa- S< J vonds c». 7 uren. ©[Van ARNHEM MAANDAGS en VRIJDAGS 'smorg. V. G ureu. IVan KEULEN ZONDAGS en DONDLRDAGS 'smorg. k\ uren. Van ARNHEM ZONDAGSen DONDERDAGS'savonds 7 uren. Van ZUTPHEN MAANDAGS en VRIJDAGS's morg. G uren. Vau KAMPEN MAANDAGS en VRIJDAGS voormiddags 10J uren. Aansluitende Diligence-diensten der Maatschappij waarvoor direcle plaatsen worden afgegeven. Te ZWOLLE naaren van MEPPEL ASSEN VEENDAM en GRONINGEN. » naar en van HEI.N'O RAALTE ALMELO  ENSCHEDE en OLDENZAAL. Corresponderende Spoortreinen est Diligences. Te AMSTERDAM op HAARLEM LEIDEN 's GRAVENHAGE en ROTTERDAM; UTRECHT en ARNHEM. Te ENSCHEDE op MUNSTER  te OLDENZAAL op LINGEN. MMr. J. A. van ROIJEN Notaiis te Zwolle zal 'MM i„ |)et ODEON le Zwolle op Vrijdag den lsten Augustus 1851 des middags om 12 ure doen inzelten en 14 dagen laler publiek verkoopen de navolgende LANDERIJEN in Mastenbroek Gemeente Zwollerkerspel tusschen de Riesebosch eu Hasselt gelegen als: I°. Een sluk IBOOILKKl) en lIA«_ÈK aan den dijk HET O.XTVANGERSLAND genaamd Seclie U No. 29' groot 0. 88. 40. 2°. Een sluk \% EiDEILKKE). achier hel vorige peiceel met de halve RIETE Seclie U No. 295 en 29G groot 2. 37. 50. 3\ Een stuk WEII>EIAKI) en H.-ie.KI  met de halve RIETE tegen het vorige perceel gelegen genaamd TER WEES LAND Seclie U No. 292 293 en half 291  groot 2. 73. 05. 4. Een stuk \I IRIDELAKI). achter het vorige perceel met de halve RIETE genaamd KORTJESLjIND Sectie U No. 161 groot 2.58.95. s. Dc onverdeelde helft in een stuk EIOOIE Wlï« genaamd VAN MUIDENSLAND Sectie U No. 300 301 en 302 groot in het geheel 4. 71. 20. ft\ Een stuk U EBDEE VKI> met de halve RIETE genaamd KNAPENLAND Sectie U. No. 154 en 155 groot 1.70. 10. 7"". Een stuk EfiOOBEAAI)  achter het vorig perceel Sectie U No. 153 groot 0. 78. 10. 87 Een stuk fl€><UMf.A!til>. achter het vorig perceel met de halve RIETE Sectie U No. 151 en 150 groot 2.83.80. 9. Een Stuk 110 OU AKI) het JONGE BEES TE LAND genaamd met de halve RIETE Sectie II No. 104 en 105  groot 1. 70. 2. 10\ Een stuk HOOUAKI» achier het votigc perceel gelegen Sectie U No. 106 groot 1.43.50. 110. Een Stuk IIOOUAK'l) achier het vorige gelegen met eene RIETE Seclie U No. 107 en 108 groot 1. 71. 60. Alles behoorende aan de Weduwe en Kinderen U El- MER IG va* dcii VEGT. De aanwijzing geschiedt door JAN van der VEGT aan de Husseler Dijk. Nadere infoimaliën bij den Notaiis.",http://resolver.kb.nl/resolve?urn=ddd:000012054:mpeg21:a0011:ocr,3,ddd:000012054:mpeg21:p003,"Provinciale Overĳsselsche en Zwolsche courant : staats-, handels-, nieuws- en advertentieblad",1037
2865586,1851/10/12 00:00:00,2402,ddd:010152811:mpeg21:a0014,http://imageviewer.kb.nl/ImagingService/imagingService?id=ddd:010152811:mpeg21:p004:image&x=1265&y=1507&w=1193&h=2402,ddd:010152811:mpeg21,2458,3909,1265,1507,4,* * Men verlangt voor de Provinciën Noord-Brabant en Limburg een REIZIGER van de beste getuigenissen  die voor Handels- Artikelen vooral de Dorpen bezoekende nog een HANDELSVAK daarbij zou kunnen waarnemen tegen ruime provisie. Nadere informatiën onder Letter P bij de Uitgevers dezer. Brieven franco. toJlFE^|^ J. HEIJNENj Gezigtkundige en Hofleverancier ~~^osi!!:y^S% te 's Hage zal tot den 15. dezer maand te Breda slu. te spreken en te ontbieden zijn in het Hotel de Zwaan van den Heer VERMUNT voor diegenen welke zijnen raad of hulp voor hun Gezigt van nooden hebben ; bet gebruik van BRILLEN wordt door hem niet aanbevolen clan wel bij wezentlijke behoeften ; men beschouwe de afbeelding hierboven wal door het gebruik van Schadelijke Brillen kan ontstiian. %* Bij geregistreerd Exploit van Zes Oetober 1851 is ten verzoeke van Vrouwe PREDERICA WILHELMINA WINCKEL Echtgenoote van en ten deze bijgestaan en gemagtigd door den Heere HERBERT VAN DER PUT Particulieren wonende te Steenbergen bebbende domicilie ten huize van bunnen Procureur M. GERARD KLEUN wonende te Breda Wijk D N°. 66 in den vorm der Wet met overgave van kopij aan deu Heere Ambtenaar van het Openbaar Ministerie bij de Arrondissements- Regtbank le Breda op het parquet aldaar beteekend aan GERRIT PIETER PAASE zonder beroep en zonder bekende woon- en verblijfplaats biunen dit Koningrijk en daar buiten Een gedrukt aunslagbillet van de Gereglelijko en Openbare Veiling en Verkooping bij Uitwinning van de mede ten lasten van hem geïnsinueerde in executie gearresteerde Onroerende Goederen bij geregistreerd procesverbaal van in beslagneming daarvan aan hem geïnsinueerde beteekend; — welke Goederen daarbij zijn omschreven als staande en gelegen te Steenbergen in Sectie W Nummer .40 tot en met Nummer 144 en bij gemeld billet zijn ingezet door genoemde Executanten op Zes honderd guldens welke het eerste bod vervangen. KLEUN Procureur. *¥* Bij Vonnis der Arrondissernents-Regtbank te Breda gewezen den 9. Oetober 1851 is in slaat van FAILLISSEMENT gesteld de persoon van SERVATIUS JACOBUS SCHREÜRS Timmerman en Winkelier te Bergen-op-Z oom uaarvan de aanvang is bepaald op den 8. daar te voren; zijnde bij gemeld Vonnis benoemd : tot Commissaris de Heer M. J. J. LOKE Regter in de Regtbank en lot Curator Mr. J. A. M. ROELS Advokaat te Bergen-op-Z oom. De Curator voornoemd J. A. M. ROELS. %* Bij G. B. VAN GOOR te Gouda komt vau de pers en is alom voorhanden voor 80 Cents: D\ J. W. E. DE MAN BIJDRAGEN TÖT DE VERLOSKUNDIGE PRAKTIJK. Onmisbaar voor elk die zich met verloskunde afgeeft ol jonggeborenen moet behandelen bevat dit GEMAKKELIJK ZAKBOEKJE een' schat van nuttige wenken als zoo vele vruchten der ondervinding op des Schrijvers merkwaardige geneeskundige loopbaan geplukt.,http://resolver.kb.nl/resolve?urn=ddd:010152811:mpeg21:a0014:ocr,4,ddd:010152811:mpeg21:p004,Bredasche courant,1193
209898,1851/09/10 00:00:00,169,ddd:010060311:mpeg21:a0011,http://imageviewer.kb.nl/ImagingService/imagingService?id=ddd:010060311:mpeg21:p003:image&x=1336&y=1300&w=1242&h=169,ddd:010060311:mpeg21,2578,1469,1336,1300,4,"%« 'sGzAVzaiACI den ""1 September 1851. lieden overleed alhier Vrouwe JOHANNA MAKIA AbiUANA HUYGENS echtgenoot van den Kdel Achtb. Heer DUIK. JOAN HENRICUS BOfiLL.VABD Lid van den Itaad der Stad. t",http://resolver.kb.nl/resolve?urn=ddd:010060311:mpeg21:a0011:ocr,3,ddd:010060311:mpeg21:p003,Dagblad van 's Gravenhage,1242
5718185,1851/02/10 00:00:00,5204,ddd:010072821:mpeg21:a0008,http://imageviewer.kb.nl/ImagingService/imagingService?id=ddd:010072821:mpeg21:p002:image&x=1142&y=94&w=2170&h=5204,ddd:010072821:mpeg21,3312,5298,1142,94,4,"AAN EENEN HEER OF EENE DAME worden op cene der Hoofdgrachten bij een Klein Gezin aangeboden: Eene ZIJ- en BINNENKAMER voorzien vau de noodige Gemakken met of zonder AMEUBLEMENT tegen / 300 „ƒ4OO 'sjaars. Adres onder Lett. S. U. bij J. C. SPIJKER Az. Boekverkooper Rcgulierspkin N. 4. (2071) (1936) Men vraagt in Huur tegen Mei aaustaaiidc: Eene BUITENPLAATS gelegen in dc omstreken van Haarlem waarvan het lIEERENHUIS 8 _ 10 Kamers moet bevatten; dezulken diemet cenig Ameublement voorzien zijn zullen bij voorkeur in aanmerking komen. Adres franco Lett. X. 0. ter Boek- en Plaatdrukkerij van IPENBUUR §• VAN SELDAM te Amsterdam. TE KUUR MET MEI IS51: -Een goed onderhouden zeer fraai IBEERENHIiIS geheel ingerigt en voor Zomer- en Wintcrverblijf met daaraan gelegen schooneu TUIN des verkiezende met Stal er bij alleraangenaamst gelegen nabij Cuyk aan de Maas het sehoone uitzigt hebbende op 2 Wegen en het Poiitveer. Te bevragen met Franco Brieven bij M. VAN DER AA te Katwijk aan dc Maas Provincie Noord-Braband. (2049) ""T2ÏÖÖI TE HUUR TEGEN 1"". MEI 1851. Het BUITENVERBLIJF BOOM EN BOSCH met deszelfs Roijale HEEEENUUIZINGE KOETSHUIS STALLING TUINMANSWONING en KOEPEL staande en gelegen te Breukckn  aan de Rivier dc Vecht nabij het Dorp en den Rijn-Spoorweg. Op Franco aanvragenader Onderrigt te bekomen ten Kantore van den Notaris N. FRANCOÏS SNEL  te Breukekn. (1958) Tegen 1"". Mei e. k. TE HUUR: Ecu HUIS en TUIN staande en gelegen te Haarlem even buiten het Zijlhek; het Huis bevat vier zoo Beneden- als Bovenkamers allen netjes Behangen Keuken  Kelder Zolder en Meidenkamer benevens eenc Mangelkaiiicr. Adres Lett. 11. bij den Boekh. T. F. VAN DOBBEN  te Haarlem. Brieven Franco j A/1 ■ l"". Men verlangt voor het nan.tnaudc Jngtsaizoeu en /\^j- j[ . eenige volgende Jaren TE HUREN eene cenigzins Uitgestrekte en Wildrijke JAGT gelegen in de omstreken van Haar-' km of zooiveel mogelijk in de oumiddelijke nabijheidvan den Holland.chcn Spoorweg tusschen de Steden Haarlem en 'sGravenhage. Reflecterende. gelieve zich met opgaaf van Ligging Uitgestrektheid Huurprijs en verdere; Voorwaarden te adresseren onder de Lett. N. IJ. bij de Boekverkooper» VISSER $• COMP. Hecreugracht en hock vnn de Vijzelstraat te Amsterdam. (2086) (1783)~TE HUUR om dadelijk te aanvaarden: Het onlangs nieuw gebouwd zoo tot uitoefening vau LANDBOUW HERBERGIERSBEROËI' of HANDEL met zorg en doelmatig- inrigting en gevoegelijk tot Uecrenwoning in te rigten HUIS bevattende 4 Kamers Keuken Pomp Kelder Koetshuis gcplafonnccrdc Stalling en verdere Geriefelijkhcden met daarachter gelegen TUIN met fraaijen BOOMGAARD enz. vroeger genaamd Twoli onder dc Gemeente Rosmalen Half Uur nfstands van 's Bo.ch. Te bevragen bij den Heer J. lIAI-TLE-B te .Hertogenbo.ch. ""T-TiO) Door vertrek nam- Elders wordt tegen Verminderde Huur aangeboden: Een OPTREK in de onmiddellijke nabijheid vau een dei .'usschen-Statioiis van den Rijn-Spoorweg tusschen Amsterdam en Utrecht te aanvaarden met Mei of eerder. Brieven franco Lett. W. Z. Bureau Handelsblad. 'f'S 1)'t1. ÏÏ-MANI» uit den Fatsoenlijken Burgerstand vnn d< I ..OAi.. He"""". (1. 31 Jaren oud TABAKKERVEN EESTEN. SORTEREN etc. kundi"" door buitengewone omstandigheden Ulam buiten Betrekking zag zich gaarne GEPLAATST als BEDIENDE in eene TABAKS-AFFAIRE als zijnde daarin reeds verscheiden. jaren werkzaam geweest waarvan de beste Getuigenissen kunnen geproduceerd worden. Rcficcterciideii ~<*c™"" ™>' T»''F"""" brieven "" adresseren onder Lett. S. bij E. T. HENDRIKbEN Kantoor-Boekhandel Hoogstraat G 62 te Rotterdam. —_i____i_ 12091) Om bij eenc Bloeijcnd-Gevestigde Zaak een BUITENGEWOON GROOTEN WINSTGEVENDEN Handel te voegen zoekt men lemand over Plus Minus 50 Mille kunnende disponeren hetzij als Commandite doch bij voorkeur als Medewerkend Deelgenoot. Adres Letter _. M. bij den Boekhandelaar J. C. LOMAN Jr. Kalverstraat N. 96. (1689) Een GEOSSIÉRT_T3_AïHTFACTUEEN verlangt lEMAND. bekend met het Italiaausch Boekhouden en m staat om m dc Hollandsche Fransche Hoogduitsche en Engelsche luien te kunnen Corresponderen. lemand met het Vak bekend zal de voorkeur genieten. Adre onder Lett. Q. A. B- Bureau Han_Msblad. ""7_Ö39TT_r wordt Gevraagd: Een PERSOON van de Protestantsche Goïïknst bekwaam en KOPEKSLAGKB die te yens de Vereischte bezit om als MEESIERKNECHL op te tredei en Bewijzen van Eerlijkheid en Goed Gedrag kan overleggen. Adre_ in Persoon of met Franco Brierfß onter Lett. L. K. bj de Boekhandelnren en Stads-Drukkers g__Bl_Aj___!lJ__J__G E* ZOON te Amersfoort. (1856) Bij den Ondergeteekende APOTHEKER en CHEMIST t« Amsterdam is gelegenheid ter plaatsing van een LEERLING of vai lEMAND die na volbra°-ten Leertijd verder Onderwijs en Opleiding verlangt. BrievcnJ^ranco. "" D. PAS. _& TD__T'ïï__-_r Ter overneming wordt gevraagd eene beklant! üf U 1 Jl-jJjJHL- APOTHEEK; ook is men niet ongenegen sich te ASSOCIËREN met vooruitzigt later dc Zaak tej kunnen over' nemen. Adres Franco onder Lett. W. bij den Boekhandelaar L. ROMIJN Kalverstraat N°. 205 te Amsterdam. (2067) BLOEffIARKT ff. 230 WS&& -EKGU BOT ESi HO VEN in Droogerijen en Zuinzaden etc-t verzoekt zijne Begunstigers hunne ORDER op' alle Soorten van EÖ»-*'» GRAS- KLAVER- en VREEMDE ZADEN deze weckte mO"" gen ontvangen om aan hunne ORDER te kunnen voldoen. (21_-0— . _*_». _. WM ï _TV!. 1) CIVIEL- EN MILITAIR; %WL& W .O. MllLit KLEEDERMAKER VAN o®^^®ftZ. M. DEN KONING en van HH. Officieren van het SNï *_f_!ws. Regement Grenadiers en Jagers te 'sllagc heeft dc cc' OS&IIIhSb» ""'ermede te berigten dat hij UNIFORMEN ver--I"".' S~__ ' _3Fdigt voor alle Corpsen der ARMEE en MAI-U**-* _(2106) Paktots in alk genres zijn altijd tor bezigtiging voorhanj_S.' KRUSDEN-S»O__.ADE. Deze met roem bekende POMADE™r' dient voortdurend allen kf. Door dcrzelve goede nitwerkingdagclijks do»* bewijzen ges*iaaft. Hoofd-Dcpöt te Amsterdam G. Vianeu Spui.N""-3 prijs ƒ1 het Fkïcbjc. (2098) Nijmegen Gebr. Swemmclaar. I 's Bosch J. K. Wclsch. Breda Jufvr. de Wed. Wicrx Rolla. | VHagc Mulder en Dolmans. Leiden  Mejufvr. Kuldenberg. I Groningen  E. G. Palmc Kapp« Hoorn. L. B. Rnttenberg. LfKIVIDATTET tï~_~-_EIel.OÖ.S'-i.ff8Ti£_i°Kß«sfSSpl* STOÏSEN diverse FANTAISIE-STOÏEEN voor KLEEDJES enz. enz. welke ter bespoediging der Likwidatie tot zeer voordeelige Prijzen worden afgezet. f 062) WOLVEKSTMAAT K°. 2S. PE MELgEHE. _ Jod.nbrees.aa.^S R enNt^dijk Mozes-enA^onsUrk V. ï\. UlllUM. FABKIEKANT IN GOUD- EN ZILVER WERK Berigt door deze dat BEIDE WINKELS zoowel met Gewone als Moderne GOEDEREN weder aangevuld zijn. (2118) ___ (2107) MEN VRAAGT tegen ï Mei op een ""dorp in Zuid-Holland' bij eenen BANKET- KOEK- en BROODBAKKER een LEERLING niet beneden de 16 Jaren. Adres onder Lett. A. met /.«»«* brieven bij GEBROEDERS BELINFANTE Boekhandelaars te''s Gravenhage. (1.57) Er Wordt ten spoedigste gevraagd: Een _U IN JHA pTTvan-e Protestantsche Godsdienst tegen Kost Inwoning en Salaris; wanne** I-ij Gehuwd is (ecliter zonder Kinderen) dan moet de Vrouw volkom6"" instaat zijn als Werkmeid te fungeren. Men adreesere zich Franco on-er Lett. 11. bij den Boekhandelaar M. A. TRIBELS op de Botermarkt) over de Waag N°. 21. AN __NGL_SU PEKSON of respectability wishes to cïïiïïgo herself as nurscry GOVER__ES:S: lias been living several ycai- '"" families of di.tinction from whom' Recomniandatiou may be had b*J no objection to travel. Ad.lrcs post paid under La. E. N- "" H. lIöVEKER Bookscllcr 467 Hccrcngmcht Amsterdam. (1992) (1983) Op Primo Mei aanstaande wordt in eene KOEK- en BAS---""*"" BAKKERS-AFFAIRE gevraagd eene WIN KEI. DOCHTER . lllCt genoemde Zaak bekend en van de Protestantsche Godsdienst. Hierop refiecterenden adresseren zich met franco brieven onder Lett. A. bij c'cll Boekliaiidelaar L. F. J. lIASSELS op den Blaauwburgwal te Amsteldam; vooral opgave vnn Ouderdom en waar informatien te bekomen -li""' (1978) Tegen 1». MEI e. k. wordt gevraagd een APOTHEKER*' BEDIENDE liefst GEËXAMINEERD bij A. POSTHUMA Apot'Itc Dockum. ""VIJFTIG GULDENS '.'XX BELOONBN G voor diegene welke een JIÜNG MENS€U 24 Jaren oud vnn ''e Prot. Godsdienst en goed kunnende Schrijven en Rekenen en vnn goi'~6 getuigen voorzien niet onbekend met Huis- of Pakhuiswcrk eenc Betrekking bezorgt als PAKHUIS- HUISKNECHT of voor KANTOOR-'""0' PEND WERK. Hierop reflecterenden gelieven zich te adresseren oinl1* Lett. F. J. Bureau Handelsblad Brieven franco. (2115)",http://resolver.kb.nl/resolve?urn=ddd:010072821:mpeg21:a0008:ocr,2,ddd:010072821:mpeg21:p002,Algemeen Handelsblad,2170
2951049,1851/11/21 00:00:00,2661,ddd:010073094:mpeg21:a0022,http://imageviewer.kb.nl/ImagingService/imagingService?id=ddd:010073094:mpeg21:p004:image&x=44&y=2679&w=1109&h=2661,ddd:010073094:mpeg21,1153,5340,44,2679,4,"'; PUBLIEKE VERKOOPING OP TEXEL. ' < JAN ZUNDERDORP en W. J. HIDDE BOK Makelaars te Texel -'rils last hebbende van Kapt. H. H. MELLEMA gevoerd hebbende het il Udaar gestrande en totaal verbrijzelde Nederl. Smakschip de Jonge Tjal'4ing van Koningsbergen naar Amsterdam bestemd geweest zijn van ..aneening krachtens Regterlijke Authorisatie door het Ministerie van i den Notaris Mb. W. BOK op Maandag 24 November e. k. sNamid' dags ten 4 Ure  aan den Burg op Texel publiek te Verkoopen: '-< Ongeveer 1000 Stuks GROVE LINNEN ZAKKEN  '■t 50 Rollen GROF LINNEN en j 2 Mud LIJNZAAD ' .alles door Zeewater beschadigd en afkomstig uit de Lading van boven' ""genoemd Smakschip. ':.< Nadere informatien zijn te bekomen op franco aanvrage ten Kantore ijrvan voormelde Makelaars. (18077) ! Men verlangt met Primo Eebruarij aanstaande tegen K.OST  NWOj'KING en LOON naar verdienste: Eenen VASTEN HUISKNECHT 'lVan de Protestantsche Godsdienst Ongehuwd en van goede getuigen voorzien. Adres Pranco Lett. H. X. Bureau Handelsblad met opgave van l'Onderdom en Woonplaats en alwaar informatie te bekomen is. (17900) } 2 SLAGERSRICÜTS! 'C-ERSKN ECHTS waaronder één van de Israëlitische Godsdienstige vereischte is bekwaamheid; terwijl diegenen welke de Slagerij niet [grondig kennen verzocht worden zich niet aan te melden ter vermijding ..■van onnoodige kosten. Adres per Franco Brieven onder Lett.M.T.B. „aan de Boekhandelaars JACOBS fr MEYERS te Amersfoort. (17990) l OINDEKKIGT LN HET BOEKHOUDEN. Een in alle deelen ervaren BOEKHOUDER biedt zich aan tot ""let gevea van grondig onderrigt in het ITALIAANBCH BOEK- T' HOUDEN en wel ten zijnen Huize voor twee of drie Avonden in i<le week teg.h een honorarium van 50 Gulden. Hierop reflecterenden gelieven zich te adresseren per besloten Briefje motto Balans Bureau Handelsblad. (-8059) _ ÏW.Ii1.. [IA-11-l\r lEMAND als Boekhouder zoo wel voor  JÖUI-lVllULlllilU. Administrative als Handelszaken grondig ervaren biedt zich aan om tegen eene matige belooning eenige halve of heele daeen werkzaam te zijn. Adres onder Lett. Q. Q. Bureau Handelsblad. D "" (18058) ï "" UIT DE HAND TE KOOP: * Een Hecht Sterk en Weldoortimmerd WINKELHUIS met f _ï-onde.lijk Verhuurd wordende Boyenwoningen en ERVE staande en ' gdegen in de Nienwe Leliestraat. Te bevragen ten Kantore van den ] Makelaar JOHs. WENT op de Heerengracht bij den Blaauwburg wal N . 272. (18084) « _-_^___ »E ONDERGETEEKENDE berigt dat hij een ! _B_tP-St_iCHROMATISCHE STEMVORK uitgevonden heeft ï jj____— -welke eene geheele Octaaf van a tot a (van klein tot één ' gestreept a) met de 12 tusschen inliggende halve Toonen aangeeft. Het 1 Terschil van Toonen wordt door Schuiven (Mechanisch verzet) veroorzaakt terwijl de Zuiverheid wiskundig berekend is; zij zijn onontbee.3 ' l\jk voor alle Musici Pianostemmers en Dilettanten daar zij niet alleen ! -dienen om alle Instrumenten van welke Soort ook  zuiver te stemmen maar ook om de zuiverheid van alle Instrumenten te onderzoeken z. ! kosten slechts per stuk ƒ5. j. J# ALLGAÏER  l __ -T . -_ N* Z. Achterburgwal bij de Huiszittensteeg N°. 85. UIT DE HAND TE KOOP bij hem: TWEE PIANINOS de ééne nit eene «er beste Panjzer Fabrieken 6* Octaaf in Palisanderhouten ; Kast voor/380; de andere uit de beroemde Fabnjk van SCHIED. MAYER te Stuttgart in Mahonijhouten Kast voor/400 benevens «en MBW™«^»«M. tootƒ180; eene bespeelde Engelsche RROADWOOD PIAMO 6 Octaaf TOor/ 150; en een 5 Octaafs ; pi ANO_TOor ƒ 25. (18116) ■ _TT WEL. Er wordt TE KOOP gevraagd binnen de stad Am_ j r^e AI<_'~IRE. welke eene ruime Winst oplevert onver- welken aard met het Huis liefet in Koop tePgen j_iG «chilhg win ww**«"" V„LreB._ adressere men zich per Briefje onder Aflossing. Hierop refl«P*™l^ J. M. E. MEIJER Herengracht lett. X. X. ny den Boe_nanaei_-i - (17953) hoek Wolveastraat te_A^^ KVoor een HEEB _^?™™K«|i KAMERS voor- S_ns___.de: DRIE «^GEMEUBILEERD »» inuenkamer en rfen-van Kleeden en Gordinen bij voorkeur Zij- en •»' HUIS of Suite: benevens een Slaapvertrek in een Toehuis of wel^J™. IÈN 'GEDEELTE VAN EEN HUIS met drie of vier ruime Ver|ckken^ Keuken enz. Adres Lett. F. bij den Boekhandelaar <*• ""L ■ ÖOGH Leidsehestraat H. 19. \lm>l> »",http://resolver.kb.nl/resolve?urn=ddd:010073094:mpeg21:a0022:ocr,4,ddd:010073094:mpeg21:p004,Algemeen Handelsblad,1109
4265884,1851/10/11 00:00:00,2326,ddd:011236835:mpeg21:a0011,http://imageviewer.kb.nl/ImagingService/imagingService?id=ddd:011236835:mpeg21:p004:image&x=2036&y=4300&w=1834&h=2326,ddd:011236835:mpeg21,3870,6626,2036,4300,4,"PRÖfESTANTSCIIE EEUEDIENST. OpyZomlay tien 12den OeMer 1851. 1 WILi;K3!S - K E R K. * I)cü ten luilf negen .uro geena dictis/ f vfifgeris van een? der t Öji ccne dient reis zijnde. > t $EMKRi) I? IT S CU. J Ur&hrJV L A\' OXM M 4 AJL. ""7""'T — rrr Des avonds teji half 7 ure van rjfenfjcL  > - BllfcTEX-KK KK. T . .li ' y. •' ;> MitKiscH.""..; ~ - ~ ; . Des icijTTifflf Ö ure Uief/Lau* • P/f- Ï7«M: - ociobér 1851. :' v-;; • - :L. Hi LKi ycir. 1 . . .. V. . . 7 L . *** — - "" t .J rOOHBÈHMÓhVCÏ VOOR MET //. JVOSDMAJU •(""- ' | /""V"" \—:jp > • { ••• » • -""-»••• . jßes rnomiddags -tenT* wc ca*» Iféngd. - Y - f. .fTL' k- ..v-% swfe.srr"" ■-'/ -V v-■ f* *„ v""'• **f '■ *. .  BOOMSCII-KATIIOLIJKE GEMEENTE. Zondag't™:Vl*<« OctóberJBs|^' j"" ten J_ : > I^C'^^"" uh^r ' ... I I ■>■ n> ■win.»»' . ...? *""#■ . ..' : •'• i "" •. 1 --f.",http://resolver.kb.nl/resolve?urn=ddd:011236835:mpeg21:a0011:ocr,4,ddd:011236835:mpeg21:p004,Bataviaasch advertentie-blad,1834
4585311,1851/12/19 00:00:00,4491,ddd:000012095:mpeg21:a0015,http://imageviewer.kb.nl/ImagingService/imagingService?id=ddd:000012095:mpeg21:p004:image&x=1088&y=400&w=1021&h=4491,ddd:000012095:mpeg21,2109,4891,1088,400,4,lygßffiTïn^ RT L Ir 1 N II O O N T E  Nolaris **• * le Dalfsen is voornemens Wn\\* om °P aanstaande Dingsdag den 'Z'.Uien December 18ül  des vooi demiddags om eMf nul- in heti Logement DE BUIT EB le Dalfsen finaal te verkoopen : Een hoekje GROND gelegen in het Dorp Dalfsen  bij inzate gebragt op f 85.— Een UITGANG van een mud 7 schepels 4 koppen ROGGE bij inzate en verhooging gebragt op » 95.— Een Dilo van 5 Schepel G Koppen Rogge op » 31.— Een Dito van 4 Schepel 9 Koppen Rogge op » 22.— Een Dito van 3 Schepel 5 Koppen Rogge op » 14.— Een Dito van 2 Schepel 8 Koppen Rogge op » 8.— Voorls zal onmiddelijk na den afloop dier veiling worden verkocht: Eenige GOED E REN gebruikt geweest zijnde tot de uiloefening eener LIJMF A B RI EK  bestaande in een groote KOPEREN KETEL 4 HOUTEN en 5 STEENEN L 0 0 1 KUIP E N  een P O M P  200 LIJ MII EK KEN eenige KOEL BAKKEN DEKSTUKKEN en verdere toebehooren  alles zoo goed als nieuw. Nadere informatiën ten Kantore van boyengenoemden Notaris alsmede ten Kantore van den Heer Mr. J. A. van ROUEN Advocaat en Nolaris te Zwolle. fMMfc'' |¥~KL E fITHOONT E Notaris te Dal f%i^^F Mm.m SCB) js voornemens om op den 30slcn . ijL December 1851 des voordemiddags om 9 uur ten huize van LAMMERT KRAK E in Ooster Dalfsen gemeente Dalfsen publiek aan de meestbiedenden le verkoopen : Twee perceelen op'stam slaand EIKEN HAKHOUT. Ongeveer O© stuks EIKEN BOOMEN waarvan eenige geschikt voor Bergroeden. Eenige BEUKEN BOOMEN. Ongeveer 3©© sluks gehakte grove DENNENBOO MEN geschikt tot HEIPALEN SPOREN en RIKKEN. Alles staande en gelegen in de Buurschappen Welsum en Ooster Dalfsen  gemeenie Dalfsen. De aanwijzing /.al gedaan worden door de bewoners op het Erve 110 NTII UI Sm Welsum en DE K B AKE  in Ooster Balfsen. Nadere informatiën ten Kantore van boyengenoemden Notaris. ZEGT HET VOOBT. Ycrkooping van vaste Goederen en Hout op stam. Jj^k Ffce Notaris Mr. B. W. BLIJDEN S T E I N te Enschede is voornemens iTjIL-. - Op Dingsdag den 3© December e. k. des voormiddags ten tien ure in het Logement DEN KLO3IP le Enschede publiek te doen inzetten en 14 dagen later dus den 13denJanuarij 1852 ler zelfder uur en plaats in perceelen kavelingen en massa finaal le verkoopen : De Erven Elferink -Achterhof en Gildehuis  gelegen in de Buurschap Ussclo Gemeenie Lonneker nabij Enschede bestaande in vijf WOONHUIZEN vijf SCHUREN circa 25 Bunders BOUW- en HOOILAND en BOSC 11 G R O N D en de aangekochle toegedeelde en nog toeledeelen HEIDEGRONDEN der Marke Ussclo gedeeltelijk reeds gecultiveerd. 2. Op Woensdag don 7 Jan. 1552 eerslkomende des voormiddags ten negen ure op het Erve ELFEBINK voornoemd m perceelen publiek le verkoopen: Een geheel Bosch bestaande in 340 meestal fraaije lange en veel zware EIKEN BOOMEN zeer geschikt voor Water en Timmerhout. De Kooper van het Erve ELFERINK heelt op nader te bepalen Voorwaarden  het regt tot overneming van het alsdan verkochte BOSCH. Nader informatiën zijn te bekomen bij gemelden Notaris en bij G. SCH O~L TE N te Ussclo die ook de aanwijzing zal doen. JPZ^-^SS-S-» In het vorig Nr dezer Courant is bij abuis <éi&%^^ * geplaatst: W- KLIN K E R T enz. moet zijn: naast W. KL I N XE R T en J. B OSSI NK op de Kamperpoortcnwal is eenen nieuwen Winkel geopend van ongebuild TA Et WEN- en ROGGENeTIÈEIi in het groot en klein Puike kwaliteit gemalen door den Molenaar P. HOOGLUGT bij wien men zich daaromtrent gelieve te informeeren. ffitts^^ËpSm* È^r wordt gevraagd  legen Februarij of «^v2P-»-» Me' > op een Buiten tusschen Zutphen en Deventer: Een 14 I.TSENII.H of EINNENIfIEID volkomen in staat om met de Wasch om te gaan en het Wollen en Linnen naaijen grondig verstaande van de Protestanlsche Godsdienst en niet beneden de 30 jaar. Opgave van vorige diensten en waar getuigen le bekomen zijn verzoekt men met franco brieren bij </en Boekhandelaar D- J. WILTEIt D I N K te Itiv.nlcr onder l.tt. X. ¦^ffljfflSN&tö 4% k'-'Ük*3 voorwaarde bestaat er getul-B ;S»^ legenheid voor een fatsoenlijk ¦T^ JONGELING van de P. G. om als LEERLING geplaatst te worden in eene KRUI DE- N I Ell S-A F F AI B E. Relleclerende adressere zich met franco Blieven onder Litt. B. bij DE ERVEN J. J TUL Boekhandelaars te Zwolle.,http://resolver.kb.nl/resolve?urn=ddd:000012095:mpeg21:a0015:ocr,4,ddd:000012095:mpeg21:p004,"Provinciale Overĳsselsche en Zwolsche courant : staats-, handels-, nieuws- en advertentieblad",1021
2351288,1851/08/02 00:00:00,2356,ddd:010979927:mpeg21:a0023,http://imageviewer.kb.nl/ImagingService/imagingService?id=ddd:010979927:mpeg21:p004:image&x=48&y=2536&w=998&h=2356,ddd:010979927:mpeg21,1046,4892,48,2536,4,%* Bekendmaking  ingevolge Art. 28 van liet Wetboek van Koophandel. Bij onderhandsche Akte van den 27 Mei 1851 is tusschen de Ondergeteekenden THOMAS BASTIAAN TEMPLEMAN VAN DER HOEVEN Commissionair JACOB JOHANNES VAN DER WILLIGEN Commissionair en Expediteur en JEAN GEORGE HENRI FAUCHEY Particulier de twee eersten wonende te Rotterdam en de laatste in de gemeente Kralingen  aangegaan eene VENNOOTSCHAP tot dc uitoefening van Handels- Commissie- en Expeditiezaken met uitsluiting van Effectenzaken of Olie op Contract alsmede het geven van Blanco Credieten. Zij zal geduren Vijfjaren en Acht Maanden welke gerekend worden te zijn aangevangen primo Mei 1851 en alzoo eindigen ultimo December 1856. Zij zal gevestigd zijn te Rotterdam en gedreven worden op de Firma FAN DER II OEFEN en COM PAG N lE waarvan de eerste Vennoot de teekening zal hebben en de beide anderen ieder per procuratie met bijvoeging zijner particuliere handteekening. Elk dezer teekeningen zal voor de Vennootschap vetbindend zijn in en omtrent alle zaken tot dezelve direct betrekking hebbende doch nimmer tot het opnemen van Gelden teekenen van Borgtogten  of dergelijke Handelingen en Vetbindtenissen waartoe ieders particuliete handteekening •wordt vereischt. THO.s B. TEMPLEMAN VAN DER HOEVEN. J. J. VAN D. WILLIGEN. J. G. 11. FAUCHEY. k KAPITALE ei LAATSTE PREMIE m /50000Pn2110 is op een Geheel Lot gesplit in 2/2 ten Kantore van JAN HENDRIK FOL Hoogstraat schuins over het Raadhuis alhier. WAFELKRAAM M£ O O 1' HAÜT J§ BV Mi JL V A Ml Mi X van ouds geplaatst geweest aan de Pakkenbrug is nu weder geplaatst aan de Raambrng over de Raamstraat. De Ondergeteekenden nemen deze gelegenheid waar om zich aan hare geëerde Stadgenootcn en Begunstigers Cook van hunne vorige Standplaats) beleefdelijk aan te bevelen  belovende cene prompte en zindelijke bediening. Gezusters PALTE. WAFELKRAAM van ouds BB Mi XOMiVMiX MX VA Mi. De Ondergeteekende maakt bij deze aan hare Begunstigers en verdere Stadgenooten bekend dat zij weder met hare WAFELKRAAM geplaatst is aan de Nlicnweliave» bij de Pakkenbrug; zij verzoekt beleefdelijk de gonst belovende eene prompte en zindelijke bediening. Wed. VERBRUGGE,http://resolver.kb.nl/resolve?urn=ddd:010979927:mpeg21:a0023:ocr,4,ddd:010979927:mpeg21:p004,Rotterdamsche courant,998
1113616,1851/04/19 00:00:00,1304,ddd:000013009:mpeg21:a0013,http://imageviewer.kb.nl/ImagingService/imagingService?id=ddd:000013009:mpeg21:p004:image&x=1913&y=1239&w=854&h=1304,ddd:000013009:mpeg21,2767,2543,1913,1239,4,(1715) Bij E. J. Brlll Boekhandelaar te Leyden  is uitgegeven : N. C. KIST Neêrland's Bededagen en Biddagsbrieven 2 deelen f 1100 de terugkomst der Leidsche Studenten  Godsdienstig gevierd op den gedenkdag van Lcidens ontzet f 030 Het Placet en de Regering  020 S. F. J. RAU  sermons sur divers textea de I'écriture sainte  3 vol. f 600 D. CHANTEPIE DE LA SAUSSAIJE le dernier commendement du Christ a ses diseiples sermon sur Matth. XXVIII: 19  20a publié en faveur de la société Ncorlandaise des Missions f 040 Leerrede over Psalm LXXVI : 13a  behelzende dr uitbreiding eener Schets naar welke wijlen Prof. J. Claeisse  weinige dagen na het overlijden van Neéïl. Koningin gepredikt heeft door F. 11. G. van HERSON f 050 J. F. van OORDT J. G. Fil.  oratio de vero in Thcologia unice sectando • f 040 W. A. van HENGEL Korte Schets der Akademische Lessen over de Evangelie-Bediening in de Nederl. Hervormde Kerk f 010 Mr. J. J. L. van deu BRUGGÜEN de Eodileer naar Christelijke en llegtsgeleerde beginselen f 300 Mr. H. OBREEN het geloof de eenige weg tot de waarheid  f 030 A. J. LASTDRAGER Bijdrage tot de geschiedenis van het onderwijs iv Nederland sedert 1825 f 060,http://resolver.kb.nl/resolve?urn=ddd:000013009:mpeg21:a0013:ocr,4,ddd:000013009:mpeg21:p004,"De Nederlander : nieuwe Utrechtsche courant : (staatkundig- nieuws-, handels- en advertentie-blad) / onder red. van J. van Hall",854
1532912,1851/08/15 00:00:00,1192,ddd:010786713:mpeg21:a0012,http://imageviewer.kb.nl/ImagingService/imagingService?id=ddd:010786713:mpeg21:p003:image&x=1332&y=3142&w=1286&h=1192,ddd:010786713:mpeg21,2618,4334,1332,3142,4,A ü V E K T E N I'IË JM. MINISTERIE VAN BINNENLANDSCHE ZAKEN. Provincie Noordbrabant. AANBESTEDING.. Op Vrijdag den sden September des jaars iBsi des middagsten 12 ure zal onder nadere goedkeuring door den Staatsraad  Commissaris des Konings in de provincie Noordbrabant  of bij deszelfs afwezigheid  door een der leden van de Gedeputeerde Stiten en in bijzijn van den Hoofd- Ingenieur van den Waterstaat in het 6de districi  aan het locaal van het Provinciaal Bestuur te's Herlogeribosch  worden Aanbesteed: De IL'istedmg van eertige Gebreken aan de onderscheidene werken in den Baardwijksciien Overlaat en aan de Rljks-SluiS in de Oostelijke Vaartkade v.>n Waalwijk in de provincie Noordbrabant met het Onderhoud dier werken tot den iSden November 18.51. Deze Aanbesteding zal geschieden bi| inschrijving en opbod. Het Bestek der bovengemelde Aanbesteding zi!  boven en behalve aan het iocaal van het Ministerie van Bmnenlaiidsciie 'Zaken  en aan dat van het Provinciaal Bestuur van Noordbrabant te 's Hen ogen bosch  ter lezing liggen op alle zoodanige plaatsen  alwaar gewoonlijk de Bestekken van Waterstaats-werken in gemelde provincie ter lezing gelegd worden. Zullende vier dagen vè'or de Besteding de noodige Aanwijzing in loco worden gedaan en voorts nadere inforinatlen te bekomen zijn bij den Hoofd-Ingenieur in Noordbrabant H. F Fjjnje den Ingenieur E. C. B. Ridder van Rappard  beiden te 's Heribjenbosch  en den Rijkswachter ! aan den Raardwijkschen Overlaat A.H. Ho. Namens den Ministervan Binnenlandsche Zaken De Secretaris-Generaal J. SciIRÖDER.,http://resolver.kb.nl/resolve?urn=ddd:010786713:mpeg21:a0012:ocr,3,ddd:010786713:mpeg21:p003,Nederlandsche staatscourant,1286
3500997,1851/02/11 00:00:00,3613,ddd:000019879:mpeg21:a0046,http://imageviewer.kb.nl/ImagingService/imagingService?id=ddd:000019879:mpeg21:p004:image&x=80&y=1833&w=969&h=3613,ddd:000019879:mpeg21,1049,5446,80,1833,4,"HOLLANDSCHE IJZEREN SPOORWEG-MAATSCHAPPIJ. HEEREN DEELHEBBERS in deze Maatschappij worden uitgenoodigd tot het bijwonen eener AI-CSEBIEENE VERC.A-DERIN-»  welke zal gehouden worden op Woensdag den 26sten Februarij 1851 des middags ten 12 ure precies in het Lokaal Odéon op den Singel bij het Koningsplein en worden de Deelhebbers herinnerd aan het slot van Art. 12 der Statuten luidende: «dat niemand in de Vergadering zal worden toegelaten dan voorzien van zijne Aandeelen; wordende zij lieden daarenboven verzocht om zich te voorzien van eene door hen onderteekende Lijst waarin de Nummers hunner Aandeelen zijn vermeld ten einde dezelve op de Vergadering over te leggen."" De Raad van Administratie der Hollandsche IJzeren Spoorweg-Maatschappij Amsterdam en Namens denzelve 7 Februarij 1851. L. J. J. SERRURIER Commiss.-Pres. (879) D. BORSKI Commiss.-Secretaris. Aan de Edel Achtbare Heeren President en Regters der Arrondissements Regtbank te Rotterdam. Verzoekt met verscbuldigden eerbied ADRIAANT.E DE KONING Echtgenoote v.n Arie Verheul werkster te Rotterdam. Aangezien zij den veertienden Mei achttien honderd vier en dertig met voornoemden haren man te Rotterdam is gehnwd. Aangezien haar man uu voor ongeveer tien jaren heeft kunnen goedviuden de gemeenschappelijke woning te verlaten zonder zich verder ooit om haar te bekommeren. Aangezien zij alzoo legen gezegde haren man verlangt te procederen tot Echtscheiding uithoofde van kwaadwillige verlating. Aangezien zij echter blijkens ten dezen geannexeerd bewijs van onvermogan niet in staat is de daartoe noodige kosten te betalen. Da1 het UEdel Achtbare moge behagen haar suppliante verlof te verleenen om kosteloos tegen baren voornoemden Echtgenoot ARIE VERHEUL te procederen tot Echtscheiding uithoofde van kwaadwillige verlating en baar een Procureur en Deurwaarder toe te voegen om haar daarin te adsisleeren. 't Welk doende enz. (Geteekend) W. S BURGER Je. Procureur. De Arrondissements-Regtbank te Rotterdam Gezien het vorenstaande reqnest alsmede artikel 4 No 7en art. 9 859 en 860 van het Wetboek van Burgerlijke Regtsvordeiiug. Beveelt dat de wederpartij in deze ARIE VERHEUL op een termijn van twee maanden  op de wijze voorgeschreven bij art. 4 No 7 van bet Wetboek van Burgerlijke Regtevorderiug zal worden opgeroepen en zulks om te compareren in het Locaal van gemelde Regtbank voor de Edel Achtbare Heeren Regters mrs. BICBON VAN IJSSELMONDE en BEELS ten deze als Commissarissen bencemd op dag en nur waarop de Regtbank van burgerlijke zake hare zitting houdt en voegt aan de requestrante als Procureur toe den Heer WILLEM SIMON BURGER Junior. Aldus gedaan en gearresteerd ter Raadkamer den negen en twintigsten Jannarij achttien honderd een en vijftig bij de Heeren mrs. VAN VOLLENBOVEN President BICBON VAN IJSSELMONDE en BEELS Regters; KRAGT Substituut-Griffier. (Geteekend) P. VAN VOLLENHOVEN. Gratis geregistreerd een blad zonder renvooij te Rotterdam den levenden Februarij 1800 een en vijftig deel 119 fol. 21  vak 6. De Ontvanger (Get) VAN BERKEL. Voor Copie conform (Gei) W. S BURGER Jr. Procureur. Op den tenden Febrnarij achttienhonderd een en vijftig. Ten verzoeke van ADRiAANTJE DE KONING Echtgenoote van Arie Verheul van beroep Werkster wonende te Rotterdam ten deze domicilium kiezende ten Kantore van den aan haar toegevoegden en alzoo occuperenden Heer Procureur WILLEM SIMON BURGER Junior aan de Haringvliet wijk 18 nummer 87 heb ik Ondergeteekende DANIEL BENDRIK CORNE beéedigd Deurwaarder bij de Arrondissements-Regtbank te Rotterdam wonende aldaar aan de Hoogstraat wijk 7 nummer 95. (Exploit doende zoo als hierna zal worden gezegd.) Gameiden ARIE VERHUEL beteekend en denzelven opgerot pen te verschijnen voor de Edel Achtbare Heeren hegiers Mrs. BICBON VAIV IJSSELMONDE en BEELS als Commissarissen op Woensdag den drie en twintigsten April achttienhonderd een en vijftig ten half elf ure in het Lokaal van gemelde Regtbank aan het Haag- Bcheveer te Rotterdam ten einde op het door mijne Reqniraute ingediend verzoekschrift om kosteloos te mogen procederen tot echtscheiding uithoofde van kwaadwillige verlatiog te worden gehoord. En heb ik Deurwaarder wijders exploit doende aan het Parket van den Edel Achtbaren Heer Officier by dezelve Regtbank me' zijn EJel Achtbare in persoon die het oorspronkelijk met «gezien"" heeft geteekend. Eu bij aanplakking van een tweede afschrift aan de voorname Deur der Vergaderzaal vnn opgemelde Regtbar.k en eindelijk bij plaatsing van een derde afschrift in de Nieuwe Rotterdamsche Courant behalve het Request ten deze voormeld en de dispositie alsmede Copie van dit Exploit De kosten zljn «Ai.. D.H CORNE (870) Deurwaarder (824) Die iets te vorderen hebben van den Boedel van LAURENS DE POTER en diens Weduwe AÜRIANA VAN NOORT beide gewoond hebbende en overleden te Iholen worden verzocht daarvan binnen 8 dagen opgaaf te doen ten Kantore van den Notaris WAGTHO te Tholen.",http://resolver.kb.nl/resolve?urn=ddd:000019879:mpeg21:a0046:ocr,4,ddd:000019879:mpeg21:p004,"Nieuwe Rotterdamsche courant : staats-, handels-, nieuws- en advertentieblad",969
604836,1851/10/20 00:00:00,636,ddd:010518449:mpeg21:a0020,http://imageviewer.kb.nl/ImagingService/imagingService?id=ddd:010518449:mpeg21:p003:image&x=2020&y=4260&w=951&h=636,ddd:010518449:mpeg21,2971,4896,2020,4260,4,"**• VERKOOPING VAN EENE AANZ7Ï™JÏF. ROEREN-HOFSTEDE EN LANDEN TE SCHALKWIJK. HENRICÜS JACOBUS van MARIËNHOFF Nota ris residerende te Wijk bij Duurstede zal op Maand»l den 10*» November 1851 des voormiddags Li inr/' teu huize van M. W. Somer in de Roskam te Houten! publiek veilen en verkoopen: N°. 1. Eene aanzienlijke BOEREN-HOFSTEDE be staande iv eene Huizinge drie Bergen Schuur Bakhuis eu verdere Getimmerten met de daarbij aau elkander gelegen BOOMGAARD BOUW-en WEILANDFN m de Gemeente van Schalkwijk aau den Mae Adaroaweg te zamen ter grootte van 41 Bunders 9:> Roeden aL w 'P':»^'1»'™1™ -^BK"" voorkomende onder Sectie B N°. 44:. lot en met 462",http://resolver.kb.nl/resolve?urn=ddd:010518449:mpeg21:a0020:ocr,3,ddd:010518449:mpeg21:p003,Opregte Haarlemsche Courant,951
51688,1851/11/21 00:00:00,52,ddd:000012087:mpeg21:a0006,http://imageviewer.kb.nl/ImagingService/imagingService?id=ddd:000012087:mpeg21:p003:image&x=2137&y=2850&w=994&h=52,ddd:000012087:mpeg21,3131,2902,2137,2850,4,AH? Illlfl3S[ï3_ 11.,http://resolver.kb.nl/resolve?urn=ddd:000012087:mpeg21:a0006:ocr,3,ddd:000012087:mpeg21:p003,"Provinciale Overĳsselsche en Zwolsche courant : staats-, handels-, nieuws- en advertentieblad",994
9035119,1851/12/30 00:00:00,4762,ddd:000020234:mpeg21:a0050,http://imageviewer.kb.nl/ImagingService/imagingService?id=ddd:000020234:mpeg21:p004:image&x=2065&y=723&w=1950&h=4762,ddd:000020234:mpeg21,4015,5485,2065,723,4,"(7739) Op Zaturdag den lOden Januarij 1852 des namiddags ten half drie ure  zal op het Raadhuis t*3 Oud- Beijerland in het openbaar voorden tijd van drie jaren onder de vereisehte goedkeuring worden verpacht: de SECREETMEBT in gezegde Gemeente vallende van 1852 tot en met 1864. *-£?•% Openbare Vrij willige Verkooping MgEEffisJtt van eene bijzonder gunstig gesitueerde *3SB3l*^ SCHEEPSTIMMERWERF HEERENHUIS  ARBEIDERS- WONINGEN en LANDERIJEN respectivelijk onder de Gemeenten Capelle op tVJJssel en Mralingen. Mr. PIERRE GERARD DALEN Notaris residerende teßotterdam als lasthebbende van zijne Principalen daartoe behoorlijk gemagtigd is van meening om op Vrijdag den 2den Januarij 1852 des namiddags ten 5 ure in het Gemeentehuis op den hoek van 's Gravenweg en de Korte Kade te Kralingen in het openbaar te veilen en te verkoopen: Nos. I a 15. Eene bijzonder gunstig aan den mond van de Rivier den IJssel gelegen SCHEEPSTIMMERWERF met SCHEEPSTIMMERDOK VIJZELMOLEN WAGENSCHUUR STALLING en .erdere GETIMMERTEN; een hecht sterk en weldoortimmerd HEERENHUIS voorzien van vele net Behangen en Geplafonneerde Kamen Keuken Kelder en verdere Gemakken KOETSHUIS KOE- en PAARDENSTALLING  voorts diverse ARBEIDERSWONINGEN alles met ERVEN GROND en TUINEN  benevens onderscheidene Perceelen uitmuntend BOOMGAARD- WEI- HOOI- BOSCH-en RIETLAND te zamen met inbegrip van IJsselwater groot in oppervlakte 23 Bunders 73 Roeden 45 Ellen alles staande en gelegen onder de Gemeenten Cappelle op d""lJssel en Kralingen; kadastraal bekend Gemeente Cappelle op (flJssel sectie A nummers 125 0 a 1253 en sectie B nos. 2 6 a 10 13 a. 22. 25  35 a 38 844 a 859 2069 2128 2129 2141 a 2149 2227 2228 2285 2286 2371 a 2374 en Gemeente Kralingen sectie A nos. 2509 a 2511 2514 a 2517 en sectie B nos. 2335 en 2336. Zulks eerst Perceelsgewijze en daarna met combinatien. De meeste dezer Perceelen zijn in eigen gebruik en allen breeder bij Billetten omschreven. Nadere informatien te bekomen ten Kantore van de Notarirsen DALEN en LAMBERT aan de Zuidblaak te Rotterdam terwijl de te veilene Goederen des Maandags Dingsdagsen Woensdags vóór den dag der veiling kunnen worden bezigtigd. (7497) (7780) De PANDEN in de Korte Lijnsteeg in de Goudsche Wagenstraat en in de Gietersteeg te Holterdam  welke op laatstleden Woensdag door de Notarissen SANDER en PAATS in het Lokaal voor Publieke Verkoopingen aan de Geldersche Kade zijn geveild zullen op HEDEN Dingsdag den Slisten December 1851 des namiddags ten vier ure ter zelider plaatse door gemelde Notarissen worden afgeslagen. Een blaauwe PAPEGAAI twee jaren oud in IJzoren Kooi; kunnende deze Vogel bijzonder goed spreken. Inclinerenden gelieven zich onder lett. LLS te adresseren aan het Bureau dezer Courant. (7724) Eene Extra Buitengewoone SALON of CONCERTFLEUGEL  geschikt voor Concert of Zangvereeniging; gediend hebbende als eerste sieraad op de Tentoonstelling te Londen. Te bespelen en te bezigtigen bij D. VAN GELDER Boeren Vischmarkt te Rotterdam. Brieven franco. (7726) ¦ir-~-^|flj| Uit de band te Koop voor eß__B____S____ WTjÖKI- Een 9 Octaaf- en een 64 OcrT"" t*aaj_~|JJfc tas-fs PIAIVINO buitengewoon Schoon en Sterk van Toon; voor de deugd wordt gegunraiuleerd. Te bevragen bij DE ERVENPEIJPERS Hoogstraat Wijk 10No. 67. (7732) Te Dordrecht Uit de Hand te Koop twee WINKELHUIZEN  beste standen op de Voorstraat zijnde het ééne tevens zeer geschikt voor elk ander groot bedrijf. Te bevragen bij den Heer J. P. F. DICKE aldaar. (7715) Door gevorderden ouderdom uit de Hand te Koop Eene goed onderhouden GRUTTER». Te bevragen bij H. BRANDENBURG te Gouda. (7589) Door Verandering van Zaken wordt ter Overneming aangeboden. Een komplete TARAK-  SNUIF-  KOFFI Jen THEE-WINKEL met Eest en verdere Gereedschappen  in eene der volkrijkste Straten dezer Stad zijnde het Huis tegen een billijken prijs er bij in huur. Adres onder letter A aan den Kantoor-Boekwinkel en Steendrukkerij van H. J. VAN BOOGERIJEN. (7737) Let Wel! ~"" Bij toeval wordt op een zeer goeden Stand Terstond ter overneming aangeboden voor een zeer matigen 1 rijs  een ZEEMANS-LOGEMENT en TAPPERIJ welke sedert eene reeks van jaren een ruim bestaan opleveren. Adres bij W. A. ROOS Nieuwehavensteeg wijk 11 No. 114. Brieven franco. (7738) f-r^a - Eene JUFVROUW uit den fatsoen__ *_Ëï lijken Burgerstand zag zich gaarne ge- JP**ié_BJr plaatst als Huishoud* ter of wel anders tot Gezelschap bij eene of andere alleen wonende DAME. Zij zal minder op loon  dan wel op eene goede en minzame behandeling zien. Adres met franco brieven onder letter X  bij den Boekhandelaar K. A ENKLAAR Kleine Draaisteeg te Rotterdam. (7721) tfif ;iü_-Vl_r °P een KANTOOR hier ter Stede 1 _ •jSjji^wordt verlangd lEMAND grondig \VltmWuw bekend met de Duitsche. Engelsche en Hollandsche Talen en daarin Correspondentie kunnende voeren hoofdzakelijk ten einde de Expeditie van Landverhuizers te administreren. Adres met franco Brieven onder letters EO aan het Bureau dezer Courant. (7736) (7740) Men verlangt tegen Mei of vroeger eene bedaagde HOFE-.-KI-.DEHI.IEID ofRONTVE van de Protestantsche Godsdienst en goede getuigschriften kunnende overleggen. Adres bij de Boekverkoopers M. WIJT EN ZONEN Beursplein of in persoon Wijnhaven Wijk l No. 263. VISITE KAAf&TEN. Van best dik gesatineerd wit CARTOTV a 7 Cents  15 Cents en 20 Cents de 100. Met Vergulden- en Rouwranden iets hooger bij J. C. NEISZEN Hoogstraat 7 No. 117. (7729) Komt ziet en oordeelt! 100 stnks FISITE KAARTJES a 80 c / 1  f 1.25. bij T. v. d. BEEK Oppert 205. (7734) (7723) Bij J. H. GERIIARD en Co. Leliegracht  No. 16 te Amsterdam is verschenen en voorts algemeen verkrijgbaar; Mr. A. Philips DE ENGELSCHE ARMEN-WETTEN  naar Inhoud en Werking geschetst. Gr. Bvo. Prijs 90 Cents Mr. A. J. Nieuwenhuis HET ONTWERP VAN WET op de JAGT en VISSCHERIJ beoordeeld. Gr. Bvo. Prijs 25 Cents. Voorts is uitgegeven: Mr J.L.. de Brnyn Kops BEGINSELEN VAN STAATHUISHOUDKUNDE. Tweede Druk. 12». Prijs f 1.90. BESCHOUWING van het ARMWEZEN. 12°. Prijs 60 Cents. DE INDIRECTE BELASTING als middel van Plaatselijke inkomsten. Gr. Bvo. Prijs f 150. Mr. A. J. B. Stolfels de WETGEVING op de OCTROOIJEN voor Uitvinding Verbetering en Eerste Invoering. Gr. Bvo. Prijs ƒ 1.50. Mr. W. C. D. Olivler DE BEPERKINGEN van den EIGENDOM door het POLITIE-REGT. Gr. Bvo. Prijs -""2.70. Ter Perse: Mr. J. .L. de Bruyn Kops  OVER HET BEGINSEL VAN ARMEN VERZORGING DOOR DEN STAAT. Antwoord aan den Heer Mr. A. Grcvellnk. Mr. H. W. de Graaf BEDENKINGEN TEGEN HET ONTWERP VAN WET OP DE JAGT EN VISSCHERIJ. Alom te bekomen a7O Cents of / 7.— de 12 Ex. HERINNERINGEN van eenen DRONKAARD Matigheid in het gebruik van Sterken Drank is de af hellende heuvel tot Onmatigheid. (7736) (7566) Bij K. FUHRI te 'sGravenhage komt van de pers: DE BINNENKAMER VAN EEN KRUIDENIER. OORSPRONKELIJKE SCHETSEN EN TAFEREELEN NAAR HET BURGERLIJKE LEVEN. UIT DE PAPIEREN VAN OUDOOM JACOB uitgegeven door B. T. Lublink Weddik. Met 12 platen naar teekeningen van H. F. C. TEN Kate. In gr. Bvo en gebonden in half Marocco-lederen band met vergulden rugtitel. Prijs /'3.50. Bij denzelfden Boekhandelaar ziet het licht: WATHAM DE SQUATTER REGULATOR OF DE EERSTE AMERIKAAN IN TEXAS. DOOR CMABTjES SEAItSEIEItB. Deze roman is kompleet in 2 deelen gr. Svo met gelithographiëerde titels en vignetten. Prijs f 4.50. (7617) Bij den Boekhandelaar NIJHO F F  te Arnhem wordt heden uitgegeven: ZANGEN VAN VROEGERE! LEEFTIJD EN Nieuwe Gedichten DOOR BEBNABB TEB BAAM. Deze tweede Bundel is versierd met de* Dichter» Portret op Staal gegraveerd door J. W. Kaiser. De prijs is f 3.90. — Van het PORTRET zijn enkele Afdrukken in folio op Chin. Papier afzonderlijk verkrijgbaar a / 2.50.",http://resolver.kb.nl/resolve?urn=ddd:000020234:mpeg21:a0050:ocr,4,ddd:000020234:mpeg21:p004,"Nieuwe Rotterdamsche courant : staats-, handels-, nieuws- en advertentieblad",1950
926120,1851/10/17 00:00:00,1781,ddd:011021460:mpeg21:a0007,http://imageviewer.kb.nl/ImagingService/imagingService?id=ddd:011021460:mpeg21:p003:image&x=1140&y=1527&w=520&h=1781,ddd:011021460:mpeg21,1660,3308,1140,1527,4,"B. WILLIAIIS. Advokaat en Regts-Raadgever en Sollicitour in Kanselary. Kantoor aan Pennsylvania Avenue eeiie deur ten oosten van Harvey & McKillip's winkel. n 32 EOPKINSON &'cURm Handelaars in 't groot en klein in Kruidenierswaren en Provisies Schoenen en Laarzen Wijnen Sterke Dranken enz. Winkel in de Empire blok hoek van Pennsylvania Avenue en Bste straat. n.18. jTó: pT kIJEHÏCSÏAEDT. Handelaars in 't groot en kloin in Manufacturen Kruidenierswaren Goud Zilver ""Yaukeo Noties"" Gemaakte kleoderen en HecrcnstoiVen. Winkel west van hot postkantoor. Sheboygan 22 November 1850. j2n2. Tarwen-en Roggen Mael. Een goed artikel bestendig voorhanden: te koop van eeu tot tieee Schellingen per barrel gocdkoojicr dan dezelfde kwaliteitop eenige plaats in town kan gekocht wordenalleen voor contant geld. lIOPKINSON & CURTIS. Sheboygan 17 Oct. 1850. n 49 GOEDKOOP VERKRIJGBAAR: TARWEN- ROGGEN- A INDIAANSCH KOREN-MEEL HAVER KOREN ZEMELEN enz. bij den ondergeteekende die tevens contant goknietnak voor Huiden. I'. BAJiDLE . to Shohoygan. Tegenover het postkantoor. uB5 W. SEAMS. Zadel- Gareel- «fc Kofiermakor Rijtuig Bekleeder enz. Winkel aan Pennsylvania Avenue bijna regt over het Merchant's Hotel Sheboygan (Wis.) n 3 HOPKEUSON & CURTIS. (Orvolgers VAX C. T. Moork & Co.) Handelaars in 't groot en klein in alle soorten nan KRUIDENIERS- WAR EN FRO I IS!ES Laarzen & Schoenen Kaochei.s Wijn km & Stkrkk Drankkn. enz. enz. De ondergoteokendon hebbon don ganschen voorraad van C. T. Moorc & Co. ovorgonomon ou veel meer waren daarbij gevoegd. Ouzo voorraad is reods do grootste van conigo in onze lijn ter dezer plaats en zal op nieuw worden aangevuldals het gevraag van negotie dit mogt veroischon. Wij verzoeken met achting do gunst van die Hollanderswelke mogton wilton koopon en wij beloven hun Goedkoopc Prijzen. Wij zoggen ten minste GkueVk tk komkn zien. Agenten tot het verkoopon van Socrates' Kruid. n4O HOPKINSON & CURTIS. JAY DEAN. ~ Handelaar in allo soorten van Keuken- Kamer- ou Plaat Kagchels; alsook de zelf rcgelerende Kamor Kagcliels Manufactnrier van alle soorten van Blikken Pandoeken en Koperen waren door heiu zeiven vervaardigde Koebellen Nagels enz.—R. Eenig agent voor Down & Co's Patent draai'ende Spuit- Regenbak- en Welpompeu. Pennsylvania Avenue Sheboygan n 9 llfllllffl PAS ONTVANGEN IN BE mmm «rop Slu-bojgau 25 Sqihiubcr 1851.",http://resolver.kb.nl/resolve?urn=ddd:011021460:mpeg21:a0007:ocr,3,ddd:011021460:mpeg21:p003,De Sheboygan Nieuwsbode,520
2102670,1851/08/23 00:00:00,2745,ddd:010332238:mpeg21:a0008,http://imageviewer.kb.nl/ImagingService/imagingService?id=ddd:010332238:mpeg21:p004:image&x=835&y=1811&w=766&h=2745,ddd:010332238:mpeg21,1601,4556,835,1811,4,"I Griffie der Regtbank. BEKENDMAKING. Curacao den 15 Augustus 1851. TTT RACHTENS besluit van de Regtbank dezer kolonie in dagteekening van den 12 dezer No. 4 gevolgd op een door den Heer GERARDUS MARTINUS HOC HE en echtgenoot. Mejufvrnuw WILHELMINA CATHARINA HENRICUS ingediend rekwest wordt hierby bekend gemaakt: dat de evengenoemde Heer GJERARDUS MARTINUS HOC HE en echtgenoot Mejufvrouw WILHELMINA CATHARINA HENRICUS mot onderlinge toestemming provisioneel van tafel bed bywoning en goederen gescheiden zyn op de door hen getroffene overeenkomst vervat in eene acte uit de notulen van Heeren Commissarissen ter rolle uit de Regtbank dd. 28 July dj. voor welke Heeren Commissarissen de evengenoemde personen tot het aangaan van minnelyke schikking verschenen waren— in de nakoming van welke overeenkomst zy op hun verzoek by gemeld besluit veroordeeld zyn. De Griffier by de Regtbank voormeld A. BEAUJON. OPROEPING VAN7 Crediteuren en Debiteuren. r^E Crediteuren en debiteuren des boedels van wylen den Heer ADRIAAN CHRISTIAAN DE GORTER worden hierby opgeroepen uitgenoodigd en aangemaand — de eerstgenoemden om hunne schuldvorderingen met derzelver bewyzen ter Weeskamer te willen inzenden—en de laatstgenoemden om binnen den tyd van' drie maanden het door hen verschuldigde aan den ondergeteekende te voldoen. Curacao den 8 Augustus 1851. De Weesmeester P. COCKBURN PRINCE. \~en nieuwe Yzerwinkek j Ï""*E ondergeteekende maakt by deze aan het publiek in het algemeen en aan zyne vrienden en begunstigers in het byzonder bekend dat hy in het pakhuis onder zyn woonhuis op de Breede straat No. 116 een Yzerwinkel geopend heeft onder de firma van F. VV. PALM & Co. alwaar hy ook andere winkelwaren te koop zal hebben. Hy neemt deze gelegenheid waar zyn nieuw etablissement aan zyne vrienden en begunstigers aan te bevelen. i Curacao den 15 Augustus 1851. F. W. PALM. I",http://resolver.kb.nl/resolve?urn=ddd:010332238:mpeg21:a0008:ocr,4,ddd:010332238:mpeg21:p004,De Curaçaosche courant,766
11263798,1851/05/04 00:00:00,4354,ddd:010786212:mpeg21:a0014,http://imageviewer.kb.nl/ImagingService/imagingService?id=ddd:010786212:mpeg21:p004:image&x=106&y=78&w=2587&h=4354,ddd:010786212:mpeg21,2693,4432,106,78,4,"PRIJS-COURANT. opgemaakt en uitgegeven den ifisten April i85.. ©p last van Zijne Excellentie den Heer Minister van Finantien door de beëedigde Makelaars J. S. Wurfbain  G. A Van der V A. Craandijk P. J. A. Sundorff T. J. B. Westerwoudt P. E. H. Praetorius J. H. Roelofsz D. Reul Koopman v der Weijden Jr. L. H. Weeljenen den Gedelegeerde L. Huijsinga Jr  ter voldoening aan het bepaalde bij art. n lit. D der vie den aysten December 1817 en voor zooverre de Buitenlandsche Effecten aangaat naar aanleiding van art. 28 der wet van den • Mei 1824 voor de regeling van het regt van successie van de waarde van effecten actiën en renten behoorende tot nalatenschaj waarvan het regt van successie verschuldigd is. UB. Van de Effecten achter welke in de kolom van den interest niets ingevuld is wordt op de memorie van aangeving geen aclit interest gebragt aangezien de te goed zijnde interest onder de getaxeerde waarde begrepen is uitgezonderd de actiën der Neder Bank en de aandeelen inde Nederlandsche ffandel-maatschappij waarbij in den handel eene rente berekend wordt. VERSCHILLENDE SOORTEN f VERSCHILLENDE SOORTEN S. w4.RriF VERSCHILLENDE SOORTEN H. Al DER EFFECTEN. « waarde. D|tR EFFEGÏEN. _. baarde. der effecten. . fl c c h3 l-l ______________________ -__. „— BINNENLANDSCHE EFFECTEN. rusland. {Vervolg). pauselijke staat. Inschrijving en Certificaten Werk. 2) Certificaten van inschrijving  Obligatien genegotieerd te Parijs. 5 69 Schuld 2>/2 57 pet. administratie Amsterdam . . . 5 99 Pct- Geconverteerde bij J. van Reeck Dito en dito 3 66'/2 » 2)Obligatien van dito te Londen. 5 100 « Vollenhoven c. s 5 69 DitO en dito 4 873/4 „ Dito dito dito . . 4'/« ' (De lire te rekenen op 5o cents.) Oblig. ten laste der O. I. bezitt. . 4 87 » 2) Inschrijving en certificaten van napels Schuldbekentenissen Amortisatie- dito bij Hope en Co. c. s. . 4 ?7 * Syndicaat 3'/3 88'/_ » 2) Dito bij Stieglitz en Co. ... 4 8b'/4 » Certificaten van 5 pets geconsoli- Scbalkistbiljetlen 4 ioo'/a » 2) Poolsche Schatkist-Oblig. Neg. deerde schuld bij Lamaison 29 Febr. 1844 4 77 "" en Rouwer 5 89 . „o-™™. „ 2) (Den roebel te rekenen op twee gulden.) c - « (De lire te rekenen tegen 5o cents.) stad Amsterdam. Aand. Polen 182g van fl.3oo . • - f 2.55-°° Schuldbekentenissen 829 ... 5 .09 « Dito dito  .835 van R. 5oo. . • . "" '47-°0 Denemarken Losrenten «845 4 993/4 "" Obligatien 4 9° /» oostenrijk. rj;to 3i/2 81 stad middelburg. Obligatien opdeWeenerRank ge- 9) Dito genegotieerd te Londen . 3 75 negotieerdbijGollenComp. . 5 76-/4 pet. Dto dlto l8/*9en l85° •- • • ■ 5 IO° Obligatien genegodeerd à 3 pct. '/ «o1/ » Dit0j hij idem  6a/ „ Kansbiljetten 9 » Dito bij idem \ 62 » amerika. DitosuppIemcnlaireletterGenO. 4 56 » Obligatienneg.opdestedenWashfarticuliere binnenlandsche Dito  bij Osy en Zoon 5 75 * ington Alexandrie en Georgenegotiatien. Dit0 bij idem 4./ 61 » town bij D. Crommelin en Actiën inde Nederl. Bank (voor Dito bij idem 4 6o'/ » Soonen 5 102 rente4pCt.) 125 » Certificaten van Originele ""VVeener 9) Obi. van de Citizens-bank in Aandeelen inde Nederlandsche obligatien bij Goll en Comp. 3g » Louisiana A°. i836 en 1837 . 5 98'/» Handel- maatscki; ilj (voor 3) Obligatien Weener metalliek. 5 68 « q)Obl. v. debanktePhiladelphia rente 4% pCt.) '.* io8'/a « 3) Dito 4«/a 54 » bij Rothschild . 54 DiioAmsterdamscbeEntrejaôtdok 41/» 99 "" 3) D!l° 4 "" Dito dito bij Hope en Comp. Aand. Iloll.-IJzeien-Spoorwegm. . . 5g » 3) Dito 3 | l\ 1 % » n°. 1 à 55oo • • 4S Leening dito A"". 1844 4'/» 98% » 3) Dito _>/„ 36'/4 » Dito bij dito n». 55oi à 10000 • • 72 Obligatien Rbijn-spoorvveg . . . 4I/J 9l • Dlto x l3'/4 "" Dito II aarlemmer-meer 5 io3 » 3) Ditorente betaalb. teAmsterd. 5 76 » mexico. «-.. .. /. I / __ 3) (Den Weencrfloriin te rekenen op f 125 D'to dito 4 h 97 » fuel Courant.) g) Oblig. genegotieerd te Londen Ditodito 4 go » Aandeelen in de Oostenrijksche geconverteerde A°. 1846 . . 5 321/» Dito in de Maatschappij van Wel- Rank te Weenen 3 f 1125.00 dadigbeid bij de Lanoy en Z.l n Ditoneg.25millioengrootVVeener brazilie. Dito in dito  bij idem . . . . > 4°/o 73'/4 » .flor. 5oo 000.00 Dito in dito bij idem . . . . ) » Dito dito W. fl. 25o 273.oo 9)obli genegotieerd teLonden Dito in de gecedeerde Oost- bij Rothschild 1824 p. st. 100. . 5 8g5|4 Vriesche Domeinen • • f 600.00 frankrijk. 9) dem "" 2°° 5 88 DitoConcordiaresparvaecrescunt r  .. . _ ._ . . „_ 9) Dito dito bij J. L. Goldsmit bij Ketwichen Voomberg ... - 70 pct. Inschrijving en Certificaten . . . 5 8_ pct. 843. .. . p. st. 100 en 200 5 87V» /Heemskerk en van Ulto <Jlto 3 5a "" 9) Dito dito bij Samuel en Philips den Rroeke . . 329 » Actien in de Fransche Rank en 83g . . . . p. st. 100 en 200 5 87'/» Ispengler en de Waal. ■ .190 » Certificaten van dito ..... . . f 970.00 I r B"" * . £„ (Den frank te rekenen op 5o cents.) _„T ____ tten Sande en Jarman. • • 258 » v F '■ columbia. Aandeelen Croese en Rlancke. . • • 247 » belgie. g) Obligatien ex Venezuela en ex 111 assuran-ZLankhorst en Rave- Grenada 3 tiecompag-\ steijn . i55 >» 4) Oblig. Negotiatie 1838. ... 3 63 pct. nien bij . |J. Zuijderhoff en A. 4) Dito i836 4 8o'/> » Venezuela. (van de Poll . . 127 » 4) (Den frank te rekenen op 47jj cents.) A C Rouman '. ' ' • • .63 » Dito losrenten. A°. i84o . ... 5 96'/4 » 9) Obligatien 6 pct. . . . thans. 3 3a a.. vj. _»u_iu_u ... (He! |>u;}a slcrlmc [(crekend opf 12.) ni nifrrncrolrl.» c^l„Il Rooien en Lugt. .. • -.33 n 5) Inschrijving en certificaten. . 2-/ 47 » g) Litgestelde schuld ia »A. van Rosse . . . • • .46 » 5) Obligalien. . . ' [41/ 84'/_ » Dito So- ieteit van Levensverzeke- 6) ücu frank te rekenen oP 5o cents.) nieuw grenada. ringen bij P. Langerhuizen  9) Obligatien 6 pct. . . . thans. i«L 16'A opgerigtA0. 1807 4 160 > pruissen. 9) Uitgestelde schuld 4 nrjITESLAKDSCüE EFFECTEN. Aandeelen leening AM 832 f ""7-oo Engeland. Spanje. g) Obligatien genegotieerd te net aivid. vervalt 6) Obligatien Londen A». .834 PCt."" 8'Ü* ActienindeO.I. Comp. Jan. en Julij . . _59 » à 85 n. st. ........ 5 ia pct. 9\U'f «te de sc|lu](] ...... . 38'/. I  J •/ — u"" r"" eW- J r g) (liet pond sterlmj; te rekenen op f lx) Dito Bank. . .AprilenOct. . - 20g n 6) Dito dito à 5io p. st 5.2 » Gered.3pcts.annuit.AprilcnOct. . . g5'/i n [6) Dito Onbepaalde 5 .2 . Geconsolid.3pctsdko.Jan.enJulij . . 96 » ;6) Dito van A°. 1842- ..... 3 38'/2 s ■ ""Wisselkoers 2 maanden f uAniC'S) Dilo Passive Schuld 5'/4 "" wiSSïïrirnrnerM 6) De 85 p.st. te rekenen op f 1000 Ned. cour.) - .V1SÖL.LK.UU11Ö1UN rusland. 7) Oblig. Binnenlandsche schuld. 3 34'/» » ter eurzc van Amsterdam. 7) Uitg. schuld Parijs . 5 » ! Obligatien bij Hope en Comp. neg. 7) (Oe piasterEcrckcnd op f a.'so Ned. Court.) flladrid. . . op3/m. ƒ 2.42 perPiast-v 1798 en 1816 "". 5 104'/4 pct. Realen'16 Dito hij dito 1828 en 1829 . . 5 io33/4 » Portugal. Lissabon . . « 3 » » 41.50 » /(O Crus3 1) Inschrijving op het Grootboek 8) Oblig. A«. i84op.st. ioothans 4 35 » Napels ...» 2 » 1.81.00 « 4<» DuÇin assignaten ........ 6 6/} „ 8; jjito A°. i845 p. st. 100 . . 4 34!/2 » n ..  _  rr v 1) Certificaten van dito diverse ad- 8) (Bet pond sterling serekend op f ia.) Parijs ...» Kort » 56.?.5 » 4° ij» ministralie-kant. te Amsterdam. 6 64'/4 » Dito Binnenlandsche Schuld. .5 4° * Londen. . . » » » n.75 » L. Si& 1) (Den rochel te rekenen op één {juiden.) (De 1000 M Reis gerekend op f 2700.) Hamblir."". . » » »35.I2I/2 » 4° ••! i 2) Inschrijvingen in zilver. ... 6 n3 » Weenen"". - » 6/w. » 26.5o n 20 B'J* 2)DitoencertificatenditoA°.i83i italie. 30 ""° en ""833. . . . . .... 5 g4f4 "" Certificaten Monte diMilano bij St. Petersburg » 2/m. « 1.81'/ » » '1>W' 2lCertificaten van dito admini- o n c „„ * ' - rT  . „ 0 -  s. enU. saportas c. s. . . . 5 72 » stratie llamourg A°. 1820. 5 gg'/4 » (De 1000 lires te rekenen oP f460 Ned. Court.) Amsterdam dato als boven.",http://resolver.kb.nl/resolve?urn=ddd:010786212:mpeg21:a0014:ocr,4,ddd:010786212:mpeg21:p004,Nederlandsche staatscourant,2587
1317833,1851/01/03 00:00:00,2549,ddd:011021420:mpeg21:a0001,http://imageviewer.kb.nl/ImagingService/imagingService?id=ddd:011021420:mpeg21:p001:image&x=47&y=763&w=517&h=2549,ddd:011021420:mpeg21,564,3312,47,763,4,"THE SHEBOYGAN NIEUWSBODE The only Dutch (or Holland) paper in the United States IS PUBLISHED EVERY FRID.IÏ at the rale of $150 per annum or $100 for six months. Payable in advance. Office: near the Sheboygan Foundry. terms of advertising: (Sixteen lines or less mJiz a square.) Square for 1 week §100 I Square 6 months $500 ~ „ 2 weeks 125 I „ one year 800 Business Cards of 5 | Even- subsequent sq. 400 fines or less per an. 500 I One column6 mo'ths 55000 Square 3 months 300 | „ „ 1 year 3000 All casual advertisements must be paid for in advance. Postmasters throughout the Union are politely revested to act as ogonts for ihis paper. —Letters and Communications to be prepaid. J. QUINTUS- Sheboygan Wisconsin. Publisher &• Editor. EOIXANDSCH LOGEHENTWISCONSIN Hns. Bste straat Sheboygan. Vriendelijke bediening en billijke prijzen verzekeren mii de eunst mijner geeerde bezoekers. n 1 JOSEPH SCHRAGE. L. TESTWTTID beveelt zijnen vrienden als ook het geeerde Holl&nd£che publiek zijn nieuw en wel ingerigt logement: HEP KOSaUTH HL1 IS. Center Straat Sheboygan Wisconsin n3O / HARRISONcTHOBABT. Advokaat cn Rcgts-Raadgevsr. Sheboygr.fi W is. n 2 * W- E- GORSLim Advokaat cn Regts-Raadgover. Office Bste straat. Sheboygan Wis. "" 2 B. WILLIAMS. Advokaat en Regfc*-Raadgever en Sollicitsur in Kanselary. Kantoor aan Pennsylvania Avenue eene deur ten costen van Harvey & McKillip's winkel. n 32 D. U. EAESUIGÏON. Advokaat en Vrederegter. Kantoor digt bij de Telegraaf Office Sheboygan Wis. n 35. iTY. VANDEEPOEL. Advokaat en Regts-Raadgever OJice over het Postkantoor. Buffalo NEw-Yor.it. 'wTseaman! Zadel- Gareel- & Kofferniaker Rijtuig Bekleeder enz. Winkel ann Pennsylvania Avenue bijna regt over bet Merchant's Hotel Sheboygan (Wis.) n 3 A. P. LYMAN. Heeft juist ontvangen een' grooten voorraad Nieuwe Goederet welke hij goedkoop te koop aanbiedt voor Contant geld. Granen of Huiden. De attentie van Hollanders eb Duitschcrs wordt met achting verzocht door de ondergeteekende. ' ff. DE VILLE & GEBBOEDERS- Kruideniers Proviand en Variété Winkel. Handelaar in Fransch & Duitsch Speelgoed Banket Sterke Dranken Wijnen Sigaren enz. tegenover de Jfow-York Store Sheboygan (Wis) n 5 G. A REN S- Handelaar in Wijnen en alle soorten van Sterke Dranken onder welke Echte Hollandsche Jenever Gezuiverde Ohio Whisky bij de Barrel. Winkel tegen over het Postkantoor"" Sheboygan Wis. n 35. HOPKINSON & CTJETIS. Handelaars in 't groot en klein in Kruidenierswaren ï& Provisies Schoenen en Laarzen Wijnen Sterke Dranken enz. Winkel in de Empire blok hoek van Pennsylvania Avenue en Bste straat. n. 38. FRANCIS RAITS- Horlogiemaker & Juwelier Repareert alle soorten van horlogies cn wil voor zijn werk instaan; ook maakt hij gouden rinpen en alle andere artikelen die steeds bij hem te koop zijn.tegenove» het Wisconsin Huis. n 36 JAY DEAN. Handelaar in allo soorten van Keuken- Kamer- en Plaat Kagchels; alsook de zelf regelerende Kamer Katjchels Manufacturior van alle soorten van Blikken Pankoeken en Koperen waren door hem zeiven vervaardigde Koebellen Nagels enz—Nß. Eenig agent voor Dows & Co's Patent draaijende Spuit- Regenbak- e:i Welpompen. Pennsylvania Avenue Sheboygan n 9 JOHN GEÜTITK ~ Buffalo Contante Kruideniers-en Provisie Winkel. Naast W. Seaman's Zadelmakerij. bestendig voorhanden. Hamburger Zoetemelk - i® Kaas Spek Zout Reuze*. Stroop Boter Aardnp- PBw.RijBt Thee koffij Suikor en alle andere Levensmiddelen voor familie gebruik. 18 Julij 18§0. n 36 J. & F. KUEHMSTAgDT. Handelaars in 't groot en klein in Manufacturen Kruidenierswaren Goud 4* Zilver ""Yankee Noties"" Geblaakte kleederen en Heerenstoffen. -Winkel west van net postkantoor. Sheboygan 22 November 1950. }2d2.",http://resolver.kb.nl/resolve?urn=ddd:011021420:mpeg21:a0001:ocr,1,ddd:011021420:mpeg21:p001,De Sheboygan Nieuwsbode,517
1317277,1851/08/18 00:00:00,1391,ddd:010518395:mpeg21:a0013,http://imageviewer.kb.nl/ImagingService/imagingService?id=ddd:010518395:mpeg21:p003:image&x=53&y=3467&w=947&h=1391,ddd:010518395:mpeg21,1000,4858,53,3467,4,"V DE MINISTER VAN FINANCIEN handelende _èze.rr__aldVaaN°er.-JOr *? K.üiug' M besllÜt van 1Ü XieStTw'jNVüßllmKe'f ""*&s%> °m' °P de -nten deze Domicilium k_f._ I'ouw Winkelier  wonende -hoek van de Fü^WlMS^ tó Wflf EM NI F . ING ""u bwind7«d« «ver S___NDRIK WILLEM NItólNG thans verpleegt in het Krankzinittgen Gesticht Meerenberg m Noord-Holland aan Z. M ingediend  over te gaan tot de oproepingen iv *_ t 3 der Wet. van 30 Mei 1847 (Staatsblad n°. 2G) voorgeschreven Brengt bij deze ter kennis vau het algemeen dat naar luid eener door den verzoeker eu door de Echtgenoot van HENDRIK WILLEM NIESING voornoemd voor den Kantouregter afgelegde en beëdigde verklariug gezegde HENDRIK WILLEM NIESING iv de maand Februarij dezes jaars in eene vlaag van krankzinnigheid heeft verbeurd  en met uitzondering van eukele onbeduidende overblijfsels iv het vuur geworpen: twee Certificaten 2% °/0 Nationale Schuld als: . Eén  groot / 1000  onder N°. 62956  uitgegeveu door hfit A_.miuist.atie Kantoor van de Heeren S. Eu D. SApößtas c. s. : eu  t:-én groot ƒ6OO onder N°. 1636 uitgegeven door V^dmiuistratïe Kantoor vau de Heereu KETWICH en _yOOMISERGH eu Wed. W. BORSKI  benevens de Be'Jaeu te-j- bekoming vau nieuwe Coupous tot beideCer-ev*t6M 1)ell°o«iide eu dat voor het verlies dezer Schuldie. '_». "" wordt verlangd tegemoetkoming op deu voet Mei ufMen van :it) Méi 847' (Staatsblad u°. 26) en 2 \V* ;''' (Staatsblad n°. 26). r^n |^ lid. mitsdien ieder die beweren mogt eeaig «ebben __ïiffiB""_ Vftn dat verlangen strijdig belang te '""i deze opgeroepen' om op de wij-e bij Arti-",http://resolver.kb.nl/resolve?urn=ddd:010518395:mpeg21:a0013:ocr,3,ddd:010518395:mpeg21:p003,Opregte Haarlemsche Courant,947
17908,1851/05/12 00:00:00,37,ddd:010924091:mpeg21:a0024,http://imageviewer.kb.nl/ImagingService/imagingService?id=ddd:010924091:mpeg21:p003:image&x=1770&y=2062&w=484&h=37,ddd:010924091:mpeg21,2254,2099,1770,2062,4,ABVËKTfiNTIEN.,http://resolver.kb.nl/resolve?urn=ddd:010924091:mpeg21:a0024:ocr,3,ddd:010924091:mpeg21:p003,Leydse courant,484
12353982,1851/05/03 00:00:00,4398,ddd:010786211:mpeg21:a0004,http://imageviewer.kb.nl/ImagingService/imagingService?id=ddd:010786211:mpeg21:p002:image&x=51&y=79&w=2809&h=4398,ddd:010786211:mpeg21,2860,4477,51,79,12,"AANGESLAGEN v Dagteekening Dagteekening g NAAM. VOORNAMEN. Geboorte- der der § plaats. In in het in het . i geboorte. naturalisatie. te gronr - personeel patentregt Totaa i2 ' » voor voor voor ■2 van Eijsinga jhr. Tjalling iEdo Johan Leeuwarden 6 Dec. 1790 Langweer f 676.14 Jorwerd 3.9 5 Baard 2.97 Franeker 24.92 Tzum 5.5o Huizum 39.26 Wommels 854-44 Oosterend 449* ' ' 5 Rauwerd 3656.80 f 23g.i6 f i.845 Nes 2i3.g7 Leeuwarden 98.53 f-êo_5.-5Q5 f 23g.i6"" 1 1.845 f 6366.60 3Vegilin van Claerber-jhr. mr. Pieter Benjamin Joure 22 Junij 1808 Tjalleberd i5.35 gen Johan Wirdum 65.23 Deinum 307.02 Grouvv 168.79 Dronrijp 456. o35 Akkrum 8.80 Oldeboorn i5i4j Joure i4i8.58 406.415 Rauwerd 5o5.32 Leeuwarden 126.11 2o5.655 Beetgum 184.66 Nijebaske 2o58.5a j t5329.885 f 612.07 594'*9 4 van Eijsinga jhr. Idzert Frans Leeuwarden 24 Julij 1794 Buitenpost 58-84 Wirdum 91 -4 '5 Langweer 637.19 Nijland 84'92 Wommels 1815.3g Ternaard 76-64 Dronrijp 58o.g""ï5 Burgwerd 20.o4 Oosterend io6i.3g Sexbierum 2.40 Huizum 77-45 Tzum 113.86 Arum 1 • 16 Baard 2.g7 Westergeest l • '2 Hcijum 158.92 Burum 188.17 Leeuwarden 293.70 353-71  f'5266.53 f 353.71 Sö^ SLooxma Tbeodorus Marius There-Leeuwarden 22 Febr. 1807 Oosterwierum 31.35 sius Baard 385.95 Ferwerd 889.075 65.6o5 Blija 133.i 6 Wommels 62g.62 Oosterend 240.o4 Leeuwarden 110.64 154.32 Franeker 132.72 Berlilcum 220.o3 Jelsum 2-7g Tzum n5.5g Sneek 47-6g Holwerd 234.615 . Ternaard g5g-78 Giekerk 356.51 325.82 Arum 3.99 Nijland i3.ii WTorkum i4-24 Nijkerk 343.o4 $ f4873.94 f 545.745 f M'9' . 'i SYpeij Nicolaas Leeuwarden 23 Dec. I7g4 Lieve Vrouwen- i47-88 Parochie St. Anna-Parochie 43-42 Baard 267.77 Ferwerd 3g5.885 Marrum 375.07 Rauwerd 363.14 Beetgum ï4-6g Jelsum 3.33 Blija 651.34 Hardegarijp 213.565 i68.og5 Hallum 25.385 Sneek 21 -4g Bergum 2 2. g 8 Nes 48-9i Ternaard 2g6.6i Giekerk i.g3  Scharnegoutum 12.88 Birdaard 4I9-9i | Leeuwarden 33i.38 536.65 Burum 23.68 « Roordahuizum 10.655 Oosterend 176.63 /fi-3'^ f3968.53 f 704.745 m",http://resolver.kb.nl/resolve?urn=ddd:010786211:mpeg21:a0004:ocr,2,ddd:010786211:mpeg21:p002,Nederlandsche staatscourant,2809
2691198,1851/02/17 00:00:00,2451,ddd:010072828:mpeg21:a0020,http://imageviewer.kb.nl/ImagingService/imagingService?id=ddd:010072828:mpeg21:p004:image&x=2224&y=2783&w=1098&h=2451,ddd:010072828:mpeg21,3322,5234,2224,2783,4,"JE DOIMNE 20000 Frs. i qui prouvera que les milliers de certificats quej'airecns de personiK* ïonorables etdont mon prospectus donne vn apercu sont faux et dc'poor"" pus de foi lesquels attestent que par mon EAI! DE LOB elles se «o?* ait repousser et e'paissir la chevelure sur des lêies chauves roême depn"" >lus de2sans. Ainsiplusde têtes dégarnies de cheveux pourvu qu'on érit* acontrcf-conens'adr.ssantamoi LEOPOLD LOB Chimiste-. F»1''!» ■ue Saint Honore N*.281 oii Ion trouve des flacons d'EAU DEL***1 i 5 et 10 francs dont vn suffit pour re'ge'nérer les cheveux et en arr_'«r a chflte. On expe'die. (Affranchir). (245f)_ Naar JAVA ligt in lading te ROTTERDAM >m onmiddelijk na den Winter te vertrekken voor PASSAGIERSJa __2?_£^£= *£- Snelzeilcnd Gekoperd Nederlandsch FREGAT"" ÏEDIP ROTTERDAM Kapt. PIETER VIS ingerigt tot de ladin? ler grootste Machmerien. Adres ten Kantore van KUYPER VANDAJ* S. SMEER bk HUDIG & BLOKHUYZEN. (454) . o. Naar CURACAO direct ligt te ROTTERDAItf JkJ. in Lading om den Zlsten Maart te vertrekken bc' _f_trW\WW nieuw gebouwd Gekoperd en Kopcrva-* W>mÉmL. BRÏM-SCIIIP GOUVERNEUR ELSEVIER' _JL________ fievoerd door Kapitein JAN KUYT voor GOEDE* —~---«__^- REN en PASSAGIERS waartoe het cxpresselijk i» m . ingerigt met eene zeer ruime en luchtige Kajuit- Te bevragen bij den Reeder H. VAN RIJCKEVORSEL of bij ""* Cargadoors KUYPER VAN DAM en SMEER. (1034) ROTTERDAM EN A..TWERPEN7 AMICITIA. (1519) BIJ OPEN WATER. .-■ui _* n°Ue:d™- _ Van Antwerpen. 1/ Febr. Maandag sMorg. 7£ ure. 19 Febr. Woensdag 's Nachts 1 nre. '? * Woensdag . 9  (tusschen 18 en 19 Febr.) 21 • Vrijdag .10 . 21 . Vrijdag 's Monr 2_ • Adres bij JOH. OOMSEz. &C Boompjes 1.23 en Wolfshoek 2 N-263. ROTTERDAM — HAVRE. """" VOOR PASSAGIERS EN GOEDEREN. Het Nederlandsch STOOMSCHIP ADMIRAAL VERHÜELL Kapitein MOUTHAAN Vertrekt WOENSDAG 19 FEBRUARIJ. BABBEYKUJ H^avreVAN DAM EN SMEER' '6 Rotterdam. en THEOP' STOOMPACKETVAART TTJssCHln^""""'' ROTTERDAM EN HAVRF -  ftEREGELDE DIENST. SSïïg&&_\\__sKssé*t DINrsnOA°rMTACoKET HAMBJR<"". Kapt. MARESSAL vertrek* DINGSDAG den 25sten dezer des Morgens. 'tlwK\ JldreMen Kantore van SMITH en ft te Rotterdam. l NAAR NOORD-AMERIKA voor LANDVEEHUIZFRq •_--regelde Wekelijksche gelegenheid van Rotterdam naar Havre ™t de STOOMPACRETTEN : avre' -**«' M ROTTERDAM Kapt. COUTARD HAMBURG . MARESSAL En van Havre met de geregelde Postschenen wpllt* •'. —. . daar naar New-York en New-Orleans vertrekken ov j™ Week V_ in 20 _. 24 Dagen. ertrekkca. Overtogt gewoonlijk De Passage-Prijs is uiterst billijk gesteld. Nadere informatien op franco aanvrat™ .™ v . SMITH EN 0. Boompjes 1 IS^-SSS! *™ de Agenten :H. LUNSINGH Gromn^ vtr IJ. E. MEYBOOM Enschedé. p miirfr' Winterswijk. ij. W. TER HAAR Arnhem. GKAAD^. Nijmegen. (734) > (VERVOLG DER ADVERTENTIEN ZIE BlJVOvrer-T *",http://resolver.kb.nl/resolve?urn=ddd:010072828:mpeg21:a0020:ocr,4,ddd:010072828:mpeg21:p004,Algemeen Handelsblad,1098
3637440,1851/06/12 00:00:00,2880,ddd:010786243:mpeg21:a0011,http://imageviewer.kb.nl/ImagingService/imagingService?id=ddd:010786243:mpeg21:p004:image&x=83&y=1313&w=1263&h=2880,ddd:010786243:mpeg21,1346,4193,83,1313,4,"ADVERTEN T I E N. MINISTERIE VAN BINNENLANDSCHE ZAKEN. Provincie Gelderland. AANBESTEDING. Op Vrijdag den 27Sten Junij des jaars iBsi des middags ten 12 ure zal onder nadere goedkeuring door den Minister van Staat Commissarisdes Konings in de provincie Gelderland of bij deszelfs afwezendheid door een der leden van de Gedeputeerde Staten en in bijzijn van den Hoofd-Ingenieur van den Waterstaat in het sde district  aan het locaal van het Provinciaal Bestuur te Arnhem worden Aanbesteed: Het Bouwen van een Veerknechtshuisje voor het Bijksveer over de Maas te Hedel. Deze Aanbesteding zal geschieden bij enkele Inschrijving en Opbod. Het Bestek op hetwelk de bovengemelde Aanbesteding zal plaats hebben zal boven en behalve aan het locaal van bet Ministerie van Binnenlandsche Zaken en aan dat van het Provinciaal Bestuur van Gelderland te Arnhem ter lezing liggen op alle zoodanige plaatsen alwaar gewoonlijk de .Bestekken van Waterstaats-werken in gemelde Provincie ter lezing gelegd worden. Zullende vier dagen vóór de Besteding de noodige aanwijzing in loco worden gedaan en voorts nadere informatien te bekomen zijn bij den Hoofd-Ingenieur M. H. Conrad te Arnhem en den Ingenieur Waldorp te Zalt-Bommel. De Minister van Binnenlandsche Zaken ThORBECRE. 207 V Regthebbenden op een Vat Wijn gemerkt Q T uit Zee aangespoeld F T en geborgen in het Ressort Noordelijk Gedeelte van Zuidholland  worden mits deze opgeroepen zich voorzien van bewijzen van eigendom aan te melden bij den Opperstrandvonder in gemeld Ressort woonachtig te 's Gravenhage. DEPARTEMENT voor de ZAKEN der ROOMSCH-KATHOLIJKE EEREDIENST. *#* De Minister van Buitenlandsche Zaken voorloopig belast met het Bestuur van het Departement voor de Zaken der Koomsch-Katholijke Eeredienst herinnert bij deze de Relanghebbenden dat de termijn  tot het indienen van de vorderingen ten laste van het zoo even genoemd Departement over het jaar iBso volgens de wet van den Bsten November iBis (Staatsblad n°. si) met den 3osten Junij aanstaande zal zijn verstreken  en dat alle Schuldvorderingen welke niet vóór dat tijdstip zijn ingediend zullen worden gehouden voor verjaard en vernietigd. 'sGravenhage den isten Mei iBsi. De Minister voornoemd Van Sonsbeecr. MINISTERIE VAN FINANTIEN. \"" De Minister van Finantien brengt ter kennis der Belanghebbenden dat bij de Gebroeders van Cleef Boekhandelaren te 'sGravenhage  en door hunne tusschenkomst in de voornaamste steden des Rijks tegen den prijs van Tien Cents is verkrijgbaar gesteld de Wet van den gdenMei 1846 (Staatsblad n*. 24) betreffende de Burgerlijke Pensioenen zoo als zij luidt na de daarin bij de wet van den 3den Mei iBsi (Staatsblad n°. 4g) gebragte wijzigingen. 'sGravenhage den loden Junij iBsi. De Minister voornoemd * Van Bosse registratie en loterijen. Bij de Tweede trekking der Derde Klasse van de 314 de Staats-Loterij op Woensdag den uden Junij iBsi  zi|n prijzen van duizend gulden of daarboven te beurt gevallen aan de navolgende noinmers : N . i 6556 een prijs van 1000 gulden n 1080.5 » o J- 1000 » » 12150 » » ~ 1000 » » 1664 » » - 2500 » De Directeur der Staats-Loterij J. H. Provincie Zuidholland. AANBESTEDING. •Op Maandag- den i6den Junij des jaars iBsi  des voormiddags ten",http://resolver.kb.nl/resolve?urn=ddd:010786243:mpeg21:a0011:ocr,4,ddd:010786243:mpeg21:p004,Nederlandsche staatscourant,1263
3901647,1856/03/02 00:00:00,5127,ddd:010112978:mpeg21:a0033,http://imageviewer.kb.nl/ImagingService/imagingService?id=ddd:010112978:mpeg21:p004:image&x=945&y=124&w=761&h=5127,ddd:010112978:mpeg21,1706,5251,945,124,4,"Openbare Yrijwiüige - YERKOOPING. De Notarissen DALEN en LAMBERT reside rende te Rotterdam als las'.bebiende van dcrzelver principalen zijn tan meening . om op Woensdag den 19den Maait 1836 des namiddags ten 4 ure in h»t locaal der publieke verkoojiingen arm de Geldersche Kade te Botterdam in het openbaar te Veilen en te Verkoopcn: No 1. Een hecht sterk en wel doortimmerd WINKELHUIS met Boyenwoningen en ERVE  staande en gelegen aan.de Zuidzijde van den Houttuin te Rvtterdam wijk 11  No. 179 kadaster sectie N No. 519. Aangeslagen in de Grondlasten op ƒ 41.33. Verhuurd het Winkelhuis tot. I°. Mei 1856. voor f 200 's jaars en de Boyenwoning beide tot I°. Mei 1857 de eerste voor f 150 en de tweede voorj 140 'sjaars makende dus te zamen 'f 490 'sjaars. No. 2. Een hecht sterk welbetimmerd en goed gesitueerd HUIS Bovenhuis en ERVE s'aande en gelegen in den Openrijstuin te Rvtterdam wijk 11 No. 70  kadaster sectie O  No. 914. Aangeslagen in de Grondlasten op f 35 67. Verhuurd bet Benedenhuis tot 1 Mei 1857 voor ƒ125 en het Bovenhuis tot 1 Mei 1856 voorj' 150 alzoo te zamen voor J 275 'sjnars No. 3. Een hecht Bterk en wel doortimmerd WINKELHUIS met Bovenhuis en ERVE  staande en gelegen aan de Oostzijde van de Botersloot te Rotterdam wijk 9 No 108 alsmede een Achterhuisje Open Plaatsje en Erve  staande en gelegen daarachter in den Smitsgang wijk 9  No. 110 kadaster sectie L Nos 98 en 100. . Aangeslagen in de Grondlasten op f 28.02. Verhuurd het Winkelhuis voor ƒ 2 per week of f 104.'sjaars het Bovenhuis tot I°.Mei 1857 voor ƒ 125 'sjnars  en het Achterhuisje voor ƒ 1 per week oifhi 's jaars reideerende dus tezamen/ 281 'sjaars. De te veilen Panden zullen kunnen worden bezigtigd .twee dagen vóór en op den dag der veiling van des voormiddags ten 10 tot des namiddags ten 3 ure mits men voorzien zij van een Permissie Billet  door een der voornoemde Notarissen afgegeTen ter wier Kantore aan de Zuidblaak te Rotterdam inmiddels nadere onderrigting is te bekomen. (2009) De Buitenplaats Landzigt geschikt voor Zvmer en Wmterverblij f bestaande in wel ingerigt Wenbel BUIS KOETSHUIS STALLING MOESTUINEN  BOOMGAARD  BOSCH- en WEILAND gelegen en staande vóór aan sGravenweg Gemeente Kratingcn bijzonder gunstig gelegen voor Jogt en Visscherij. welke op den27s'en Februarij laatstleden door dn Notarissen DALEN en VAN DER BOOP ia geveild en alstoen heeft opgebragt f 4900 zal op Woensdag den sden Maart 1856 des namiddags ten 4 ure in hetNötarishuiste Rotterdam worden afgeslagen. (2044) Het Huis met TumenErve aan de Oostzijde van de Schiekade de IUIN met KOEPEL aa-i de Tweede Sehielaan het PAND met TUIN en ERVE in do Raampoortlaan en de twee Perceelen OPEN GROND in ds Weenastraat allé to Rotterdam op den 27sten Februarij laatstleden door den Notaris FVIA' DER BOOP eeveild. zullen op Woensdag d~n sden Maart 1856 des namidHags ten 4 ure in het Notarishuis aldaar eerst ieder af'onderlijk eü daarr.a bij combinaticn worden b!geslagen. (2045) ""#--% De Vaste Goederen fer.. if B| behoorende tot de Nalatenschap van W^ÊMl' wÖlen Vrouwe A. M. VAN DER jjfjjJjfëL NIE POORT Doöoiriè-c van Mr. (SëSeISibIEÏSI^J. WEERTS bij vorige Couranten en bij Bilietten in het breede omschreven en waarvan de inzet heeft plaats gehad op den 25sten Februarij 11. in het Logement het Zwijnshoo/d te Arnhem zijn met de hoogen gebragt op de navolgende prij'en . te we'en : LHet HEERENHUIS c a. op / 15000.— II De BOUWPLAATSEN en LANDERIJEN. Het eerste perceel op / 47395.— Het tweede perceel » « 3811.— Het derde perceel • » 8125.— Het vierde perceel » - 26023.— Massa van de perceelen een twee drie en vier » » 92567.— Het vijfde perceel » » 24455.— Het zesde perceel. » - 7948.— Pet zevende perceel « «• 5100.— Massa van de perceelen vijf zes en zeven » « 42047.— Het achtste perceel » - 18067.— Het negende en tiende perceel . » » 7950 — De toeslag blijft bepaald op Maandag den lOden Maart 1856 des avonds precies ten 6 ure in bovengemeld Logement. Verhoogineen kunnen gedaan worden ten Kantore van den Notaris VAN ECK te Arnhem alwaar nadere lulichtingen te bekomen zijn. — Brieven Jranka. ' (2051) Het WINKELHUIS met BOYENWONING en ERVE staande en gelegen arm den Steiger op den Westhoek van de ValkisTeg  binnen de B'acf Rvtterdam wijk 10 No. 42  den 27sten Februarij 1856  door den Notaris VAN RUCKEVORSiL in het Locaal voor Openlnre Vcrkoopingen aan de Geldersche Kade te Rotterdam geveild en opgeboden tot J 4 300 zal aldaar op Woensdag den sden Maart 1856 des namiddags ten 4 ure door denzelfden Notaris worden afgeslagen. (2Q381 fH^& Publieke %f^ iS|§i VERKOOPIING JEE VAN PAARDEN RIJTUIGEN TUÏGEiV El\Z. Op Dingsdag den Uden Maart 1856 des morgens ten 10 uren aan de Romein aan de Schiekade te Rotterdam ten overstaan van D. B. CORNE var een aantal diverse RIJTUIGEN als: BAROUCHETTEN  TENTWAGENS TILBURÏ'S VIGIL ANTBN COUPÉ CALÈCHE PHAETON KAPWAGENS CHAISEN SPEELW AGENS EZELW AGENS en ARRENSLEDEN; diverse fraaije TUIGEN HOOFDSTELLEN ZWEEPEN enz. benevens 4 PAARDEN. (2056) In een druk bezocht gedeelte >*KtÏ|. der Buitenstad wordt ifffi^_fgg^ UIT DE HAND TE KOOP T_9|*S:';i^s| aangeboden x3^J»iniC3^__^ wttT 42 VffloTaifii iiYui Air -H- *U x » voor verßcmiiend gebruik geschikt en van alle Gerie?en voorzien. Adres franco brieven  onder let'er A ten Kan tore van L. VAN GEM.ERDENAzn. Z*akw .op het Spui te Rotterdam. (2036)",http://resolver.kb.nl/resolve?urn=ddd:010112978:mpeg21:a0033:ocr,4,ddd:010112978:mpeg21:p004,"Nieuwe Rotterdamsche courant : staats-, handels-, nieuws- en advertentieblad",761
5234820,1856/06/15 00:00:00,4058,ddd:010788679:mpeg21:a0012,http://imageviewer.kb.nl/ImagingService/imagingService?id=ddd:010788679:mpeg21:p005:image&x=64&y=244&w=1290&h=4058,ddd:010788679:mpeg21,1354,4302,64,244,6,"den 28sten Mei tot den 13den Julij (16 Mei en 1 Julij O. S.) en er tegen de maand Julij op het eiland Siskar een tijdelijke lichtopstand zal daargesteld worden  waarop het licht van den voormaligen toren branden zal. De beide landmerken op hét eiland Wulff vernietigd in 1854 zullen eveneens tegen de maand Julij j-door gelijksoortige worden vervangen ;  2°. dat over eene kleine uitgestrektheid in het Kanaal der reede van Kroonstad uitgaande van het Fort Paul I in de rigting van het Westen tegenover het Fort Konstantijn.en vau dit Fort insgelijks in de rigting van het Westen onderzeesche versperringen zich bevinden tusschen welke de doortogt onbelemmerd is gelijl- te voren. De Zuidelijke lijn dier versperringen of die bij het Fort Paul I is aangeduid door witte bakens en tonnen en de tegengestelde lijn of die bij het Fort Konstantijn door roode bakens en tonnen. De bevelhebber van het Westelijke wachtschip heeft in last hiervan kennis te geven aan de Schepen welke de haven van Kroonstad willen aandoen. 's Gravenhage den 2den Junij 1856. De Minister voornoemd De Smit v. d. Bkoecke. Provincie Noózdbrabant. AANBESTEDING..  Op Vrijdag den 27sten Junij des jaars 1856- des middags ten 12 ure zal door de Gedeputeerde Staten der provincie NoöTdbrabant in bijzijn van den Hoofdingenieur van den Waterstaat in hét 6de District aan het locaal van het Provinciaal Bestuur te 's Hertogenbosch worden Aanbesteed : het gereedmaken der Aartten __-ddin»-n-et de daarin vereischte Bruggen en Duikers  mitsgaders* de_B9grjnding en Bestrating van den Provincialen Weg van Geldrop over Mierlo naar Helmond eene lengte bevattende van l<G.3-b eb- _ Deze Aanbesteding'zad geschïedep bij tnseirrijvhig en opbod. • o_i*_M \ Het Bestek der bovengemelde Aanbesteding zal boven en behalve aan het locaal van het Provinciaal.' Bestuur ter ieaing. liggen op alle zoodanige plaatsen waar :gèvvoonl ij k f de' Be_4ekMenï; .iaj_ Waterstaatswerken ïn gemelde provincie tei wöfffëh. i'""I""1^ Zullende drie dagen'v_ór de besteding' de hoódïge aanwijzing in loco worden gedaan*..en nadere^infqrraK%tjen..te_bekomen zyn zoo bij den Hoofdingenieur van den Waterstaat in Npordbrubant als bij den Ingenieur jhr. E. C. B. Ridder van Rappard jtte _.iHeitogeéboscJ-. en* den Opzigter A. van der Korput te St. Oedenrode. . .J ~fl ü9b(i-Tt ■'-„ y^Rï:r' oov n 9 eÏIBI TOifmtiSstl rVJler < b no._.tft_ as? sbïÖBW ■ vOOTH. Provincie ZuidhaUand. AANBESTEDING-. De» Staatsraad Commissaris des Konings in de provincie Zuidholland verwittigt bij deze de belanghebbenden dat onder nadere goedkeuring door de Commissie van Administratie over de Gevangenissen te Rotterdam in tegenwoordigheid van den Hoofdingenieur of een der Ingenieurs van den Waterstaat in het lOdei district op Zaturdag 'den 2lsten Junij 1856 des middags om twaalf ure in een der locaren""d-r'b-trokken Gevangenis zal worden AanbesteeH: het uitvoeren van eenige werken aan de Gevangenis voor jeugdige veroordeelden te Rotterdam in verband staande tot de gedempte wateren om het gebouw. II Deze Aanbesteding zal geschieden alleen bij inschrijving volgens artikel Jl van het Bestek. '"" j Het Bestek zal-ter lezing liggen te 's Grajvenbage in bet gebouw van het Departement van Justitie en van het Provinciaal Bestuur van Zuidholland alsmede in het gebouwvafa de lste Wagenstraat S 82; te Rotterdam in den Romein in het Hof van Berlijn en in het Neêrlands Wapen bij Frijthöfsj. en te Gouda in den Zalm en in het Herthnis.._■--• '>(3j Dingsdag en Woensdag vö*ór den dag der; Aanbesteding des morgens tusschen 10 en 12 ure zal de aanwijzing op de plaats worden gedaan. en inmiddels nadere inlichting te bekomen zijn.bij den Hoofdingenieur van den Waterstaat A. Greve en den Ingenieur J. F. Augier te 's Gravenhage. 's Gravenhage den 9den Junij 1856. ' De Staatsraad. Commissaris des Konings voornoemd tVYdUÏ. HEiR .H-___l»l)l-laa8Jiu oi'-(i * f f »Ö) bluda- .la.naill  — ~.. MAiRIXE. Openbare Verkooping bij inschryving op 'sßijks Werf te Hellevoetsluis •op Vrijdag den 4den Julij 1856 des middags ten 12 ure van een voor verdere dienst afgekeurd Vaartuig gediend hebbende tot Ziekenschip en zulks ter Sloop volgens de Voorwaarden ter lezing liggende ten Burele van den Hoofdingenieur op voorschreven Werf. Zullende de Inschrijvingsbiljetten behoorlijk op zegel en gecachetteerd uiterlijk op loovengemelden dag en uur ter Secretarie van de Directie der Marine te HelWoetsluis moeten zijn ingeleverd en na dien t_d geene meer worden aangenomen. Het vaa_t_ig jjgt ter bezigtiging alle werkdagen van des voormiddags 10 tot des naciddags 4 ure. Hellevoetsluis ii.jUTjij J 856. De Directeur en Kommandant der Marine F. W. Fkeddesbekb. OPENBAKE i-MBESTEDING. De Inspecteur in de lste Fortificatie-Inspectie of bij zijne afwezigheid de Eerstaanwezende Ingenieur te Muiden  zal onder nadere goed-teuring van den Minister van Oorlog in het openbaar in massa en zoo noodig op tarief Aanbesteden : het maken van eene Ravelijn  van eene Brug van eene gemetselde",http://resolver.kb.nl/resolve?urn=ddd:010788679:mpeg21:a0012:ocr,5,ddd:010788679:mpeg21:p005,Nederlandsche staatscourant,1290
32984,1856/01/13 00:00:00,56,ddd:000011341:mpeg21:a0014,http://imageviewer.kb.nl/ImagingService/imagingService?id=ddd:000011341:mpeg21:p002:image&x=1258&y=2268&w=589&h=56,ddd:000011341:mpeg21,1847,2324,1258,2268,4,ADVEKTKVriE-f.,http://resolver.kb.nl/resolve?urn=ddd:000011341:mpeg21:a0014:ocr,2,ddd:000011341:mpeg21:p002,Dagblad van Zuidholland en 's Gravenhage,589
58926,1856/07/18 00:00:00,42,ddd:010788397:mpeg21:a0015,http://imageviewer.kb.nl/ImagingService/imagingService?id=ddd:010788397:mpeg21:p004:image&x=640&y=4235&w=1403&h=42,ddd:010788397:mpeg21,2043,4277,640,4235,4,TE'S GRAVENHAGE TER ALGEMEENE LANDS-DRUKKERIJ,http://resolver.kb.nl/resolve?urn=ddd:010788397:mpeg21:a0015:ocr,4,ddd:010788397:mpeg21:p004,Nederlandsche staatscourant,1403
26055,1856/10/28 00:00:00,45,ddd:000011619:mpeg21:a0013,http://imageviewer.kb.nl/ImagingService/imagingService?id=ddd:000011619:mpeg21:p003:image&x=1238&y=1133&w=579&h=45,ddd:000011619:mpeg21,1817,1178,1238,1133,4,Al»VB<:BtTft.vrflKX.,http://resolver.kb.nl/resolve?urn=ddd:000011619:mpeg21:a0013:ocr,3,ddd:000011619:mpeg21:p003,Dagblad van Zuidholland en 's Gravenhage,579
2257977,1856/01/11 00:00:00,2229,ddd:010771908:mpeg21:a0007,http://imageviewer.kb.nl/ImagingService/imagingService?id=ddd:010771908:mpeg21:p003:image&x=2121&y=3430&w=1013&h=2229,ddd:010771908:mpeg21,3134,5659,2121,3430,4,"*** Mr. M. RE n.IWCH Hfbtaris te ('rijpskerk gedenkt ten verzoeke en ten Huize van de Weduwe en Kinderen van wijlen H. J. BANSEMA te Niehove op WOENSDAG den 16den Januarij ISSO  des avonds te 5 uur  publiek te verkoopen : SiJ-St Jhfr**'\is£ Aa E en* &*n_-enlrjke IiOOP- m__s behi- izisg heb-1 aß^Sff BEBCi  no. 33 met SCHUUR o____i'*- »K> STALLING ERF HOF en TUIN. 11. Het REGT DEU VASTE BEKLEMMING van 1 8. 76 R. en 80 Ellen best GROENLAND jaarlijksche vaste huur / 20—00. 111. Het REGT DER VASTE BEKLEMMING van 1 B.  74 Roeden best GROENLAND jaarlijksche vaste huur ƒ 20 — 00. IV. Het REGT DER VASTE BEKLEMMING van 2 8. 42 R. en 80 Ellen best GROEN- en BOUWLAND jaarlijksche vaste huur ƒ 15 — 00. — Alles staande en gelegen te Niehove. Mr. M. RE HIIXCH Noj& *»rN*. taris te Grijpskerk gedenkt ten *ü rr 9 verzoeke van de Erven van wijlen mgmmmMb maikejansschuiringa wè&w. —""3SSSSH—6__a-x_. w H Kkijthe op DONDERDAG den 17den Januarij 1856 des avonds te vijf uur ten Huize van den Kastelein A. HUIZINGA te Niehove publiek te verkoopen : Het REGT DER VASTE BEKLEMMING van 2 Bunders 66 Roeden LAND gelegen in het Hondsveld onder Oldehove jaarlijksche vaste huur f 15—00. *** Mr. .n. RE MÏIXCK  Notaris te Grypskerk gedenkt ten verzoeke van A. R. LINTHORST  te Kaakheem  op ZATURDAG den 19den Januarij 1856 des avonds te 5 uur in na te melden Behuizing te Niezyl publiek  voor den tijd van 4 jaren  ter verhuring en ter verkoop aan te bieden en alzoo te verhuren of te verkoopen: * tm IJvïvsMfc/i Eene BKHIIKI\« . no. 21 «f_%^^:: HllJti B mtt St'HlT'B STAL- V >""■ Ll__ en TIIX  zijnde eene -"" — neringrijke Herberg staande en gelegen aan de Vaart en aan de Straat te Niezijt Gemeente Grijpskerk. *** Mr. M. RE MUMJUM. Notaris te Grypskerk > gedenkt  ten verzoeke van den Heer JOH. BOLT Steenfabrikaut op den Ham op DINGSDAG den 22sten Januarij 1856 des avonds te 5 uur ten Huize van den Kastelein T. FERINGA  te Visvliet publiek te verkoopen: I. Den EIGENDOM van ongeveer 2 Bunders LAND  gelegen onder Visvliet bij CH. MAAS onder beklemming in gebruik tegen eene jaarlijksche vaste huur van ƒ 21—-00. 11. Den EIGENDOM van eenen DIJK  gelegen onder en ten Oosten van Visvliet bij CH. MAAS onder beklemming in gebruik tegen eene jaarlijksche vaste huur van f 20—00. 111. Den EIGENDOM van ongeveer 1 Bunder en 50 Roeden LAND gelegen te Visvliet bij R. J. SIKKEMA onder beklemming in gebruik tegen eene jaarlijksche vaste huur van ƒ 18—00. IV. Den EIGENDOM van negen BEHUISDE HEEMSTEDEN gelegen te Visvliet en Pieteizijl te zamen in gebruik voor eene jaarlijksche vaste huur van f 26—40.",http://resolver.kb.nl/resolve?urn=ddd:010771908:mpeg21:a0007:ocr,3,ddd:010771908:mpeg21:p003,Groninger courant,1013
2287180,1856/03/03 00:00:00,2108,ddd:010086163:mpeg21:a0017,http://imageviewer.kb.nl/ImagingService/imagingService?id=ddd:010086163:mpeg21:p004:image&x=1179&y=81&w=1085&h=2108,ddd:010086163:mpeg21,2264,2189,1179,81,6,"fl„n_|| TE HUUR TEGEN 1 MEI 185 G : WÊEmWtHct alleraangenaamst tot ZOMER-en WINTERVERBLIJF Ki||||zcer geschikt BUITENGOED KLEIN BILJOEN ;:c--¦""¦**^ """"legen te Velp bevattende 9 Kamers Koetshuis en Stalling benevens eenen grooten TUIN. Nadere inlichtingen zijn te bekomen bij den Rentmeester D. DAAMEN op den Hmzsßiljoen te Velp bij Arnhem. (__Ki\ lEMAND van goeden huize met den HANDEL en do BEUBS bekend over eenig Vermogen kunnende beschikken wenschte zich te verstaan met lemand insgelijks Ilandelskcnnis en eeaig Kapitaal bezittende. ten einde gczamentlijk eene HANDELSZAAK."" op te rigten ofwel zich in cene bestaande Zaak ie Associëren. Adres mot eigenhandig geteekende Brieven Franco onder Lett. Y. bij de Boekh. do Wed. L. VAN HULST ek ZOON N. Z. Voorburgwal over de Nieuwe Kerk G 121. (3383) MEN VERLANGT  onverschillig in welke Provincie tegen Mei of eerder TE HUUR of TE KOOP een KOFFIJHUIS SLIJTERIJ UITSPANNING jof dergelijke Zaak mits een goed burger Bestaan opleverende opgave van Huur- of Koopprijs enz. met Franco Brieven onder Lett. A. A. bij den Boekhandelaar C. L. B RIN KMAN  te Amsterdam. (3130) Een fatsoenlijk JONGELING van de Protestantsche Godsd.  20 jaren oud zijne Leerjaren in eene KRUIDENIERS-AFFAIRE geëindigd hebbende  wenschte tot verdere Bekwaming in zoodanige Zaak ALS BEDIENDE geplaatst te worden. Adres' met franco Brieven onder Lett. R. bij den Boekhandelaar A. TER GUNNE tcDeventer. (3350) ASSOCIATIE. Wordt gevraagd een DEELGENOOT in cenc ruime winstgevende Zaak eene Som kunnende aanbrengen van 8 tot 14 Duizend Guldens. Diegene welke hiertoe mogten genegen zijn worden verzocht zich aan te melden met gefrankeerde brieven onder Lett. E. bij A. VAN BOEHOVEN Lijnmarkt te Utrecht. (3219) Een GEPENS. OFFICIER  oud 38 Jaren Gehuwd  met eén Kind  zag zich gaarne ten spoedigste als OPZIGTER of BOEKHOUDER in eene Fabriek of wel in eenige andere Administrative Betrekking geplaatst des verkiezende tegen genot van Huisvesting en Voeding. Men gelieve zich te adresseren met gefrankeerde brieven  onder Lett. E. S. Bureau Handelsblad. (3368) LECiml DE LIJDENSWEKEN uitgegeven door de Erven F. BOHN te Haarlem DE KRUISWOORDEN. ZEVEN LIJDENSPREKEN VAN Ds. BEETS ƒ1.50- TWAALF PREEKEN DOOR REETS f 2.80. STICHTELIJKE UREN VAN BEETS 4 Dln. elk Deel gebonden ƒ 2.90; ingenaaid ƒ 2.60. DAGBOEK VAN EEN EVANGELIEDIENAAR gehouden op zijne reis naar en door bet HEILIGE LAND door G. FISK 2 Deelen met 7 Platen/5.90. (3434)",http://resolver.kb.nl/resolve?urn=ddd:010086163:mpeg21:a0017:ocr,4,ddd:010086163:mpeg21:p004,Algemeen Handelsblad,1085
589798,1856/12/09 00:00:00,1411,ddd:011021659:mpeg21:a0008,http://imageviewer.kb.nl/ImagingService/imagingService?id=ddd:011021659:mpeg21:p003:image&x=478&y=2232&w=418&h=1411,ddd:011021659:mpeg21,896,3643,478,2232,4,WAAK IS JOHANNA WILLEMINA DAMXOET? I Dip in 1850 if Itiiir.il» wiioiule. Hnnr brneder Jan ; Dnmkurl in BIT Wk.-itik ''-I- vhh hnnr te h.M.riu Vrienden en bekenden (lit- «-villi» imrigt van liaar I ki:•••(•■li geven. worden vriendelijk rerxuelit dmirmn ii|>irnat te di»eu nan ! J . 11. WAUiriZKIT. ! 3n-3G2 A ll« For« <lu Luc Co.. Wi«. | WAAR ZIJX HENDRIK MOMBEEG en JANS WIEGEES? i Die in 1 S.')s van Zutphen (N'ederland) le Keokuk 'in !••«■» nnnkwhmeii. Hunne mulei* acdert liun ve«- | Ink iiiets van liei. veriiumen hebbende verkeereli in i gri»it«- oiiL'ertiftlieiil. lieriel aangaande ben wordt verlanird ilix.r U. F. STEGKMAN. 6w362 tc Pella. lowa. f'erhooping tnn Hoeken. Den 8 Januari} t.k. zal len huize van C. F. PETERS SOCIAL lIALL i PENNSYLVANIA AVENUE IX DK STAD BHEDOYOAX WORDKS- VERKOCUT EENE FEAAIJS COLLECTIE IJollaiulselic Boektcerkcn. De Catalogi» daarvan is remmden nan nl!n geabtiiieerden der Nieuw»Wilp en is teren» op aanvraag bij den uitgever deieu gretis te betuinen. Een ieder zij niet «mveraehilHi» ten np*ic' van xulk eeno gelegenheid mn in uiovrul verechii.endo vakken van wetenschappen ïich logon vndirlmidsclie prijzen ecue kleine Ribliolheek nan le schaffen. Sheboygan. 10 December 1856. itaritter en Jwits GROOT-HANDELAREN In Wijnen. Likeuren. Sigaren. Obio Wbiikey Grog«fc Puncb-Exmicleu. Bitter Kummel. en». AchUte Straat Zuidelijk von liet Portkantnor 360tf Sliebovgau Wis. 150000 Steenen Liggende nan den lioek ran Jdfewm Avenue en AchUte Straat zuidelijk von bet P.ialkauloor «ijn te koop en lo bevragen bij K GARTNER <fc ARENS. 3id360 Handelaren in Dranken. Nieuwe Goederen! De ondergetekende maakt hirrmedo xijne begnnetigers en hel publiek bekend dat hij eenen grooteren voorraad van nienwe winter goederen ontvangen heeft ran extra goede «jnaliteit «elke hij tegen de minM mogelijke prijien aanbiedt en ep aalke goede voorwoorden ala eenig hnia te Pella. SOMT ZIET £5 KOOPT! L. H. ra* BPANCKERE» Woabington Street tegenover Wolten' Dreg Store. Pill» 8 So*. 1965. 3S7tf,http://resolver.kb.nl/resolve?urn=ddd:011021659:mpeg21:a0008:ocr,3,ddd:011021659:mpeg21:p003,De Sheboygan Nieuwsbode,418
1956795,1856/05/21 00:00:00,2049,ddd:010544793:mpeg21:a0015,http://imageviewer.kb.nl/ImagingService/imagingService?id=ddd:010544793:mpeg21:p003:image&x=2017&y=69&w=955&h=2049,ddd:010544793:mpeg21,2972,2118,2017,69,4,"•«* OPENBARE HERBESTEDING. Dijkgraaf en Heemraden van den Znid-PlaspoliL-r in Schielanl  zijn van meening op Zaturdag den 3Ist'"" Mei 1856 des voormiddags teu 10 ure te Moordrecht in het Post/tuis 'm het openbaar te Herbesteden in ééu Perceel: Het driejarig onderhoud van de ten dienste van genoemden Polder bestaaude 21 WIND-MOLENS  twee STOOM - MOLENS SLUIZEN BRUGGEN en verdere GETIMMERTEN bestaande in al het Timmer- Metsel- Smids- en Rietdekkerswerk met de leverantie vau de Materialen welke daarvoor vereischt worden. Het gewyzigd Bestek zal acht dagen te voren ter plaatse der aanbesteding ter lezing liggen terwijl de uoodige inlichtingen te bekomen zijn bij voornoemd Bestuur afsmede bij den eerste Opziener N. Exalto te Moordrecht die aanwijzing in loco zal doen op Vrijdag deu 30Bte"" Mei 1856. % ERNEDE «J* AKDRAII. De ondergeteekenden maken bekend dat zij met 1° Mei jl. de WIJN-AFFAIRE vroeger onder de Firma IL J. Ü.VERNÈ DE gedreven voortzetten onder de Firma VERNÈDE & ANDRAU verzoekende het aan de vorige Firma geschonken vertrouwen op de nieuwe te willen overdragen. H. J. D. VER NÈD E. Utrecht L. F. 11. ANDRAU. den \7ien Mei 1856. %*~ROZiaJ\-AÏIJIVMAKERIJ RE MOOJP "" TE HOORN. De ondergeteekende heeft de eer te berigten dat in zijne Fabriek te bekomen is KRUIDEN-AZIJN eerste kwaliteit a 30 Cents tweede kwaliteit a 25 Cents per Fleseh. Deze Azijn is vervaardigd uit de welriekendste Kruiden van het Plautenrijk. J. A. HEUL E. »** Binnen AMERSFOORT. Te HUUR met 1 Augustus 1856: Eene zeer nette eu goed onderhouden HEEREN-HUIZINGE staande aan het beste gedeelte van den Singel voorzien vau negen onderscheiden zoo Boven- als Benedenkamers Zolder Keuken met Regen- en Welwaterspomp Kelder Dienstboden- en Provisiekamer eu grooten welaangelegden TUIN met onderscheidene fraaije Heesters en Vruchtboomen  Volière en Bergplaatsen voor Turf eu Hout enz. strekkende tot en eenen uitgang hebbende aan het Stads Plantsoen. Nadere informatien te bekomen bij den Boekhandelaar W. L. OKHUYZEN te Amersfoort. Brieven franco onder Letters B. B.",http://resolver.kb.nl/resolve?urn=ddd:010544793:mpeg21:a0015:ocr,3,ddd:010544793:mpeg21:p003,Opregte Haarlemsche Courant,955
279786,1856/07/27 00:00:00,78,ddd:010113121:mpeg21:a0023,http://imageviewer.kb.nl/ImagingService/imagingService?id=ddd:010113121:mpeg21:p003:image&x=119&y=4349&w=3587&h=78,ddd:010113121:mpeg21,3706,4427,119,4349,4,"een tot zei regel / l-^- A tt^ IC* S> *Ttt V? f|J rn Sf -fp ST Bovendien 45 Cent» voor Zêgelregt en een Nommer der Courant. «^ Per gewonen regel "" O.ÏO A JLP W JCi JE* Jl £l Ui Jl Ji Ju ÏMm Groote letters berekend naar plaatsruimte.",http://resolver.kb.nl/resolve?urn=ddd:010113121:mpeg21:a0023:ocr,3,ddd:010113121:mpeg21:p003,"Nieuwe Rotterdamsche courant : staats-, handels-, nieuws- en advertentieblad",3587
4012442,1856/03/02 00:00:00,5131,ddd:010112978:mpeg21:a0032,http://imageviewer.kb.nl/ImagingService/imagingService?id=ddd:010112978:mpeg21:p004:image&x=155&y=119&w=782&h=5131,ddd:010112978:mpeg21,937,5250,155,119,4,"Stoombootvaart op do Maas. Onderneming T*. «I. BEKCJER. Haart 185©. Van VENLO naar ROTTKRDAM Zondag Vavunds ten 7 ure na aankomst vnn de Stoomboot van Maastricht en voorts Maandag Wocnsdni en Donderdag 's avonds ten 11% ure. Van ROTTERDAM naar VEXLO Maandag 's avonds ten 8 ure en voorts Dinssrlag Donderdag en Vrijdag 's avonds ten 11% ure Correspondentie* Per Rijtuig vnn IViOOK. Mar MJMEGENon van CRKVECOEUR naar 'A BOSCH bij de Open Afvaart. Per Pruissische Diligence* V!>"" VENLO opde Spoortreinen te VIEKSEN . dngelijks 's morgens ten 4 ure en 's namiddags ten 3y2 ure Per Stoombooten van VENLO naar MAASTRICHT dagelijks boha'vc Dingsdag en Vrijdag  'smorgrns ten 4 ure. Arnn MAASTRICHT naar VENLO dagelijks behalve Dingsdag en Vrijdag 'smorgens len 11 ure (2010) Agent te Rotterdam C. Sl'filNWliG. (2020) De Ondergeteekende zal als last en volma_;t hebbende van zijne Principalen  op Dingsdag derf 18den Maart e.k. 's avonds ïevennre  té> huize van J. Kom te Middelh-mis aaiibr:. leden : LEGGEN eener ZOMERRIDK ongeveer ter lengte van 3SOO Ellen met den DUIKER daarin op het Buitengors der Westplaat Flakke'e. Het Bestek en de Voorwaarden liggen ter inzage van belanghebbenden b\j de Wed. P. ROODZANT 4 J ./. ./. SGEEEK.beiden te Middelharms zoo mede teu zijnen kantore alwaar tevens op franco aanvrage nadere inlichtingen te bekomen zijn; terwijl op den dag van do besteding en den dag te voren de aanwijzing van het werk op de plaats zelve zal geschieden. Middelharnis G C M KOLFF. 28 Februarij 1856 (2053) De gewone MAKELAARS IS KRUI' DENIERSWAREN te Rdterdam zullen op Donderdag 6 Maart 1856 des middags ten 12 ure voor het Pakhuis wijk 1 No. 501 in de Bierstraat publiek verkoopen: 150 Fusten Zantisehe KRENTEN liggende aldaar en dat bij Lavc'.fcgon '<>o als dezelve daags vóór en op den Verkoopdag voor een ieder zijn te zien ~TmIJHTEÏÜNG. De MAKELAAKS IN TABAK te Rotterdam zullen op Woersdag 12 Maart 1856 des voormid dags ten 11 «re 'in het Notarishuis aan dé Gel ders-he Kade. Publiek Veilen: GS Pakken Tisayat en 311 ' „ •""* : Cagayan IIINILLÜ TABAK.. Alles min of meer door zeewater besnh»d;gl direct van Man lli via Lon-ien aangebragt per het Schip Sea King. Nadere onderrig'ing bij de Makelaars (20101 Openbare Verkoopuig te Schiedam. op Woensdag 5 Maart 1856 des ntmiddass ten' e-m ure biuien de Koopmr.nsbeurs aldaar van: Circa 08 Last Rogge meerder ên minder door zeewiter beschadigd aungebragt met het Schip Kleinkinderen kepitein L. VAN PER Weiden van Galaiz thans liggende in Ligters bciijden de Beurs. Nadere onderrigting bij den Makelaar E. C. RIJNBENDE te Schiedam en de Heeren W. & A. SMALT & Co. te Rotterdam 2019) (1536) J. T. WISCBEREOFF. C. J. DE LANGE en P. BA VELAAR  Makelaars te Rotterdam zullen op Dingsdag den 25sten Maart 1856 des namiddags ten efen ure in het Notarishuis alhier Publiek Veilen : Ca. 00000 Stuks diverse Soorten ongemonteerde Malakka en andere soorten van WANDELSTOKKEN uit zee aangevoerd; to bezigtigeu 2 Werkdagen vóór en op den dag der Veiling. Nadere onderrigting bij bovengenoemde Makelaars VERKOOPIN& VAN KANTOOR- M SCHRIJFBEHOEFTEN. VAN MARLG k DE SILLE zijn voornemens ten overstaan van de Notarissen VAN DER VEN k VAN BULBRT residerendo te Rottedvn op Maandag d-n 3den Maart 1Ö56 des morgens ten 10 ure aan het Venduhuis aan de Viasmarkt te Rotterdam Publiek le Verkoopen: Eene Part.j POST- SCHRIJF- en andere PAPIEREN ENVELOPPEN. LAND- en SPEELKAARTEN LEIJEN 2 Fusten Zwane INKT COPIEER en andere INKT. LAK. STALEN en VEEREN-PENNEN POTLOODEN OUWELS Gebonden en Ingenaaide BOEKEN  alsmede 2 COPIEER-PERiEN. Nader gesorteerd en in partijtjes gelegd en voor ieder nog te zien op Maandag morgen aanstaande van 8— 10 ure vóór de Voi kooping. (20411 Publieke Verkcvoping Op Vrijdag den 7den Maart 18SG des morgens ten 10 ure  in de Verkoopzaal aan de Scheepmakershaven te Rotterdam ten overslaan van D. E. CORNE van eene belangrijke Partij RlocMende POTGEWASSEN HEES TERS cm. waaronder ruim 180 CAMELIA'S 200 STA M ROOZEN fijne lage ROOZ KN AZALEA'S. CALMEA'S DE CLYTRA L.\URIEREN ALVR CACTUSSEN HYACINTHEN benevens DALIA'S CANNA'S GLADLSLUS ANEMONUS enz. — D»nS 3 le Toren e ne""?"" tiger. (2054) OPENBARE VRIJWILLIGE VEHKOOPIKG VAN Meubelen Huissieradeu enz. Op Maand tg den lOden Maart 1856 des Morgens ten 10 Ure aan de Zuidblaak Wijk 2 No. 21 te Rotterdam ten overstaan van D. B. CORNE van een Souden INBOEDEL  bestaande in SECRÉTAIRE KABINET LEDIKANTEN met BEDDEN en TOKSsEHOOREN COLLES en Andere TAFELS STOELEN VOLTAIRES PENDULE SPIEGELS SCHILDERIJEN MANGEL VLOERKLEEDEN HAARDEN KOPER TIN en GLASWERK. Zaturdee bevoren» te bezigtigeu. (2055)",http://resolver.kb.nl/resolve?urn=ddd:010112978:mpeg21:a0032:ocr,4,ddd:010112978:mpeg21:p004,"Nieuwe Rotterdamsche courant : staats-, handels-, nieuws- en advertentieblad",782
3114100,1856/04/17 00:00:00,2831,ddd:010086208:mpeg21:a0020,http://imageviewer.kb.nl/ImagingService/imagingService?id=ddd:010086208:mpeg21:p003:image&x=1156&y=2517&w=1100&h=2831,ddd:010086208:mpeg21,2256,5348,1156,2517,4,"De Verificateur voor de Comptabiliteit der DIRECTE BELASTINGEN IN- en UITGAANDE EEGTEN en ACCIJNSEN voor de provinciën Zuid- en Noord-Holland en Utrecht is van voornemen op Woensdag 23 April eerstkomende des voormiddags ten Elf Ure aan het Bureau van Verificatie op het Binnenhof te 's Gravenhage over te gaan tot het Verkoopen bij Inschrijving van eene bijzonder groote Partij GESCHEURD PAPIER en eenig GRAAUW-en BORDPAPIER  hetgeen even als de voorwaarden voor den Verkoop dagelijks (de Zondagen uitgezonderd) door een ieder kan bezigtigd worden van des voormiddags Elf tot des namiddags Twee. Ure. (6624) _ Mr. J. M. CALI.ENFELS.____ Aan het LOGEMENT en UITSPANNING de Wijkerbrug zeer aangenaam gelegen aan de Trekvaart nabij Voorburg en 's Gravenhage zijn gedurende de Zomermaanden weder GEMEUBILEERDE APPARTEMENTEN TE HUUB met Kost en Bediening. Te bevragen bij den Eigenaar G. W. LEEUW (6373) BEPAMEN VOffiIÈIITÖÖBSTBLUNG VAN VOORTBRENGSELEN VAN SCHILDER- TEEKEN- BOUW- BEELDHOUW- EN GRAVEERKUNST TE AMSTERDAM VOOR DEN JARE 1856. BURGEMEESTER en WETHOUDERS dezer Stad in vereeniging met den EAAD VAN BESTUUB DEE KONINKLIJKEAKADEMIE VAN BEELDENDE KUNSTEN hebben besloten dit •^«ïl^.mf «^m«ï™/^ewPPEMBARE TENTOONSTEL«J\«' JAN KUNSTWERKEN VAN LEVENDE KUNSTENAARS te doen plaats hebben. De Ondergeteekenden van wege deze Stad en den Eaad voornoemd gekommitteerd brengen de volgende bepalingen ter kennis van alle Besturen Maatschappijen Beoefenaars Verzamelaars Voorstanders en Bevorderaars van Beeldende Kunsten. Art. I. De Tentoonstelling voor Kunstwerken van Schilder- Teeken- Bouw- Beeldhouw- en Graveerkunst van levende Kunstenaars zoowel binnen als buiten dit Eijk gevestigd zal plaats hebben in het Lokaal der Koninklijke Akademie van Beeldende Kunsten Art. 11. Deze Tentoonstelling zal op Dingsdaq 9 September eerstkomende geopend en op Maandag 6 Oetober daaraanvolgende gesloten worden. Art. IH. Alle Kunstwerken zullen vóór of uiterlijk op Maandag 25 Augustus vrachtvrij moeten bezorgd worden aan het gemelde Lokaal en de Schilderijen Teekeningen en Prenten met behoorlijke Lijsten voorzien zijn; zij moeten geadresseerd worden aan de Kommissie met eenen Brief houdende den Naam en de juiste Woonplaats van den Vervaardiger met eene korte omschrijving van het Onderwerp alsmede desverkiezende opgave van den Koopprijs der Kunstwerken; zullende al wat na den 2osten Augustus mogt worden ingezonden alleen kunnen geplaatst worden indien de ruimte zulks toelaat. Art. IV. AUe geplaatste stukken hetzij al dan niet verkocht zijn èn Wijven tot de finale sluiting der Tentoonstelling onder het opziet der Kommissie die zooveel mogelijk zal zorg dragen voor eene goede bewaring zonder echter voor schade of gemis in te staan; zullende echter geene stukken gedurende de Tentoonstelling worden afgegeven. Art. V. Men zal niet toelaten stukken die bevorens op stedelijke Tentoonstellingen alhier geweest noch welke volgens het gevoelen der Kommissie niet genoegzaam geschikt zijn; en houdt de Kommissie het oordeel deswege ganschelijk aan zich; ook uit de stukken van die vervaardigers welke onderscheidene Kunstwerken mogten inzenden en uit hoofde van de beperktheid van het Bokaal niet allen zouden kunnen geplaatst worden zal de keuze ter plaatsing door de Kommissie gedaan worden; kunnende men ingeval van teruggave van de behoorlijke geheimhouding en bescheidenheid verzekerd zijn. ° Art. VI. Geene Stukken die door anderen rior. a a tt _• zelven worden ingezonden zullen toegelaten worden Tnfv^^ eener schriftelijke toestemming van deze laatsten ' bijvoeging Art. VII. Een Catalogus zal de Namen en Wr..... s .  -.r naars en tevens de Kunstwerken welke te onPlaa]sen derKunsteaandiüden. te kooP morden aangeboden Art. VHI. Gedurende de week. volsendp __ _ ? . stelling zullen de Kunstvoorwerpen weder afeLven nf'""8?f TentóoJl-spood vrachtvrij terug gezonden worden. 'fee*=even of met den meesten De Kommissie wensehende de belangstelW j„ a0t>oj>ia a mbij het algemeen te verlevendigen «Sdi* iïdS KS^.811 van dit doel zou kunnen bijdragen om ha?e ™_-- mt'_die tot bereiking te ondersteunen. De Verleg^Z^^^Zi^tV^'1]]^ J. BROUWER ANrmr» e  L. ROVER VicT^S' Vooruiier- Amsterdam  t wfflK***-29 Maart 1856. J. W- KERKHOVEN. J. DE VOS Jz. A. B. B. TAUREL. C. P. VAN EEGHEN. (6618) * WITTERING  Secretaris.",http://resolver.kb.nl/resolve?urn=ddd:010086208:mpeg21:a0020:ocr,3,ddd:010086208:mpeg21:p003,Algemeen Handelsblad,1100
2119262,1856/12/25 00:00:00,1769,ddd:010274595:mpeg21:a0011,http://imageviewer.kb.nl/ImagingService/imagingService?id=ddd:010274595:mpeg21:p003:image&x=1260&y=100&w=1198&h=1769,ddd:010274595:mpeg21,2458,1869,1260,100,4,GRAND CONCERT VOOIL ET MTRIENTAL donné par Mademoiselle et Messieurs J. DUMON et V. BUZIAU dans la salie du Spectacle le 3 Janvier 1857. PREMIÈRE PARTIE. 1. Ouverture. 2. Fantaisie sur vn air allemand pour flüte par Mr. Dumon. Böehm. 3. Air du Craciato chanté par Mademoiselle Clijmans . . Meyerbeer. 4. Fantaisie sur ia marche d'Othello pour Violon par Mr. Buziau Ernst. 5. Air varié sur vn thème original pour flüte Dumon. SECONDE PARTIE. 1. Ouverture. 2. Fantaisie sur la favorite pour violon par Mr. Buziau. . Allard. 3. Air de Robin des Bois (Freyschütz) chanté par Madermoiselle Clijmans Weber. i 4. Air Tyrolien pour flüte par Mr. Dumon Böehm. 5. Le carnaval de Venise pour Violon par Mr. Buziau. . Ernst. 6. Mélodies chantées par Mademoiselle Clijmans Schubert. *f* Al degenen die iets verschuldigd zijn of te vorderen hebben van den Boedel en Nalatenschap van wijlen den Heer P. N. JANSSENS in leven Oud-Kolonel der Stedelijke Schutterij en Raad der Stad Breda eertijds aldaar gewoond hebbende en nu op den 12. December 1856 te Princenhage overleden worden verzocht daarvan betaling of opgave te doen ten Kantore van den Notaris K. H. BODE te Princenhage Letter A  N°. 189 voor den 15. Januarij 1857.,http://resolver.kb.nl/resolve?urn=ddd:010274595:mpeg21:a0011:ocr,3,ddd:010274595:mpeg21:p003,Bredasche courant,1198
2966816,1856/02/13 00:00:00,2668,ddd:010086145:mpeg21:a0017,http://imageviewer.kb.nl/ImagingService/imagingService?id=ddd:010086145:mpeg21:p004:image&x=2248&y=2657&w=1112&h=2668,ddd:010086145:mpeg21,3360,5325,2248,2657,6,"Bij J. HERMANS Uitgever en Boekhandelaar te Breda gaat ter perse : PROEVE van een ONDERZOEK NAAR DE BESTE DERBEKENDE WIJZEN OM HIERTE LANDE GROOTE ZEESLUIZEN TE BOUWEN door J. STROOTMAN  Ingenieur van 's Rijks Waterstaat en Lid van het Koninklijk Instituut van Ingenieurs. Met Platen voorstellende onder anderen de SLUIZEN te ANTWERPEN te LIVERPOOL en te HAVRE. (2249) iHDERWIJS EN OPVOEDING.  Bij den Boekhandelaar J. BRINKGREVE te Deventer ziet het licht: DE ONAFSCHEIDELIJKHEID VAN OINDER WIJS EN OPVOEDING OP OPVOEDKUNDIGE EN CHRISTELIJKE GRONDEN BETOOGD door B. T. NIJHOF. Prijs ƒ0.35. (2288) n_HMffl«_rM_D_. OORLOG IS AZIË. i Door de Erven C. M. VAN BOLHUIS HOITSEMA te Groningen  is Heden uitgegeven : Prof.Dr. KARL KOCH DE CAUCASISCIIE LANDEN EN  ARMENIË  in REISTAFEREELEN van Curzon  K Koch Macinl tosh. Spencer en Wildbraham Vertaald door J. J. A. GOEVERNEUR. Prijs ƒ 3.20. Wie zich eene duidelijke voorstelling wil vormen van het tooneel des oorlogs in den uitgestrektsten zin  kan door dit Werk zijnen wensch bevredigd vinden. En buitendien het is hier geen reisverhaal van een enkel Reiziger; maar eene keurlezing uit verschillende werken het resultaat der onderzoekingen en nasporingen van mannen wier werken bij de ver. schijning met de meeste gretigheid zijn ontvangen  — cene beschrijving van landen i/die zich zoolang aan de nasporingen der Europeërs onttrokken hebben en waar men zelfs heden nog streken aantreft die nog nooit ? door den voet van een beschaafden Europeaan betreden zijn."" (1939) ! Bij A. C. KRUSEMAN te Haarlem komt van dc Pers THANS KOMPLEET: i JERUXALEII VERLOKT. » HELDENDICHT VAN TORQUATO TASSO VERTAALD DOOU J. J. L. TEN KATE. Twee Deeltjes met Portretten van Tasso en ten Kate . . ƒ4 Gebonden in een Linnen Band #4.25 Tevens verscheen: HET EERSTE DEELTJE VAN Ch. DICKENS DAVID COPPERFIELD. NIEUWE GOEDKOOPE UITGAVE VEETALING VAN C. M. MENSING. Met Portret van Dickens en Twee Platen .... ƒ 2.25. :- Terwijl te gelijk bij alle Boekhandelaren de Inteekenlijsten ïïggen voor HET FRAAI EN WELGELIJKEND PORTRET VAN . Dr. NICOLAAS BEETS voorkomende in Aurora 1856 maar thans op verzoek van velen verkrijgbaar gesteld. Op GROOT PAPIER f _.25 / CHINEESCH „ 2 '' Dit Portret kan tevens afgesneden worden op zulk eene grootte dat "" dit zeer geschikt is om geplaatst te worden voor des Auteurs Werken: Gedichten Stichtelijke Uren enz. enz. (2025)",http://resolver.kb.nl/resolve?urn=ddd:010086145:mpeg21:a0017:ocr,4,ddd:010086145:mpeg21:p004,Algemeen Handelsblad,1112
3249353,1856/03/22 00:00:00,2909,ddd:010086183:mpeg21:a0024,http://imageviewer.kb.nl/ImagingService/imagingService?id=ddd:010086183:mpeg21:p004:image&x=57&y=64&w=1117&h=2909,ddd:010086183:mpeg21,1174,2973,57,64,6,"rv___* VERKOOPING. H. J. RIETVELD B. BAKKER Wz. J. MEI- JERINK MEIJER en J. J. VAN DER MEULEN k__3 _^_!_ Makelaars* zullen ten overstaan van den Notaris J3jgggjgjj^_ JAC*. DE MAN op Maandag zijnde den 21sten ?. April 1856 in de Nieuwe Stads Herbergaan het IJ in pn&iieke Veiling aan den meestbiedenden of hoogstmijnenden Verkoopen • ___?rT?S?OT*taür' Welbezeild Gekonerd BARKSCHIP genaamd -AUtLAAR laatst gevoerd door Kapitein L. A. J. BOULET groot volgens Nederl. Meetbrief 440 Tonnen of 232 Lasten. En dat verder met al deszelfs RONDHOUTEN OPSTAAND en LOOPEND WANT ANKERS TOUWEN ZEILEN en KETTINGEN als breeder bij den Inventaris vermeld. lemand nader onderrigt begeerende spreke met bovengemelde Makelaars ] of met de Kargadoors HOYMAN en SCHUURMAN. ' (4899) TE KOOP: "" | . Een IJzer thans alhier in aanbouw zijnde SCHROEF- t *^—^—*-^—\STOOMSCHIP van de navolgende afmetingen: Lengte 155 Voet J 1 Breedte 23 ;/ >Engelsche maat. i -Holte 13 u S Hetzelve heeft ruimte voor ca. 470 Kubiek Ton Goederen eene elegante ] Kajuit voor 18 k 20 Paisagiers alsmede eene Hut op het Dek en buiten- j dien Kajuiten voor Kapitein en Bemanning. 2 Machines van 60 Paardenkracht welke bij een Kolenverbruik van 1 7 k 8 Cnt. per uur 10 k 12 mijlen vaart zullen maken. Beladen zijnde 1 is de diepgang 10a 10£ voetEngelsch. Beiden  Schip zoowel als Machines c worden van de beste Materialen en constructie  onder het opzigt der Lloyds i gebouwd en daarvan een Certificaat voor 12 jaren A. 1. Klasse te bekomen ; kunnende binnen ééne maand geheel voor vertrek naar Zee gereed 1 geleverd worden. _ Aangaande den Prijs betalings-voorwaarden enz. zijn nadere inlich- ] tingen te bekomen bij Glasgow (Schotland) 14 Maart 1856. L. LEFFMANN (4804) . Scheeps-Makelaar. De Papierfabriek HET KLOOSTER onder de Firma H. ex H. PANNEKOEK met bijbehooieude GEBOUWEN i BOUWPLAATS BOUW- WEIDE- en HEIDEGRONDEN in Eer- £ beek onder Brummen ampel bij Aanplakbiljetten omschreven is in i eerste Veiling en latere Verhooging op Prijs gesteld als volgt: 1 Perc. 1 ƒ14256 ; Perc. 2 ƒ261 ; Perc. 3 ƒ385 ; Massa der Perc. 2en 3 S ƒ7Bl ; Perc. 4 ƒ2OOO ; Perc. 5 ƒ146; Perc. 6 ƒ1011; Perc. 7 ƒ170; Perc. 8 < ƒ585; Perc. 9 ƒ250; Perc. 10 ƒ169; Perc. 11 ƒ450; Perc. 12 ƒ3Ol ; Massa der Perc. 4 tot en met 12 ƒ5510; Perc. 13 ƒ320; Perc. 14 ƒ325; Perc. 15 ƒ230; Perc. 16 ƒ260; Massa der Perc. 14 15 en 16 ƒ800; Perc. 17 ƒ250; Perc. 18 ƒ160; Perc. 19 ƒ251; Perc. 20 ƒ108; Perc. 21 ƒ255; Perc. 22 ƒ400; Perc. 23 ƒ176; Perc. 24 ƒ145; Perc. 25 ƒBl ; ! Perc. 26 ƒ95; Perc. 27 ƒ220; Perc. 28 ƒ105; Perc. 29 ƒl2l ; Perc. 30 * ƒ240; Perc. 31 ƒ120; Perc. 32 ƒ865 ; Perc. 33 ƒ148; Perc. 34 ƒ5l. ] De Tweede of laatste Veiling blijft bepaald Maandag 31 Maart 1856 s des Middags ten 12 Ure in het Logement Het Nieuwe Kromhout te Brummen zonder Beraad. Informatiën zijn op Franco Aanvrage te bekomen bij den Heer G. HUISKAMP te Eerbeek en de Notarissen HONDDJS  te Wageningen  en VAN ITTERSUMJe Brummen. (48t3) iii:i:k_:\ iioiim\. Dc fijnste ZIJDEN HOEDEN zijn aan de Fabriek van den Onder- ' geteekende Heiligen Weg D 241 te verkrijgen h f 5.50. Billijker * prijzen zullen voorzeker nog nimmer betaald zijn terwijl hij de verzekering geeft dat zijne Hoeden met alle anderen kunnen wedijveren. F. A. DUPUY. NB. OUDE HOEDEN worden opgemaakt k ƒ 1.50. (4916) De Notaris J. W. ROELOFFS VALK residerende te Nieuwer- Amstel  zal op VRIJDAG den 28sten Maart 1856  des Voormiddags  ten 10 Ure_ op de Boeren Hofstede bewoond door de Wed. J VAN J ESVELD in de Rijke Waveren onicr Ouder-Amstel publiek Verkoopen: - 33 stuks extra schoon en gezond HOORNVEE 5 SCHAPEN ; 1 ZOG mst BIGGEN l BLOKWIELDE WAGEN  eenige BOERENen MELKGEREEDSCHAPPEN en ruim 20000 Nederlandsche Ponden ; welgewonnen HOOI ; alles daags te voren te zien. (4897 BDoor buitengewone omstandigheden biedt men met primo Mei e.k. j TE HUUR aan: Twee nette en voor alle bedrijven good ingerigte WINKELHUIZEN gelegen op de Leidschestraat bij dc Keizersgracht. Te bevragen bij G. FIKKERT en ZOON Mr. Timmerlieden op de Prinsengracht bij de Spiegelgracht. (4895) TETHUUR aangeboden een WINKELHUIS op de Leidschestraat tegen den prijs van ƒ 370  waarin zich bevindt een WINKEL-OPSTAL als: Kast Toonbank en Gas-Toestel geschikt voor alle Affaires en hetwelk tegen matigen prijs kan ¦worden overgenomen. Te bevragen onder Lett. S. K. bij den Boekhandelaar W. H. ZEELT Leidschestraat bij de Kerkstraat. (4887)",http://resolver.kb.nl/resolve?urn=ddd:010086183:mpeg21:a0024:ocr,4,ddd:010086183:mpeg21:p004,Algemeen Handelsblad,1117
2992880,1856/07/03 00:00:00,3344,ddd:010777078:mpeg21:a0018,http://imageviewer.kb.nl/ImagingService/imagingService?id=ddd:010777078:mpeg21:p004:image&x=981&y=76&w=895&h=3344,ddd:010777078:mpeg21,1876,3420,981,76,4,"JALOUSIËÜ. V B. DIJCKER & COMP. Hofleveranciers van Z. M. den Koning in lliniiCll- en Builen «laloiisiën te Leyden berigten het geeerde Publiek van Utrecht en omstreken _ dat zij gearriveerd en te ontbieden zijn bij den Heer C. J. Wolf in het Vergulde Poortje op de Neude tot en met Zondag den 6. Julij aanstaande. ATiJIMfyST MAATSCHAPPIJ VAM LEVENSVERZEKERING EN LIJFRENTEN. Hoofd-administratie te Londen Sackvillestraat no. 30. Hoofd-Agent voor Nederland JOHN MAVOR STILL te Amsterdam. Agent voor de Provincie Utrecht J. W. HEIJL » te Utrecht Mariaplaats Driehoek. Dadelijk beschikbaar Kapitaal f 1300.000. Deze maatschappij  geadmitteerd bij bijzondere Parlements acte en oppertoezigt der voornaamste mannen van Engeland heeft hare soliditeit voldoende bevestigd zoo door een veeljarig bestaan in Engeland Frankrijk en Duitschland als door de wijze waarop zij zich in vergelijking tot andere maatschappijen van hare verpligtingen bij voortduring en zonder eenig voorbehoud gekweten heeft. In Nederland zijn reeds veelvuldige bewijzen van deelneming geleverd en dit heeft genoemde Maatschappij aangespoord om haren werkkring verder uit te breiden en derzelver beginsel in het belang der minvermogenden te doen strekken tot een weldadig doel. Zij biedt als Voordcelen aan : 1». Polissen overdraagbaar aan anderen en betaalbaar aan'den Houder. 2<>. Verzekeringen tegen zeer billijke voorwaarden op personen buiten 's lands of in Indien woonachtig. 3"". Levensverzekeringen op ziekelijke personen tegen extra premiën. 4«. Lijfrenten aan Weduwen kinderen of andere personen. SU.5U. Lijfrenten gewaarborgd in verhouding tot den betrekkelijken levensduur tegen de hoogst mogelijke rente. 60. Giften (donnatiën) voor leergelden of opvoeding van kinderen huwelijksche voorwaarden en zijdelingsche (collaterale) zekerheid. Ten slotte verbindt zij zich tot de voorziening in alle die gevallen waarop hare bepalingen kunnen geacht worden toepasselijk te zijn. Prospectussen en informatiën zijn kosteloos te bekomen bij de Agenten en bij den ondergeteekenden Agent te Utrecht door wien onlangs reeds eene belangrijke post na slechts zeer korte deelname in bovengenoemde levensverzekeringmaatschappij is uitgekeerd  en bij wien tevens kan worden deelgenomen in verschillende Brand-Assurantie-Maatschappijen als voor: meubelen en Koopmanschappen  Hulzen en Gebouwen ln het algemeen Boerderijen enz. Directeur J. F. GEORGE te Amsterdam. H.VAN VEEREN* P.&M.MONTIJN// Oudewater. Utrecht J. W. HEIJL. Mariaplaats Driehoek.",http://resolver.kb.nl/resolve?urn=ddd:010777078:mpeg21:a0018:ocr,4,ddd:010777078:mpeg21:p004,Utrechtsche provinciale en stads-courant : algemeen advertentieblad,895
2430728,1856/11/22 00:00:00,2344,ddd:010482980:mpeg21:a0013,http://imageviewer.kb.nl/ImagingService/imagingService?id=ddd:010482980:mpeg21:p003:image&x=2125&y=1551&w=1037&h=2344,ddd:010482980:mpeg21,3162,3895,2125,1551,8,"dgVBnnniBBHnDK. 1 December  voory^ÖL f 100 reeep. 's maaiids. 20"": een Huis op Molenrliet.J?. (2907) F. DE GROOT. Het Huis  thans \VS\SV\VA bewoond door den? beer A. 11. Bloem%^ op Parapattan. Adres (2901) J. C. VAN Cl IA M BON. £^QnHHMnk Om spoedig te aanvaarden K\\S^V^-^""""l Landje I.ontar Satoe Kraroat aan de groote Postweg  met goed woonhuis en erf heerendiensten tuinhuur  enz. Op zeer billijke voorwaarden  bevraagbaar bij (2931) TIEDEMAN & VAN KERCHEM. ÉÊMÈkf -ÏMiBB» De ondergeteekende zijne zaken li- J^^&g quideerende verzoekt hiermede zijne Debiteuren alsmede ook die der vroegere firma Brandon f Meijer bun debet ten spoedigste te voldoen. (2984) L. MEIJER. Batavia 14 November 1836. tja ï ïÊJf %Jt M»9•■•VsffiSL ésL | FactCHr de Piano'»» .  p-evient le public qn'il est allé a S _ hL-^-y—T rang  et qtl'il ne sera de retour ii 11 .e  (jue vers Ie lo Décerabre. (2990) Mad. GHYMERS zich alhier blijvende vestigen beveelt lich aan tot het geven van Muzieklessen op de Piano en in de Zangkunst. Tot inlichtingen gelieve men 7ich te adresseren aan het bureau der directie van hel Fransche tooneel op Pas sar Baroe. (29i!0) Café Lambert. Poule d'houneiir Dimanehe le 23 Novembre  a 9 heures du soir a I'occasion de la pose du SECOKB BILLARÏ9. Prix de la mise ƒ 2—. (2993) ü Noordwijk.",http://resolver.kb.nl/resolve?urn=ddd:010482980:mpeg21:a0013:ocr,3,ddd:010482980:mpeg21:p003,"Java-bode : nieuws, handels- en advertentieblad voor Nederlandsch-Indie",1037
3206242,1856/12/03 00:00:00,3302,ddd:010544958:mpeg21:a0018,http://imageviewer.kb.nl/ImagingService/imagingService?id=ddd:010544958:mpeg21:p004:image&x=47&y=90&w=971&h=3302,ddd:010544958:mpeg21,1018,3392,47,90,6,Eene extra fraaije sortering tMUWE VOORWERPEN voor Geschenken alsmede een ruime sortering in KINDERSPEELGOEDEREN zijn van af heden in onze Benedenen Boven-Magazijnen tentoongesteld. De Wed. dk LANGE en van EK Leveranciers van IL M. de Koningin. Haarlem Nov. 1850. *Jf De ondergeteekenden binnen de Gemeente Nieuwe Niedorp eenen Houtzaagmolen hebben doen bouwen en tevens eenen Handel in Houtwaren zijnde begonnen brengen zulks bij dezen ter kennisse van het algemeen zich beleefdelijk aanbevelende tot het leveren van alle soorten van GEZAAGDE en ONGEZAAGDE HOUTWAREN daaronder begrepen MOLENASSEN en ROEDEN. Zij stellen zich voor niets onbeproefd te laten om door eene soliede behandeling zich het vertrouwen hunner begunstigers waardig te maken en vleijen zich dan ook dat uit aanmerking dat in het geheele kanton Schagen geen dergelijke Trafiek meer bestaat en alzoo door deze hunne onderneming in eene wezentlijke behoefte wordt voorzien de noodige ondersteuning te zullen mogen erlangen. J- BOLTE & C°. Nieuwe Niedorp 24 November 1856. *„* G. T. N. SURINGAR te Leeuwarden heeft uitgegeven en algemeen verkrijgbaar gesteld: VERSPREIDE GESCHRIFTEN van ABr. des AMORIE van der HOEVEN in leven Hoogleeraar te Amsterdam. Voorafgegaan door een Woord ter nagedachtenis van den Ontslapenen doorM.COHENSTUART Pred.bij de Bern. Gem. te Alkmaar. Een Boekdeel in groot oct. ƒ 325. Behalve de Redevoeringen eu Geschriften die vroeger afzonderlijk in het licht verschenen en niet voorkomen in de bereids verzamelde Redevoeringen en Leerredenen van dezen Schrijver bevat dezen Bundel niet minder dan zes Stukken die vroeger niet in den handel en slechts voor een bepaalden kring van Lezers gedrukt of in een ander geschrift opgenomen waren. Den derden druk der NAGELATEN LEERREDENEN van ABr. des AMORIE van der HOEVEN Jr.  inleven Thcol. Dr. en Predikant te Utrecht. Voorafgegaan door eene Levens- en Karakterschets des Ontslapenen van de hutul zijns Vaders. Met PORTRET ƒ 375. Het Portret van Van der Hoeven Jr. bij deze uitgave gevoegd is nog afzonderlijk te bekomen voor. ... ƒ 125. Eenige Exemplaren op groot Papier ' 180. Idem Proefdrukken * 300. J. V. UILKENS. DE VOLMAAKTHEDEN VAN DEN SCHEPPER IN ZIJNE SCHEPSELEN BESCHOUWD tot verheerlijking van God en tot bevordering van nuttige natuurkennis. Op de tegenwoordige hoogte der Weterschap gebragt door de Heeren Prof. KAISER Dr. E. M. BEIMA Prof. M ATTHES Prof. J. Van der HOEVEN en Prof. MIQUEL. Derden deels zevende Aflevering behelzendeßeschouwingen mor het Dierenrijk door Prof. J. van der HOEVEN opgeluisterd door vele lloutsiiée-Figuren en Platen gegraveerd door STAM. Met nog ééne Aflevering van het tweede Deel die eerstdaags verzonden wordt en eene van dit derde Deel die ter perse is zal deze geheel vernieuwde uitgave van het Werk van UILKENS voltooid zijn. BLIKKEN IN HET LEVEN DER NATUUR. N°. 6. Bevattende: HET INSTINCT DER DIEREN. Naar het Hooo-duitsch van BERNSTEIN door W. F. R. SURINGAR Phil. Nat. Cand • 20 Cents. Met dit Stukje is de tweede Jaargang van dit populaire en goedkoope Tijdschrift gesloten die thans in zijn geheel verkrijgbaar is voor 00 Cents. Vau den eersten Jaargang zijn nog enkele Exemplaren voorhanden; terwijl op den derden die met het volgende jaar begint en waarvan de Hoofd-redactie is opgedragen aan de Heeren Dr. J. BOSSCHA Jr. R S. T.MODDERMAN en W. F. R. SURINGAR bestellingen worden aangenomen bij den Uitgever en verder bij meest alle Boekhandelaren in het Rijk.,http://resolver.kb.nl/resolve?urn=ddd:010544958:mpeg21:a0018:ocr,4,ddd:010544958:mpeg21:p004,Opregte Haarlemsche Courant,971
9913366,1856/02/12 00:00:00,4159,ddd:010788575:mpeg21:a0009,http://imageviewer.kb.nl/ImagingService/imagingService?id=ddd:010788575:mpeg21:p003:image&x=43&y=133&w=2582&h=4159,ddd:010788575:mpeg21,2625,4292,43,133,4,"ADVERTENTIEN. MINISTERIE VAN BINNENLANDSCHE ZAKEN. Provincie Noordholland. AANBESTEDING. Op Donderdag den 21sten Februarij 1856 des namiddags ten 2l/2 ure zal onder nadere goedkeuring door den Commissaris des Konings in de provincie Noordholland of bij zijne afwezendheid door een der leden van de Gedeputeerde Staten en in bijzijn van den Hoofdingenieur van den Waterstaat in het 9de district aan het locaal van het Provinciaal Bestuur te Haarlem worden Aanbesteed: het in verbinding brengen der nieuwe Koopvaarders-schutsluis met de haven het Nieuwe Diep en met het Noordhollandsche kanaal. Deze Aanbesteding zal geschieden bij enkele inschrijving. Het Bestek ligt ter lezing behalve aan het locaal van het Ministerie van Binnenlandsche Zaken en aan dat van het Provinciaal Bestuur van Noordholland  te Haarlem  op alle zoodanige plaatsen alwaar gewoonlijk de Bestekken van Waterstaatswerken in gemelde provincie ter lezing gelegd worden. Zullende Maandag en Dingsdag vóór de Besteding de noodige aanwy'zing in loco worden gedaan en voorts nadere informatien te bekomen syn bij den Hoofdingenieur van den Waterstaat E. de Kriiijff te Haarlem en bij den Ingenieur J. Strootman te Nieuwe Diep. De Minister van Binnenlandsche Zaken Van Reenen. MINISTERIE VAN FINANTIEN. %• De Minister van Finantien Gelet op de resolutie van heden waarbij krachtens het Koninklijk besluit van den 19den November 1850 n°. 81 in verband met dat van den 23sten Juny 1852 n°. 85 wordt vastgesteld de 229ste Staats-Loterij brengt bij deze ter kennis van een ieder die verlangen mogt in genoemde Loterij deel te nemen dat ten deze zijn gemaakt de navolgende bepalingen : I°. De twee honderd negen en twintigste Loterij zal bestaan uit twintig duizend loten tien duizend prijzen en twee premien overeenkomstig het plan aan deze gehecht. 2°. Ten behoeve van 's Rijks schatkist zal worden ingehouden vijftien ten honderd van alle prijzen en premien van één honderd gulden en daarboven en tien ten honderd van alle prijzen van zeventig gulden en daarbeneden alles onverminderd de bijlage van twee gulden voor ieder klassikaal lot hetwelk voor de laatste klasse verwisseld wordt. 3°. De loten zullen in geene kleinere deelen mogen gesplitst worden dan in twintigsten. 4°. De toelating van splitters en debitanten zal moeten geschieden met inachtneming van de bepalingen in de Koninklijke besluiten van den oden November 1818 (Staatsblad n°. 37) 13 dito 1827 n°. 145 (Staatsblad n». 50) en n°. 146 van den 6den Januarij 1831 n°. 68 (Staatsblad n°. 2) vervat. s°. De klassikale loten voor de eerste klasse zullen voor den inlegprijs verkrijgbaar zijn voor de houders van loten die in de laatste klasse der 228ste Loterij met niet zijn uitgekomen; mits tot het bekomen derzelve ten kantore van den Directeur der Staats-Loterij te 's Gravenhage of van een der collecteurs aanvraag gedaan worde gedurende de collecte. 6°. De voornoemde Directeur zal bij de opening der collecte voor de 229ste Loterij  aanvankelijk een getal- van één duizend loten afzoneren en beschikbaar houden om daaruit aan ingezetenen van het eke'"" fe<""'!le  doch bekend zijnde loten voor eigen r> na ° A sPelen tegen den inlegprijs af te geven mits de prys van ac alzoo afgegevene loten aan hem in ééns voor alle klassen voldaan worde. i ?°' De ï)l1reCter-'i meergenoemd zal van de uitgifte der voormelde loten eene behoorlijke opgave aan den Minister inzenden overeenkomstig de bepalingen daaromtrent i„ zijne instructie vastgeSteld. 8». De uitbetaling van eenen prijs of van eene premie zal door den Directeur der Staats-Loterij alleen kunnen bewerkstelligd worden tegen overgifte van het door hem afgegeven oorspronkelijk lot waarop de prijs of premie gevallen is. 9°. Alle prijzen en premien welke niet worden afgehaald binnen vier jaren te rekenen vaneden vijftienden dag na het uittrekken van de laatste klasse der Loterij waarin de prijzen en premien gevallen zy""n vervallen zonder uitzondering aan 's Rijks schatkist. Evenzeer vervalt aan 's Rijks schatkist het te veel betaalde op doorgefourneerde loten welke in eene der vier eerste klassen met een prijs zijn uitgekomen  wanneer dat te veel betaalde niet binnen gemelden termijn van vier jaren is teruggevorderd. 10°. De collecte der 229ste Loterij zal geopend worden op Maandag den 3den Maart 1856 en worden gesloten op Zaturdag den loden derzelfde maand. 11». De trekking van de onderscheidene klassen zal geschieden veertien dagen de eene na de andere. Die van de eerste klasse der Lotery' zal plaats hebben en geheel moeten afloopen op 31 Maart. 12 en 3 April 1856; die der tweede klasse op 14 15 16 en 17 derzelfde maand; die der derde klasse op 28 29 en 30 derzelfde maand; die der Vierde klasse op 13 14 en 15 Mei 1856; endieder vijfde of laatste klasse Op 26 27 28 en 29 Mei 1856 3 4 6 10 11 12 13 17 18 19 en 20 Junij 1856 terwijl de laatste 100 nommers op Zaturdag den 21sten Junij 1856 zullen getrokken worden. 12°. De collecteurs splitters en debitanten zullen bij het verkoopen of verhuren van loten niet meerder mogen vorderen dan Bij verkoop: I. Van loten voor alle klassen of doorgefourneerde: Geheele loten f 69.00 Halve - 34.50 Vijfde i - 13.80 Tiende i - 6.90 Twintigste» - 3.45 11. Van klassikale loten. Bij verkoop: Bij verhuring: Voor de eerste klasse. Geheele loten ... f 14.00 Geheele loten... f 4.00 Halve n ... - 7.00 Halve » . . . - 2.00 Vijfde ii ... - 2.80 Vijfde i 0.80 Tiende « ... - 1.40 Tiende »....- 0.40 Twintigste - 0.70 Twintigste n . . . - 0.20 Voor de tweede klasse. Geheele loten... f 26.00 Geheele loten... f 8.00 Halve «... - 13.00 Halve » . . . - 4.00 Vijfde ii ... - 5.20 Vijfde n . . . - 1.60 Tiende » . . . - 2.60 Tiende » . . . - 0.80 Twintigste » ... - 1.80 Twintigste n . . . - 0.40 Voor de derde klasse. Geheele loten ... f 40.00 Geheele loten... f 10.00 Halve ii ... - 20.00 Halve n . . . - 5.00 Vijfde ii ... - 8.00 Vijfde » . . . - 2.00 Tiende «... - 4.00 Tiende n . . . - 1.00 Twintigste n . . . - 2.00 Twintigste » . . . - 0.50 Voor de vierde klasse. Geheele loten ... f 56.00 Geheele loten ... f 14.00 Halve » ... - 28.00 Halve - 7.00 Vijfde » ... - 11.20 Vijfde i 2.80 Tiende » . . . - 5.60 Tiende » . . . - 1.40 Twintigste » . . . - 2.80 Twintigste «... - 0.70 Voor de vijfde klasse. voor de lste week. Geheele loten ... f 71.00 Geheele loten ... f 18.00 Halve » ... - 35.50 Halve «... - 9.00 Vijfde - 14.20 Vijfde » . . . - 3.60 Tiende «... - 7.10 Tiende » . . . - 1.80 Twintigste » . . . - 3.55 Twintigste » . . . - 0.90 Diegenen welke de hierboven bepaalde prijzen voor klassikale kooploten hebben betaald zullen indien hun lot niet wordt uitgetrokken in de klassen waarvoor hetzelve genomen was derzelver fournissement voor de volgende klassen kunnen voldoen gelijk hetzelve bij het plan is vastgesteld  namelijk voor geheele loten : bij de verwisseling voorde tweede klasse met ..... f 12.00 voor de derde klasse met . . '. - 14.00 voor de vierde klasse met - 16.00 voor de vijfde klasse met - 15.00 en voor de gedeelten van loten naar evenredigheid van deze prijzen; alles zonder verdere bijbetaling van eenig opgeld. 13°. De prijs waarvoor de loten gedurende de verdere trekking der vijfde klasse zullen mogen verkocht en verhuurd worden zal nader voor elke week afzonderlijk worden bepaald. De collecteurs splitters en debitanten zullen zich moeten gedragen naar de vorenstaande bepalingen welke te dien einde  overeenkomstig art. 3 van het Koninklijk besluit van den 6den Januarij 1831. n°. 68 in de Nederlandsche Staats-courant zullen worden geplaatst. Dien ten gevolge worden de ingezetenen welke geheel doorgefourneerde loten  tegen den inlegprijs voor eigen rekening mogten verlangen te spelen oplettend gemaakt op de bepalingen volgens welke de afgifte dier loten tot het daarbij uitgedrukte getal aan den Directeur der Staats-Loterij is opgedragen te wiens kantore men zich in persoon of by' gemagtigde zal moeten vervoegen tot verkrijging dier loten. 's Gravenhage den 6den Februarij 1856. De Minister van Finantien Veolik. PLAN voor de 229ste Staats-Loterij bestaande uit 20000 loten  10000 prijzen en 2 premien. EEKSTE KLASSE. TWEEDE KLASSE. De inleg is f 5. De inleg is f 12. 1 prijs van .' . . .f 20000 1 prijs van . . . .f 20000 1 ii i - 5000 1 ii ii .... - 5000 1 ii » 2500 1 ii ii .... - 2500 2 prijzen van f 1250. - 2500 2 prijzen van f 1250. - 2500 10 ii >' - 1000. - 10000 10 .' » - 1000. - 10000 10 il » - 400. - 4000 10 ii ii - 400. - 4000 10 » » - 200. - 2000 10 » ii - 200. - 2000 15 » "" - 100. - 1500 15 ii ii - 100. - 1500 1450 » »' ' 20- - 29000 1450 » » - 30. - 43500 1500 prijzen bedragen . f 76500 1500 prijzen bedragen . f 91000 DEKDB KLASSE. VIERDE KLASSE. De inleg is f 14. De inleg is f 16. 1 prijs van . . . .f 25000 1 prijs van . . . .f 25000 1 » »:...'■..- 5000 1 i - 5000 1 » »....- 2500 1» 2500 2 prijzen van f 1250. - 2500 2 prijzen van f 1250. - 2500 10 » » - 1000. - 10000 10 n » - 1000. - 10000 10 "" » - 400. - 4000 10 ii » - 400. - 4000 10 » o - 200. - 2000 10 i » - 200. - 2000 15 » » - 100. - 1500 15 ii ii - 100. - 1500 1450 » » . 45. . 65250 1450 » » - 65. - 94250 1500 prijzen bedragen . f 117750 1500 prijzen bedragen . f 146750",http://resolver.kb.nl/resolve?urn=ddd:010788575:mpeg21:a0009:ocr,3,ddd:010788575:mpeg21:p003,Nederlandsche staatscourant,2582
1526012,1856/12/12 00:00:00,1583,ddd:010544966:mpeg21:a0014,http://imageviewer.kb.nl/ImagingService/imagingService?id=ddd:010544966:mpeg21:p002:image&x=2008&y=3234&w=964&h=1583,ddd:010544966:mpeg21,2972,4817,2008,3234,4,231ste STAATS-LOTERIJ Trekking der tweede Klasse. 4^ Lijst. N°. 16101 en 4458 ieder een prijs van ƒ 1000. *#* WELDADIGE LV\UKE\»»TE_\! De commissie belast met de inzameling van liefdegiften ten behoeve van de uit Aalten M'interswijk en Dinxperlo afkomstige schipbreukelingen van de Ocean Home heeft de eer langs dezen weg de. ontvangst van de navolgende giften bekend te maken: Ontvangen van Z. M. den Koning ƒ 150. Bij mr. H. A. Roelvink te Aalten: van Hare Majesteit de Koningin-Moederder Nederlanden ƒ 50 ; van N. N. ƒ 10. Bij m. W. H. Dullert te 'sGravenhage: van J. F. V. ƒ 10; T. 11. ƒ3; G. ƒ 10; H. ƒ3. Bij mr. J. IV. Staats Evers te Arnhem: van N.N. uit Velp ƒ10; P. ƒ 250 ; G. ƒ 1 ; T. ƒ 5 ; W. ƒ2; R. ƒ 1 ; van eenige kinderen op de dorpsschool te Velp ƒ 153; C. ƒ 350; jh'. G. v. O. ƒ 450; baron v. P. v. B. ƒ 15 ; W. A. K. ƒ 10. Bij den predikant Sanne* te Arnhem : van P. ƒ 3 ; S. M. ƒ 309; E. d. M. Q. uit Doesburg ƒ 7425; g. v. S. ƒ 1980; V.C. ƒ250 onbekend ƒ 990 ;Z. B. twee coup. ƒ 247s en ƒ 6185; ƒlen ƒ 6; beide gecollecteerd in de Groote-kerk te Arnhem; 2 coupons werk. schuld elk a ƒ 1237» van de Familie V. te Utrecht en J. A. ƒ 10. Bij den predikant Pape te Aalten: twee coupons postm. Leeuwaarden  groot f 297 en ƒ198. Bij den predikant de Waal te Aalten: een coupon pormerk Amsterdam  groot ƒ 1235. Bij m. 11. E. Roelvink te Zutphen: van S. v. IL ƒ 10.; v. H-fl. Bij m. Colson Aberson te Doetinchem: van B. M. ƒ2; N. N. uit Terborg ƒ 016' en ƒ 010. Van de Ainsterdamsebe Courant diverse daaraan opgezondene giften ten bedrage van ƒ 11515 te weten: van ~W- K ƒ 40; J. N. ƒ 10; S. J. C. ƒ 10; onbekend ƒ 350 ; G. B. L. S. ƒ070; J. E. ƒ 25; B. S. ƒ 10; E. 11. ƒ 495; onbekend /1; v. G. ƒ 10. Van het Algemeen Handelsblad ƒ 2050. Van de N. Uotterdamsche Courant ƒ 2084 ; zijnde het bedrag der aan deze beide dagbladen toegezondene giften. Van de Deventersche Courant ƒ 1732' zijnde van B. M. en P. ƒ1485 en N. N. ƒ 247». Van de Arnhemsche Couraut ƒ 396  ingezonden door N. N. uit Nijmegen. Terwijl de commissie haren welmeenenden dank betuigt voor deze milde giften  vermeent zij het ongelukkige lot dezer zoo zwaar beproefde personen wier aanzienlijk geleden verlies ten bedrage van ƒ 7000 door bovenstaande bijdragen slechts voor een veertiende gedeelte is vergoed bij voortduring met nadruk aan de bekende liefdadigheid hunner landgenooten te moeten aanbevelen.,http://resolver.kb.nl/resolve?urn=ddd:010544966:mpeg21:a0014:ocr,2,ddd:010544966:mpeg21:p002,Opregte Haarlemsche Courant,964
2831877,1856/10/14 00:00:00,2007,ddd:010584511:mpeg21:a0002,http://imageviewer.kb.nl/ImagingService/imagingService?id=ddd:010584511:mpeg21:p001:image&x=94&y=2395&w=1411&h=2007,ddd:010584511:mpeg21,1505,4402,94,2395,4,"PüBhIC A ï 1 E. De CEBEPITïEEBDE STATEX der provincie Friesland brengen ten vervolge op hunne Publicatie van den 6 dezer ter kennis der ingezetenen dat van den 4 tot en met den 10 dezer: 1. 36 runderen in de Provincie aan de besmettelijke longziekte zijn gestorven als in de gemeenten: Achtkarspelen 1  Baarderadeel 5 Doniawerstal 2 Haskerland 2 Hennaarderadeel 8 Idaarderadeel 2 Kollumerland en Nieuw- Kruisland 2 Leeuwarderadeel 2 Smallingerland 1 Wonseradicl 4 Workum 1 en Wijmbritseradeel 6 en 73 door die ziekte aangetaste runderen voor rekening der eigenaars zijn afgemaakt als in de gemeenten: Baarderadeel 7 Doniawerstal 5 Ferwerderadeel 1 Franeker 1 Haskerland 3 Hennaarderadeel 11 Idaarderadeel 4 Leeuwarden 1 Leeuwarderadeel 3 Menaldumadeel 2 Rauwerderhem 5  Sloten 1 Srreek 2  Utingeradeel 1 Wonseradeel 12 Workum 1 en Wijmbritseradeel 13 bedragende daardoor het totaal der gevallen sedert den 1 Januarij dezes jaars 4295; 2. de besmettelijke longziekte zich heeft geopenbaard onder de runderen van de veehouders: Jan Terwisscha van Scheltinga te Oosterwierum; de Wed. Reinder Rienks Sijbrandij te Wieuwerd: Sjoerd Gerrits Nijland te Oosterlittens; Reinder Jans Bosma te Bozum ; Pier Abes Santema te Britswerd; Pieter Jans de Boer te Weidurn; de Wed. Petrus Jetzes Kalma te Jorwerd ; Boijen Wassenaar te Sint Anna-Parochie ; Pieter Obes IJntema te Bolsward; Haantje Wijbes Salverda te Franeker; Jacob Wijbrens Kornelis te Joure; Sijtze Barteles Luchtenveld te Haskerdijken; Ate Sjoerds IJpma te Oosterend; Jan Oeges Kok te Roordahuizum; Tjeerd Louwes Wiersma te Augsbuurt; Hermanus Habbema te Burum; Sipke Lieuwes de Graaf en Doekele Johannes Osinga te Leeuwarden; Sipke Wopkes de Boer Sijtze Andries Andringa en Hotze Bontjes Meintema te Wirdum; Simon Renzema te Lioessens; Wabe R. Wartena  te Terzool; Sjerp J. Piersma en Oept J. de Boer te Rauwerd; Fokke Nannes Koopmans te Tjerkgaast; Tjitze Tjeerds Rijpkema te Terhorne; Jan Reinders Bangma te Makkum; Feike Tjerks de Boer te Tjerkwerd; Gabe Jans Haarsma te Piaam; Jan IJdema te Makkum ; Pier Watzes Hidma te Witmarsum; Gerlof Gerritsen Douwe Nop en Jan Bokma te Workum; Pier Annes Osinga te Indijk; Pieter Sijbren» van der Velde te Oosthem  en Bauke Jans van Dijk te IJsbrechtum; 3°. gezond zijn verklaard de runderen van de veehouders : Douwe Jans de Boer te Gerkesklooster; Sander Annes van der Meulen te Nijega (Smallingerland); Tjepke Pieters de Vries te Huins; Reinder Jans Bosma te Bozum; Anke Folkerts Postma te Jorwerd (beide gedeeltelijk); Jelle Sijmens van der Woude te Jellum; Bontje Jitzes Looijenga . te Wieuwerd; Jentje Freerks van Es  te Nes (Utingeradeel) ; Rijkel Sijmens Vierstra en Hille Sjoerds Lanting beide te IJlst; Arme Tjalkes Gaastra Jelle Douwes Hilarides en Johannes Durks Twerda allen te Wommels; Floris Ruurds Reitsma te Wirdum; Joute D. van der Werff te Leeuwarden (in eene weide onder Vrouwen-Parochie); Arme Ulbes van Dijk te Gauw; de Wed. Frans Lammerts Tolsma te IJndijk; Hinne Haitzes Visser te Upecolsga ; Klaas Kornelis Witteveen  te Nijland en Wopke Hijlkes Grondstra te Woudsend. Leeuwarden De Gedeputeerde Staten voornoemd den 13 October 1856. ""Van PANHUIJS Voorzitter. A. van der LAAN Griffier.",http://resolver.kb.nl/resolve?urn=ddd:010584511:mpeg21:a0002:ocr,1,ddd:010584511:mpeg21:p001,Leeuwarder courant,1411
1746981,1856/09/17 00:00:00,801,ddd:010086722:mpeg21:a0011,http://imageviewer.kb.nl/ImagingService/imagingService?id=ddd:010086722:mpeg21:p002:image&x=1250&y=4545&w=2181&h=801,ddd:010086722:mpeg21,3431,5346,1250,4545,6,"DU BARRY'S REVALENTA geneest: . < TT'TT'T- OnP_rv_Tfc""TfcTTVT/^ T? AT hoe hardnekkig ook en al hare ernstige gevolgen  als: Congestiën bloedsaandruJ» Vl_l\l_. JL V-/A Jrlillj_L_.l^l «9 naar het h°°fd duizeligheid stuipen hersenontsteking zenuwziekten verlammiD«' hoofdpijn hardkloppingen aandoeningen van lever _n nieren  maagkramp  spanning misselijkheid opgeven oprispingen lusteloosheid en vel» andere ziekten die uit slechte spijsvertering en bedorven sappen voortkomen. Zij geneest ook door hare voortreffelijke inwikkelende eigenschapp*» asthma verouderde hoest beginnende tering en andere borstkwalen. Zü is te bekomen in het VERKOOPHUIS en de bekende Depots. (1557- 17/ i. 56) IIITJBIIMATröMAE. SOCIEwT ENGELSCHE LEVENSVERZEKERING-MAATSCHAPPIJ. MPITAAL EES lIIMOBI 6ULDEIS: ALGEMEEN AGEINT W. J. C. ADRIAAN VAN HASSELT. Sluit Verzekeringen voor het geheele leven en tijdelijke Contracten van Onmiddelijke en Uitgestelde Lijfrente?' VOORBEELD. lemand oud 23"" Jaren Verzekert zich door de betaling van ƒ l per week . indien hij den ouderdom van 60 Jaren berejK t de keus tusschen eene Lijfrente van ƒ464.66 'sjaars eene som van ƒ 4543 of eene Polis van ƒ5845 betaalbaar op zijn Overlijden aan zijne *r genamen en heeft het regt om na 4 Jaren Deelneming 2/3 van de Gestorte Premie te leenen. _ __._.—__""_._* _ Hoofd-Agent voor Noord-Holland 9. 11. VON ZIEGLER. Agenten: Te Hoorn H. BAKKERte Enkhuizen JJ. LAKEI-MA-*' te Groningen Mb. B. ». H. TELLEKEN en J. A. VAN HASSELT te Zwolle Jl. KAMPHUIS enz. (15559)",http://resolver.kb.nl/resolve?urn=ddd:010086722:mpeg21:a0011:ocr,2,ddd:010086722:mpeg21:p002,Algemeen Handelsblad,2181
3113029,1856/03/12 00:00:00,3049,ddd:010771934:mpeg21:a0011,http://imageviewer.kb.nl/ImagingService/imagingService?id=ddd:010771934:mpeg21:p004:image&x=2102&y=2526&w=1021&h=3049,ddd:010771934:mpeg21,3123,5575,2102,2526,4,"MAGAZIJN VAN HEEREN HOEDEN. ■ƒ■* De ondergeteekende heeft de eer te beri""ten' dat bij heeft ont«M9KS vanden  alle soorten van V A S«FTM3BB»f TOOR en FRANSCHE ZIJ. I REN HOEREN  alsmede ?EEj|i|mmmffiH pbedihastühokbe!»- Rekommandeert zich ten vriendelijkste. J. A. WREESMAN in de Klok  tusschen de beide Markten. Aa» efr Groote Markt achter ••■■BmIBMhIIbhuI de Waag te Groningen. De ondergeteekenden hebben de eer  hunnen Stad- en Ijindgenooten te verwittigen dat zij uit de beste Fabrijken hebben ontvangen: Een «roof en fraai assortement supra fljne CASTOR EN FUA\SCHE ZIJDEN HEEREN HOEHEN VOLGENS HET LAATST UITGEKOMEN MODEL ; alsmede een groot assortement riti:m it \ y 11; viioi: i» i:\. bevelende zich ten vriendelijkste in eens ieders gunst. H. en T. SIJPKENS. HOEDI-IPËÏÏIËGU van de Wedw. P. NILSON in de Oude Ebbittgestrttat. 4B* Bovengenoemde heeft ontvangen en is iBJ jjfo? ruim voorzien van fijne VILTEN en FRANSCHE ZIJDEN HOEBEN T\Mtt2Ê£2?~ PETTEN  CASTOR- en andere KINBERHOEBJEB naar de 5 nieuwste Modellen ; waarmede zij zich ■^■■■■■■■■■ beleefdelijk aanbeveelt. HeerenHßakkers  Attentie s. v. p.ü! KBEITEI van het gewas van 0>"" J|h 1851 welker smaak en deugd alge- meen bekend zijn zijn nog tegen matige prljz e n  alsmede SA HOS. en XWARTE ROZIJNEN (groote Krenten)  te bekomen in de Steentilstraat te Groningen bij J. H. van HASSELT Jr. A PUIK! PUIK!! ■*SSI&F NIEUW HOOR en WIT KLAVER*«""'""* ZAAR  tegen billijke Prijzen te bekomen bij W. POTT A.z. in de Langestraat te Winschoten. '*** Bij E. RE BOER *% KONEN Gekwalificeerde Colleeteurs te Groningen zijn voor de 330ste STAATS-LOTERIJI (waarvan de eerste Klasse op MAANDAG den 3lsten Maart 1856 zal beginnen te trekken) LOTEN volgens Prijs-courant te bekomen. Op den nieuwen OLIE- en PELMOLEN te Brummen wordt tegen het begin van Julij GEVRAAGD : een TWEEDE KNECHT liefst ongehuwd  zijn werk vooral het Pellen  goed verstaande. Adres onder de letters T. W. aan het HULPKANTOOR te Brummen. Brieven franko.",http://resolver.kb.nl/resolve?urn=ddd:010771934:mpeg21:a0011:ocr,4,ddd:010771934:mpeg21:p004,Groninger courant,1021
738322,1856/11/24 00:00:00,949,ddd:010113240:mpeg21:a0049,http://imageviewer.kb.nl/ImagingService/imagingService?id=ddd:010113240:mpeg21:p004:image&x=86&y=4300&w=778&h=949,ddd:010113240:mpeg21,864,5249,86,4300,4,GENERAL SGREW STEAM SHIPPING GOMPANT (Incorpo'oted by Royal Charter.) Wekelij kseb'e Dienst TUSSCHEN ROTTEEDAM EN LONDON voor Goederen en Vee. Het Enge'scbe Sehroefstoomschip EARL OFAÜCKLAWD Kaplein WILLIAM W. APPLETON Vertrekt Woensdag 26 November de* morgens vroeg. Adres bij de Agenten GEORGE LEVINGSTON en J. A. SOUWENS te Rotterdam en W. E CARËY ft SON 34 Marklane London. (10382) Wekeiykisehe Stoomvaart TUSSCHSIT &GÏÏMMI II IHIIIIiE ' Eet IJie-en Stoomschip Prins vaa ©ramJe Stapt D. VISSER aal geregeld vau hier vertrekken  iederen Woentiag en van ©Minikerken dei Zatwdaga. (179) Adrea bij da Agenten JOEi OOMS Ez. &0o- ',http://resolver.kb.nl/resolve?urn=ddd:010113240:mpeg21:a0049:ocr,4,ddd:010113240:mpeg21:p004,"Nieuwe Rotterdamsche courant : staats-, handels-, nieuws- en advertentieblad",778
2270460,1856/09/15 00:00:00,2370,ddd:010544891:mpeg21:a0018,http://imageviewer.kb.nl/ImagingService/imagingService?id=ddd:010544891:mpeg21:p004:image&x=1036&y=2452&w=958&h=2370,ddd:010544891:mpeg21,1994,4822,1036,2452,4,"V N. J. van BEMMEL J. H.BRINKMAN J.van der VLUGT T. A. LIWI.TN N. WAALEWIJN W. M. van BEMMEL en J.BROESE Makelaars presenteren (als lasthebbende van hunne Principalen) op Zaturdag den 20ste» September 1856 in het Logement de Gouden Leeuw te Haarlem in publieke Veiling te Verkoopen ten overstaan van den Notaris JE. WALAARDT SACRÉ: Een zeer aanzienlijk groot schoon hecht sterk en weldoortimmerd dubbeld HUIS en ERVE staande en gelegen aan de Oostzijde van de Kruisstraat nabij de Smedestraat te Haarlem  met eenen fraaijen Tuin en ruim Koetshuis en Stalling voor acht Paarden ingaande in de Lange Wijugaardstraat. Zijnde het Huis voorzien van eene roijale Vestibule en Gang met Marmer bevloerd  gelambriseerd en rijk Gcstucadoord. Vier groote modern behangen gelambriseerde en geplafoniieerde Benedenkamers met Schoorsteenen en Kasten; zeven Bovenkamers; en voorts Bad- Strijk- Mangel- en Dienstbodenkamcrs Keuken Kelder Kleêren Turfzolder en verdere Commodiiiteiten. Geteekend Wijk 6 N°. 169 en bij het Kadaster bekend als Huis en Erve in Sectie C onder N°. 637 ter grootte van 22 Roeden 70 Ellen en als Koetshuis en Stalling in Sectie C. onder N°. 2117 ter grootte van 2 Roeden 96 Ellen eu alzoo te zamen groot 25 Roeden 66 Ellen. Dit Perceel zal jmbliek te zien zijn op den Verkoopdag en bovendien op vertoon van een Toegangsbewijs bij bovengemelde Makelaars verkrijgbaar bezigtigd kunnen worden op Dingsdag en Donderdag van 2 tot 4 ure. Breeder bij Billetten omschreven en nadere informatie bij bovengemelde Makelaars. De bewijzen van Eigendom en Veilconditien zullen drie dagen vóór en op den Verkoopdag ter visie liggen ten Kantore van den Notaris voornoemd. V Rij MARTINUS ""nÏJHOF te 's Gravenhage ziehet licht: Het * EDERLAIVDSCIIE RIJKS-ARCHIEF. Verzameling van onuitgegeven oorkonden en bescheiden voor de geschiedenis des Vaderlands uitgeg. door Dr.-R. C. BAKHUIZEN van den BRINK Mr. L. Ph. C. van den BERGII en Jhr. Mr. J. K. J. de JONGE. 2e Aflevering Roij. Bvo.8vo. ƒ 190. Inhoud der le en 2e Afl.-. Eerste Vergadering der Staten van Holland in 1572. — Memoires du Baron de Kinckel. 1787 — Uiterste wil van den Graaf van Hoorn. 1568- — Hecmundensia. (H. S. betreff. den Abdij van Egmond.) M. L. van DEVENTER her jaar 1566. Eener historische proeve uit den Nederlandschcn vrijheidsoorlog. Met een voorwoord van Dr. R. C. BAKHUIZEN van den BRINK Roij. B™. f 150. JT. G. HOLTROP Catalogus librorum saeculo XV. impiessorum quotquot in Bibliotheca Regia Haganaasser______ Gr. B™. (628 bl.) ƒ 4—. Bij do ERVEN F. BOHN te Haarlem -___ ziet het licht: CHRONOLOGISCHE TABELLEN der ALGEMEENE GESCHIEDENIS naar die van Dr. W. P. VOLGER voor Nederlanders bewerkt door Professor J. VAN VLOTEN Eerste Afdeeling. Oude- Geschiedenis ƒ130.",http://resolver.kb.nl/resolve?urn=ddd:010544891:mpeg21:a0018:ocr,4,ddd:010544891:mpeg21:p004,Opregte Haarlemsche Courant,958
2518710,1856/11/29 00:00:00,1423,ddd:010777205:mpeg21:a0019,http://imageviewer.kb.nl/ImagingService/imagingService?id=ddd:010777205:mpeg21:p004:image&x=980&y=90&w=1770&h=1423,ddd:010777205:mpeg21,2750,1513,980,90,6,"Rhij n-Spoor weg-Maatschappi •*. DE DIRECTIE MAAKT BEKBND DAT TE BEGINNEN MET DEN lsten DECEMb' AANSTAANDE EEftl GOEDEREN TREIN Van ANBTËRDAII naar EMMERIK en terug en van ROTTERDAM naar UTRECHT en terug IN WERKING ZAL WORDEN GEBRAGT. | Oeze <Ooederen-Treinen loopen als volgt: Vertrek van AMSTERDAM ten 1 ure 30 min. 's namiddags. t ROTTERDAM • I_S « .»© » t UTRECHT :«:$«» t ARNHEM "" O ' 's avonds. Aankomst te EMMERIK » H • ÏO "" Vertrek van EMMERIK ten 8 ure 3© min. 'smorgens.  ARNHEM 1£ 30 's namiddags. » UTRECHT » 3 * 30 Aankomst te AMSTERDAM • 1 » 15 ' . ROTTERDAM » ö "" 's avonds. Op alle Statious zal tot het Opnemen van PASSAGIERS voor de 3de Klasse worden opgehoud* zijnde voor het overige deze Goederen-Treinen tot het Iervoer van KoopilianSgOl1 en Vee bestemd. De Directie der Nederl. Rhijn-Spoorweg Maatschappij. Amsterdam 24 November 1856. C- W- HESEEDE!% President. .1 t S'JACOB Secretaris.",http://resolver.kb.nl/resolve?urn=ddd:010777205:mpeg21:a0019:ocr,4,ddd:010777205:mpeg21:p004,Utrechtsche provinciale en stads-courant : algemeen advertentieblad,1770
1741901,1856/08/21 00:00:00,1871,ddd:010251530:mpeg21:a0014,http://imageviewer.kb.nl/ImagingService/imagingService?id=ddd:010251530:mpeg21:p004:image&x=1941&y=2021&w=931&h=1871,ddd:010251530:mpeg21,2872,3892,1941,2021,4,Bij den Uitgever dezer Courant is van de pers gekomen .: €10 1® W Uk &__ <___ £___ _§ £P ___ _g___m El^E SCHETS UU DE DERDE Ehl IV DOOR J9HI HE&iRY NEWMAN D£\ Rector aan de Katholieke Universiteit le Dublin ü.t het Engelsch vertaald met vergunning van den schrijver door N. L. SCUEFFEIIS. DERDE AFLEVERING. Blad 7 8 9. Dit werk in 8° formaat op zeer fraai papier gedrukt met eene nieuwe letter zal kompleet niet meer kosten dan de engelsche uitgave dat k f 2.10 en versierd worden met dc origineele plaat voor den titel. De afleveringen volgen elkander om de 8 dagen zoodat het spoedig geheel compleet zal zijn. Pius IX en Lord Palinerslon DOOR den Graaf Cv. »E MOA'TALESIBERT. Prijs 25 Cts. GEZEGEND GEBRUIK. VAN HET GEWIJD BROOD ONDER AANROEPING VAN DEN R. jyicofcAAS VAN ToLENTÏN Religieus van de orde van den H. AUGUSTINUS Prijs 5 Cts. de goovrüchtïgFdienstmaagd. OF Dagelijksche Oefeningen in al hare werken benevens gewigtige waarschuwingen aangaande de plfeten van knechten en dienstmaagden. Zeer dienstig Voor alle Christenen. Prijs 10 Cents.,http://resolver.kb.nl/resolve?urn=ddd:010251530:mpeg21:a0014:ocr,4,ddd:010251530:mpeg21:p004,De Tĳd : godsdienstig-staatkundig dagblad,931
73080,1856/09/06 00:00:00,84,ddd:010777133:mpeg21:a0019,http://imageviewer.kb.nl/ImagingService/imagingService?id=ddd:010777133:mpeg21:p004:image&x=56&y=2992&w=870&h=84,ddd:010777133:mpeg21,926,3076,56,2992,6,"j__ JBA9 *W JE _Bafc*-_P JH_j?__""'ri_U JLJE T__T",http://resolver.kb.nl/resolve?urn=ddd:010777133:mpeg21:a0019:ocr,4,ddd:010777133:mpeg21:p004,Utrechtsche provinciale en stads-courant : algemeen advertentieblad,870
5291318,1856/07/09 00:00:00,4740,ddd:010544834:mpeg21:a0014,http://imageviewer.kb.nl/ImagingService/imagingService?id=ddd:010544834:mpeg21:p002:image&x=66&y=73&w=2929&h=4740,ddd:010544834:mpeg21,2995,4813,66,73,4,"Door den algemeenen kerkeraad der Ned. Herv. gemeente te Middelburg is uit het bevorens vermelde drietal van predikanten beroepen d». F. P. J. SIBMACIIER ZIJNEN theol.en litt. doet. te Delden. *>«* INSTITUUT van wijlen zijn Exc. den Luit. Admiraal run Kinshergen. Elburg 2 Julij 185G. Na dat op de beide voorgaande dagen het jaarlijkseh openbaar Examen der leerlingen van den heer J. van BRAAMBEEK was gehouden  waarbij curatoren bij vernieuwing reden vonden om zich te verblijden in deu zeer gunstigen staat van het onderwijs aan deze inrigting en in de gemaakte vorderingen der leerlingen in onderscheidene vakken had heden de plegtige prijs-uitdeeling plaats. Voor gemaakte vorderingen in de oude talen werden met prijzen begiftigd in de 1»>« klasse P. Dectman en J.N. tan Hall in de2<i« klasse J. J. Benteyn  in de 3de klasse L. Augustijn en A. 2. van der Hoop in de 411e klasse H. Gerlings en J. D. Scheerenberg. Onder de leerlingen  die zich aan deze inrigting voorbereiden voor land- en zeemagt handel enz. mogt diezelfde eer te beurt vallen in de l»te klasse l»te afd. aan C. E. den Tex W. A. T. Koek F. M. van Eek J. .1. Rijshouder en M. Lucardi In de 1ste kl. 2<ie afd. aan . F. T. de Vaynes van Brakell H. Broers E. Haitsema Muiier P. Lijcklama a Nijeholt W. Verdam  W. Uittenboogaart en __ J. D. van der Feltz; In de 2&* kl. l»te afd. aan H. _ . van der IVolde A. de Jong  J. Jl. Krudop en C. L. de Nijs. In de 2d« kl. 2a« afd. aan H. v. il. Maaten Hzn. A. van Crans K. v. d. Maaten Ezn. en F. Uittenboogaart. In de3dekl. l»ts afd. aan J. van Heerde. In de 3Je kl. 2de afd. aan F. Luderus en A. Hoe/hamer. In de 4Je kl. I"""" afd. aan W. Hardij. Vijf verdienstelijke leerlingen P. Deetman J. N.van Hall J.J. Benteyn C. E. den Tex en F. M. van Eek spraken door hen zelve opgestelde redevoeringen over onderscheidene onderwerpen uit terwijl andere bekroonden in verschillende talen op bevallige wijze hunnen dank betuigden voor de eer die hun te beurt was gevallen. De plegtigheid nu en dan afgewisseld door muzijk en zang werd geopend door eene rede van den reetor A. KISSELIUS en gesloten door een toespraak van den directeur J. van BRAAMBEEK  die beide hunne regtmatige hulde bragten aan de nagedachtenis van den edelen Stichter dezer Inrigting en met voldoening mogten terugwijzen op eeu tijdvak van eene halve eeuw gedurende welke deze school niet alleen bleef bestaan maar ook bijna onafgebroken zich in uitnemenden bloei mogt verblijden en een aantal nuttige leden aan onderscheidene standen der maatschappij mogt schenken. De erkende bekwaamheid en ijver van den directeur rector en overige onderwijzers de uitmuntende localiteit en de gunstige resultaten  die deze school bij voortduring oplevert doen dan ook curatoren het nieuwe tijdperk intreden met vol vertrouwen  dat deze school duurzaam haren verdienden roem zal handhaven en aan het doel des Stichters blijven beantwoorden. Tot teekeumeester van het Instituut is benoemd de heer J. Dona Jr. van 's Gravenhage. De nieuwe cursus der beide inrigtingen van onderwijs zoo wel van die voor jongens als van die voor meisjes wordt geopend op Maandag 18 Augustus 1856. 'S»» KBN_Ili(IETI_C!. Burgemeester en Wethouders van HAARLEM achten het noodig ter kennis te brengen van de ingezetenen en wie het verder aangaat dat er geene gelegenheid bestaat om van het Plantsoen in den Hout en op de Bolwerken Sparren of andere Takken aftestaan voor het versieren der woningen ter gelegenheid van het Costersfeest; dat mitsdien aan den Houtvester in last is gegeven om alle aanzoeken daartoe strekkende van de hand te wijzen ; en dat tegen het ongeoorloofd afsnijden en weghalen van het groen uit den Hout of van de Bolwerken stiptelijk zal worden toegezien onder toepassing der straffen daartegen bij de Wet bedreigd. Haarlem 8 Julij 1856. Burgemeester en Wethouders voornoemd He BRUYN KOPS Voorzitter. C. MOL Loco Secretaris. VIJF EN TWlNTIGJARÜiFTÈÈSTVIERING ~ te AMSTEROAM  ter herinnering aan den Volksgeest van 1830 en 34. De ondergeteekenden hebben de eer namens het Hoofdbestuur der Vereeniging het Metalen Kruis te verwittigen dat de Feestdagen bepaald zijn op 26 27 en 28 Augustus e. k. De Afdeeling Amsterdam 1"" Sectie zal op Maandag 25 Augustus gelegenheid geven aan de dan reeds aanwezige Feestelingen tot behoorlijke opening van het Feest. Verder zij berigt dat buiten en behalve de afdeelingen der Vereeniging ieder die geregtigd is het Metalen Kruis te dragen zich van heden af aan (Brieven franco) tot 20 Julij kan doen inschrijven met duidelijke opgave van Naam en Woonplaats bij den President der Afd. Amsterdam 1« Sectie F. C. ZILLESEN op de Prinsengracht over de Stads-Timmertuinen of bij den Thesaurier dier Afdeeling BRANDON MONDOLPHO op den Binnen-Amstel te Amsterdam. De Feestcontributie te storten bij latere ontvangst van 't bewijs van deelneming is bepaald op/ 10 (zegge tien Gulden) waaronder begrepen is een generaal feestmaal des middags na de onthulling van het gedenkteeken aan den Volksgeest van 1830 en 31 terwijl de Feestelingen tevens toegang zullen hebben voor zoo verre de plaatsruimte het toelaat a ƒ 1 (zegge een Gulden) op de vier eerste rangen in den Stads-Schouwburg te Amsterdam bij eene besloten gaia voorstelling op 25 Augustus door de Afdeeling Amsterdam le Sectie te geven aan een gelijk getal hater Stadgenooten uit hare voormalige Kameraden uit alle wapenen thans behoorende tot de arbeidende klasse. De Feestelingen betalen half entre bij eene openbare luisterrijke Soiree in het Park op 26 Augustus; eene Dame onder hun geleide geniet datzelfde voorregt. De aftegeven kaarten a / 1 in den Schouwburg op 25 Augustus  en voort 't half entre in het Park op 26 Augustus zullen in blanco aan toonder zijn en kunnen dus aan derden worden uitgereikt mits behoorende tot dezulken die geregtigd ziju het Metalen Kruis te dragen. De plegtige onthulling vau het Gedenkteeken op den Dam zal plaats hebben op Woensdag 27 Augustus in tegenwoordigheid vau Z. M. den Koning. Heeren Officieren en Oud-Officieren van alle Wapens mits in 't bezit van het Metalen Kruis worden hartelijk uitgenoodigd op bovenstaande conditien zich wel te willen aansluiten aan hunne Kameraden thans niet meer tot het Leger behoorende zullende de Afdeeling Amsterdam y Sectie zorg dragen voor eene waardige ontvangst en in tijds een voegzaam Locaal aanwijzen als algemeen vereenigingspunt tijdens de Feestdagen. ue Vereeniging het Metalen Kruis verheugt zich in ue sympathie en de krachtige medewerking van het Be; U„Uri-:eir oofdstad> tot opluistering voor alle Standen van dit Vaderlandsche Feest. UiJ genoegzame voortdurende deelneming zullen de Feesten op den avond van 28 Augustus besloten worden met De ""v geW°°n luisterrÜk Bal e» Vauxhall in het Park. _4„ t? °sten vau dit Bal zijn echter niet begrepen onder de Feest-contributie. ma kt ■est'^ro3ramna zal eerstdaags bekend worden gei in de Arnsterdamsche en Haarlemsche Couranten opgave tevens van wat verder ter kennisse moet woruen gebragt der belangstellenden die van nu af hunne aandacht geheven te vestigen op de beide Dagbladen voormeld  voor alles wat betrekking zal hebben op de festivieiten. Ue Feest-Commissie der Vereeniging Amsterdam het Metalen Kruis 1 Julij 1856. E. W. van DAM van ISSELT. J. IL BURLAGE.",http://resolver.kb.nl/resolve?urn=ddd:010544834:mpeg21:a0014:ocr,2,ddd:010544834:mpeg21:p002,Opregte Haarlemsche Courant,2929
1881750,1856/05/13 00:00:00,1950,ddd:010544786:mpeg21:a0020,http://imageviewer.kb.nl/ImagingService/imagingService?id=ddd:010544786:mpeg21:p004:image&x=1036&y=97&w=965&h=1950,ddd:010544786:mpeg21,2001,2047,1036,97,6,Het aanzienlijk LANDGOED M AST LAND bestaande in Heerenhuis voorzien van Vestibule 10 Beneden- en 10Bovenkamers Kelders Keuken Koetshuis Paardenstal Waschhuis Mangelkamer Bergplaats en Oranjerie Moes- en Engelsch aangelegde Tuinen met Vischvijvers Bosschen en Hakhout. 5 BOERENWONINGEN of HOFSTEDEN met BOUW- WEI- en HOOILANDEN gelegen onder de Beek Gemeente Princenhagc te zamen groot 106 Bunders 48 Roeden 60 Ellen. Welke Goederen zullen geveild worden in 39 Koopen breeder bij Aanplak-Billetten waaraan een Kadastraal Plan is gevoegd in het bijzonder omschreven eu vermeld en om nader in zoodanige massa's of combinatien te worden Verkocht als het den Eigenaren zullen goedvinden. Nadere onderrigting te bekomen ten Kantore van gemelde Notarissen te Teteringen en Princenhagc terwijl dagelijks aanwijzing der Goederen en Koopen  ter plaatse zelf zal gedaan worden door den op Mastland wonenden Tuinman A. van DIJK. * * N. J. van BEMMEL J. H. BRINKMAN J. van der VLUGT T. A. LIWIJN N. WAALEWIJN W. M. van BEMMEL en JAN BROESE Makelaars presenteren als lasthebbeuden van hunnen Principaal in openbare veiling te Verkoopen op Zaturdag den 14den Junij 1856  in het Logement de Gouden Leeuw te Haarlem  ten overstaan van den te Velsen residerenden Notaris C. SCHREUDER: Het alom bekende binnen weinige jaren nieuw verbouwde LOGEMENT en STALHOUDERIJ genaamd VE OUDE ROOMOLEN OF DE ROSKAM te Haarlem waarin die Affaire sedert onheugelijke jaren is en nog met goed succes wordt uitgeoefend met kapitale Koetshuizen en Stallingen voor 30 Paarden en 7 stuks Hoornvee en verdere Aanhoorigheden allergunstigst gelegen in de onmiddelijkc nabijheid van het Station der Spoorweg op den hoek van den Kruisweg en.Varkenmarkt ter grootte van 14 Roeden 70 Ellen. Alsmede eene partij WEI- of HOOILAND groot 4 8. 03 R. 90 E. gelegen buiten de Nieuwe- of Kennemerpoort te Haarlem in den Schooterveen - Polder strekkende van den Singel tot aan den Delft belend ten Noorden C. Hildebrand en ten Zuiden J. G.Feye Kadastraal bekend onder de Gemeente Haarlem Sectie A N°. 101 102 en 103. . Breeder bij Biljetten te omschrijven en informatien by gemelde Makelaars ; zullende de Bewijzen van Eigendom en Veilconditien in tyds ter lezing liggen ten Kantore van deu Notaris voornoemd en Copij derzelve ten Kantore van den Makelaar N. J. van BEMMEL te Haarlem.,http://resolver.kb.nl/resolve?urn=ddd:010544786:mpeg21:a0020:ocr,4,ddd:010544786:mpeg21:p004,Opregte Haarlemsche Courant,965
3128731,1856/05/25 00:00:00,3696,ddd:010113059:mpeg21:a0028,http://imageviewer.kb.nl/ImagingService/imagingService?id=ddd:010113059:mpeg21:p004:image&x=78&y=932&w=1564&h=3696,ddd:010113059:mpeg21,1642,4628,78,932,4,DE STOOMBOOT de Stad Vlissingen /V° ii Vertrekt. Van VLISSINCJEN  des MAANDAGS  WOENr.T~-.vGS en VRIJDAGS 'smorg ten 8 ure na aankon sr. v_n de Stoomboot van Breslecns. Van ROTTERDAM des DING3ÜAGS  DONDERDAGS en ZATURDAGS 'smorgens ten 11% ure na aankomst der Hollandsche en Rhijn-Spoortreinen. (1786) STOOMBOOT STAD ZIERIKZEE. Van ZtER-KZKBi Van ROTTERDAM. Woebsd ___lei's mórg 7{ujDi_gdd.ï. Mei.maff-g lOju Vrijdag 30 ¦ « il) ¦¦ I'ond. 29 «'s midd. 12_- Zondag Uunij » 9 „ Zaiurd.3l »'s morg 4 - Maand. 2 »'smidd.l2-•'Maand 2 Junij • 4 - AnDlegplaats te Doreirerht. Groote Hoofd. (1791) Publieke Veiling. Op MORGEN den 26» ten ..-. 1856 des voormiddags len half elf ure in het Logement d* Zn aan den Sleb'er te Rotterdam . van Ca. 236 Vaten _. nperiliie ttEJVE _ EE 500 i' dito PALMS-TTO 264 ¦¦' extra «__¦__ KBKE TARWEBLOEM direct van Noord-Amerika hier aangevoerd Nadere Onderrigting te bekomen ten Kantore • nn Jac. DORREPAAL & Co en SCHADEE 4 Co (4745) Publieke Verkoopiii«. MORGEN 26 Mei 1856 des voormiddags ten hal/ e f ure. in het Logement de Zon aan den Steiger  te Rotterdam  van : (4694) Omtrent 103 Lasten RüGGE meerder en minder door Zeewater beschadigd Ban gebragt van New-York met het Schip Dumfrüt Kapt. A. Thompson. Liggende in Ligters. Nadere onderrigting ten Kantore vat. de Heeten JA(b. DORREPAAL & Co. en Wm. & ALB. SMALT & Co. ___________________________________________ De Notarissen JAN VAN DER ÉHOOP JACZn. en GERRIT WENK Junior residerende te Rotterdam als Inst hebbende van hunnen Principaal zijn voornemens om op Vrijdag den lSden Junij 1856 des namiddags len 5 ure. in de Herberg de Vernulde Zwaan te Delftharm in het openbaar te Veilen en te Verkoopen: Een Hechten. Sterken en zeer gunstig gesituterdsn WI.-D KORENMOLEN ook ingerigt tor PELMOLEN  genaamd Maasziqt. met daarbij behoorende WOTVIVttEA en ERVEN voorts een uitgestrekt TERRKIN  rondom in achter den Molen gelegen alles sraande en gelegen aan den Hoogen Schielandschen Zeedijk onder Schoonderlco Gemeente D'ljsh.xven strekkende met een gemeen Uitpad en een Perceel waarover het te Veilene het regt van weg bezit vóór van den Dijk tot achter in de Rivier de Maas; zijnde onder het te Veilene mede begrepen de AANSLIJKING of AANWAS welke aan de zijde der Rivier reeds aanwezig is of later mogt ontstaan zoodat dit Perceel wegens de groote Ui'gestrck-heid die het nu reeds heeft of welke daaraan later d.or .. nndamming mogt worden gegeven  bijzonder Geschikt is tot het dnarstellen van FABRIJK- of andere GEBOUWEN Met al de tot den Molen behoorende vaste en losse WERKTUIGEN en GEREEDSCHAPPEN. Het te veilene is bij her kadaster bekend sectie B Ns 940 941 942 en 943 ter grootte van 19 Roeden 20 Ellen en in de grondbelasting over 1856 aangeslagen tot f 11145. Zijnde dadelijk te aanvaarden. Inmiddels zijn nadere onderrigtingen te bekomen ter Kantoren van de gezegde Notarissen en znl het te veiletre twee dagen vóór en op den dag der veiling kimnen worden bezigtigd mits voorrien zijnde van een Permissie Jaljet daartoe door een der genoemde Notarissen nf te geven. (4804) De TUINEN met HI.IKV-t.ttEN en ERVE* «nn den Blommersdijhschen Rijweg en in de Sehotelhosch-  te Rotterdtm op oéen '-listen Mei laatstleden door den Noiaris VAN DER HOOP gefeild zullen op Woensdag den 28sten Hei aanstnande des na .ïiddags ten 4 ure in hot Noarishuiß nldaar worden afgeslagen. (4/97) Het HUIS met KANTOOR en ERVE aan de Geldersche Kade te Rotterdam tusschen de Wijnhaven en de Wijnstraat wijk 2 No. 194 hetwelk op den 2lsten dezer door de Notarissen VAN DER HOK VEN en LORIE m h-t Notarishuis te dezer S'ede is geveild zal aldaar op Womsdnq da 28-tcn Mei 1856 des namiddags ten 4'ure -fordin Hfge.lagen. (-790) Publieke Verkooping op Dingsd'ig den 27sten Mei 1856 des voormiddags ten 11 ure in 's Rijks Entrepot san de.Scheepmakersbaven  wijk 1  No. 518 te Rotterdam ten o erstoan vnn D. tl. CORNE. van: 18« Vaatjes IJzeren Draad-Nagels zijndo min of meer beschndigd Kunnende daags te voren aldaar worden bezigtigd; terwijl nadere Informatien en Monslers te bekomen zijn ten Kantore van ./. J. DX HAAS & Co. aan de Wijnhaven alhier. (4638),http://resolver.kb.nl/resolve?urn=ddd:010113059:mpeg21:a0028:ocr,4,ddd:010113059:mpeg21:p004,"Nieuwe Rotterdamsche courant : staats-, handels-, nieuws- en advertentieblad",1564
1146152,1856/10/23 00:00:00,1477,ddd:010113208:mpeg21:a0008,http://imageviewer.kb.nl/ImagingService/imagingService?id=ddd:010113208:mpeg21:p004:image&x=2461&y=259&w=776&h=1477,ddd:010113208:mpeg21,3237,1736,2461,259,5,UITVERKOOP WEGENS LIKWIBAfIE. De Ondergeteekende besloten hebbende zijn MAC&AZIJN van TAPIJTEN en MEITBELSTOFFEN op te heffen is voornemens ter bespoediging der Likwidatie de nog voorhanden GOEBERÊN  bestaande in alle soorten van TAPIJTEN VLOERKLEEDEN LOOPERS  KARPETTEN HAARD- en SOPHA-KLEEDJES  Fransch  Engelsch en Duitsch DAMAST voor Over-CrOrdltjnen tot zeer VERMINDERDE PRIJZEN UIT TE VERHOOPEIV. J. H. SMAALE Ju  (8297) Hoogstraat No. 111. Spéoialité de (2177) cmnsEs sur bsuri ¦ cheas Chs. COUCKE Hoogstraat gg. J&. far Ha W. Ti Een Actief PERSOON die vele Relatien in de Provincie Gelderland heeft wenscht ir et soliede Mandelaren Fahriekantcüa Blsii-3ateu»'S etc in onderhandeling te treden om er hunne be'angen te behartigen. Adres onder lett. 8. bij J. TH. DE BROUWER Boek- en Papierhandelaar Hoofdsteeg No. 125. Brieren franco. _^ (9395) Eene JiFYEÖUW van goede Familie welke verscheidene jaren in een Bfanufactuur-Winkel werkzaam is geweest en thans nog werkzaam is zag zich gaarne tegen December of eerder «3EPJL/&.A.TIST. Adres met franco Brieven onder het Nommer dezer Advertentie aan het Bureau dezer Courant. (9400) I,http://resolver.kb.nl/resolve?urn=ddd:010113208:mpeg21:a0008:ocr,4,ddd:010113208:mpeg21:p004,"Nieuwe Rotterdamsche courant : staats-, handels-, nieuws- en advertentieblad",776
1318520,1856/02/13 00:00:00,1385,ddd:010112960:mpeg21:a0009,http://imageviewer.kb.nl/ImagingService/imagingService?id=ddd:010112960:mpeg21:p002:image&x=2180&y=2510&w=952&h=1385,ddd:010112960:mpeg21,3132,3895,2180,2510,4,228ste STAATS-LOTERIJ. Trekking van 12 Februarij. — sde Klasse  9ste Lijst. «JKTSOMKÉV JWOSXMEaiI (naar de officiële Kjtl ) Prijs van / 25000 : No. 6098. • * 2500: No. 9037. fi ii 1000: No. 62 19490. - - 400: No. 4561 18784. * n » 200: No. 2390 57136385 14809. ii ¦• 100: No. 35 797 1368 3378 4045 9727 11101 12024 12637. 15233 17015 17229 17566 17718 17763 18068. Prijzen van f 70: 105 1588 3824 6272 8782 10011 12127 14022 16498 17933 265 1817 3870 6364 8785 10024 12272 14036 16500 17996 320 1910 3874 6436 8891 10026 12279 14287 16658 18005 409 1983 4059 6460 8899 10225 12416 14366 16669 18020 428 1996 4077 7143 8932 10261 12437 14451 17002 18034 511 2212 4185 7165 9013 10338 12459 11622 17088 18045 567 2289 4220 7441 9048 10374 12528 1475.2 17111 18156 572 2322 4350 7517 9053 10387 12551 14761 17119 18368 715 2363 4382 7571 9096 10398 12703 14795 17150 18503 718 2398 4643 7677 9127 10512 12715 14903 17190 18673 727 2436 4749 7746 9212 10553 12821 11929 17198 18935 867 2499 4875 7812 9367 10667 12877 15001 17251 18971 980 2570 4890 7968 9561 10823 13062 15021 17235 19044 1000 2599 4904 8135 9613 11186 13342 15337 17336 19067 101tf'2823 5129 8143 9646 11205 13422 15i25 17363 19175 105Ï 2899 5175 8167 9719 11400 13505 15534 17480 19204 1104 2949 5287 8223 9724 11479 13598 15632 17536 19280 1141 2978 5357 8241 9769 11527 13634 15/27 17605 19314 1147 2987 5444 832 S 9782 11580 13635 15816 17607 19383 1171 3016 5476 8399 9825 11605 13718 15973 17672 19500 1215 3112 5597 8437 9895 11620 13731 16105 17714 19722 1301 3189 5633 8499 9908 11764 13841 16297 17758 19759 1495 3253 5680 8623 9919 11899 13899 16326 17767 19829 1514 3276 6130 8701 9960 12077 13942 16370 17803 19936 1526 3420 6167 8768 10002 12085 14009 16385 17828 19958 1546 3521 6249,http://resolver.kb.nl/resolve?urn=ddd:010112960:mpeg21:a0009:ocr,2,ddd:010112960:mpeg21:p002,"Nieuwe Rotterdamsche courant : staats-, handels-, nieuws- en advertentieblad",952
1999422,1856/06/17 00:00:00,2034,ddd:010980441:mpeg21:a0049,http://imageviewer.kb.nl/ImagingService/imagingService?id=ddd:010980441:mpeg21:p004:image&x=1075&y=94&w=983&h=2034,ddd:010980441:mpeg21,2058,2128,1075,94,4,"CIROUE EOUESTRE ED. WOLLSCHLAGER geplaatst op de FJLABBmEXMABKT te BELFT. Aanvang der VOORSTELLINGEN op DINGSDAG 17 dezer des avonds ten Si ure en voorts DAGELIJKS tot Maandag 23 Junij 1856: BUITENGEWONE VOORSTELLINGEN waarin al de voornaamste Artisten zullen wedijveren. In deze Representatien zullen de schoonste Paarden worden voorgesteld  en zal de Heer Jfean Mare Cardlgnae wiens gelijken in de Gymnastiek niet te vinden is zijne vetbazende Toeren uitvoeren; alles besloten door de prachtvolle opvoering der Melodrama's en Eqnestrlschc Pantomimes volgens de dagelijksche Programma's. *#* Aan de bekende en onbekende Schuldeischers in de onder het voorregt van Boedelbeschrijving aanvaarde Nalatenschap van wijlen JOHANNIS TAN KEMPEN gewoond hebbende te Ooltgensplaat en overleden den 23 Februarij 1856"" wordt bij deze ter kennis gebragt dat den 4 Julij 1856 ten Kantore van den Notaris A. VAN WEEL Dz. te Ooltgensplaat visie kan worden genomen der Rekening: en Verantwoording derzelve Nalatenschap; zullende indien er geen verzet plaats heeft ten volgenden dage des voormiddags ten tien ure ten Kantore van genoemden Notaris VAN WEEL worden overgegaan tot Uitbetaling der Vorderingen voor zoo verre het saldo der Nalatenschap zal kunnen strekken. ** Het HUIS en ERVE in di~WaFersteeg-te Rotterdam wijk 8 n.° 202 — en het HUIS TUIN SCHUUR en ERVE genaamd BusthoeH te Hillegersberg geteekend n.° 9 op Woensdag den ir Junij 1856 door den Notaris WENK in het Locaal voor Publieke Verkoopingen aan de Gelderschekade te Rotterdam geveild zullen op MORGEN den 18 Junij 1856 des namiddags ten 4 ure door voornoemden Notaris ter zelfder plaatse worden Afgeslagen en Verkocht. Het HUIS ingerigt tot Broodbakker!! met fiUILZOLDER GRAANZOLDERTJE. OPEN PLAATS BOYENWONINGEN en ERVE aan de Kipstraat  achter het Verbrande Klooster te Rotterdam wijk 11 n.0449 op den 11 Junij 1856 door den Notaris CAZAUX geveild en in trekgeld gegolden hebbende ƒ 1900 zal op MORGEN Woensdag den 18 dezer maand des namiddags ten 4 ure in het Huis der Notarissen aan de Gelderschekade  worden Afgeslagen.",http://resolver.kb.nl/resolve?urn=ddd:010980441:mpeg21:a0049:ocr,4,ddd:010980441:mpeg21:p004,Rotterdamsche courant,983
536340,1856/05/28 00:00:00,420,ddd:010788663:mpeg21:a0007,http://imageviewer.kb.nl/ImagingService/imagingService?id=ddd:010788663:mpeg21:p004:image&x=1440&y=3867&w=1277&h=420,ddd:010788663:mpeg21,2717,4287,1440,3867,10,"ADVERTE.NTI-.EN. MINISTERIE VAN OORLOG. *m* De gewone Audiëntie van den Minister van Oorlog zal op ft*n"" staanden Dingsdag den 27sten Mei mitsgaders op Dingsdag den 3d*ri Junij daaraanvolgende geen plaats hebben. 's Gravenhage den 21sten Mei 1856.",http://resolver.kb.nl/resolve?urn=ddd:010788663:mpeg21:a0007:ocr,4,ddd:010788663:mpeg21:p004,Nederlandsche staatscourant,1277
1893441,1856/02/21 00:00:00,1991,ddd:000011378:mpeg21:a0024,http://imageviewer.kb.nl/ImagingService/imagingService?id=ddd:000011378:mpeg21:p004:image&x=57&y=2756&w=951&h=1991,ddd:000011378:mpeg21,1008,4747,57,2756,4,"kiesYcreeniging: [.EDERLAM eu ORANJE. Zijn tol ?A\DIDATE_Y voor de Gemeenteraad gesteld : Jlir. ..Ir. ./. I. Hinijvndonvk Haron Bi. van ijytiden. De DIAKENEN der Ned.-llervornidc Gemeente te 's Gravenhage berigten niet dankzegging aan den edelmoedigen gever dat bij hen ten behoeve hunner armen is ontvangen de som van ƒ175 in geld. De gever verlangt dat hier zal worden bekend gemaakt ""dat deze som is een gedeelte van de op» brengst van een uitgeloot aandeel in de Negotiatie u voor Armenwoningen en wel het meerder bedrag dat « deze uitloting hem heeft opgeleverd dan de som ti waarvoor het bedoelde aandeel hem bij erfenis was « toebedeeld willende hij met gelden uit deze Negotiatie «die nu door een armbestuur is overgenomen geen u winst doen. n Diakenen voornoemd Namens deze 11. J. VAV DEK IIKIM Adv. Diaken. S. C. J. vav AALST Groot-Boekhouder. Ontwerp van Wet op liet I_ager Onderwijs. Een adres van adhsesie tot ondersteuning van 't verzoekschrift der HH. Predikanten O. G. Reidring  e. s. gerigt aan de Tweede Hamer der Statest-Generaal zal gedurende acht dagen ter onderteekening liggen in 't Afschaffings-locaal lste Wagenstraat. Cl_> jfc Door *' ARARTOG ar. fjÊtfËÊbJÈ') Gedelegueerde van de 2de klasse dor /M_?S«FÏgA Staats-Loterij Achterom S n(. 328 jPT^e§^Jr§ te 's Gravenhage is gedebiteerd in de €jj^^~Jf& thans trekkende Vijfde Klasse een VIJFDE LOT van den HOOGS TE N Plt IJ S van 7100000 OP r. 13457 onder de handteekening van de Heeren __)ƒ. M. Polak en Zoon Noordeinde te 's Gravenhage. lUB. BovengenoemdeKOOPT in Goud en Zilver Epauletten en Geborduurde Htaatslekleederen en laat zich deswege ook aan huis ontbieden.",http://resolver.kb.nl/resolve?urn=ddd:000011378:mpeg21:a0024:ocr,4,ddd:000011378:mpeg21:p004,Dagblad van Zuidholland en 's Gravenhage,951
463842,1856/06/26 00:00:00,438,ddd:011060035:mpeg21:a0010,http://imageviewer.kb.nl/ImagingService/imagingService?id=ddd:011060035:mpeg21:p004:image&x=2171&y=4469&w=1059&h=438,ddd:011060035:mpeg21,3230,4907,2171,4469,4,PROTESTANTSCHE EEREDIENST. Zondag den 29aten Juny des morgens ten half 9 nr». Nrderduitsch. n. VAK nAVPTAATI Ds. VAN DAVELAAB. ; VOORBEREIDING. .  0 ' ' ' ROOMSCU-KATIIOLIEKE EEREDIENST. Zondag den 29sten Jong des morgens ten half 9 ure.,http://resolver.kb.nl/resolve?urn=ddd:011060035:mpeg21:a0010:ocr,4,ddd:011060035:mpeg21:p004,"De Oostpost : letterkundig, wetenschappelĳk en commercieel nieuws- en advertentieblad",1059
2673913,1856/04/18 00:00:00,1991,ddd:010584460:mpeg21:a0029,http://imageviewer.kb.nl/ImagingService/imagingService?id=ddd:010584460:mpeg21:p006:image&x=1550&y=59&w=1343&h=1991,ddd:010584460:mpeg21,2893,2050,1550,59,8,"~<_KI» - Ue Notaris E. T. KUIPER zal op Vrijda» _ Btt* ï 1 .'""i; des voordemiddags 10 uur ten huize van de VVed 4"" 2* kker Poï kleine Klaver onder Bolsward om contant gold pre^T. verkoopen: Koeijen van longziekte verdacht of genezen. 8 b<._ o 3 mlk:„eLiu Lammen ongeveer 2000 t Hooi 2 zijden gel^J Jj* pen ™et «""  K-irn 3 Molkenvaten 2 koperen en 6 houten Emmers Mf'k> f- SChar O 6 houteï Melka«h-n Brok- en Boteraad Mestkret Harkt^g! lingen 10 nouw Kapwagens 1 Fourgon en krompaneel Chais „». Kaasvaten enz. al-mcd pulpUum  saartstuk-Klok Spi^^ .. 'Ten^ 2SoLder «en Porce.e.n- Koper- Tin IJzer- AardïA S J p'en Bod met toebehooren en hetgeen meer zal worden ten voorschijn WNB e voo melde Koeijen zullen niet mogen worden gekocht dln^f NB' Zt of buiten het Rijk vervoerd te worden of door Veehouders^ BOELGOED VAN MBHEBDW EN BESLAG "" te j_ jrjr ar jb Jt t»» _t. Vle Notaris A. WITHOLT te Sexbierum zal op Woensdag den 23 Ab_ II 1856 's morgens 8 uur ten huize van de Erven Jelte Melles Kuip™ nabii den Groenen Dijk onder Minnertsga publiek bij boelgoed op zes niaand ' credit tegen voldoende borgstelling.verkoopen: En uitmuntend BOERE-KEEUW en BESLAG bestaande voornamelijk in. 3 vare- en 5 kalve Koeijen 3 kalve Rieren 3 Hoklingen  6 besta P^' waaronder 2 schoone zwarte Ruinen o en 6 jaar oud 7 Schapen met en zond- Lammen. .15 Hennen en ) Haan; voorts 1 Kapwagen l Chais 3 beslag Hooiwagens 3 dito Aardkarren 3 Ploegen 1 Vorenploeg 5 Eggen 1 Voren* 1 Sleep. 1 Landrol 1 Koolzaadbak  2 Barton 1 Dorschrol 1 Graant ' 1 Snijbank 1 Bindtladder Tijm en Touw 1 beate karnmolen met toebeboo»/ 1 Kam met koperen hoepen 2 koperen Aden 1 houten Dito. 2 koperen en i houten Emmers 5 Molkvaten Harken Vorken en ander Handgereedschap JaaeUinen Zijlen en ander Touwwerk 1 Slijpsteen. 1 Mest-Kruiwagen met P[a„ ken"" 1 Mesthoop p. m. 8000 Weitsluikschoven  1 partij gerookt Spek beneven. eeniU MEUBELEN en HUISGERADEN waaronder: 3 Kabinetten 1 Secre taire 2 Staartstuk-Klokken 3 Beddon met toebehooren Tafels Stoelen Spie. gels Schilderijen en wat meer geveild zal worden. VEE-BOELGOED TE POPPIN6AWIER op Maandag den 31 April 1H.»«. De Griffier T. GOSLIGA te Rauword en IL J. OOSTERHOFF Zaakwaarnemer aldaar zullen op authorisatie van HH. Gedeputeerde Staten op voormelden dag 's morgens ten 9 ure ten huize van de Weduwe Klaas D. Sijbrandij te Poppingawior bij boelgoed tegen gereede betaling verkoopen: 16 stuks zoo melke- kalve- als vare Koeijen 2 Hokkelingen 1 Bul 3 kope. ren Emmers en eindelijk een klip Hooi. enz. enz. De koopers zijn verdacht dat zij houders moeten zijn van een certificaat van den Burgemeester hunner Gemeente  dat op hunne Stallen de besmettelijke longziekte hoerscht.",http://resolver.kb.nl/resolve?urn=ddd:010584460:mpeg21:a0029:ocr,6,ddd:010584460:mpeg21:p006,Leeuwarder courant,1343
294525,1856/04/27 00:00:00,315,ddd:000011439:mpeg21:a0028,http://imageviewer.kb.nl/ImagingService/imagingService?id=ddd:000011439:mpeg21:p004:image&x=51&y=4002&w=935&h=315,ddd:000011439:mpeg21,986,4317,51,4002,4,.. nflßüL Men is van meening  ingevolge bekomene BB 3 magtigingvan de Arrondissements-Regtbank rn! te 's Gravenhage ten overstaan van den 1 ™ ' aldaar residerenden Notaris J. IV. VAN DEN BKRGH in het openbaar in het Venduhuls der Notarissen  in de Nobelstraat te sGravenhage op Maandag den 26 April 1856  des nvonds ten 7 ure  te verkoopen:,http://resolver.kb.nl/resolve?urn=ddd:000011439:mpeg21:a0028:ocr,4,ddd:000011439:mpeg21:p004,Dagblad van Zuidholland en 's Gravenhage,935
740567,1856/12/11 00:00:00,787,ddd:010251625:mpeg21:a0016,http://imageviewer.kb.nl/ImagingService/imagingService?id=ddd:010251625:mpeg21:p004:image&x=47&y=3221&w=941&h=787,ddd:010251625:mpeg21,988,4008,47,3221,4,DJJMS WIRKEN VOOR RE DAARBIJ GEVOEGDE PRIJZEN Sï_ FOLIO. Natalis Alexand. i Hi-tcria Ecclesiastica Veteris Novique Testainenti. 8 vol. in folio. Parisiis 1699. — Oud doch goed geconserveerd exemplaar in 7 geheel leeren banden f 22.50 -Cp.neMi _ Lilpide in Scripturam Sacram Comme.i-tarii. Editio in folio '^f Hiervan zijn nog eenige afzonderlijke goed geconserveerde en ingebonden deelen voorhanden welke voor zoo ver ze er nog zijn worden afgeleverd per volume ad ..... ƒ 5.00 Wolfgang* Reipuhlieae Romanae in externis provinciis bello acquisitis constilutae commentariorum libri __od_itn. Vol. in i'olio. Francofurli 1593. Ingebonden exemplaar ƒ 1.50,http://resolver.kb.nl/resolve?urn=ddd:010251625:mpeg21:a0016:ocr,4,ddd:010251625:mpeg21:p004,De Tĳd : godsdienstig-staatkundig dagblad,941
1897674,1856/05/19 00:00:00,1762,ddd:010083476:mpeg21:a0009,http://imageviewer.kb.nl/ImagingService/imagingService?id=ddd:010083476:mpeg21:p002:image&x=2284&y=959&w=1077&h=1762,ddd:010083476:mpeg21,3361,2721,2284,959,6,Warmoesstraat bij den Niezel 403 worden vervaardigd GRAVURES ETSEN CRAYON-TEEKENINGEN COPIJEN VAN SCHILDERIJEN enz. (8677) Kan dadelijk een bekwaam STEENDRUKKER geplaatst worden. liiffiïsraliiiiiN m cemebtT bij DESGUERROIS cf Co. Bloemmarkt. (8694) IN AMSTERDAM. Door Ziekelijke Omstandigheid wordt terstond of om later te aanvaarden TE KOOP gepresenteerd: Eene van ouds bekende TAPPERSen BILLARDHOUDERS-AFFAIRE welke een best Debiet oplevert benevens eene nette INVENTARIS; het HUIS voor eenen matigen Huurprijs waar afzonderlijk van Verhuurd wordt. Brieven Franco onder Lett. W. X. Bureau Handelsblad. (8696) r_Tü GEVRAAGD: /fjWPS een MUILEZEL GEEN MUILDIER. Reflecterenden sïjE»_ïis__. vervoegen zich met opgave van Hoogte en Prijs met franco «WbTf» brieven Lett. V. bij J. W. EVERSZ  Boekhandelaar te Zeijst. (8297) PENDULES. Zich geheel willende wijden aan het FABRICEREN van e» den Handel in CHRONOMETERS en HOROLOGIEN gaat de Ondergeteekende steeds voort met het Finaal UITVERKOOPÉN van zijne PENDULES tot Fabrieksprijs. Overigens blijft hij zijne Affaire als vroeger voortzetten en ruim voorzien van SCHEEPS-TIJDMETERS recommandeert hij zich aan HH. Scheepsrceders on Kapiteins als ook voor het Herstellen en Observeren derzelve. Voor het Observeren voornamelijk gebruik makeüde van een door hem uitgevonden Instrument (Meridiometcr) inviteert hij tevens alle HH. Liefhebbers uit tot bezigtiging van genoemd Instrument. VAN ARCKEN (7336) Fabriekant en Horologiemaker van Z. M. den Koning. BISCUITS ..WB-ïSS. OLIWIERV goedgekeurd door de Keizerlijke Akademie van Geneeskunde geauthoriseerd door het Fransche Gouvernement vier jaren onderzocht in de Hospitalen van Frankrijk. Tot SPOEDIGE en RADICALE GENEZING zonder Kwik of Salsaparillen van PRIMITIVE en CONSTITUTIONELE SYPHILITISCHE ZIEKTEN aandoening van den mond en van de keel rhumatische beenpijnen van het hoofd en de leden verder huiduitslag dauwworm  kliergezwellen scherpten in het bloed en in de vochten. Zelfs die aan andere geneeswijzen weerstand bieden. Zij zijn aangenaam van Smaak en worden gemakkelijk verdragen. De Doos/5 de Halve Doos/2.60. Hoofddepot bij H. H. ULOTH Apotheker Zeedijk hoek Kolkje te Amsterdam. (8138),http://resolver.kb.nl/resolve?urn=ddd:010083476:mpeg21:a0009:ocr,2,ddd:010083476:mpeg21:p002,Algemeen Handelsblad,1077
3812984,1856/01/18 00:00:00,3836,ddd:010771911:mpeg21:a0009,http://imageviewer.kb.nl/ImagingService/imagingService?id=ddd:010771911:mpeg21:p004:image&x=65&y=94&w=994&h=3836,ddd:010771911:mpeg21,1059,3930,65,94,4,WUBBENHORST bewoond. IV. Eene nette BEHUIZING get. C 135 s'aande aan dn Turlsingel te Groningen wordende door den Stotlmaker G. H. NOÓRDA in eigendom bewoond. V. Eene ruime nieuws dooriimmcrdc BEHUIZING get. Q 12 met TUIN er achter staande en gelegen Zuidz.de aan het Damsterdiep te Groningen. VI. Vier nieuws getimmerde WOONKAMERS get. Q 3 4 5 en 6 staande mede aldaar achter het vorige it-r--ceel. De perceelen 2 en 3 toebehoorende aan de Weduwe en Erven K. ERENSTEIN. VII. Eene nette BEHUIZING met OPEN PLAATS en mandeeligcn GANG get. O 78  staande en gelegen Zuidzijde in de Wipstraat te Grimingen doende- jaarlijks tot grondpacht ƒ 1—65  wordendo door de Weduwe H. J. GREBEN in eigendom bewoond. VUL Eene WOONKAMER get. I 215 staande op den Kraanpoortenwal te Groningen doende jaarlijks tot grondpacht ƒ o—3o. IX. Eene VROUWEN ZITPLAATS in do Martinike-rk te Groningen '-'et. no 11. X. Eene dito ZITPLAATS in dcz-li'de Kerk get. no. 12. *i\\ XI. Een wél febouwd en goed onderhouden JM\ VKKR-CHIP genoemd fittVMO .roen 'gffi&V 28 Tonnen net desztlis OPGOKi) n TOÈBEJÈmig& HOOIEN laatstel.jk bevaren door wijlen G. 11. BOTJE in hel Veer tusschen €ironingen en __- mjemtner liggende in het Hoendiep te Groningen. Om te aanvaarden de Perceelen I—X op den lsUn Mei 1856  en Perceel XI dadelijk na d.n Toeslag. Alles te b. zien daags vóór en op den Verkoopdag  des namiddags van 2—4 uur. Ben 2Ssten Januarij 1856 zal nog ten Huize v. n EEKHOFF  ten overstaan van den Notaris Mr. J. Jl. CRGJIEHI worden vt?rkoeht: v Eene 11111 l lIKIM.. staande Oostzijtle ÖITiK in d- Havenstra t get. 1.47 met OPEN PLAATS ffi___ waarop MANDEELIGE PUT en BLEEKVELD. VI. Eene lii:HU/.l\l.  in de Visscherstraat op ei.cn grond get. 144 met MANUEELIGEN PUT bewoond door L. BIEVRIE. *#* Na bekomen Regterlijk Verlof zullen eerstdaagsi ten overstaan vin den Nofnris Mr. J. Jl. CHEAIEItS  te Groningen iv het opi-nbaar worden verkocht: jffir-jjf. L Eene BEHUIZING get. N no. 213 staande Bjiiiffl m de N. Ebbingestraat. j|l_|f .IL Eene BEHUIZING bestaande uit 4 WONINGEN onder één Dak in de Jacobijnerstraat get. B 37 en 38. 111. Eene WONING get. G 228 aan de Reitemakersrijge. IV. Vier WONINGEN aan het Zuiderdiep get. G 254—257. V. Vijf KAMERS aan de Kruidgracht  onder één Dak  get. P 73—77. VI. Eene KAMER mede aldaar get. P 71. Alles staande te Groningen. *** Ten overstaan van Mr. J. S. «-. ItOYI _«„  Notaris te- Wedde zal op DINGSDAG tien 2-Sten Januarij 1856 des avonds te zes uur te Bellingwolde ten Huize van den Kastelein G. N. ADDENS ter verkoop worden geveild: liet volgend te Bellingwolde gelegen VAST »OE» toebehoorendevan S. R. DALLINGA te Bellingwolde en CONSORTEN; te weten: « I. Eene 1101 Itl \ 11111 l l t JBliVfti en *< 111 I II  met de VASTE BEKLEMMING van Erf 3-.. m>» i Boomgaard en Landerijen in HHI eene opatrekking gelegen DE BEREND OKKEBHEEBT genaamd te zamen groot 59 B. 87 R.  14 E. zullende deze beklemming voortaan jaarlijks op Midwinter tot vaste huur doen ƒ2oo—oo. 11. De EIGENDOM der Gronden onder I bedoeld. 111. Omstreeks een Bunder LAND op het Kleine Nieuwland. IV. De VASTE BEKLEMMING van 6 B.  19 R. 30 E. Land op de zoogenaamde Udengast zullende tot vaste huur doen iaarlijks op Midwinter ƒ 100 — 00. V. De EIGENDOM d<-r Gronden onder IV bedoeld. VI. De VASTE BEKLEMMING van 2 B.  72 R.  70 E. Land DE HENSEKAMP genaamd zullende jaarlijks op Midwinter tor vaste huur doen ƒ 40 — 00. VII. De EIGENDOM van het Land onder VI bedoeld. VIII. De VASTE BEKLEMMING van 2 B.  01 R. 40 E. Land iv de ZWIERS-HEERT zullende jaarlijks op Midwinter tot vaste huur doen ƒ 30 — 00. IX. De EIGENDOM van het Land onder VIII vermeld. X. De VASTE BEKLEMMING van 5 8. 52 R. 30 E. LAND dc zoogenaamde OSSEKAMPEN iaarlijks op Martini tot vaste huur doende ƒ 80—00. XI. De EIGENDOM van eene HUISPLAATS en TUIN groot 39 R. 60 E. bij E. J. ABBES als Meijer in gebruik doende jaarlijks op Mei tol vaste buur ƒ'ls—oo. XII. Eene BOEREN BEHUIZING en SCHUUR (thans door S. R. DALLINGA bewoond) met de VASTE BEKLEMMING van ERE TUINEN BOOMGAARD en LANDERIJEN in eene opstrekking gelegen te zamen groot 52 8. 06 R. 80 El.  zullende deze Beklemming jaarlijks op Midwinter tot vaste buur doen f 200—00. XIII. De EIGENDOM der 'GRONDEN onder XII bedoeld. Eindelijk nog eenige ZITPLAATSEN in de Kerk en GRAVEN op het Kerkhof te Bellingwolde. Nadere inlichtingen zijn te bekomen ten Kantore van den Notaris.,http://resolver.kb.nl/resolve?urn=ddd:010771911:mpeg21:a0009:ocr,4,ddd:010771911:mpeg21:p004,Groninger courant,994
3738616,1856/07/08 00:00:00,2644,ddd:010584483:mpeg21:a0009,http://imageviewer.kb.nl/ImagingService/imagingService?id=ddd:010584483:mpeg21:p004:image&x=1531&y=2567&w=1414&h=2644,ddd:010584483:mpeg21,2945,5211,1531,2567,4,HARDDRAVERIJ TE RURUM op DONDERDAG den 24 Julij e. k. Door het vertrek naar de Hoogeschool bestaat er gelegenheid voor een JONGELING voor KOST INWONING en HUISELIJK VERKEER in den fatsoenlijken stand met vrije KAMER. Men adressere zich in persoon of met franco brieven bij den Heer U. J. HUBER  Doctor in de Genees- en Verloskunde  in de Groote Kerkstraat te Leeuwarden. lemand van fatsoenlijke familie zag zich gaarne ten spoedigste geplaatst als KLERK  REIZIGER of in eene andere betrekking  zijnde met administratie in het. vak der belastingen bekend. Adres franco onder letter Z. aan A. van ZUIJLEN te Leeuwarden. !n eene Tabaks- en lirui<leniers-affaire worden gevraagd: Een WINKELBEDIENDE en een LEERLING om bij voorkeur dadelijk in dienst te treden. Nadere informatien zijn te bekomen met franco brieven bij Groningen 5 Julij 1856. H. & E. de VRIES Commissionnairs. Een WAGENMAKERSKNECHT goed kunnende werken kan dadelijk vast werk bekomen bij JAN HANEMA te Oosterwierum. Men verlangt om met 1 September in dienst te treden: Een bekwame GRUTTERSKNECHT ongehuwd van de Protestantsche Godsdienst en zijn werk grondig verstaande. Adres met franco brieven bij P. van ASPEREN te Warga. Twee KLEERMAKERSKNFCHTS kunnen vast werk bekomen bij MINNE D. MENNEMA te Oudkerk. Brieven franco. VERKOOPÏNG VAN BOEREN in onderscheidene TALEN en WETENSCHAPPEN afkomstig uit de Bibliotheek van den Heer W. G. WEIILBCRIi Jr. vroeger Med. Doctor te Joure; welke verkocht zullen worden op Woensdag den 9 Julij 1856 ten huize van den Logementhouder W. J. Muurling te Heerenveen door den Boekhandelaar F. HESSEL ten overstaan van den Notaris J. H. D. MUNNIK. Alles op heden Dingsdag te zien. %* TELEGRAAF. — HANDEL. De uitgever van het Nieuws- en Advertentieblad de PROVINCIALE FRIESCHE COURANT berigt dat de jongste noteringen van Effecten  Granen  Kaden  Oliën enz. der Amsterdamsche Beurs  voortaan in genoemde Courant zullen worden opgenomen. — En dat ten dien einde zoowel de Zondagsche als de Donderdagsche nommers des avonds te voren zullen worden uitgegeven en beide de marktberigtcn van dienzelfden dag bevatten. Leeuwarden L. SCHIERBEEK den 3 Julij 1856. Uitgever der Provinciale Friesche Courant. V NIEUWE ATLAS VAN FRIESLAND. Namens HH. Gedeputeerde Staten berigt de Ondergeteekende dat de laatste der geteekende Kaarten die van OOSTDONGEKADEEL van den 26 Junij tot den 10 Julij ter Secretarie dier Gemeente ter visie zal li^en en dat ieder in de gelegenheid wordt gesteld om daarop schriftelijke aanmerkingen aan het Bestuur mede te deelen alsmede om afzonderlijke ex. aƒ 2 daarvan °te bestellen bij hem en de Boekhandelaren Scn.AAFSMA en Hansma te Dokkum dewijl die na de uitgave niet meer to bekomen zullen zijn. \y. EEKHOFF. ******* §> Ü den Boekhandelaar H. KUIPERS bij de Langepijp op den hoek *»* i_ vau de Weerdt te Leeuwarden en verder alom is te bekomen: R IJ REL VOOR HET CHRISTELIJK GEZIN uit de oorspronkelijke talen op nieuw overgezet en ingerigt naar de behoeften van den tegenwoordigen tijd door BS. F. 1\ FOCKEK» Theol. Doctor en Predikant te Twijzel en Koten. lste en 2de Deel ƒ 6.60. Men leze hieromtrent Recensent Feb. 1855. Jaarb. v. Wetenseh. Theologie XII. 1. Kerkel. Courant 25 Febr. 185-1. Waarheid in Liefde 1853 111. Tijdspiegel November 1853 enz. enz.,http://resolver.kb.nl/resolve?urn=ddd:010584483:mpeg21:a0009:ocr,4,ddd:010584483:mpeg21:p004,Leeuwarder courant,1414
960204,1856/02/27 00:00:00,994,ddd:010544725:mpeg21:a0025,http://imageviewer.kb.nl/ImagingService/imagingService?id=ddd:010544725:mpeg21:p006:image&x=1037&y=3790&w=966&h=994,ddd:010544725:mpeg21,2003,4784,1037,3790,6,%* Door onverwacht sterfgeval UIT de HAND te KOOP of te HUUR om dadelijk of met I°. Mei te aanvaarden: Eene BROOD- BESCHUIT-en KLEINGOED-BAKKERIJ een goed bestaan opleverende gelegen op den besten stand op een welvarend Dorp in Z.-Holland naar keuze met of zonder de Gereedschappen  kunnende de helft der Kooppenningen op het Pand gevestigd blijven. Brieven franco .Letters 11. M. aan den Boekhandelaar C. C. van p-R HOEK te Leyden. %* Door 11. R. RÖELFSEMA te Groningen is verzonden  de 2*ie Aflevering van : tr__P__>) _ü__< i-fS'sSt?'-_^l>-il__ _-*!. IT5 Sir JOHIV REDCLIFFE. Inhoudende: De vermoording van den Baron von Hackelberg. — Eene Soiree in de Salons der Vorstin Lieven. — Een morgen in het Hotel van Vorst Oczakoff'. — Vorst Oczakoff in het Kabinet van den Russischen Gezant von Kisseleff. — Montenegro. — Een Bivouac op een der Rotseilanden vau het Meer van Scutari. — Togt van Nicolaas Griva» naar Scutari De 3de Aflevering volgt binnen 14 dagen.,http://resolver.kb.nl/resolve?urn=ddd:010544725:mpeg21:a0025:ocr,6,ddd:010544725:mpeg21:p006,Opregte Haarlemsche Courant,966
1975881,1856/08/09 00:00:00,751,ddd:010788416:mpeg21:a0022,http://imageviewer.kb.nl/ImagingService/imagingService?id=ddd:010788416:mpeg21:p007:image&x=26&y=2969&w=2631&h=751,ddd:010788416:mpeg21,2657,3720,26,2969,8,"De uitkomsten der scheepvaart zijn geweest: INKLARING. TJITK.LARING. ____- _* ?eder:land- I Naar Nederland. I eaeriandsche schepen ... 56 metende 6618 lasten Nederlandsche schepen . . . 55 metende 6099 lasten UU Noord-Amerika. Naar Noord-Amerika. •-Amorikaansche schepen. .40 ~ 4228 .. N.-Amcrikaansche schepen. .35 » 37451/2 » *__ tV xvreemde Patsen. Naar andere vreemde plaatsen. schepen 35 ~ 139 U/2 lasten Nederlandsche schep.n 81 » 1424 lasten ~ 71 „ 2944 ~ Engelsche >f 69 „ 27481/2 « fransche „ 8 „ 17H/2 „ Fransche »- 9 „ 189 „ H__.ge ° "" 2 "" 751/2 -'» Portugesche » 2 „ 751/2 » «amburger ~ 7 ~ 258 ~ Hamburger » 7 258 » • — 123 48401/2 ii —118 4695 » Totale inklaring. .219 » ..... 156861/2lasten. Totale uitklaring. . 208 metende 14539V2lasten.",http://resolver.kb.nl/resolve?urn=ddd:010788416:mpeg21:a0022:ocr,7,ddd:010788416:mpeg21:p007,Nederlandsche staatscourant,2631
2442602,1856/10/11 00:00:00,1997,MMVEEN01:000077571:mpeg21:a0012,http://imageviewer.kb.nl/ImagingService/imagingService?id=MMVEEN01:000077571:mpeg21:p003:image&x=2319&y=3547&w=1200&h=1997,MMVEEN01:000077571:mpeg21,3519,5544,2319,3547,4,Advertentie mmi s. LöTim SCHEEPSMAKELAAR te IVew- ('astle en IVorth-Shields  brengt mits dezen ter kennisse van SCHEEPSKAPITEINS en REEDERS dat hij in staat is ten allen tijde de HOOGST MOGELIJKE VRACHTEN te bezorgen en spoedige EXPEDITIE. Onderstaande Vrachten zijn bij bovengenoemde tegenwoordig te bedingen. VRACHTLIJST van den 25 September. Amsterdam • • • 12-0 | Oporto ^ 19-10 Rotterdam . . . Hamburg . . . Bremen .... Copenhagen . . Koningsberg . Dantzig .... Memel .... R'ga Petersburg . . Stettin Lubeck .... Belt en andere) Plaatsen in Jutland. Lissabon 11-10 12-0 11-10 14-10 16-10 110 10-0 10-0 28-0 16-0 15-0 13 tot 15 20-10 Cadix Gibraltar Malaga Barcelona . . . . Genua Livorno Marseille vrij van Duty of Vlaggeld Nice 21-10 2323-10 3131 3028 30-10 Napels 32Triest Venetie .... Constar.tinopel 31-10 34NOACII S. LOTINGA heeft altijd Stukgoed-Vrachten naar plaatsen in de Oost- of Middellandsche Zee  gewoonlijk van twee tot vijf Pond per Keel boven do gewone Koolvrachten cn spoedige expeditie. UIT DE HAND TE KOOP: EENE OPENE Y Io I pa*aa idi  groot 15 Tonnen en 7 jaar oud bij JURRIEN R. EERKES  bij het Vallaat te Ommelanderwijk.,http://resolver.kb.nl/resolve?urn=MMVEEN01:000077571:mpeg21:a0012:ocr,3,MMVEEN01:000077571:mpeg21:p003,Veendammer courant,1200
2717280,1856/12/19 00:00:00,2720,ddd:010397785:mpeg21:a0043,http://imageviewer.kb.nl/ImagingService/imagingService?id=ddd:010397785:mpeg21:p004:image&x=2062&y=96&w=999&h=2720,ddd:010397785:mpeg21,3061,2816,2062,96,4,MEISJES- VROUWEN- EN WEBUWENFOIS SEDERT 1828 GEVESTIGD TE ROTTERDAM  goedgekeurd bij Koninklijk Besluit van 10 Julij 1840 n.° 135. Beschermheer de Ed. Achtb. Heer -I. V. Hoffman. Commissarissen de Heeren R. BORDEWIJK A. SMALT en D. G. VELTCAMP HELBACH. Directeuren van het Fonds voornoemd berigten bij deze aan alle belanghebbenden dat op de gewone Jaarvergadering den 27 September 11. alhier gehouden  is gearresteerd de REKENING en YERANT WOORDING over het met ultimo Junij 11. omgekomen 28ste Fondsjaar na door^Heeren Commissarissen en eene Commissie ad hoc van drie Deelnemers te zijn onderzocht en goedgekeurd. Uit een en ander is gebleken dat alle loopende Jaarwedden tot haren afloop toe door op het Nationaal Grootboek ingeschreven Kapitaal zijn gedekt  alsmede alle Lasten en Kansen door Gewone en Buitengewone Reserven  terwijl alle uit batige Saldo's vroeger toegekende Kortingen  ten bedrage van 4 tot 38 per Cent blijven gecontinueerd en daarenboven het Kapitale Fonds eene belangrijke vergrooting heeft verkregen. De Afdrukken der genoemde Stukken voor de Deelhebbers zijn ter distributie aan de Agenten verzonden waardoor zij zich op nieuw en bij voortduring sedert de Oprigting van het Fonds zullen kunnen overtuigen van de soliditeit der Inrigting en de openbaarheid van de handelingen des Bestuurs. Directeuren van het Fonds voorn. Rotterdam J. G. ARBON. December 1856. P. K. GÖRLITZ. De Agenten dezer Im-igtigig* zijn : Voor Alkmaar de Heer C. Kioon Voorjoure de Heer G. R. Postte Noordschnrwoude. humus. n Amersfoort IV. ll.deßruyn. „ Leeuwarden de Heer L. ___ Amsterdam  de Heer C. J. Harmenzon. Ebeling. „ Leyden de Heer A. de Mare. „ Assende HeerJ.E.Driessen. „ Maastricht de Heer L. X „ Brielle de Heer D. y. Stjll Heymcr'tks. te Zwartewaal. „ Middelburg de Heer Mr. A. „ Helft de Heer G. Boel. F. Sifflé Not. „ Dordrecht de Heer F. J. v. „ Mijdrecht de Heer H. V. Scheer s. Royen. „ Edam de Heer C. Breeyelt „ Nijmegen de Heer A. F. Schuitemaker. Aarts. „ Francker de Heer P. Ü. F. „ Schiedam de Heer D. van Junius. der Tas \.z.  Goedereede de Heer C. J. „ Sluis (ïn Zeeland) de Heer Visser. J. Lansen Croin cand. Not. „'s Gravenhage de Heer S. „ Sneek de Heer K. Geel. Essenlus Greeff. „ Texel de Heeren KoningSfCo. „ 'sGravesande de Heer /. J. „ Utrecht de Heeren Cock & v. d. Bosch. v. d. Tou. „ Groningen de Heer H. Beek- „ Vlaardingen de Heer J. M. huis Damstê. Lagerwerjf. _ Hasselt (in Overijssel) de „ Zaandam de Heer Anth. Heer G. Freislich Not. Holst. „'s Hertogenbosch de Heer „ Zierikzee de Heer J. G. J A. Kaub. Bethe. „ Hoorn de Heer/. Bakker Az. „ Zijpe en Schagerbrug de Heer IV. van Os. •*•„♦ De bekende en onbekende Schuldeischers in de onder het voorregt van boedelbeschrijving aanvaarde Nalatenschap van den Wel Edelen Heer CORNELIS SUERMONDT op den 6 Junij 1856 te Rotterdam overleden  worden opgeroepen op Maandag den ao December 185-5 des voormiddags ten 11 ure te compareren ten Kantore van de Notarissen VAN DER HOOP en REEPMAKER te Rotterdam  ten einde tegenwoordig te zijn bij de aflegging der eerste Rekening en Verantwoording van hefbeheer van genoemde Nalatenschap alsmede  indien er geen verzet plaats heeft Betaling hunner Vorderingen te ontvangen voor zoo ver her bedrag des Boedels daartoe nu reeds toereikende zal zijn.,http://resolver.kb.nl/resolve?urn=ddd:010397785:mpeg21:a0043:ocr,4,ddd:010397785:mpeg21:p004,Rotterdamsche courant,999
7187648,1856/04/25 00:00:00,5216,ddd:010584462:mpeg21:a0027,http://imageviewer.kb.nl/ImagingService/imagingService?id=ddd:010584462:mpeg21:p008:image&x=1557&y=32&w=1378&h=5216,ddd:010584462:mpeg21,2935,5248,1557,32,10,"Boelgoed van afbraak. De Deurwaarder P. dk VRIES to Bolsward zal op Maandag den9ll  1856 des morgens ten t.en uur op Knossen onder het bso£ *? V Isward  publiek bij boelgoed verkoopen: <><* der Eene groote partij AFBRAAK bestaande in : Kozynen Rame D ' ken'ribben Planken Juffers Kolders Steen Pannen Vorsten' W^60' Bt hout en een Karnmolen. ' M' rI i^nn S. W. HOEKSTRA to Wommels __*_ IIOLLhiOEI). Maandag den 28 April 1856 '8 mo ' f -kt DVLUUVü D.rk Boer Qp L.tte^ns 9 Wommels met bevoegd min.stenc by boelgoed tegen gereed ge)d te % 7 melke- en kalve Koeyen 1 R.er 3 Kal vers 1 vos Merriepaard °^ 1 Chais 1 Kapchais 2 Hooiwagens waarvan 1 beslagen 1 Kam'metv hoep 1 Kaasketel voor ruim 20 Koeyen 1 Kaaspers met Steen 22 houtenT* 6 koperen- en 6 houten Emmers 1 Handketel 3 Melkvaten Zuiptonnea ï> Tob 2 Kaasvaten en Tobkes Varkenstroggen 1 Thyme 1 Bmdtladder lB^ Gareel en Hoofdstel 1 Emmerbank 3 Jukken 1 Koebart 1 Kret 'm""?* ken Koeklaauwcn Hooilep Grijpen Harken Vorken enz. mm Meubelen waaronder: 1 Chiffonnière 1 Schuiftafel Stoelen Koper * Blik IJzer- Glas Aardewerk en hetgeen meer zal worden aangeboden. ' ™' nArf r\ Al?li S. AV HOEKSTRA te Wommels gedenkt nli_r BOELGOMKuag den 30 April 1856 's namiddaÏT^ huizinge no. 16 te Cubaard met bevoegd Ministerie bij boelgoed a Contant verkoopen: _ MEUBELEN en HUISRAAD waaronder: 1 Bed en Peluw i K  Staartstuk-Klok 1 Spiegel 1 Tafel Stoelen 1 Scherm. 1 Tob eenig Po.1 1 Strijkijzer 1 tinnen Koffijkan Koper- Tin- Blik- IJzer- Glas- en Aardew'v en hetgeen meer zal worden aangeboden. SCIIARVERHIRING Woensdag den 30 April 1856 des namiddags te 3 ure in de Herbere Zurich van de Beweiding in 1856 van: ° '■ 18 KOESCHARREN voor 6 maanden. 22 KOESCHARREN „ 2 maanden. 2 PAARDESCHARREN „ 6 maanden. 2 PAARDESCHARREN „ 2 maanden. Op den Slaperdijk bij Zurich en de Landen in het Zuricher oord. Geen Hoornvee zal worden aangenomen afkomstig van Stallen of uit Weiden in welke gedurende dit of het vorig jaar de longziekte heeft geheerscht. Terzelfder tijd zal worden verlmuril: de Visscherij in de Dijksvaart van Sottrum tot aan Steen 57 en de opbrengst der Tollen van de Sluitboomen in de Dijksvaart te Zurich en onder Aln\enum. Uit de hand te koop: Een uitmuntend best loopend BILLARD zoo goed als nieuw. Te bevrauenbü S. WEIJER te Leeuwarden. ' ' lemand van fatsoenlijke familie ruim 30 jaren oud P. G. eenigzins theoreretisch bekend met Landbouw en Veeteelt wenschte zich gaarne verder prat tisch te bekwamen bij een ervaren Landbouwer die een gemengd bedrijf uitoefent. Wie genegen is tegen billijke vergoeding voor kost en inwonin"" zoo iemand bij zich te plaatsen gelieve zich binnen 8 dagen met franko brieven onder letter B te adresseren bij den Boekhandelaar W. EEKHOFF te Leeuwardm REGISTRATIE. Op een Kantoor der Registratie in de provincie Friesland wordt ten spoedigste verlangd een EERSTE KLERK adres onder lett. A aan het Postkantoor te Heerenveen brieven franco. AH. VIERSEN openbaar Onderwijzer te Zwartsluis verlangt een ONe DERM_EESTER die het Orgel kan bespelen. Er bestaat ook bij hem gelegenheid tot plaatsing van een KWEEKELING. Behalve in andere vakken kan men onderwijs genieten in de Fransche Hoogduitsche en Engelsche talen. Acht a tien TIMMER- en METSELAARSKNECHTEN kunnen tegen goed loon voor langen tijd werk bekomen bij R. RADERSMA te Wieuwerden J. J. KUINDERSMA te Bozum. Acht of tien TIMMER- en METSELAARSKNECHTEN kunnen terstond werk bekomen voor eenen geruimen tijd bij WOPKE M. de BOER Timmerman te Warga. Vijf TIMMER- en METSELAARSKNECHTEN hun werk verstaande kunnen dadelijk werk bekomen bij J. BOORSMA te Weidurn en P. POPMA te Jorwerd. \|ier TIMMER- en METSELAARSKNECHTEN kunnen dadelijk werk bekomen bij het bouwen van eene Schuur voor den Heer S. S. Sevenster te Stiens  tegen een goed loon. |l A. WIJNSTRA van Oppenhuizen vraagt twee METSEL AARSKNECH-1 « TEN om geruimen tijd te Achlum te werken. Twee KASTMAKERSKNECHTEN van de Gereformeerde Godsdienst kunnen dadelijk vast werk bekomen bij A. A. HILLEBRAND Meubel- en Spiegelmaker in de Poststraat lett. 11 no. 107 te Leeuwarden. Een a twee WAGENMAKERSKNECHTEN kunnen dadelijk werk bekomen bij G. IJ SMIDT te Oldeboorn. Een KUIPERSKNECHT het Hotervat-inaken ten deele verstaande kan den 12 Mei 1856 geplaatst worden bij JAN IJ. HOEKSTRA Kuiper te Rinsumageest. Adres in persoon. XP. BLANKSMA op 12 Mei 1856 Mr. Smid te Oosterbierum verlangt • alsdan een SMIDSKNECHT die zijn werk goed verstaat tegen goed loon. — Adres bij SAKE FABER Mr. Smid te Witmarsum franco. Zes VERWERSKNECHTEN kunnen dadelijk werk bekomen bij de Ondergeteekcnden. Eryen D VAN- DEK HEIDE Wz. Leeuwarden. H VAN BUUREN. Y'o'rno WERSKNECHTEN knnnen dadelijk werk bekomen bij J. KIESTRA Mr. Verwer etc. Noordvliet te Leeuwarden. Een VERWERSKNECHT zijn werk geheel of ten deele verstaande lic» _ t'™. T?d„' kan dlreot voor een geruimen tijd werk bekomen bij D. *■ GALEMA te Hallurn. Brieven franco. E lij BLEEKSMA te Rauwerd verlangt een VERWERSKNECHT. en VERWERSKNECHT die zijn werk geheel of ten deele verstaat kan I Jt^^o**JSJ_HU£ J' K HAASMA te St. Jacob. Brieven franco""Tlen VERWERSKNECHT zijn werk geheel of ten deele verstaande b» Li van stonden aan werk bekomen. Men vervoege zich in persoon bijden Ondergeteekende. LOURENS F. de BOER te Witmarsum. TT H^?ifv^RSKNECE[TEN kunne"" lelijk werk bekomen bij E J'filSKSra&J^ Kleer<™ker te Sint Anna-Parochie. .. Af S T^^Co_?' van «oed Sed™S- kan geplaatst worden hij den rti^_2£™irtsö£SA •to oudke*k- ™»in pers°on aldaar ?• Tl Fi een Ut KN^CHT' dio «oed kan werken  kan op den 12. Me. tegen JU een goed loon geplaatst worden. Nader informatie bij R. van VU^Tn »i j . _ tt i- -n^nvcn franco. Bal^erTe DoXmT V^l *££■* J' Mr- Eeve™oF;R^MECHTt' Zijn Werk ""»""*»* en van goed zedelijk gedg Li .erlangt op 12 Mei e. k. geplaatst te worden Geead&den vervoegen a* tTsnSC 0 'eVen °nder l6tter % biJ de* Boekhandïar TS. FEENSTRA T 6 DFNIFRS AkFFI°TRr S6VraaSd 'm eene TABAKS-FABRIEK en KRÜ1' aan den Boekh. F. HESSEL te IT A%""** mcl iranco Dncveu o-enlaatst worden ÏSi i„ ir.j ï 7-.t' Inwoning en behoorlijk Salaris « „eplaatst worden by de W cd. K. DRAGER te Franeker. Brieven franco- __ _ {Zie verder het tweede Bijvo'f1)^",http://resolver.kb.nl/resolve?urn=ddd:010584462:mpeg21:a0027:ocr,8,ddd:010584462:mpeg21:p008,Leeuwarder courant,1378
2747608,1856/01/09 00:00:00,3026,ddd:010776930:mpeg21:a0015,http://imageviewer.kb.nl/ImagingService/imagingService?id=ddd:010776930:mpeg21:p004:image&x=1881&y=1234&w=908&h=3026,ddd:010776930:mpeg21,2789,4260,1881,1234,4,"De Rcvalenta bezit eene verwonderlijke geneeskracht; er gaat geen dag voorbij waarop niet de een o( andere merkwaardige genezing bekend wordt; niet uit ver verwijderde landen van onbekende lijders maar in ons eigen land in onze steden en dorpen onder onze oogen zien wij ze plaats hebben; hier even als in andere lanien worden ze veelal openlijk bekend gemaakt door lijdeis uit alle standen met naam eu woonplaats er bij; het zijn particulieren ambtenaren geleerden zelfs voorname medici die van deze feiten getuigenis afleggen de bijzondei» eigenschappen der Revaleuta erkennen en ze algemeen aanbevelen. De lievalenta is een heerlijk gemakkelijk goedkoop smakelijk geneesmiddel dat nooit kwaad doen kan en altijd helpt als hei maar GOED GEKOOKT WORDT waarop wij bijzonder aandringen moeten. Men zie daarover de kleine gebruiks-aanwrjzing die bij iedere Bus loa afgegeven wordt en zorge dat daarbij met een weinig oplettendheid ie werk gegaan worde. De Rcvalenta is te verkrijgen iv onderstaande Depots voor >-7..t eeut ƒ 2.—  f 8.50 f».— en ƒ 16.— Er zijn vele nagemaakte soorten; men lette er op da» men DU BABRY'S REVALENTA koope. Amsterdam Verkoophuii. Utrecht L.J. R Bosch Ltjnn» AmersfoortC.C Tv d.Roemer Viauen M. A. Verkerk. „ .1. I. Bruning. Wageningen W. J. Tibovt Baarn E v. Dapperen. Wijk hij Duurs.. Wed. C.Zorm. Hilversum R. I.J. o. Alphen. Zeist G. C. Adlt-ng; Kuilenburg •/ A. IJoiidius.an in de bekende Dépöu ia Utrecht T.UhlenbroeJcUi\i.\it:rb de andere steden. „ T.C/tlenuru< kChoarsi. WAARNEMINGEN gedaan op het Koninklijk Nederl. Meteorologisch Observatorium te Utrecht. / Z mnenburo.f . a WiiiU- llaoin Tber. Alwgk Vocb- Oer. | J i rigt Ikr bij O"" | F d ien.p. ugb regen Aanmerlcihffen. 8 2 nnw. O 0 73:.04 31.8 — 0.7 0.96 0 Retrokk.;mist. j 10 mi». 0(1 4DU31.1 I 98 0 Idem; nevelig 9j 8 nw. 00 42.1&|31.5 | 96| o.l.Mist. PRIJZEN OER EFFECTEN. A M S TE R D A M 8 Januarij 1856. Nbdeklanh. Wcrkel. Schuld .. . 2'/ pCt. C21/. 6215/ i« 6215/ i« dito dito 3 „ 74/8 74Vie 747 dito dito 4 „ '92»/u 927|8 ""Via Oost-Indische Leuning 4 „ 9l'/4 92 91»/ Leen. Holl. Spoorweg . . . 100 Rusland. Oblig. bij Dope en Co. 5 ~ 100 1001/» Obli(tat. 1828 & 1829 5 „ 995/» Certificaten it>4o. . . 4 „ 74'/4 Cert. hij Slieglilz . . 4 „ 73'/4 diio Adm. te Lond. 4 „ 86 Cert. van Assigu. .. 6 „ 57'/s s/4 57'/« Spa>.jb. Obligatien 1'/4 pCt. 215/ie 21'/j 217. Binnenl. Schuld ... 3 „ 34'/ 345/» 34J/„ AmorUaable 6'/8 ""'Ac • •'Vg Bew\jzen Coupons . . . 4*/» Uosn.Mll IK. ""ObÜg. Metakek ...5 „ 63>/« C3'/2 63/2 Oblig. N. 5 „ 78»/| l**h 73 '/„ dito dito La li. ... 5 „ 73»/IB 73-V-4 73 y4 duo dilo B/j „ B*'/» 3;»V8 lïltAZlL-K. Geldl. 1824 £ WO. . 5 pCt. 97% „ 1824 t 200. . 5 „ 9ü34 I'OKTUUAL. Obligatien 3 pCt. 41'/a <l/j 41 '/„ Ajieuika. Venez.Oldig. 6 pCt. nu 4>/4 „ M'U 255/8 Grenada Oblig. .. . 2'/i > lsVi Is9/» Mexico Obi. 1851 f lul) 3 „ 19»/» 19»/i§ Nouid-Au.crik. Am. 15dnk-act ls/s flieeht bij 1.. Ê. nOMCU en ill>O.V",http://resolver.kb.nl/resolve?urn=ddd:010776930:mpeg21:a0015:ocr,4,ddd:010776930:mpeg21:p004,Utrechtsche provinciale en stads-courant : algemeen advertentieblad,908
917377,1856/07/02 00:00:00,911,ddd:010771977:mpeg21:a0008,http://imageviewer.kb.nl/ImagingService/imagingService?id=ddd:010771977:mpeg21:p004:image&x=73&y=4717&w=1007&h=911,ddd:010771977:mpeg21,1080,5628,73,4717,4,*** H. RK «VAAR» te Groningen heeft uit gegeven: L. E. HALBERTSMA NORDERNEIJER .. Schetsen en Fantazien. Met Platen en een Tarief van liet SKeebad te ItorderneiJ. f 3.30. *** Door de Erven C. M. VAM BOLHVII HOITBEHA is uitgegeven en alom te bekomen: HET WXM 11 POLITIE VOOR DE GEMEENTE GRONINGEN vastgesteld door den Raad in zijne Vergadering van den .den Junij IN.»«  behoorende by' de Groninger Courant van den 29sten Juny. Prijs IS Cent.,http://resolver.kb.nl/resolve?urn=ddd:010771977:mpeg21:a0008:ocr,4,ddd:010771977:mpeg21:p004,Groninger courant,1007
1974847,1856/05/20 00:00:00,2009,ddd:010980417:mpeg21:a0050,http://imageviewer.kb.nl/ImagingService/imagingService?id=ddd:010980417:mpeg21:p004:image&x=2079&y=107&w=983&h=2009,ddd:010980417:mpeg21,3062,2116,2079,107,4,OPENBARE VRIJWILLIGE VERKOOPING De Noraris JAN VAN DER HOOP Jac. Zn. residerende te Rotterdam  als last hebbende van zijne Principalen is voornemens om op MORGEN den 21 Mei 1856 des namiddags ren 4 ure in het Notarishuis aldaar in het openbaar te veilen en te verkoopen : N.° 1. Een welaangelegden TUIN beplant met exquise Tracht- en andere Boomen TUINHUIS' met Fraai Uitzigt en ERTE gelegen en staande aan den Blommersdiikschen Rijweg gemeente Rotterdam wijk 14 n.° 22 Kadaster sectie C n.s2iio en 2615 te zamen groot 11 Roeden 1 El. Aangeslagen in de Grondbelasting over 1856 tot ƒ26.65. Zijnde dadelijk te aanvaarden. N.° 2. Een welaangelegden TUIN met Bcpotlnff en Beplanting HUIZING LOODS en ERVEN gelegen en staande aan de westzijde van de Schotelboschlaan gemeente Rotterdam wijk 14 n.° 265 Kadaster sectie C  n.s 2417 2418  2419 en 2420 tet grootte van 3 Roeden 80 Ellen benevens 1/40 AAI.DEEL in het LAND achter de Tuinen van de Schotelboschlaan gelegen. Aangeslagen in de Grondbelasting over 1856 tot ƒ 11. 81. Zijnde insgelijks dadelijk te aanvaarden. Inmiddels zijn nadere onderrigtingen te bekomen ten Kantore van den genoemden Notaris  en kunnen de te veilen Onroerende Goederen nog HEDEN en MORGEN worden bezigtigd  mits voorzien zijnde van Permissiebiljetten  daartoe door genoemden Notaris af te geven. Publieke Verkooping a Contant te (;or:i>_f;ni;i;»i; op Vrijdag 23 Mei 1856 des voormiddags half elf ure op de Kade aldaar van eene SLOEP diverse RÖNDHOUTEN BALREA' ZEILEN KETTINGEN TOUWWERK enz. Openbare Verkooping. De Notaris L. C. DIJXHOORN residerende te Overschie  is van meening op Maandag den 26 Mei 1856 des voormiddags ten 9 ure  aan het huis wijk 3 n.° 14' in den Droogenhoek  te Overschie in het openbaar te' verkoopen : Gemaakt GOUD en ZILVER PORSEI EIN GLAS- VERLAKT en AARDEWERK BEDDEN met TOEBEHOOREN Katoenen en Wollen DEKFNS MANS- enVROUWEKLEEDEREN Gemaakte STOFFEN TAFELS STOELEN SPIF.GELS KOPER TIN en andere GOEDEREN meer; alles des Vrijdags en Zaturdags voor den verkoopdag des voormiddags van 9 tot 12 en des namiddags van 2 tot 6 ure in gemeld Huis te bezigtigen.,http://resolver.kb.nl/resolve?urn=ddd:010980417:mpeg21:a0050:ocr,4,ddd:010980417:mpeg21:p004,Rotterdamsche courant,983
791508,1856/05/13 00:00:00,852,ddd:010251447:mpeg21:a0019,http://imageviewer.kb.nl/ImagingService/imagingService?id=ddd:010251447:mpeg21:p004:image&x=1012&y=87&w=929&h=852,ddd:010251447:mpeg21,1941,939,1012,87,4,"Verkiezing van twee Leden voor de Provinciale Staten van Gelderland op 13 Mei e. k. Als Candidaten worden in het district Ruurlo bijzonder aanbevolen de Heeren : Mr. Jl. DAM Advocaat te Zutphen en Jl. V. A. WEUii Notaris le Groenlo. (2119) Eenige vrijzinnige Kiezers. Verkiezing 13 Mei a. s. Door de Kiezersveieenigiug »de Grondwet"" zijn als Candidaten van het lidmaatschap der Provinciale Staten van het kiesdistrict Ruurlo met algemeene stemmen aangenomen  de Hoeren Mr. JT. DAM Advocaat te Zutphen. JT. H. JU DB.IESSEN te Aalten welke beide Candidaten in de Gemeente van Borculo Vorden Groenlo en Lichtenvoorde bepaaldelijk de meeste stemmen op zich zullen vereenigen. (2118)",http://resolver.kb.nl/resolve?urn=ddd:010251447:mpeg21:a0019:ocr,4,ddd:010251447:mpeg21:p004,De Tĳd : godsdienstig-staatkundig dagblad,929
3131772,1856/08/25 00:00:00,3242,ddd:010544873:mpeg21:a0019,http://imageviewer.kb.nl/ImagingService/imagingService?id=ddd:010544873:mpeg21:p004:image&x=61&y=1581&w=966&h=3242,ddd:010544873:mpeg21,1027,4823,61,1581,6,*** De Notaris Van EVERDINGEN te Tiel zal op Donderdag den vierden September 1856 bij toeslag bij G. Wijkniet te Tiel 's voormiddags om 11 ure  Verkoopen : Onder Bijsie ij h. Een nieuw gebouwde HOFSTEDE HET KAMERTJE genaamd gelegen aan den Rijndijk  bestaande uit kapitale Boerenwoning met Bakhuis Berg Erf Tuin Boomgaard en daarachter gelegen Bouwland zamen groot 7 Bunders 50 Roeden 56 Ellen. Te aanvaarden 1 November 1856. Ingezet / 12000 Tweede Perceel. Een Perceel BOUWLAND naast het vorige Perceel groot 3 Bunders 46 Roeden 10 Ellen. Te aanvaarden als voren. Ingezet ƒ4210 Derde Perceel. Een Perceel WEILAND in het blok Bergdaal groot 1 Bunder 10 Roeden 20 Ellen. Ingezet / 1320 Vierde Perceel. Een Perceel DITO  't einde het vorige Perceel groot 1 Bunder 79 Roeden. Ingezet / 3360 Beide te aanvaarden met 1 December 1856. Vijfde Perceel. De voormelde 4 Percelen in eene generale Massa groot 13 Bunders 86 Roeden 22 Ellen. Ingezet f 20700 \* W. J. ELSENHORST  Makelaar te Haarlem zal op Woensdag den 10den September 1856 des middags ten 12 ure in het Logement den Geleerden Man aan den Heeren- of Wageuweg  onder de Gemeente Bermebroek in openbare Veiling Verkoopen ten overstaan van den te Haarlem residerenden Notaris Mr. C. GERLINGS: Een hecht sterk weldoortimmerd en voor weinige jaren nieuw gebouwd HUIS waarin de Brood- en Koekbakkers-Affaire met goed succes wordt uitgeoefend; alsmede eene STALLING voor één Paard eene SCHUUR ERVE en een grooten TUIN alles staande en gelegen aan de Noordzijde van de Reek- of Roheller Zandvaart te Bermebroek get. N°. 73 Kad. Sect. Litt. A. N°. 199 Huis en Erf groot 97 E. en N°. 200 Tuin groot 4 R. te zamen groot 4 R. 97 E. De Kooper kan een gedeelte der Kooppenningen als le Hypotheek op het Perceel gevestigd houden. Breeder bij Billetten omschreven. Nadere informatien zyn te bekomen bij bovengemelden Makelaar. De Bewijzen van Eigendom en Veilcouditicn zullen acht dagen vóór den Verkoopdag ter visie liggen ten Kantore van den Notaris voornoemd. * * F. G. WALLER B. LANGERHUIZEN D. F. STIEVEN S. J. de FLINES J. KARSEBOOM H. ERNST en H. LOTZ Makelaars zullen op Maandag den 15den September 1856 te Amsterdam des avonds na half zes ure in het voormalig O. Z. Heeren-Logement door den Notaris Mr. J. COMMELIN  doen Verkoopen : N°. I. Een hecht en sterk HUIS en ERF op de Keizersgracht tusschen de Wolven- en Hartenstraten get. K.k. 315. N°. 2. Een hecht sterk en zeer doelmatig ingerigt WINKELHUIS en ERF met afzonderlijke BOYENWONINGEN in de Palm-Dwarsstraat tusschen de Palmstraat en Palmgracht get. Q.Q. 186. N° 3 Twee WINKELHUIZEN en hunne ERVEN met vier afzonderlijke BOYENWONINGEN staande nevens en geheel ingerigt als het Perceel N . 2 get. Q.Q. 187 en 188 te zamen in één Koop. . De Percelen onder No. 2 en 3 vermeld zijn in het jaar 1850 geheel nieuw en solide gebouwd en zeer doelmatig ingerigt tot Arbeiders-Woningen; zij zullen eerst elk afzonderlijk in twee Koopen worden Geveild en daarna te zamen in Slag gelegd. Breeder bij Biljetten omschreven en te zien des Dingsdags Donderdags en op den Verkoopdag: N°. I op vertoon van een Toegaug-Biljet van 1 tot 3 ure en de N°. 2 en 3 van 12 tot 2 ure. De Bewyzen van Eigendom en de Veilconditien zullen op den gewonen tijd ter inzage liggen ten Kantore van boyengenoemden Notaris.,http://resolver.kb.nl/resolve?urn=ddd:010544873:mpeg21:a0019:ocr,4,ddd:010544873:mpeg21:p004,Opregte Haarlemsche Courant,966
2444832,1856/12/03 00:00:00,1248,ddd:000011654:mpeg21:a0024,http://imageviewer.kb.nl/ImagingService/imagingService?id=ddd:000011654:mpeg21:p004:image&x=156&y=3554&w=1959&h=1248,ddd:000011654:mpeg21,2115,4802,156,3554,4,"Door GEUHOEOEMÏM MMELtJSFAVTE te *sCïraveiiha*e IK VERZONDEN HET lste VEL VAN HF.T STUIVERS MAGAZIJN TIJDSCHRIFT VOOR lEDEREEN. Het Tijdschrift voor iedereen moet iv de eerste plaats goedkoop zijn: daarom ontvangt men voor/1.3© een boekdeel dat zooveel inhoudt als I©© vellen druks in gewoon Svo. gT^f* Omtrent den inhoud leest men iv hel Prospectus: Het moet een Tijdschrift worden bij duizenden verspreid dat zich aanbeveelt door eene groote verscheidenheS van inhoud M n zul er No veil» Reizen Ontdekkingen Uitvindingen Populair wetenschappehjke onderwerpen welke op praktisch terrein te huis behooren ja tot Huisselyke zaken toe n vinden zóó de meer beschaafde als de min ontwikkelde lezer daarin wat van z.jne gading vindt. Een tijdschrift voor iedereen in den volsten zin des woords. lvnocD van hei Iste vel: Een staatkundig huwelijksplan Twee levens. - Rouglas .lerrold. - Statistiek. - Gratis advyzen gedachten cm. Allerlei - Recepten Raadgevingen enz. Het STUIVER» MAGAZIJN wordt uitgegeven in royaal Bvo. De zestien compres gedrukte pagina s zullen zoo veel als vier gewone vellen draks beslaan. Jaarlijks worden 59 vel uitgegeven welke twee flinke boekdeelen"" vormen. Men kan die boekdeelen in losse vellen  a 5 ets. per vel of in 12 maandelijksche afleveringen met gekleurden omslag en inhoudsgave a 3& ets. per aflevering bekomen",http://resolver.kb.nl/resolve?urn=ddd:000011654:mpeg21:a0024:ocr,4,ddd:000011654:mpeg21:p004,Dagblad van Zuidholland en 's Gravenhage,1959
2380050,1856/08/02 00:00:00,2322,ddd:010780104:mpeg21:a0003,http://imageviewer.kb.nl/ImagingService/imagingService?id=ddd:010780104:mpeg21:p004:image&x=53&y=50&w=1025&h=2322,ddd:010780104:mpeg21,1078,2372,53,50,4,"Vergadering der PROVINCIALE COMMISSIE VAN GENEESKUNDIG ONDERZOEK en TOEVÖORZIGT in Drenthe tol het afnemen van examens op Donderdag 7 Augusius e. k. des morgens 9 uur iv het gouver..emenlsgebouw le Assen. Assen den 1 Augusius 1856. Het lid en Secrclaris der Commissie vn. D. COHEN. IMDDMrIRIJ OP DE LOO Op nader le bepalen dag hij den kastelein ABELS. Alle paarden worden toegelaten. ~Wblicatie. ...■iggyr-nfc De COMMISSIE uit de El- GENAREN der VEENEN en __) _£*-& GRONDEN voor het VEEIV 'SP""^B SCHAP de OOSTEKIIIOERSI'UE en Zl IDEWELDSCHE VEKYEV van JEJEXT tot WAIjTMFj Ingesloten maken hij dezen bekend: dal de LEGGER van het GRONDGEBIED vau ieder der NEGEN' MARKTEN' en de LUST der EIGENAREN iv iedere MARKTE aanwijzende bet BUNDERTAL dat ieder daarin he/it. zijn opgemaakt en dal deze LIJSTEN of REGISTEItS. waarvan de laaislgcnoemde de STEMBEVOEGDHEID aanwijst gedurende veertien dagen ler lezing der belanghebbenden zullen voorliggen in iedere Markle. respeclivelijk als volgt: Te Eexlerveen in'het VERLAATSHUIS. te Giclerveen in den huize BAREVELD: te Bonnerveen ten huize van B. GROENWOLD; te Gasselterboervcen len huize van FREDERIK SPREEN; te Gassellernijeveen len huize van W. BAKKER; te Droiavenderveen ten huize van OTTE N'lJENlll'lS; te Buinervecn ten huize van JACOR MEURSING: voor Eicloo len huize van WILLEM KREMEIt te Exdoo; voor Valthe ten huize van de Wed. NIJENIIUIS le Vallhe: van af den 15 Augustus lot en met den 31 van die maand  gedurende welk lijdsbestek ieder BELANGHEBBENDE de bezwaren die hij legen deze beide snikken mogt hebben kan inbrengen iiij voormelde COMMISSIE die daarop uiterlijk vóór den 1 Oetober e.k. zal beslissen en van die beslissing binnen drie dagen schriftelijk kennis geven aan hen die zich hebben bezwaard; terwijl zij die door de beslissing der COMMISSIE hunne bezwaren niet achten opgeheven zich — miis dit doend- binnen acht dagen na de ontvangst der beslissing — wenden kunnen tot GEDEPUTEERDE STATEN . die in het hoogste ressort uitspraak zullen doen. - Gieten den .28 Julij 1856. De Commissie voornoemd: J. NUENIIUIS President. C. L. KNII'HORST. Secretaris.",http://resolver.kb.nl/resolve?urn=ddd:010780104:mpeg21:a0003:ocr,4,ddd:010780104:mpeg21:p004,Provinciale Drentsche en Asser courant,1025
705516,1856/10/06 00:00:00,681,ddd:011060064:mpeg21:a0003,http://imageviewer.kb.nl/ImagingService/imagingService?id=ddd:011060064:mpeg21:p001:image&x=2167&y=1741&w=1036&h=681,ddd:011060064:mpeg21,3203,2422,2167,1741,4,VEHDU-DEPABTEWEaT. VEHKOOPIMU Op Dingsdag den 7den October. Voor de woning van den deurwaarder bij den Rand van Justitie Damwyk in de stad. — En voor de woning van den kapitein Bruijn ia het officiers kampement no. 28. Op Woensdag den Bslen October. In de Kampoong Baroe. En des avonds in de Sociëteit Concordia van Boekwerken. Op Donderdag den 9den October. Voor het sterfhuis van wylen den heer W. von Franquemont te Bibis. Op Vrijdag den 10sten October. Te Pekalongan.,http://resolver.kb.nl/resolve?urn=ddd:011060064:mpeg21:a0003:ocr,1,ddd:011060064:mpeg21:p001,"De Oostpost : letterkundig, wetenschappelĳk en commercieel nieuws- en advertentieblad",1036
7425756,1856/10/09 00:00:00,3526,ddd:011060065:mpeg21:a0006,http://imageviewer.kb.nl/ImagingService/imagingService?id=ddd:011060065:mpeg21:p003:image&x=65&y=123&w=2105&h=3526,ddd:011060065:mpeg21,2170,3649,65,123,4,"-—^NKÜTIEvr Op Vrijdag den 17' den October 1856. In de pakhuizen van den Heeren P. Kervel & Co. foor D. D. vaw BÓECKriOLTZ ter opruiming van een factuur van eene PARTIJ KOFFU- en THEESERVIEZEN waarlooze witte PORCEINEN BORDEN SLABAKKEN VRUCHTEN-SCHALEN LIJNWADEN een kist min of meer beschadigde % CALICOTS puike EAU DE COLOGNE exquise RHIJNWIJN BIER en wat te voorschijn g«bragt zal worden. (&61) VERTREK W STOQMSCHEPM HET STOOMSCHIP BANDA ' Vertrekt naar Samarang en - Vjf Batavia  op Woensdag den IGden (567; W. CORES DE VRIES. BEKENDMAKING. Ten kantore van dun ondergeteekende is aangebragt per stoomschip AMBON uit de MOLUCCOS. B. A. een kist inhoudende.. 1 KINDERWAGENTJE. Per Stoomschip PADANG van Samarang of Batavia. Een KIST adres M. Floris. Bovenstaande goederen zijn togen betaling der vracht en de kosten dezer annonce te bekomen bij (525) ;. .W. CORES DE VRIES. ÊS[s"" fatsoon'Ü'ce ingezetenen bestaat gelegenheid voor een of. twee C&M-mkssai.k?*. -Adres bij de'uitgevers dezer. (554) VERLOREN Een jonge New-Founland HOND zwart met witte borst en één witte poot Hij die denzelven terug brengt bij J. LIOYD & Co op de Kalimaas .kan op eene goedi* belooning rekenen. (555) LIRFIII^ ®tfening baart lUmst. ; Op Zaturdag den ISden October 1856* M TROÜWRIJVG TOONEELSPEL IN DRIE BEDRIJVEN. (vier tafkreelen.) Aanvang precies ten lialf nclit ure. Toegang-billetten voor een heer of eene dame ƒ 3.— een kind ƒ 2.—; besproken plaatsen 60 duiten. Het bespreken der plaatsen geschiedt op den dag der representatie aan het bureau van het Komedie-gebouw van 's morgens acht tet 's namiddags twee ure. Men gelieve zich bij het verlaten der zaal van een contramerk te voorzien. In het lokaal; mag niet gerookt worden. (565) Pi H. Anïkn Horologiemaker is verhuisd haat de Boomstraat ten huize van den Heer J. H; Rosemeieu. » -'■- .' ; (558) SOCIËTEIT CONCORDIA. THE DANSANT. 6>p Donderdag den 9den Oclober 1858. Namens de Directie ; \)\\\ De Secretaris | . (548) GROLMAN. ONTVANGEN PER DANDA. Een groot assortiment NIEUWE MUZIEK voor Piano van / 0.50 /1 2 3 4 het stuk. BEIJER'S MELÖDIÉN-BÖEK verzameling van 100 diverse melodien voor eerstbeginnenden. Bijzonder goedkoope KANTOÖRBOEKEN met koper beslag. ..... PAPIER CHINOISE «ui PAPIER DE LUXE ENVELOPPES DITO. ' GOMOUWELS met figuren. Bij (569). HARTENS 4 CO. PAS ONTVANGEN Bijzonder VERSCHE ZOETEMELKSCHE en LEIDSCHE KAAS groote HAMMXN SELTZERWATER op halve kruiken puike BOTER PORTWIJN op halve flesschen MARASCHINO MÜSCAAT WIJN en VINAIGRE a L'ESTRACON. (559) . GEBR. van DELDEN. Fijne op snee vergulde SPEELKAARTEN in doosjes van 2 spellen a'ƒ• :3.—-' per doosje. Idem idem a / .12—\ het doz. (570) -MARTENS & CO. FIJN ZWART LAKEN. ; do. do. SATIN DÉ LAINE. do. do en GEKLEURDE TRICOTS voor-broeken. ■■~ ; ZEPHIR WOL geassorteerd per pond bij (572) DE STURLER 6c CO. GÜYOTS ENCRE DE LA PETITE VERTU in kruiken van / 1 2 3. Bij MARTENS & CO. Deze inkt is sedert 1602 algemeen als de-beste bekend en vloeit niet (569) SJMPMMCHE APOTHEEK. VERSCH!<: GROENTEN ZADEN. (556) 4 J; SBITT.",http://resolver.kb.nl/resolve?urn=ddd:011060065:mpeg21:a0006:ocr,3,ddd:011060065:mpeg21:p003,"De Oostpost : letterkundig, wetenschappelĳk en commercieel nieuws- en advertentieblad",2105
1885912,1856/11/28 00:00:00,1981,ddd:011084733:mpeg21:a0015,http://imageviewer.kb.nl/ImagingService/imagingService?id=ddd:011084733:mpeg21:p003:image&x=53&y=89&w=952&h=1981,ddd:011084733:mpeg21,1005,2070,53,89,4,"Puike Hammen Boter I'. en 2"". soortj Sellservvalér in '/ kruiken Azijn -?> 2*. '■ soort Haantjes1 Bier van Reudvrp z. m.- Ziwiiserschc-cn Leidsche Kazen—Likeilren van JVijnand Fockimj en andere merken Sl. Nicolaas Gebak Banket eti Suikerwerkj Pepermunt henevens een 'factuur Galanteriën waaronder vele voorwerpen"" geschikt voor St. Nico- Ina» Cadeau* als: Albums Portefeuilles Poitemonnaies Toonecl-kijkers 'Schilpadden \Verk» Sigaren en Naalden-doosjes etc. bij (1053)  JANSCHELTEMA. ST. NICOLAAS FEEST. Dc ondergeteekende liecft dc ccr te bcrigten dat liij ontvangen keurig mooi speelgoed cn diverse andere' artikelen bijzonder geschikt voor schenken bij gelegenheid van het St. NICOLAAS FEEST; zijne toco -zal op den avond van Vrijdagden vijfden en Zaturdag den zesden December aanstaande fraai verlicht en geheel voor dat feest ingerigt zijn. Hij neemt de vrijheid zich in ieders gunst aan te bevelen cn te verzoeken dat men dien avond ter voorkoming van verwarring comptant bctale. J. SIEDIJK. Samarang 28 November 1856. (1051) Brand Assurantie Maatschappij PHOEUIL Gevestigd te hondon sedert IÏB3 ONGELIiUITEÈttD KAPITAAL De ondergetcekcnden Agenten dezer Maatschappij blijven voortdurend verzekeringen sluiten tegen Brandschade op Woon- cn Pakhuizen Meubelen Koopmansgoederen enz. zoo inede op Suiker- Koffij- en Thee-établissementen. Dc verzekeringen zijn onmiddelijk van ; kracht zoodra dc behoorlijke opgaven cn aanvragen zijn bewerkstelligd. C. DAMNITZ & CO. (1055) lc Samarang.",http://resolver.kb.nl/resolve?urn=ddd:011084733:mpeg21:a0015:ocr,3,ddd:011084733:mpeg21:p003,Samarangsch advertentie-blad,952
21238,1856/10/04 00:00:00,37,ddd:000011596:mpeg21:a0021,http://imageviewer.kb.nl/ImagingService/imagingService?id=ddd:000011596:mpeg21:p004:image&x=1266&y=136&w=574&h=37,ddd:000011596:mpeg21,1840,173,1266,136,4,Al>VtiKTl_Vril_Ar.,http://resolver.kb.nl/resolve?urn=ddd:000011596:mpeg21:a0021:ocr,4,ddd:000011596:mpeg21:p004,Dagblad van Zuidholland en 's Gravenhage,574
6990480,1856/01/25 00:00:00,5256,ddd:010584436:mpeg21:a0016,http://imageviewer.kb.nl/ImagingService/imagingService?id=ddd:010584436:mpeg21:p010:image&x=1577&y=21&w=1330&h=5256,ddd:010584436:mpeg21,2907,5277,1577,21,10,"8.. n TN. SURINGAR Boekverkooper in den Rotlef-  Vrosnius op de Kelders te Leeuwarden xs verschenen: np""PROVINCIALE ALMANAK VAN FIUKSm UCi *»*v"" _. MIST «HBIHKELJAIB issc. .„ Kalender vindt men hierin het Koninklijk GW„ i Behalve den g»^ c„ o«iMfto daarvoor . Staten-Generaal even:^„„iheden etc. etc. alsmede An van Buitenlandsche .icy <>}cweStelsjk Bertin ik 1 _ Tnwendia Burgerlijk Beheer als de Militaire en A„  'GamZuJ als ook de «#e 2«to__i^gl po» Vervoer *°\f'x^m-> en vermeerderingen die dezen Almanak 6J Onder de vele verbeto g^ ondergaßn behoo]t ondw jj* voorleden jaar oo  eene abel der Landmaat aanwijzende de v Dienst vanden Rijk* JU Ugaj  >! ding tusschen. i^^^--» vertKk en aai)komst der verschiUendO„ weder daaraan is toegevoegd. Bij denzelfden is mede verschenen en aan de Inteekenaren verzonden: DE VIJFDE AFLEVERING DER wmmm gbschiedib van het dieremi Prof. X VAU DER HOEVEN. j Deze aflevering behookt tot het derde deel dek geheel __~- UITGAVE van: J. A. ÜILKENS. DE VOLMAAKTHEDEN VAN DEN SCHEPPER IN ZIJNE SCHEPSELEN BESCHOUWD TOT VERHEERLIJKING VAN GOD KN TOT BEVORDERING VAN ÏSUTTIGE NATUURKENNIS. Herzien en op de tegenwoordige hoogte der Wetenschap gebragt door Prof STAKER Dr E M. BEIMA. Prof. C. J. MA ITH Eb. Prof. J. VAN Dp HOEVEN Prof' H. C. VAN HALL. Prof. F. A. W. MIQUEL. Van hetzelfde werk is ter perse  de vSjltte aflevering des tweeden deell terwijl het eerste vierde en vijfde deel dezer belangrijke uitgave reeds». heel voltooid het licht zien verrijkt met de in staal gegraveerde Portretten « Newton Htjmbolt Llnnaeus en Leopold von Bucii. * ***** I>V Geiïrs- BORGRINK te Leeuwarden is uitgegeven en alom» ***** I'l'kriigbaar gesteld: CHRISTUS HET HEIL DER KERK zigtnaar inden ontwilskelingsgang- van liet ftodsrijk op aarde Een woord ter behartiging aan alle Evangelische Christenen opgedragen door K. van BELKTJM Schrjtt van „Dr. Martinus LüTnEK"" de Christelijke Bode"" enz ƒ2 Verders debiteren zij met succes: Wet op l»et fitegt van Successie en op dat van Overgang lij Overlijden ƒ 1-8(1 De Heer de Gelder in den „Recensent"" 1852 van deze Wet sprekende zef er van: „Men ziet hieruit dat het werk eene nuttige strekking heeft."" „Wij prijzen dit werkje gaarne aan."" Meerder hierbij te voegen is overtollig. Boyengenoemden nemen bij dezen tevens de vrijheid hunnen BOEK- en Pi PIERHANDEL bij het geëerd Publiek aan te bevelen. De nieuwst uitgekomen! Werken in alle talen en wetenschappen — benevens vele soorten van Schrijf Post- en Pakpapieren Teeken- en Bureaubehoeften zijn er steeds tegen tój'i prijzen te bekomen. ******* F!koor en Boekhandelaar H. KUIPERS op den hoek van de Weet! *** V over de Lange Pijp te Leeuwarden is uitgegeven en alom ra krijgbaar gesteld: HET KARAKTER DKll HAKSK_WK_ S 5» E H. E „ £8 EB BC I 11. Vrij bewerkt naar het Fransch van MATTER door W. B- _. V.IX EÏK Theol. Doet. en Pred. te Deventer. Prijs ƒ O.GO. V lETS NIEUWS EN GOEDKOOPS! TAN BRUTEN # BLEEKER te SNEEK Lebben algemeti verzonden: MET PRACTISCH VOLKSBOEK. MUSEUM VOOR KUNSTEN EN WETENSCHAPPEN. vooral in hare toepassing op het dagelijksch leven. ONDER MEDEWERKING VAN EENIGE VADERLANDSCHE GELEERDEN. MET HOUTSNEDEN en uit te geven in NUMMERS «> M> kolommen zeer compressen druk tegen den RUITW WOON LAGEN prijs van slechts 10 CENTS per nummer. Het doel dezer uitgaaf is om verschillende onderwerpen uit het gebied* »A™_H. KUNST en Hi;m«im. populair doch tevens volle* e behandelen. Voor eene zeer algemeene verspreiding is de prijs buitenge** aag gesteld waarom de Uitgevers het in de attentie van iedereen zeer aai*; len. Men zie overigens den Prospectus en No. I—4 die in eiken Boekw»*1 voorbanden zijn. Buitengewoon goedkoop Papier. Wfi?ißTP^TS™.EEKSCIIE VERBi-™™r> met eene der eerste PAWgS ¥1 BRIEKEN zyn alle soorten van VELIN SCHRIJF- en POSTPAP»* uitmuntend SCHOOLPAPIER en dito GmNEERD wat de xeM 2 M r f\T J*""_ 9eene hoging alsmede PAK- of ZAKJEf^ Ttee- ™Bfwllonde1 kwaliteiten voorhanden bij Van DRUTEN & &***». te Sneek die tevens door het bezit eener uitnemend werkende SHELPERS EN STEMPEEPERS i „Lïgm""!1HgeStold Zijn' ALLE MOGELIJKE SOORTEN van »*J ££_'__ *J__™?_? H°OÖDRÜK -n'voorletters «U-*.»* Bij bovengenoemde"" _ to^™^™' enz. VEEL VERMINDER! >E PRIJZEN SSvooTlV^.o ««KHWKRKKï van de voorlaatste j«r«» ? *B. ÏS £vol?f ELSCHAPPEN LEESBIBLIOTHEKEN «g ? loverd dan _ fontam bU'tenSew°°n lage prijzen wordt het Pap.er *""e'",http://resolver.kb.nl/resolve?urn=ddd:010584436:mpeg21:a0016:ocr,10,ddd:010584436:mpeg21:p010,Leeuwarder courant,1330
2293672,1856/02/29 00:00:00,1636,ddd:010584446:mpeg21:a0035,http://imageviewer.kb.nl/ImagingService/imagingService?id=ddd:010584446:mpeg21:p007:image&x=1525&y=110&w=1402&h=1636,ddd:010584446:mpeg21,2927,1746,1525,110,8,»e Notaris TROMP te Bergum zal op Maandag 3 Maart 1856 des namiddags te 4 uur iv de Herberg van Minze Krol te Gary'p  finaal verkcopen: Eene HUIZINGE met SCHUUR ERF en BOOMGAARD staande en gelegen te Garijp in het Westeinde  bij den verkooper in eigen gebruik  bekend in de gem. Bergum sectie C nos. 539 540 en 541 zamen groot 33 roede 70 el. In eigendom behoorende aan G. J. Heddema en 12 Mei e. k. te aanvaarden ; staande op f 804. PUBLIEKE VERKOOPING VAN EEN KOREN- PEI- EN MOMMEN ENZ. bij j__ oj_ i_ ._r__r. De Notaris C. H. BEEKHUIS te Buitenpost zal ingevolge regterlyko authorisatie op Woensdag den 5 Maart 1856 's namiddags 4 uur ten huize van W. Hoekstra Kastelein te Kollum publiek by stry'k- en verhooggeld presenteren te verkoopen: 1. Een in volle werking zijnden KOREN- PEL- en MOUTMOLEN de Duif genaamd met WONING Erf en Tuin staande en gelegen aan do Westzijde van den Trekweg ten Zuiden van- en bij Kollum. 2. Een stuk BOUWLAND en SINGEL aldaar ten Zuiden van den Molen gelegen  groot p. m. 1 b. 30 r. Een en ander bij Jan Jacobs Formsma in eigen gebruik; de Molen c. a. op den 12 Mei 1856 en het Land dadelijk te aanvaarden. DEZELFDE NOTARIS zal op tijd en plaats voormeld krachtens art. 1223 B. W. presenteren te verkoopen: Eene voor weinige jaren nieuw gebouwde en zeer geschikte WINKEL-HUIZING met Erf en Tuin staande en gelegen aan de Voorstraat te Kollum bij Hendrik Ronnes Meersma in eigen gebruik; 12 Mei 1856 te aanvaarden. DEZELFDE NOTARIS zal Donderdag den 6 Maart 1856 's namiddags 4 uur ten huize van Sjoerd Mients Binnema Kastelein te Optwyzel presenteren te verkoopen: 9 b. 74 r. 50 e. BOUW- WEID- en HOOILAND gelegen onder Optwijzel behoorende tot de nalatenschap van Wijlen Jan Annes Kuipers; in perceelen zoodanig by Billetten zijn omschreven. Al wie iets te vorderen heeft van verschuldigd is aan of papieren en bescheiden onder zich mogt hebben behoorende tot de nalatenschap van wijlen den Heer CORNELIS JANSZ. FEDDES op den 2 dezer overleden te Dresden wordt verzocht daarvan vóór den 4 Maart aanstaande opgaaf of inzending te doen aan den Heer C. H. BEEKHUIS Notaris te Buitenpost. Leeuwarden den 25 Februarij 1856.,http://resolver.kb.nl/resolve?urn=ddd:010584446:mpeg21:a0035:ocr,7,ddd:010584446:mpeg21:p007,Leeuwarder courant,1402
2816712,1856/09/04 00:00:00,2698,ddd:011060055:mpeg21:a0008,http://imageviewer.kb.nl/ImagingService/imagingService?id=ddd:011060055:mpeg21:p003:image&x=2176&y=2262&w=1044&h=2698,ddd:011060055:mpeg21,3220,4960,2176,2262,4,Extra fijne SPEELKAARTEN verguld op snede  in doosjes a ƒ 3.— Extra fijne SPEELKAARTEN verguld op snede a f 12.— per dozijn. Extra fijne HOMBREKAARTEN a ƒs.— per dozijn. Benevens een factuur SCHRIJF- en KANTOOR-BEHOEFTEN  PAPIER DE LUXE EN VELOPPES TEEKENALBUMS fraaije PORTKFEUILLES en PAPETEKIEN TAFEL- en KANTOOR-SCHELLEN  KINDER-PRENTEBOEKJES enz. Bij (458) MARTENS & CO. Te Bekomen bij E. PUHRI. T. B. Macaulay. Geschiedenis van Engeland. 3 dln Idem. Keur van redevoeringen. S. Bleekrode. Jaarboekje van kunsten en wetenschappen. 1846—18*2. 5 dln. Cu. Dickkns. Tafereelen uit de geschiedenis van Engeland. Met platen. Mary Howitt. Du klokkenmaker. Onze tijd. Merkwaardige gebeurtenissen onzer dagen. Deel XVI. Met de kronijk van 1855. Soerat hoekoem ondang ondang atas tanah Hiudie Nederland. (401) IN COMMISSIE ONTVANGEN Een fraai assortiment MUZIEK voor PIANO; bij (460) MARTENS & CO. VIOOLSNAREN. GUITAARSNAREN. ELASTIEKEN. PASSERDÖOZEN. VERWDOOZEN. KRAIJENHOF'S PASSERS. Fraaye ivoren PENNEHOUDERS EN PENNEHOUDERS van perle d'amour. BRISTOL PAPIER. ZAK-THERMOMETERS. KALENDERS. . VELLUM CLOTH. Per el. (TEEKENPAPIER.) GOM ME GRATTOIRE ANGLAISE. . MAMMOUTH GOLD PENS. Te verkrygen bij (332) E. FUHRI. LIMONADE GAZEUSE in '/ en % fl. GINGERADE en SODAWATER. Bij (452) LEDEBOER Ac COi,http://resolver.kb.nl/resolve?urn=ddd:011060055:mpeg21:a0008:ocr,3,ddd:011060055:mpeg21:p003,"De Oostpost : letterkundig, wetenschappelĳk en commercieel nieuws- en advertentieblad",1044
3445897,1856/11/08 00:00:00,1729,ddd:010397750:mpeg21:a0043,http://imageviewer.kb.nl/ImagingService/imagingService?id=ddd:010397750:mpeg21:p004:image&x=1075&y=2361&w=1993&h=1729,ddd:010397750:mpeg21,3068,4090,1075,2361,4,"BELANGRIJKE VERKOOPING "" ROEKEN PLAAT WERKEN en P RENTEN le ROTTERDAM. Op MAANDAG den 24 NOVEMBER 1856 en volgende dagen zullen de Boekhandelaren J. VANBAALES EN ZONEN ten overstaan van de Notarissen SANDER en PAATS in het Lokaal der Publieke Verkoopingen aan de Gelderschekade te Rotterdam  publiek verkoopen : Eene uitgebreide en belangrijke Verzameling BOEKEN onder welke gevonden worden: In Folio Bijbels waaronder een prachtig Exemplaar met de Platen van Luyken Scheuchzer; een groot-papier Pracht- Exemplaar van Flavius Josephus  Moubach  Lesage Cats Pothier Buohoz Nozeman en Sepp Vogelen; Audebert Singes; Weinmann  Knorr  Monfaucon  I'Antiquité enz  enz ; een heerlijk Exemplaar van de Atlas van Blaauw in Ebbenhouten Kast; van der. Maelen  Atlas van le Vasseur enz. — In Quarto  Bijbels waaronder van van der Palm en goede Theologen; een Fraai Exemplaar van Vondels Werken' Scheller Drapiez  Herbier; een Uniek Exemplaar van de Oeuvre» de Roussean: de Gebelin  Monde Primitif enz. enz-. — In Octavo eene groote Verzameling der beste Godgeleerden Historiëlen en Reizen; eene Verzameling Dichters en Taalkundigen; eene uitgebreide Verzameling Regtsgeleerden voornamelijk het Moderne FRANSCHE REGT als: Corpus Juris van Beek: MERLIN 52 vol.; LOCRÉ PAILLIEÏ THOULLIER TROPLONG 21 vol.; ANNALES DU BARRE AU 20 vol.; BULLETIN DES ARRETS DE LA COUR DE CASSATION 128 vol. enz. enz.; Natuurkundigen  waaronder een heertijk Exemplaar van Buffon en Lacépede ; eene Verzameling over Geologie en Mineralogie; eenige Geneeskundigen en eindelijk eene uitgebreide Verzameling Romans en Mengelwerken hoogst belangrijk vooral voor de Fransche Letterkunde. Eene belangrijke Verzameling PLAAT- en PRACHT WERKEN waaronder LA BIBLE par DE SACY PARABLES OF OUR LORD; VIE DE NAPOLÉON; THE CORONATION OF GEORGE IV; DESGRIPTION DE L'EGYPTE; HF.NTZEY MONTAGNES DE LA SUISSE; de Pittoresque Reizen van ZLJRLAUBEN en ST. NON; COIGNET L'ITALIE; een zeer Fraai Exemplaar van AUDEBERT en VIEILLOT met Goud gedrukte Onderschriften; een Koninklijk Exemplaar van het beroemde MUSÉE FRANCAIS et ROTAL io 6 Deelen; SPECIMENS OF SCULPTURE; het Werk van WEIROTTER en van CHALON; L'ILLUSTRATION compleet in 24 Fraaije Banden; Cabinets de CHOISEUL et de POULLAIN  en eene menigte Fraai Geïllustreerde WERKEN  meest alle in de rijkste Maroquinen Banden  verguld op snede. Eene Verzameling Kapitale Moderne Engelsche PRENTEN en STEENDRUKKEN ; eene groote Partij Oude GRAVURES en ETSEN en eindelijk eenige TEEKENINGEN en ALLERLEI waaronder een Kastje met Afgietsels van Cameën  een Thelescoop Rijkers en Boekenkasten. De Boeken zullen te zien zijn op Vrijdag en Zaturdag 21 en 22 November op de gewone uren. Voor de bezigtiging van de Plaat- en Prachtwerken  moderne en oude Prenten  Teekeningen en Allerlei» adressere men zich aan de Boekhandelaren /. VAN BAALEN en ZONEN van Donderdag 13 tot Donderdag 20 November. De Catalogus is a 25 Cents bij bovengenoemde Boekhandelaren te bekomen  alsmede te Amsterdam bij den Boekhandelaar FREDERIK MULLER _enje 's Hage bij den Boekhandelaar W. P. VAN STOCKUM.",http://resolver.kb.nl/resolve?urn=ddd:010397750:mpeg21:a0043:ocr,4,ddd:010397750:mpeg21:p004,Rotterdamsche courant,1993
3107178,1856/02/08 00:00:00,3257,ddd:010544709:mpeg21:a0016,http://imageviewer.kb.nl/ImagingService/imagingService?id=ddd:010544709:mpeg21:p003:image&x=2019&y=1511&w=954&h=3257,ddd:010544709:mpeg21,2973,4768,2019,1511,4,"FIMIBMINBERIfffi. Fe db *> tBLISGS PATENTSTIJFSEL. WÈtiÊÊm^fflCb BEKROOND a^jsj§||j||jyF^3 l^e PrÜs va"" bovenstaand Ar- ILXï^^^^^^X tikel is' vau af heJeu' weder _ sèstt\Jir gesteld op ƒ 3250 per 100 Pakjes (50 K°.) gepakt als naar gewoonte. Wormerveer. CORNs. PRINS Cz. 5 Februarij 18 56. Bloemzaden NIEUWSTE en FIJNSTE voor den TUIN van BUITENLANDSCHE CULTUUR. 50 der schoonste soorten van ƒ 250  benevens Prijscourant vau alle Planten en Zaden  in schoonste sortering bij Haarlem Febr. 1856. H. POLMAN MOOY Bloemist en Zaadkooper. *#* NATIONALE MILITIE. De ondergeteekende berigt door deze aan zijne geeerde Begunstigers dat hij even als in vorige jaren zich belast met het stellen van PLAATSVERVANGERS en NOMMERVERWISSELAARS. J. MAAS. Sint Jansstraat over het Gouvernement te Haarlem. Berigt. J. W. SON Taodiueester en vervaardiger van Kunsttanden  zal Maandag 11 dezer te spreken ofte ontbieden zijn bij den Heer P. R. GROENE WOUD te' Enkhuizen; 12 dezer bij den Heer BAKKER te Medemblik; 13 en 14 dezer bij den Heer K. dk VRIES op het Breed te Hoorn; verder aan zijne woonplaats Sint Antoniebreedstraat over de Ooijevaar te Amsterdam eiken Dingsdag bij den Heer T. KLOPPENBURG te Purmerende uitgezonderd den 12den dezer. Men wordt verzocht op personen te willen letten die rondzwerven en zich voorgeven namens hem te practiseren. *** In een der schoonste en gezondste oorden van Gelderland biedt zich in een stil ordelijk Huisgezin uit Moeder en twee volwassen Dochters bestaande voor eene fatsoenlijke Dame op aannemelijke voorwaarden de gelegenheid ter INWONING aau. Ook bij ziekelijken toestand kan men op de meest zorgvuldige verpleging staat maken. Adres met franco Brieven onder Lt. 8. aan den Boekhandelaar J. V. SCHATTENKERK te Doesborgb. %* In de omstreken van den Vogelenzang Bloemendaal of Velsen wordt verlangd: Een BUITENVERBLIJF voor de Zomermaanden minstens drie Kamers met Keukentje eu Tuin bevattende. Aanbiedingen franco aan het adres van den Heer TOM BERGH Makelaar te Haarlem. ""%» T E HUUR: Eene welbeklante uitmuntend ter nering staande BROODBAKKERIJ  met de daarbij behoorende GEREEDSCHAPPEN te aanvaarden 1° Mei e. k. Te bevragen met franco Brieven  ouder Letter Z.. aan den Boekhandelaar F. G A. J. van WERKHOVEN te Alphen a/d Rijp. ""%♦ TE HUUR te Legden: Een kapitaal ruim zeer logeabel HEERENHUIS met TUIN gelegen op een der aanzienlijkste Standen (Hooigracht). Te bevragen bij J. C. WENDEL Mr. Huisverwer Rapenburg hoek Heercnsteeg Wk.IV N°. 865 aldaar. *1* MET p°. APRIL TE HUUR: De alleraangenaamst gelegen BUITENPLAATS BERBICE  onder Voorschoten drie kwartier afstands van Leyden met derzelver roijale Huizing bestaande uit zeven Beneden- en negen Bovenkamers bijzonder geschikt voor Zomer- en Winter-Verblijf Te bevragen bij den Eigenaar F. H. van ITERSON op den Huize Berestein onder Voorschoten",http://resolver.kb.nl/resolve?urn=ddd:010544709:mpeg21:a0016:ocr,3,ddd:010544709:mpeg21:p003,Opregte Haarlemsche Courant,954
2018016,1856/06/21 00:00:00,2016,ddd:010780092:mpeg21:a0004,http://imageviewer.kb.nl/ImagingService/imagingService?id=ddd:010780092:mpeg21:p004:image&x=1111&y=63&w=1001&h=2016,ddd:010780092:mpeg21,2112,2079,1111,63,4,"_. Zestig- perceelen <_KA$ in %& LANDEN . onder üosïerwdlde eu __wjfL™c=/(^.--5_rfi; omliggende dorpen zoodanig hcnËitW-- 1"" -■'■ &:. »»■ -'.A ;: '-' schreven zijn hij billenen daarvoor Ier lezing opgehangen in de herbergen van POSMA en SCHADE te Ooslcrwolde. DOKTER en DE GROEN ie Donkerbroek.-- Weduwe SCHURER en LEGENDAL ie Makkiriga. — BOSCH en CLOU ie Appelscha — DE VRIES te Elsloo — en de Weduwe TEN HOOI! ie Ilaule. Mt. S J. 00STIXG. Nouuïs Ie Eniinen  zal leu verzoek0 ""„oer principalen op DINGSDAG de.i 1 Julij 185G- des mor geus Ie 0 ure Ie Zand c;_. gemeente Odcoru. Jen huize van den kastelein G. II. HINKEN aldaar zonder nadere |i al uislag PUBLIEK VERKOOPEN: t/is Hamleden in de KA- W\# VJKÏvüA'GEX Nos. 9 en 10 van - hel Vallbervceu melde 45..DKK.<.■■ gro\H„X zijnde deze heide KAVEU\r>i__ puik best Tï'R. VEKS en te zanicn groot 19 ISunders. 44 Roeden eu lü Ellen Mr. S. J. OOSTING. Op MAANDAG den 14 .Tufij 1856. 's nadpmiddags om 4 uren. zal in de Herberg van II. K. WAI.DA Ie Smilde _»(L'81__E__ WORDEf VEK3S1J _IB.3> : Eene BOEKBXl'liAATM.sc- tikA legen aldaar lx slaande uit HUIS _HP§>_il._na_B___ »iCBÏl'_:__ eir pi. 111. vijf en iwitir».„„f-^i^iaa I'S bunders «R_i- en MOr.V- IjAjV© en vijf bunders toegemaakte DALCIROXD. De voorwaarden liggen ter lezing ten kanlore van Mr. C. E. KNII'IIOHST Notaris ie Znidlarcn en hij den Eigenaar Mr. P. VAN DEK VEEN ie Smilde. De lieer Mr. II. EDELINCK cum sociis ie Groningen zijn voornemens na bekomen atilhorisalic PUBLIEK TE DOEN VERKOOPEN. ten overslaan van den Notaris SL1NGENUElli; ie Coevorden. op DINGSDAG den tweeden September aanstaande des avonds om 7 uien: Eene BOKKEXPLAATS gc#Sr»'#___Ér/ x-f-* .4 '°'5en aan.de Vicht bij Coevorden beslaande uit ecu WELGEBOUWI) «_LJ__-Si_I .g;»Iy£ cm soedouilerhoudeil ill !_ en —; ■■---•-*» mill'l'K. circa veertien bunders best HOOI- en .VEIOELAVD  ruim zes bunders uitmiiiilend BOli.VI.AX» twaalf K»E\VEIBE_ in de Mars. een ZAADVEEX groot circa acht bunder» BOÏIWI.AXO  IKO»II__\O en VEE_ alsmede de iu Slceiivvijksmoer en eenige stukken VELOCBOXB. Informatiën zijn ie bekomen hij den Nolaris Coevorden lü Junij 185(i. A. SLINGENBERG.",http://resolver.kb.nl/resolve?urn=ddd:010780092:mpeg21:a0004:ocr,4,ddd:010780092:mpeg21:p004,Provinciale Drentsche en Asser courant,1001
2932525,1856/09/24 00:00:00,2861,ddd:010772012:mpeg21:a0005,http://imageviewer.kb.nl/ImagingService/imagingService?id=ddd:010772012:mpeg21:p004:image&x=1075&y=66&w=1025&h=2861,ddd:010772012:mpeg21,2100,2927,1075,66,4,"111. De EIGENDOM van pi. m. 6 Bunders LAND gelegen op Aalsurn onder Oldè/wve bij PIETER F. VONK onder beklemming in gebruik voor eene jaarl. op Midw. versch. huur van ƒ 40 — 00. IV. Een GRAF op de Zuider Begraafplaats te Groningen in de lste Klasse 2de Rij no. 46. Behoorende tot de Nalatenschap van wijlen den Heer J. de JONGE en Mejufvrouw. V. Eene roijale nieuws doortimmerde KOOPMANS of HEEREN BEHUIZING get. O 37 met OPEN PLAATS en TUIN er achter Oostzijde in de Nieuwe Ebbingestraat te Groningen op eigen grond wordende door J. M. LUIDER en Mejufvrouw in eigendom bewoond. Inmiddels UIT »K HAAD TK HOOP. VI. De EIGENDOM van eenèn grooten BEHUISDEN MOESTUIN gelegen achter Helpman onder Haren bij WARNER JANS VELTHUIS en Vr. onder beklemming in gebruik voor eene jaarl. op den lsten Mei versch. huur van / 32 — 00. VII. ADIDEM van ongeveer Bunder LAND gelegen aan den Wolddijk onder Noordwolde bij de Wedw. FOLKERT PIETERS POELMA onder beklemming in gebruik voor eene jaarl. op Midw. versch. huur van ƒ2l — 00. En voorts nog s VIII. Een TïlSf met daarin staand HUISJE en AFDAK zijnde ongenommerd gelegen achter in de Cubaof Blindesteeg Noordzijde buiten de Oosterpoort alhier doende 's jaars tot grondpacht ƒ 1 — 874 > door nu wijlen GOSSE H. MOLENBERG en Vrouw bewoond en gebruikt geweest. Om te aanvaarden: Perc. I en H op den lsten November 1856 Perc. V op den lsten Mei 1857 en de overige Perc. dadelijk na den Toeslag. Te btzien : Perc. I op den Verkoopdag en des daags bevorens van 10—2 uur op Toegangkaartjes in tijds ten Kantore van den Notaris te bekomen ; Perc. V en VIII op gemelde dagen  van 10—12 en van 2—4 uur en Perc. IV alléén op den Verkoopdag des namiddags van 2—4 uur. Nadere informatiën ten KANTORE van den Notaris. Woensdag don lsten October 1856 des voormiddags te 10 uur en verv.  zal vóór en in de Behuizing aan den Singel te Groningen  laatst door wijlen Mejufvr. de Wedw. J. de JONGE bewoond geweest publiek É worden verkocht: haar nagelaten ""Jêö«3». nette lAROEDEI; bestaande o.a. in MAIL CHIFFONIÊRE 2gHJ»' W KABINET  BUREAU  STAAN- « DE SPEELKLOK EIKENH. LINNENKAST MAH. en EIKENH. UITTREK- en andere TAFELS  STOELEN SPIEGELS met VERG. LIJSTEN SCHILDERIJEN PORSELEIN KRISTAL GLAS- en AARDEWERK  KOPER- TIN-en BLIKGOED best BEDDEGOED LINNEN- en TAFELGOED VLOERKLEEDEN CARPETTEN  KAGCHELS een KINDERAVAGKN eene partij TURF. Voorts «OU» en SSIIj- VER  waaronder een KERKBOEK met GOUDEN KRAPPEN en RANDEN dito OORIJZER HORLOGIE en hetgeen meer te bezien zal zijn daags bevorens van 10—12 en 2—5 uur. Mr. W. LAMAN TRIP Notaris. Op Maandag den 6den October ê ls< .1G  des voormiddags te 10 uur en vervolgens  zal  ten overstaan van Mr. 9_______l C. DE RAA'ITZ Notaris te Groningen  voor en in de Behuizing -"" '^fc van nu wijlen Mejufvrouw de Wedw. A. BOOMGAARD  te Groningen  aan de Vischmarkt publiek worden verkocht: Een nette lABOE«EL  bestaande o. a. in MAH. CHIFONIERES  STOELEN  EIKENH. KABINET  BUREAU met BOVENSTUK  TAFELS  STOELEN SPIEGELS  SCHILDERIJEN  STAANDE SPEELKLOK  2 KAGCHELS  OUD PORSELEIN  «OU» en 'M.IU.»ER LINNEN- en TAFELGOED KOPER- TIN- BLIK- GLAS-en AARDEWERK ENZ.  ENZ. Te bezien des ZATURDAGS bevorens  van 2—4 uur. Mr. C. de RANITZ  Notaris.",http://resolver.kb.nl/resolve?urn=ddd:010772012:mpeg21:a0005:ocr,4,ddd:010772012:mpeg21:p004,Groninger courant,1025
3071980,1856/09/11 00:00:00,2855,ddd:010086716:mpeg21:a0026,http://imageviewer.kb.nl/ImagingService/imagingService?id=ddd:010086716:mpeg21:p004:image&x=2352&y=2419&w=1076&h=2855,ddd:010086716:mpeg21,3428,5274,2352,2419,4,FRASCATI. GEDURENDE DE KERMIS ALLE AVONDEN: GROOTE SOIREES MUSICALES CHAMPETRES. SOUVENIR DU BOIS DE BOULOGNE. Entree fl gedeeltelijk in vertering. Aanvang 8 Ure. Jt. EDUARD STUMPgff. QDÉ Ö lt. 11 SEPTEMBER. VIJFDE CONCERT DER JOHANNISBERGER CAPELLE ONDER DIBECTIE VAN DEN Heer JULIUS LANGENBACH. Iste DEEL. 1. Ouverture Stradelia Flotow. 2. Hofballt'anzer Walzer Strauss. 3. Preludio uit Giuramento Mercadante. 2de DEEL. 4. Ouverture Euryanthe C. M. von Weber. 5. Aria uit Stradelia Flotow te zingen door Fraulein ZIÉGELER. 6. Potpourri der Maskenball K-mze. 3de DEEL. 7. Ouverture der Mulatte Balfé. 8. Aria uit I due Foscari Verdi te zingen door Fraulein ZIÉGELER. 9. Duet en Finale uit dc Bugenooten Meijerbeer. 4de DEEL. 10. Overture Fidelio Beethoven. 11. Schneeglóckchen Walzer Strauss. 12. Hurra Sturmgalop Ke'ler Be'la. Aanv. 8 Ure. Entree ƒl waarvan 40 c. in vertering. J. SCHEVEERS. CIRQUE EQUESTRE van E. Wol-sc-iiase-*. Op het Amstelveld. HEDEN DONDERDAG des Avonds ten 8{ Ure; Groote Engelsche Jagt zooals dezelve gewoonlijk in de uitgestrekte Bosschen van het Graafschap Wales in Engeland worden uitgevoerd. Voorafgegaan door: Het Programma der Werkzaamheden in de Manege. CÏBQUE FRAN9OISLÖISSET op de NIEUWE MARKT. HEDEN AVOND ten 8| Ure ; GROOTE VOORSTELLING volgens Programma. Groot Engelscli Circus van THs. PRICE £ ZOON op de Nieuwmarkt. AUe Dagen gedurende de KERMIS ten 6 en 8_ Ure: GROOTE VOORSTELLINGEN. le. Rang 99 Cts. 2e. Rang 60 Cts. 3e. Rang 30 Cte. GROOT BEROEMD HONDEN- lliillEATi OF KUNSTRIJDEN IN MINIATUUR BESTAANDE UIT 30 VIERVOETIGE KUNSTENAARS. APEN HONDEN EN MINIATÜURP AARDEN. tot heden toe nog niet op die wijze gezien van L. BRUCKMAN. Staande de smaakvolle elegante Tent op het Amstelveld. Eene Voorstelling des Avonds ten 6 en eene ten 8§ Ure. DONDERDAG 11 SEPTEMBER 1856: HET INDIAANSCH BANKET uitgevoerd in Nationaal Costuum. lIECW GRÖÖF COSIORAMISfiH STBRÉOSCOPISCH SALON van M. STILLE van Hamburg. in het van ouds bekende Café des Artistes Halvemaansteeg. De Voorstellingen hierin te geven bestaan uit de schoonste Vergezlgten Monumenten etc etc van Frankrijk Italië Zwitserland Algiers etc etc door de voornaamste Photographen van Parijs vervaardigd Dezelve z_n zóó verrassend voor den aanschouwer dat hij zich niet anders kan voorstellen dan op de plaats zelve tegenwoordig te zijn dewijl men geene Schilderij maar de Natuur zelve voor zich ziet. Men kome! zie! en oordeele. Entree 25 Cents. M. STILLE. Het Salon is geopend van des Namiddags ten 2 Ure.,http://resolver.kb.nl/resolve?urn=ddd:010086716:mpeg21:a0026:ocr,4,ddd:010086716:mpeg21:p004,Algemeen Handelsblad,1076
1998654,1856/09/02 00:00:00,2069,ddd:010544880:mpeg21:a0017,http://imageviewer.kb.nl/ImagingService/imagingService?id=ddd:010544880:mpeg21:p004:image&x=58&y=2769&w=966&h=2069,ddd:010544880:mpeg21,1024,4838,58,2769,4,".j____|. Men is voornemens op Woensdagen 24 Sep§&ljfetj|si tember en 8 October 1856 om 4 ure bij W..J. *«AïS_-_- van ENTER te Twello door den Notaris Mr. J. N. EVERTS te Twello bij inzate en toeslag te verkoopen: Een voor weinige jaren nieuw gebouwd HUIS met 5 Vertrekken en Achterhuis waarin Bakkerij en Winkel wordt uitgeoefend met TUIN en LAND te zamen ongeveer één Bunder groot bijzonder aangenaam gelegen op den hoek van den Straat- en Dorpsweg bij Twello op ruim \ uur afstand van Deventer zeer geschikt om tot HEERENHUIS in te rigten. Informatien bij boyengenoemden Notaris. Brieven franco. V OPENBARE VRIJWILLIGE .ERKÖOPING De Notarissen ARY HOGLRSDIJK residerende te Pynacker en JOHANNES HOGERSDIJK residerende te Rotterdam zullen op Donderdag den 18den September 1856 Veilen en op Donderdag den 25sten September daaraanvolgende finaal verkoopen beide dagen des namiddags ten een ure iv het natemelden Logement en Uitspanning de Gouden Koetswagen: Het van ouds gerenomeerde florisante bijzonder aangenaam en gunstig gelegen ETABLISSEMENT genaamd DE GOUHEN KOETSWAGEN ingerigt tot Logement en Uitspanning bestaande in : Kapitaal Huis w.arm Eetzalen Logeer en andere Kamers Keuken Kelder provisie en Domestiekenkamers Kleer- eu Turfzolders ; voorts een groot Koetshuis Hooizolder Stallingen voor 70 Paarden Openplaatsen en Erve alles staande en gelegen aan den Haagschen Straatweg even buiten de SrtadDelftGemeente Rijswijk Kadaster Sectie F Nos 322 bis en 395 groot 12 Roeden 60 Ellen. Aangeslagen in de Grondlasten op ƒ 6718. Kunnende den lsten October 1856 worden aanvaard. Nadere informatien te bekomen ten Kantore van voornoemde Notarissen. Het te Veilene kan dagelijks worden bezigtigd van voormiddags 9 tot namiddags 1 ure. V ""By KEMINK en ZOON te Utrecht is verschenen en alom te bekomen • VERSLAG VAST DE DERDE BIJEENKOMST VAV CHRISTELIJKE ONDERWIJZERS  gehouden te Utrecht den 17den Mei 1856 a ƒ-35. V Door L. G. POST te Purmerende is op heden uitgegeven en alom verkrijgbaar gesteld: HET WEZEN DER GODGELEERDHEID EN HARE BETEEKENIS VOOR WETENSCHAP EN LEVEN het Groote Vraagstuk van onzen Tijd door J. POST Gz. Predikant te Asch a f 12 a. >",http://resolver.kb.nl/resolve?urn=ddd:010544880:mpeg21:a0017:ocr,4,ddd:010544880:mpeg21:p004,Opregte Haarlemsche Courant,966
36411,1856/06/12 00:00:00,53,ddd:010901453:mpeg21:a0018,http://imageviewer.kb.nl/ImagingService/imagingService?id=ddd:010901453:mpeg21:p003:image&x=1442&y=1375&w=687&h=53,ddd:010901453:mpeg21,2129,1428,1442,1375,4,2Ururrtmttm.,http://resolver.kb.nl/resolve?urn=ddd:010901453:mpeg21:a0018:ocr,3,ddd:010901453:mpeg21:p003,Middelburgsche courant,687
79328,1856/08/30 00:00:00,74,ddd:010083579:mpeg21:a0021,http://imageviewer.kb.nl/ImagingService/imagingService?id=ddd:010083579:mpeg21:p003:image&x=1169&y=3676&w=1072&h=74,ddd:010083579:mpeg21,2241,3750,1169,3676,4,ADTBJ&TBH-flElf.,http://resolver.kb.nl/resolve?urn=ddd:010083579:mpeg21:a0021:ocr,3,ddd:010083579:mpeg21:p003,Algemeen Handelsblad,1072
1270016,1856/08/28 00:00:00,1408,ddd:010078556:mpeg21:a0015,http://imageviewer.kb.nl/ImagingService/imagingService?id=ddd:010078556:mpeg21:p004:image&x=1946&y=65&w=902&h=1408,ddd:010078556:mpeg21,2848,1473,1946,65,4,les aan- en bij elkander ter plaatse de Oggelen; Kadaster A 240 en 244 tot en . met 265 te zamen groot 10 B. 32 R. CO 1 ¦'.- Het Voorgras dezer perceelen heeft in 1855 opgcbragt 373.20. VERING DER PERCEELEN ONDER DE GEMEENTE ESCH Na de Veiling dezer Perceelen in zeven Koopen  worden de Koopen zamengevoegd  als: le) De veertiende en vijftiende Koopen. 2e) De veertiende  vijftiende zestiende en zeventiende Koopen. 3e) De dertiende  veertiende  vijftiende  zestiende en zevenlicndc Koopen . en 4e) Dc dertiende lot en met de achttiende Koopen. Be Houtgewassen op de Perceelen onder de Gemeente Esch hebben gemiddeld opgebragl f 96.62 jaarlijks. Nader onderrigt en inzage der extrakten uit de kadastrale leggers alsmede van het plan dei- Gemeente Esch  zijn te bekomen ten kantore van den Notaris %mLm:rm?>m& voornoemd teiwijl aanwijzing der Perceelen zal worden gedaan  als: Betreffende de Perceelen onder Hedel door WILLEM VAN HEESBEEN Gemeentes-Ontvanger aldaar. Betreffende de Perceelen onder Alphen  dooide Wed. JAN VAN BEN HURK aldaar en Betreffende de Perceelen onder Esch door ABRIANUS FAN HEN BROEK op de Buitenplaats B AAR SC II O T aldaar.,http://resolver.kb.nl/resolve?urn=ddd:010078556:mpeg21:a0015:ocr,4,ddd:010078556:mpeg21:p004,De Noord-Brabanter : staat- en letterkundig dagblad,902
4447740,1856/06/24 00:00:00,4395,ddd:000012735:mpeg21:a0024,http://imageviewer.kb.nl/ImagingService/imagingService?id=ddd:000012735:mpeg21:p004:image&x=69&y=566&w=1012&h=4395,ddd:000012735:mpeg21,1081,4961,69,566,4,"VAN DE Zwolse..»- lleclei-ijkerNkauier RHIJNVIS FEITH op Woensdag den 25 Junij 1856 des avonds te 7' uur in ODEON. Toegang; voor de buitengewone Leden te 8 uur. Viering van hei Si. .Jaii>»f'ee.-Jt door de drie ZZ.\ Loges van Overijssel in het O.' van Zwol/e op Zaturdag den 28 Junij 1856  des voordemiddags ten half twaalf uur. n. - — BURGEMEESTER f.n WETHOUDERS van ZWOLLE zullen op Maandag den. 30 Juuij 1856  des middags le 12 ure op het Stadhuis voor afbraak verkoopen het gebouw der gewezen Nlliltcrrafïiliadl-rij aan de Diezcrpoort te Zwolle ; en zulks op de voorwaarden die ter Secretarij ter lezing liggen. Zwolle 19 Junij 1856. Brrgemeesler en Weihouders uoomoemd  J. A. G. de VOS van STEENWIJK L. N. BCHUUBMAN Secr. Jtspj-f--^ *. *---. De algemeene rangschikking in den in TfljL -*»4^ staat van kennelijk onvermogen verklaarden •w»4--—»»»-«* boedel van D. P WAKKER marktincester te Zwolle is met do bewijz m op heden door den ondergeteekende ter griffie der Arrondissements Regtbank alhier reponeerd tan einde daar gedurende 14 dagen ter inzage te verblijven. Xwolle 24 Junij 1856. De Curator. '¦'''' ' Mr. .1. TIIIKBOUT. ]K9'-B***2ïF^* De schuldeischers in bet faillissement van SLIJPT jjL R. C. JANSSUN SJz. koopman en loodgieter te Zicolle worden opgeroepen om op Zaturdag den 28 Jnnij aanslaande des morgens ten negen ure te verschijnen in de Raadkamer der Arrondissements Regtbank te Zicolle ten einde aan te hooren de rekening en verantwoording  welke door de ondcrgeleekendcn ten overstaan vau den lieer Uegter-Commissaris zal worden afgelegd. Zwolle 23 Junij 1856. Mr. L. HERTZVELD Mr. W. P. HUBERT Curators. ""-**r^**^^H^Kte Ter voldoening aan Art. 1082 B.YY.wor- den de onbekende schuldeischers in den ¦pU^^^^ onder het voorregt vau boedelbeschrijving aanvaarden boedel en nalatenschap van wijlen WILLEM TIMMERMAN gewoond hebbende te Steenwijk opgeroepen te verschijnen op Dingsdag 8 Julij 1856 des voormiddags te 10 uren ten kantore van den Notaris I. J. FABIUS te Steenwijk  ten einde zoo wel aan deze als aan de schuldeisehers die bekend zijn REKENING en VERANTWOORDING te doen en hunnen schuldvorderingen te voldoen voor zoo verre het bedrag der nalatenschap toereikende zal zijn. JftTsa^tÈt^' Op Donderdag den 26 Junij 1856  zal iv JS^-vTJJö ne- Lokaal der Scholen het irewone HALFJARIGE EXAiTIEM DEKLKEKLIKGEIÜ van het Gymnasium alhier gehouden worden. Voor de nieuwe vakken 's morgens te negen uren en voor de oude talen te drie uren nadenniiddag. Diegenen welke verlangen zich voor den volgenden Cursus als LEERLINGEN te doen inschrijven  worden verzocht zich te dien einde zoo spoedig mogelijk bij den ondergeteekende aan te melden. Zwolle den 24 Junij 1856. C. 11. THIEROUT Ggmn. Reet. ZWOLSCHE HANDELSBEURS. ""<n~s^s^P»^ R ondergeteekenden doordrongen van Hjfl [^ het nut en de noodzakelijkheid  van de opsjj|i^^^^ rigting eener llamlel«l>eur*-' hier ter Stede noodigen hunne mede Handelaren die datzelfde gevoelen zijn toegedaan uit tot het bijwonen eener VKIIKIDVIItIXG op Donderdag deu 26 dezer  des avonds te zes ure precies in het Gebouw ODEON ter bereiking van dat zoo zeer gewenschte doel alsmede tot bet teekenen van een daartoe strekkend Rekwest aan den Stcdelijken Raad. Zwolle 23 Junij 1856. E. & M. A. JACOBS. OVINK & SCHELLEWALD. A. den BOUWMEESTEB & ZONEN. van ENGELEN & van LAER. PARKER & Comp. HENS & SCHAEPMAN. Oproeping van Organisten. r^^3^ -De *n aanmerking wenschen te komen "" ""$&? bij de vervulling der betrekking van orga•^¦JPII*BJJJ njs(. fler Hervormde kerk te Rijssen op een jaarlijks tractement van f 200  daar tevens behoefte bestaat aan een bekwaam Muzijk-Onderwijzer kunnen zich voor 15 Julij e. k. met vrachtvrije brieven adresseren aan den ondergeteekenden. Russen 18 Junij 1856. Namens Kerkvoogden G. ter HORST President. EEN SGHILDERSKNEGHT ||-***^-*S^> zijn werk behoorlijk verstaande kan dadelijk Qlp^^ voor minstens drie maanden werk bekomen bij A. BESSEM te Vollenhove.",http://resolver.kb.nl/resolve?urn=ddd:000012735:mpeg21:a0024:ocr,4,ddd:000012735:mpeg21:p004,"Provinciale Overĳsselsche en Zwolsche courant : staats-, handels-, nieuws- en advertentieblad",1012
2719134,1856/08/30 00:00:00,2658,ddd:010780112:mpeg21:a0001,http://imageviewer.kb.nl/ImagingService/imagingService?id=ddd:010780112:mpeg21:p001:image&x=35&y=1167&w=1023&h=2658,ddd:010780112:mpeg21,1058,3825,35,1167,4,Vergadering van den Raad der gemeente Assen op Dingsdag den 2 September IS5_  «les avonds te zeven ure. GEDEPUTEERDE STATEN der Provincie Drenthe brengen ter kennis van de belanghebbende Gemeentebesiu ren 'en Ingezetenen van deze Provincie dat door den Gemeenieraad van Smildc . onder hoogere goedkeuring is beslo' ten tot het houden eener Weekmarkt. op eiken Woensdag 1 aldaar en dat gezegde Besturen en Ingezetenen wanneer 1 zij daar tegen bezwaren mogien hebben die vóór den lOden \ September aanstaande schriftelijk aan dit Collegic zullen kun' r.en indienen. Assen den 27 Augustus 1856. Gedeputeerde Staten voornoemd DE VOS VAN STEENWIJK Voorzitter VV. H. HOFSTEDE . Griffier. GEDEPUTEERDE STATEN der provincie Drenthe brengen door deze ter kennis van de Besturen en Ingezetenen der belanghebbende gemeenten in deze Provincie dat blijkens ontvangene kennisgeving var. Heeren Gedeputeerde Staten der Provincie Groningen door den Raad der gemeente Haren is besloten om' de tweede JAAR-VEEMARKT aldaar Welke tot heden is gehouden op den tweeden Woensdag in de maand Augustus in het vervolg telkens op den tweeden Donderdag in de maand Auguslus te doen houden; en dat Wanneer bij de bedoelde Besturen of ingezetenen daartegen bezwaren mogten bestaan die bezwaren alsdan vóór den Östen September aanslaande aan dit Collegie schriftelijk «uilen kunnen worden bekend gemaakt. Assen 27 Augustus 1856. Gedeputeerde Slaten voornoemd. DE VOS VAN STEENWIJK. Voorzitter. VV. 11. HOFSTEDE. Griffier. EN WETHOUDERS der gemeente Assen «loen te weten- dat de schouw der waterleidingen in deze Semeeiile wegens den hoogen waterstand is uitgesteld tot ♦Jl de tien eerste dagen van September aanstaande en worden de onderlioudpligtigcnuitgenoodigd om hunne panden Mnog zoo noodig tegen dien tijd in schouwbaren staat te brengen.  Assen den 26 Augustus 1856. ___*_* ' De Burgemeester 11. J. OOSTING De Secretaris. KUMMELL. BEKENDMAKING. BURGEMEESTER en WETHOUDERS der Gemeente Aisen doen te weten dat de Inschrijving op de GELBLEEAIX_  die ingevolge raadsbesluit van 9 Augustus 1856 goedgekeurd door Heeren Gedeputeerde Stateu van Drenthe bij resolutie van 27 dezer maand no. 17. len behoeve der gemeente Assen tot een bedrag van f 2.00.00 zal worden gedaan ten kantore van den gemeente Ontvanger is geopend gedurende de dertien eerste dagen der eerstkomende maand September. Het plan der geld een ing ligt ter inzage ten Gemeentehuize en teil kantore van den Ontvanger der gemeente A ficpii Assen den 29 Auguslus 1856. De Burgemeester. 11. J. OOSTING. De Secretaris. KUMMELL. der. gemeente Assen doet te weten dat de bestrating van den Beilerweg zal aanvangen den 2 September aanstaande en dien ten gevolge de weg onder Assen van af het huis van Mr. /. A. W. Gratama tot aan klokslaanlje in het stadsbosch tegenover het huis van G. Popken voor de passage met rijtuigen gedurende eenige dagen zal zijn gesloten. Assen den 29 Aug. 1856. De Burgemeester voornoemd H. J. OOSTING.,http://resolver.kb.nl/resolve?urn=ddd:010780112:mpeg21:a0001:ocr,1,ddd:010780112:mpeg21:p001,Provinciale Drentsche en Asser courant,1023
2374050,1856/04/26 00:00:00,2499,ddd:010544774:mpeg21:a0021,http://imageviewer.kb.nl/ImagingService/imagingService?id=ddd:010544774:mpeg21:p004:image&x=66&y=2313&w=950&h=2499,ddd:010544774:mpeg21,1016,4812,66,2313,4,"*** VIT DE HAND TE HOOP. Eene zoo goed als nieuwe BAROUCHETTE voor vier Personen met losse Bok en Achterzitting; allezins geschikt voor een en twee Paarden ; als ook een dito EZELWAGENTJE. Te bevragen in persoon of met franc» Brieven bij H. van HETEREN Wagenmaker te Harmeleu. %* Men verlangt te KOOPEN: Een goed geconserveerd ORGEL geschikt om het gezang van drie a vijfhonderd stemmen te kunnen leiden de levering kan binnen drie maanden plaats vinden. Reflecterenden adresseren zich met opgave van renseignementen onder Letters D. M. tyj den Boekhandelaar 11. B. BREYER te Arnhem. ~ WORDT TE HOOP AANGEBODEN : 24 DEUR- E.\ RAAM KOZIJNEN met aauhoorende DEUREN en RAMEN: in Gothischen stijl bijzonder geschikt voor Kerkgebouwen. Adres met gefrankeerde Brieven onder Letter K. bij de Boekhandelaars A. van HOOGSTRATEN en ZOON te 's Gravenhage. BUREAU-ORGEL te KOOP gevraagd. Adres franco met informatie» aan J. de VRIJ te Winterswijk. ~£RÜ lste REGIMENT DRAGONDERS. tp£&& VERKOOPING op Maandag2B Aprila. s. •rFjggflJßii ten 12 ure precies aan de Kazerne te Haarlem van zeventien op rcforme gestelde PAARDEN. Zegt het Voort. *_*~ ORDE DER VERKOOPING welke gehouden zal worden door deu Makelaar .1. RITSEMA ten sterfhuize van den Heer O. F. Gehrels aan de Oudegracht W. 4 N°. 1014 te Haarlem. Dingsdag 29 April 1856 de Machines en Gereedschappen der Fabriek alsmede de Winkelgoederen  te beginnen met de Goederen  welke in de Gasthuisstraat voor de Stal verkocht zullen worden. Woensdag 30 April 1856 de Inboedel te beginnen met N°. 326 — 340 en vervolgens vau N°. 1 — 143. Ten 1 ure precies gemaakt Goud- en Zilverwerk en Boeken. Vrijdag 2 Mei 1856 Tafel- en Linnengoed gemaakte Kleedereu  Bedden  Kleeden Meubelen enz. te beginnen met de Kleeden op de Botermarkt vervolgens met N°. 144 tot het einde telkens des morgens ten 10 ure. •~^~~ ""CBASVBIL ING~ op Maandag 5 Mei 1856 op Halfwegen Haarlem en Amsterdam des namiddags teu 5£ ure ten huize van den Kastelein D. A. Hoogland in het Regt hui» van Houtrijk »n Polanen. ___ ZEGTHETJ^ORT. \* Op Zaturdag den 3den Mei 1856 's namiddags ten 5 ure zal iv het Locaal van Vcrkoopingen te Utrecht achter St. Pieter in het openbaar worden Een voor weinige jaren nieuw gebouwd HUIS met afzonderlijk Bovenhuis Achterhuis Erf en Tuin  waarin gemetselde Bloemenkast enGoudvischkom  groot4l Roeden  90 Ellen staande en gelegen te Utrecht buiten de Witte-Vrouwenpoort aan de Noordzijde van deßildtsche Steenstraat Wijk L Nn. 45. Breeder bij Biljetten. en nader onderrigt ten Kantore van den Notaris H. DUYFJES te Utrecht.",http://resolver.kb.nl/resolve?urn=ddd:010544774:mpeg21:a0021:ocr,4,ddd:010544774:mpeg21:p004,Opregte Haarlemsche Courant,950
2672000,1856/08/06 00:00:00,2672,ddd:010397669:mpeg21:a0045,http://imageviewer.kb.nl/ImagingService/imagingService?id=ddd:010397669:mpeg21:p004:image&x=2094&y=1294&w=1000&h=2672,ddd:010397669:mpeg21,3094,3966,2094,1294,4,"V Bij den Burgemeester zijn ontvangen Twee Stuks COUPONS 2è % W. S. ieder groot ƒ 12. 37J. Administratie-Kantoor Rotterdam. Dezelve zullen  volgens aanwijzing van den onbekenden Zender in Stads Kas worden gestort. Rotterdam den 5 Augustus 1856. V Het BESTUUR der Rottcrdnmschc Vereeniging voor Gymnastle- en Zwemscholen heeft de eer te berigten  dat van HEDEN af de gelegenheid is geopend om voor het nog overige gedeelte van het Ioopende Bad-Saizoen Halve Abonnements-Kaarteii te verkrijgen  aan het Locaal der Zwemschool tot de volgende Prijzen: Voor Baden in eene besloten Badkamer... ƒ6. 00. "" » » de algemeene Bassins 4. 00 „ eene Les per dag op de uren door den Directeur te bepalen . 5. qq Boven en behalve 50 cents voor het ""gebruik van Handdoeken. & Rotterdam 5 Augustus 185Ö. Het Bestuur voornoemd  H. VAN RIJCKEVORSEL Voorzitter. J. L. NIERSTRASZ Fung. Secretaris. H. HALBERSTADT XTmT i»'8 V-E11""»'»» «aar het Wolfshoek wijk 2 n? 295 nabij de LUTHERSCHE KERK. V De PRESIDENT der PROVINCIALE TOF vRrSlir""* GENEESKUNDE ONDERZOEK £ Inl n°p°£%%T '"" .ZUI°HOLLAND residerende te DORDRECHT verwittigt de Belanghebbenden dat de Lessen aan de Geneeskundige School te Rotterdam met September aanstaande zullen worden geopend; en dat zij welke verlangen van dezelve gebruik te maken  zich  met overlegging hunner geboorteaanmelden ter inschrijving Vrijdags van iedere week des middags ten twaalf ure. Tot herinnering dient dat voor de Mannelijke Leerlingen de ouderdom van 16 jaren e-n voor de Vrouwelijke die van tusschen de 20 en 30 vereischt wordt. Dordrecht 4 Augustus 1856. Dr. M. G. TIMMERS VERHOEVENr ftÖR^ J' BURG HART mm-WT ""f321"" aan zÜ""e geëerde Begunstigers bekend **"" dat hij dit jaar met zijne welingerigte WAFELKRAAM wederom geplaatst is in de magere Varkensteen:. de eerste Kraam van den Schiedamschendijk • belovende eene prompte en civiele bediening. ' Agm%fÊm^n Er wordt gevraagd  op een dorp nabij mffêmmW Rotterdam om ten spoedigste in diens' -Wf te treden  eene DIENSTBODE. tusschen de 30 en 40 jaren van goede Getuigen voorzien- Adres m Persoon of met gefrankeerde Brieven ondef letter A aan het Bureau dezer Courant.",http://resolver.kb.nl/resolve?urn=ddd:010397669:mpeg21:a0045:ocr,4,ddd:010397669:mpeg21:p004,Rotterdamsche courant,1000
1025430,1856/07/13 00:00:00,1330,ddd:010113108:mpeg21:a0016,http://imageviewer.kb.nl/ImagingService/imagingService?id=ddd:010113108:mpeg21:p004:image&x=2516&y=113&w=771&h=1330,ddd:010113108:mpeg21,3287,1443,2516,113,4,"Sociëteit Aurora gevestigd in het Lokaal JVieuw Pax-IntrantlbllS aan de Schiekade. Het BESTUUR noodigt eenige JOSïftrK_Ll]V- CfEIV van 14 tot 16 jaren nit om deel te nemen aan de Beklim raming van deu Cocanjcmast op 20 Ju'ij 1856. Degenen dio gecegen zijn kunnen zich aanmelden i.i het Sociëteita-L .kaal op Donderdag den 17den Julij des avond. fen 8 ure. 13 Julij 1856. (6359) PS. Heden Namiddag Harmonie Concert. Compagnon geYrangd!! Door Ontbinding der Compagnieechap met onderling goedvinden  van eenen aolieden en weibeklanten WIJWHAWDEL.  te 's Gravenhage verlangt de eerßte Eirmant Kapitaal bezittende een JONG MENSCH als YE.VVOÖT . die tevens genegen is zich voor een gedeelte met do Administratie te belas'en. (6353) Adres franco onder letters W. H. D. bij den Boekhandelaar G. Dli GEUS. te 's Gravenhage. 1&-»V"" <_3_i In <><rie Houtkooperij gevesj^iiai23||gtig.'i iai in eene der .Steden von Z.-Bolland wordt VERLANGD : Een BEDIENDE met den Handel volledig bekend. Adres met re-frunkeerde Brieven  onder letter A. bij den Beekhandelaar F. BOEKER te Dordrecht. (6352) *_Bfe_3ï_l-&I**""1**"" -^'J Gereformeerde Liecten in een ig|pSg||f? Klein en Stil Gesin  bestaat gedegenheid Voor een Commensaal. Adres bij den Boekh G. B. POESCEMANN alhier. 16346;",http://resolver.kb.nl/resolve?urn=ddd:010113108:mpeg21:a0016:ocr,4,ddd:010113108:mpeg21:p004,"Nieuwe Rotterdamsche courant : staats-, handels-, nieuws- en advertentieblad",771
27495,1856/04/03 00:00:00,47,ddd:000011416:mpeg21:a0019,http://imageviewer.kb.nl/ImagingService/imagingService?id=ddd:000011416:mpeg21:p004:image&x=233&y=3985&w=585&h=47,ddd:000011416:mpeg21,818,4032,233,3985,8,ADVERTENTIE?.,http://resolver.kb.nl/resolve?urn=ddd:000011416:mpeg21:a0019:ocr,4,ddd:000011416:mpeg21:p004,Dagblad van Zuidholland en 's Gravenhage,585
1162052,1856/11/08 00:00:00,1486,ddd:010113224:mpeg21:a0009,http://imageviewer.kb.nl/ImagingService/imagingService?id=ddd:010113224:mpeg21:p004:image&x=915&y=1114&w=782&h=1486,ddd:010113224:mpeg21,1697,2600,915,1114,4,"ROTTERDAI-HAVRE. AFVAARTEN: Van Rotterdam 4 9 14 19 24 29 van iedere maand. Hot Stoomschip Elve  Kapt. HAIJEN vertrekt naar JMavre. Zondag 9 Novtmber. Adres ten Kantore van SMITH & Co. te Rotterdam P. GRANDIN te Eavri. (9842) Arfte* STOOMBOOTDIMST ""^4teJ^*ÉP ROTTERDAM «ti dam tusschen gelegene Plaatten. (712) JJfcovember 1850. Van ROTTERDAM Van MIDDELBURG Zaturdag 8 's morg 11Ju Zondag 9 'smorg. gju Dingsdagll « 1 ¦ Dingsd.ll • 10 ~ Woensd.l2 - 1- Dond. 13 . llf Vrijdag 14 » 8}» Vrijdag 14 . i\* Za'urdagls « B{<- Zondag IR » 6r» ~DE STAD GOES. (1335) Kovembe • ISS 6. Vrn GOKS : Van ROTTERDAM: Dingsd. 11 's morg 9 u Maand. 10 'smorg 5 u Donderd 13 « 10 . Woensd 12 . 6 . Zaturd. 15 •< 5 . Vrijdag 14 - 7 » (9916) A. J. LAMME te Rotterdam zal in Dtctmbtr aanstaondt laten Verkoopen : EENE FRiAIJE VERZAMELING SCHILDERIJEN door voorname Onde en Hedendaagsche Meesters TEEKEXITCOEIV zeldzame PRESTTEJN en ETSEN van Rembrandt. Gedeeltelijk nagelaten door wijlen don Wel Ed. Heer J. F. VAN OORDT.",http://resolver.kb.nl/resolve?urn=ddd:010113224:mpeg21:a0009:ocr,4,ddd:010113224:mpeg21:p004,"Nieuwe Rotterdamsche courant : staats-, handels-, nieuws- en advertentieblad",782
2330952,1856/06/05 00:00:00,2418,ddd:010544806:mpeg21:a0017,http://imageviewer.kb.nl/ImagingService/imagingService?id=ddd:010544806:mpeg21:p003:image&x=73&y=56&w=964&h=2418,ddd:010544806:mpeg21,1037,2474,73,56,6,"%* In eene daartoe op heden gehoudene Vergadering van Kiezers is tot CANDIDAAT voor het Lidmaatschap van de 2de Kamer der Staten-Generaal Hoofddistrict Hoorn met bijna algemeene stemmen verkozen  de Heer ' Mr. P. M. Wolthenius. Het Bestuur der Kiezers-vereeniging Purmerende W. PAUW Vt. 26 3fei1856. F. van AMMERS H. CARBASIUS Secretaris. ~~%* VLAËR & KOL te Utrecht adverteren dat ten • overstaan van den Notaris H. J. BUSKES en getuigen te Utrecht den 2de"" Junij 185 G ziju uitgeloot 7 OBLIGATIEN ten laste den Straatweg van Zeyst naar de Grebbe N°. 18 111 143 155 184 238 en 260; en noodigen de Houders derzelve uit alsmede die van Coupons dier Negotiatie te verschijnen 1 Julij aanstaande om die tegen recief ten hunnen Kantore in te leveren om ter invordering op te zenden. *** De Notaris N. STERK residerende te Dinxperlo roept bij deze op de wettige Descendenten vau wijlen den Heer WILLEM GOLDBACH in leven Boekhouder gewoond hebbende te Ostende ten einde inlichtingen te kunnen bekomen aangaande eene aan hen opgekomene Erfenis. Brieven franco. Technische School te Utrecht. Deze inrigting in het jaar 1850 tot stand gekomen biedt aan jongelieden die zich aau het Fabriekwezen  den Koophandel den Landbouw of de Bouwkunde wenschen te wijden de gelegenheid aau die kundigheden te verkrijgen welke overeenkomstig met de eischen van den tijd als onmisbaren grondslag mogen beschouwd worden voor de beoefening van elke tak van nijverheid. In het bijzonder ook dient deze School tot eene regtstreeksche voorbereiding voor de toelating tot de Akademie te Delft. Overeenkomstig met deze strekking wordt er onderwijs gegeven in de Wis- Werktuig- Natuur-en Scheikunde de Geschiedenis de Topische Natuurkundige en Handelsgeographie de Nederduitsche Hoogduitsche Fransche en Engelsche Talen  de Mechanische Technologie  Technologische- en Landbouw Scheikunde het Boekhouden en het Bouwkundig-Werktuig- enOrnamentteekenen. De Cursus is bepaald op drie jaren en zal weder eenen aanvang vemen op den l_den Augustus e. k. Tot dezen Cursus worden toegelaten jongelieden die aan een Admissie-examen dat den lGaen Augustus aanstaande zal worden afgenomen kunnen voldoen. Voor de huisvesting verzorging en huisselijke opvoeding der Leerlingen bestaat gunstige gelegenheid. Voor de aangifte tot het examen en het verkrijgen van den Prospectus der Inrigting en alle verdere informatie vervoege men zich tot den Heer D. GROTHE Directeur der Technische School. De verzorgers der Technische School H. A. van den WALL BAKE W. H. de HEUS G. J. MULDER R. van REES.",http://resolver.kb.nl/resolve?urn=ddd:010544806:mpeg21:a0017:ocr,3,ddd:010544806:mpeg21:p003,Opregte Haarlemsche Courant,964
2422875,1856/09/11 00:00:00,2625,MMSADB01:000003500:mpeg21:a0008,http://imageviewer.kb.nl/ImagingService/imagingService?id=MMSADB01:000003500:mpeg21:p004:image&x=1094&y=131&w=923&h=2625,MMSADB01:000003500:mpeg21,2017,2756,1094,131,4,"Advertentie DE PILLEN VA®! HOLLOWAY zijn een onwaardeerbaar geneesmiddel voor dengenen welke aan Lever- en Maagkwalen lijden. De deugd en kracht dezer Pillen beproefd zijnde door een groot aantal lijders en wel bijzonderlijk in Nederland Java en Suriname is het onnoodig om dezelven verder uit te weiden daar duizenden daarvan gebruik gemaakt hebbende hare weldadige uitwerking hebben ondervonden; al degenen welke lijden aan ongesteldheid aan de Lever of de Ingewanden gebrek aan spijsvertering zware hoofdpijnen duizeligheid aandrang van het bloed naar het hoofd kunnen geen beter werkend middel gebruiken. Zij zijn ook buitengewoon heilzaam voor borstkwaal mits dat tevens de 25alf daarbij ter inwrijving op de borst des morgens en 's avonds wordt gebruikt. 3*>aat ïjer bermectberii ïDe&iet zijn de Prijzen als volgt: DOOSJES PILLEN a/080 f 185 /' 300 /675 /"" 1350 /""2050 POTJES ZALF » / 080 f 185 /'300 ƒ705 ( 1385 ƒ2025. Zijn op franco aanvrage a contant te bekomen bij G. Boes te Tilbury; bij H. J. van den Goorberg te Breda; bij P. J. Verluiden le Beryenopzoom en bij S. SrRAATJI.II IIoord-HepdHiomler le 's Hertoyenbosch alsmede in HULLOWAY'S Etablissementen te Londen 244 Strand en te New-York  80 MaidenLane. (2374) Bij J. J. ARKESTKYN en ZOON te 's Hertogenbosch is van de Pers gekomen en bij alle Boekhandelaars te ontbieden: Het BLOEMKORFJE een buitengewoon lief en nuttig leesboekje voor de jeugd; naar het Hoogduitsch door J. WATERREUS Onderwijzer te Delft Prijs 15 Cents. De Uilgevers willen niets zeggen tot aanbeveling van dit Boekje dat zich door eenvoud en natuurlijkheid boven de meeste Leerboekjes onderscheidt. Het stelsel der niel-verbuiging is er gedeeltelijk op toegepast om alzoo het vloeijend lezen der leerlingen te bevorderen. De Uitgevers vleijen zich met het gunstigst debiet. (2375)",http://resolver.kb.nl/resolve?urn=MMSADB01:000003500:mpeg21:a0008:ocr,4,MMSADB01:000003500:mpeg21:p004,Provinciale Noordbrabantsche en 's Hertogenbossche courant,923
97554,1856/05/27 00:00:00,229,ddd:011021817:mpeg21:a0008,http://imageviewer.kb.nl/ImagingService/imagingService?id=ddd:011021817:mpeg21:p002:image&x=69&y=353&w=426&h=229,ddd:011021817:mpeg21,495,582,69,353,4,— De Nieuwabode kost voor !*ederlaird $3} per jaar j $ 200 is de 6maaudeu; enkele nomuiers lUCenl*. — Kleiue sommen gelda hetzij benedon een dollar of centen boven eeu of meer dollar» kunnon ons immer per brief in postutempcU van een en drit cents van laatstgenoemde 't liefst in betaling worden toegazonden. Zulke stempel» kan men koopen bij alle postmeester*. Geregistreerde brieven met geld kau men leu onzen risico zemkn. Vuor bet registreren moet de afzender 5 couta betalen. NB.—Geboorte-. Tronw- en Poodberiglea wo:den ui den Nieuwsbod»- geplaatst voor 25 Cents.,http://resolver.kb.nl/resolve?urn=ddd:011021817:mpeg21:a0008:ocr,2,ddd:011021817:mpeg21:p002,De Sheboygan Nieuwsbode,426
3739389,1856/11/21 00:00:00,3867,ddd:010544948:mpeg21:a0022,http://imageviewer.kb.nl/ImagingService/imagingService?id=ddd:010544948:mpeg21:p004:image&x=1039&y=953&w=967&h=3867,ddd:010544948:mpeg21,2006,4820,1039,953,4,"*I* Men wenscht ov.rtcnemen: Eene niet al te uitgebreide ZAAK mits geen Winkel-Alfaire  liefst gevestigd binnen of nabij Ainhem of wel eene zoodanige welke zonder nadeel naar die Stad zou kunnen verplaatst worden terwijl bijzonderlijk in aanmerking zou komen eene Zaak waarin de tegenwoordige Eigenaar altaus voorloopig Commanditair-Vennoot zou willen blijven Refleetci .uden gelieven zich te adresseren met franco Brieven onder Letters V. C. bij den Boekhandelaar A. ter GUNNE te Deventer. %* In den loop van de maand Maart of April 1857 zal op nader te bepalen tijd en plaats in het openbaar ter Verkoop worden Geveild: De AMBACHTSIIEERL .JKIIEID VAN St. ANNALAND Eiland Tholen Provincie Zeeland met de Ambachtsi-cgten en Ambachtsgevolgen aanzienlijke Beplantingen Dij kettingen. Tienden van Veldvruchten Regt van Jagt en Visscherij Eifpachten Renteu en verdere Inkomsten. Eene goed onderhoudene HOFSTEDE met uitmuntende ZAAI- en WEIDELANDEN gelegen in de Gemeente St. Amialand groot 44 Bunders 60 Roeden 15 Ellen. Een Perceel BOUWLAND aldaar gelegen groot 9 Bunders 83 Roeden 05 Ellen. En Vier Percelen WEIDELANDEN en AANWAS mede aldaar gelegen ter gezamentlijke grootte van 9 Bunders 96 Roeden 56 Ellen. Het verlangd wordende onderrigt kan worden verkregen bij Jonkheer F. C. de CASEMBROOT te St. Maartensdijk  en ten Kantore van den Notaris W. J. van VOORST CATSHOEK te Tholen. Brieven franco. Bij A. C. KRUSEMAN te Haarlem komt van dc Pers: BEDERDIJK HERDACHT DOOR Mr. Isaac Da Costa in eene redevoerinsr. gehouden op denlldL"" October IM3G. Bij gelegenheid der Eeuwfeestviering van des grooten Diehters-gcbooitejaar door de Rederijkerskamer opgerigt te Amsterdam ten jare 1844. Prijs ƒ-60. ** Bij W. BECKING te Doesborgh is verschenen de lle Aflevering van het Godsdienstige Maandschrift: HET BROOD DES LEVENS CRRISTELIJKE ©VERBEKXO.GEU.. Inhoud: Eene Apostolische vermaning door D. J. GULDEN. Kam de Broedermoorder door Dr. A. W. v. CAMPEN. Een Vloekpsalm door IL A. C. DENIER van der GON. Prijs per 12 Aflev. ƒ 250. %* Bij C. van der POST Jr.  komt van de pers: SPAXDAU De Vrouwen. Met Platen ƒ 240. J. B. CHRISTEMEIJER Vedelklaukeu Rijmelarij van vrolijken inhoud. / -»6U. ZAAD EN SCHOVEN Bloemlezing uit Duitsche Proza Schrijvers uit het Hoogduitsch door den Vertaler van ZSCHOKKE'S Stichtelijke Uren ƒ 180. BUNGENER Eene preek onder Lodeusijk XIV. * 180. DUIZEND EN ÉÉN NACHT Arabische Vertellingen. Met 1800 Houtgravuren. 3 Plu. in 4° ƒ 2340. IWic wil niet gaarne een' fatsoenlijken | Brief lecren schrijven ? „Aan den stijl herkent men den man"" | r zeide een groot Geleerde en hij had wel gelijk. $ I Die geen goeden Brief kan schi ij ven kan geen aan- » | spraak maken op den naam van fatsoenlijk Man; I I al wie die kunst leeren wil bestede slechts EEN I I GULDEN en koope het Ij ï Volledig Brievenboek van (llaudius I waarin hij alle mogelijke voorschriften van Brie- | I ven toepasselijk op alle omstandigheden des le- I I yens en regels omtrent het Briefschrijven zal aan- I \ treffen. X 0 Hoewel dit Boek pas is uitgegeven zijn er reeds X If DUIZENDEN Ex. van verkocht omdat het zoo | I Goed en zoo Goedkoop is. Het is bij 11. C. A. CAMPAGNE teTiel I len verder in alle Boekwinkels te bekomen. I 'émi—. -fc_o6a... -jg_>&ri. -Jbjofei- $*_■i",http://resolver.kb.nl/resolve?urn=ddd:010544948:mpeg21:a0022:ocr,4,ddd:010544948:mpeg21:p004,Opregte Haarlemsche Courant,967
3159010,1856/10/29 00:00:00,3067,ddd:010772028:mpeg21:a0004,http://imageviewer.kb.nl/ImagingService/imagingService?id=ddd:010772028:mpeg21:p004:image&x=1088&y=74&w=1030&h=3067,ddd:010772028:mpeg21,2118,3141,1088,74,6,"| van ouds bekende neringrijke MMMZMtBMitICf en MJOCrMS- JfMEBTT met groote SCHUUR en STALLING staande aan den Grindweg naar Appingedam te Oostwold in den Oldambte. 11. Eene BERIIXIMG naast perceel I in gebruik bij D. J. WIJNSTOK. 111. Ongeveer Z\ Bunder EIOEBT !>*>■». in het Hun inga Meer bij Oostwold gelegen — en IV. PI. m. 2_ Bunder LAWD te Oostwold gelegen. B. HAITZEMA VIËTOR Notarü. BEKENDMAKING^ In den loop der maand NOVEMBER aanstaande gedenken R. FEIS en Vrouw publiek ter verkoop te presenteren: «__»__«_»'? #*IV_ aoor ben bewoonde BEHVISHIW)rSmaDbr|B KIKG aan de Binnen-Venne te *f^O_ft|iD Winschoten tot allerhande Affaires Q______*.!DW-J__i_t_b» geschikt met den daarachter gelegene TUINT | om te aanvaarden den lsten Mei 1857. B. HAITZEMA VIËTOR Notaris. UIT DE HAND TE KOOP: Eene goed betimmerde HERITI- JP____V __?J7_B WéfKti  zijnde eene welbeklante ü»___Effl JHnH BAlïïiMiMiMkM staande in de 'TÜiirrß Nieuwe Ebbingestraat te Groningen; ta3ËSS==» om te aanvaarden op den lsten Mei a.s. Te bevragen bij den Eigenaar en Bewoner J. B. J. HIDDING en ten KANTORE ran Mr. J. RENGERS HORA SICCAMA  Notaris te Groningen. TE KOOP: | Een nieuwsgebouwde PEIi-en ROOCIEr|Ji ROIiEW 75 Voet vlugt. Inlichting bij onder\__r\ geteekende. -«_____» Bij Winneweer aan 't Damsterdiep. JKT J- T- HOUTMAN. Ontvangen aan het MAGA Z IJ N van G. MEDDENS Hoek Heeresiraal  de NIEUWSTE MODELLEN ran ROEDES  RAIVTKEiS en JII'TSi:»' en verder CHAIiKN liOMGS  XIJUKV UTOEEEI  enz.  voor het Saizoen welke van af WOENSDAG zullen zijn UMT&MiSTAIMéB. 7mg________M_____ Wij hebben de eer de ontvangst te be__■ tL ""» rigten der NIEUWSTE PARIJZER MO- DELLEN van HOEDEI  NITIEM  IHAB""TELI enz.; welke van af MAANDAG den 3den November in ons Magazijn zullen zijn ten toon gesteld. Wij zijn ook ruim voorzien in  alle andere voor dit Saizoen passende SOl VEAIXE» en bevelen dezelve beleefdelijk ter bezigtiging aan. UCHTMANN & ZONEN. <<nw Ondergeteekende maakt hare geëerde Begunstigers gMÉp? bekend dat zij heeft ontvangen de NIEUWSTE JT®*) MODELLEN van RARE» WIITKHHOK. DEW en RBTSESf ; verzoekt gunst en rekommandatie. Wed. B. PEKELAËR. Gezusters DE ENIJFF jsm hebben de eer te berigten dat zij ontvangen heb- ben de MODELEiER? van HOEDES en <£_*_* mVT«ES  IHASTKIiH en verdere NIEUWE ""*■■■» ITOEFES' voor het Saizoen. NIWE PiMIMOP A helder en troebel benevens JAMAIKA RUM COGNAC a ƒ 100 ƒ 120 en ƒ 140 de Flesch; beste FRANSCHE BRANDEWIJN van 70 a 100 Ct. de Kan ; Oude PORT-a-PORT en MADERA uit de beste bronnen aangevoerd ; bij groote Bestellingen wordt de prijs iets minder gesteld. N. E. ROST Oude Kijk-in'tJatstraat. E. F. ROST Groote Markt in de Waag. I",http://resolver.kb.nl/resolve?urn=ddd:010772028:mpeg21:a0004:ocr,4,ddd:010772028:mpeg21:p004,Groninger courant,1030
4663710,1856/06/27 00:00:00,4506,ddd:000012736:mpeg21:a0029,http://imageviewer.kb.nl/ImagingService/imagingService?id=ddd:000012736:mpeg21:p006:image&x=81&y=66&w=1035&h=4506,ddd:000012736:mpeg21,1116,4572,81,66,6,"Di Notaris HüI'ELT te Kuiure zal op / 'i -l/dij 1856 des avonds om 7 uren in de 'NIEUWE STADS HERBERG te Kuinre ten verzoeke van DE ERVEN -van den Heer R. STEENBEEK publiek verkoopen: In de gemeente Klanken!.ani: «kx.jj. 1. Een best stuk .Veïdelaud. bij Jm 'M--.. Piertjes steeg genaamd DE HALVE ZEVEN fi-;- n 1} >'_¦ MAT groot 1 B. 94 R. 80 Ellen. Staande op f 1876. 2. Een dito stuk f-roenland. genaamd DE OSSEKAMP groot 3 15. 29 R. 2U Ellen. Staande op f 3300. 3. Een stuk Buitendijks Hooilaud  ti-tenover de Ossekamp gelegen groot 1 IS. 76 11. 3(1 Ellen. Staande op ƒ 1763. in de gemeente Kuinre: 4. Een Koereiiliuï*» met SCHUUR STALLING VARKENSIIOK WERF en TUIN met de HIATENHOEKJES aan de Linde gelegen groot 45 R. 60 Ellen. Blijft buiten veiling. Aldaar in den Kui.engiolder: De navolgende alle uitmuntende stukken Buitendijks HOOiLÜTO. fi. Een stuk. genaamd ZIELWEEH. aan de Wagenweg groot 2 B. 27 R. 50 Ellen. Staande op / 3014. 6. 5/7 gedeelten in lIARM DEHKSWEER geheel groot 4 Bunders. Staande op f 3200. 7. Een stuk  genaamd MOLENIVEER  aan de Polderdijk  groot 88. 21 R. 10 El. Staande op/ 3500. 8. Een stuk ten Westen van Perceel 7  genaamd DE EINDJES groot 2 P>. 27 R. Staande op ƒ 1819. 9. Een stuk genaamd ZUIDELIJKE 4 MAT van hei Molenweer achter het vorig Perceel groot 2 B. 15 R. 60 El. Staaude op f 2730. 10. Een stuk genaamd NOORDELIJKE 4 MAT naast het vorig I'ercecl  groot 2 Jl. 52 R. 70 El. Staande op / 2503. 11. Een stuk genaamd SLEEKEN aan den Polderdijk groot 2 15. 56 R. 90 El. Staande op f 3351. 12.' Een stuk genaamd BUITENHOEK van de Sleeken  i aan de Lende gelegen groot 77 R. 90 El. Staande op f 880. Nadere informatiën bij voornoemden Notaris. Mr. <». A. IJSSEL de SCHSvPPEK Notaris te Olst zal op Zaturdag den 12 Julij 1856 des voormiddags ten 11 ure ten huiz:: van deu kastelein C. STEIN in het dorp ll'ijhe ter voorloopi.e en 14 dagen daarna ter zelfder uur en plaats ter uiterlijke toewijzing ingevolge regterlijke authorisatie tot ont-cheiding van den boedel van GERRIT van WERVEN timmerman te ll'ijhe en zijue kinderen veilen de volgende vaste goederen in het dorp ll'ijhe gelegen: **-*^^»\_s»r**'i? 1- ''en ""n*** El**'*» Seliuur ff-iM^». «IJ^^'i*ls» en Tuin aan de Lnngestraat in -'.LZ^d^A^ gebruik bij G. van WERVEN. 2. Een Huis en Erf met daarachter gelegen Tuintje mede aan de Langestraat verhuurd aan 11. van ASSEN. 3. Ecu Hui.»- in de Jakke bcrattende 5 Woningen verhuurd aan W. F. RENSEN en anderen. 4. Een Illlitt en Eri"" in de Jakke bevattende twee Woningen verhuurd aan J. vanrPOORTEN en 11. HUISMAN. 5. Twee aaneen gebouwde __'oningen aan den Dijk met daarbij liggende Tuing-rond verhuurd aan L. HULLEMAN en A. BE RUITER. Aan te wijzen door G. van WERVEN voormeld. Grasverpachting. De Heer It'. 1». UI. van KAKI. Notaris te Heino zal op Dingsdag den 1 Julij lSöti des aelitcriniddags om drie uren ten huize van WILLEM MELMAN  aan de Nieuwe Wetering onder Heino  verpachten de navolgende perceelen f-rasgewas: Ijk/ * 6 in Kamphuisland bij het Otseuboscll. $*}¦§--_ Bin den Deernhorsl tegenover MEI MAN. ?£fc-""in.¦'*'} £'.$ lm den Lagen llietlrink bij den Heij/over. 4 in den TUiben bij de Uilenspiegelsbrug. fi bij E. WILLEMS in den Ragen. 8 in het Sma/leslag. 16 in de Doornsla.ge.n beide op den Alerdinck. 6 in Solenlaud bij de RöpschoofsbrUg. Publieke verkoopingen van Gras- en Zaadgewas door de Deurwaarders KOEKOO JANSEN en VOETüLir.ïi. ""L * 1. Vrijdag 4 Julij e. k. des middags om Jfyi wP:-r één uur ten hui/.e van A. ROS buiten de CK_ifV'f-j¦¦_->-; Sassenpoort : het Zaadfrewas van de ZANDP.RINKEI- TIENDE ""te Windesheim in 8 perceelen. Aanwijzer HENDRIK HARMSEN te Windesheim. 2. Vrijdag 4 Julij e. k.  des namiddags om 3 uur in de herberg DE MOL te Wijthem: het Grasjfewas van de navolgende landerijen als: de PADDEPOL in Sekdoorn het HOOILAND achter de Ruitetee AALVANGE USLAND de NIEUWE KAMP de SCHELLEMATE te Soeslo het HOVENIE'SHOOILANÜ en dc ACHTERHAGEN bij den Alerdinck. Aanwijzer HENDRIK BOMHOF werkbaas op Soeido. Voorts: de DRIE TIPPE het VETTE BEESTENLAND POTHOFS KOE- en HOOILAND en de VAE- K ENKOOI. Aanwijzer JAN DIJK bij de Linthorst. 3. Zaturdag 5 JuJij e. k. des morgens om 10 uur ten huize van de Weduwe K. (i. FIKSE te Welsum onder Dalfsen eenige perceelen aldaar op stam staande Kog i> e.",http://resolver.kb.nl/resolve?urn=ddd:000012736:mpeg21:a0029:ocr,6,ddd:000012736:mpeg21:p006,"Provinciale Overĳsselsche en Zwolsche courant : staats-, handels-, nieuws- en advertentieblad",1035
2232865,1856/02/08 00:00:00,1853,ddd:010924821:mpeg21:a0020,http://imageviewer.kb.nl/ImagingService/imagingService?id=ddd:010924821:mpeg21:p004:image&x=1354&y=89&w=1205&h=1853,ddd:010924821:mpeg21,2559,1942,1354,89,4,"EEN BOVENHUIS TE HCÜR bevattende een Voor- en Achterkamer doch liefst de Voorkamer alleen -Keuken met Regenpomp doorloopende Bestekamer en afgesloten Zolder. Voorts alle gemakken voor een stil huisgezin voor eenen Heer of eene Dame. Te bevragen op de Mare ""Wijk VI. K». 1172. VRIJWILLIGE VERKOOPING '•"" het Heeren-Logement aan den Burg binnen Leyden op js |ï|u Zalurdag den 16d™ Februarij 1856 bij Opbod en op Zaturdag »sMi___lf den 23st™ Februarij daaraanvolgende bij Afslag heidedagen des avonds ten 7 ure van: Eenen vermakelijken SPEELTUIN met steenen Koepel Keuken en nog een Vertrekje gelegen even buiten de Zijlpoort der Stad Leyden aan den Heereweg ouder de gemeente Leyderdorp Lelter Z. N°. 97 bekend bij het Kadaster Sectie A. N°s. 1239 en 1240 ter grootte van 4 roeden en 37 ellen. ....- Dadelijk te aanvaarden en le bezigligen daags vóór en op de dagen der Veiling en Toewijzing van des voormiddags ten 10 tot des namiddag ten 4 ure. Nadere inlichtingen zijn te bekomen ten Kantore van den Notaris J. A. PRYN te Leyden. OPENBARE VERKOOPING jggK Aan den Burg te Leyden op Zaturdag den 9d™ Febiuarij 1856 Bii'lil es avon<*s ten zes ure'van= <___feï N"". 1. Een HUIS es ERF ingerigt tot Verwerij aan de westzijde van de Oranjegracht Wijk VIII. N"". 651. — N"". 2en 3. Twee DITO aan de noordzijde. van het Levendaal Wijk 111. N°. 254 en 255. —■ N°. 4. Vier nevens elkander staande HUISJES aan de oostzijde van zekere Poort aan de noordzijde van de Korte Langegracht Wijk V. N'-\ 1065» 1065\ 1065<=en 1065"". — N"". 5. Een DITO in de Maryen Gysensteeg bij de Haarlemmerstraat Wijk VI. N°. 533 allen te Leyden. Kunnende worden bezigtigd daags vóór en op den verkoopdag. Inlichtingen te bekomen bij den Notaris P. MULLER te Leyden. VERKOOPING IN DE STADS-BANK VAN LEENING TB LEYDEN op'Dingsdag den 12d™ Februarij 1856 des Voormiddags ten 10 ure van Verstane Panden zoo van Juweelen Goud Zilver en Horologien als van Wollen Linnen en andere zoo gemaakte als ongemaakte Goederen beleend in de maand October 1854. Zijnde daags vóór den Verkoopdag des Voormiddags van 10 tot des Namiddags ten 2 ure voor een ieder te zien. I",http://resolver.kb.nl/resolve?urn=ddd:010924821:mpeg21:a0020:ocr,4,ddd:010924821:mpeg21:p004,Leydse courant,1205
615300,1856/10/21 00:00:00,1465,ddd:011021651:mpeg21:a0008,http://imageviewer.kb.nl/ImagingService/imagingService?id=ddd:011021651:mpeg21:p002:image&x=908&y=2236&w=420&h=1465,ddd:011021651:mpeg21,1328,3701,908,2236,2,"J Meubel-Magazijn ; VAN j H. WOLTERB &P. WEJXELMEYER ' in de aehtsto straat tegenover bet Public Square Sheboygan - - - - Wisconsin. ' Wij bevelen hiermede onze medebor- < pers vso >ht-boy|rai> en dtszelfs om- l «treken. ons nieuw ingerigt rijk MEUBEL-MAGAZIJN J aan waarin wij niet alleen gewone maar ook alle soor- l ten ven fijne meubelen voorham'en hebben. Wij zijn i in staai gesteld alle tot ons rak behoorende artikelen ' snel en goedkoop te vervaaidigen. en kunnen voor de deugritJijkbeid van 01 ■ werk inslaan. 6m353 WOLTEKS &. WINKELMEYER. ] GOEDKOOPSTE wnii «Bom C. T. MOORE Heeft deur dagen de grootst* en zoLnsaiatara keo> > van waren ontvangen die ooit in Sheboygan gebrag- • werd en is bereid om dezelve tegeu de laagste prijzei voor contant geld of geldswaarde te verknopen.—Koop lusügen woraen nitgenoodigd om deze prachtige keu van waren met haune opmerkzaamheid te vereeren Wtukel in de achtste straat tf353 C. T. MOORE. t ROOD > ~ grijs > Flanel BLA AUW ) * bruin en «rit katoenflanel tet de laagste prijzen bij 1 'f 353 C. T. MOORE. Gaat naar C. T. Moore om uwe inkoopen t* \.\T doen: daar ïjn altijd goede waren te vinden. suiker thee. koffij stroop gember naleratu». kruidenierswaren bij C. T MOORE. JOS. KESEBËRG-'S WINKEI. VAN MANTJPACTUREN GLAB- & AARDEWERK & KRUID EH EERSWAREN. De ondergrteekende beveelt zijnen CW"" • 2 nieuwen iugerigiei' en malde goed- XJ S> kooytlc en vUtruxJdtte toaren voorzicnen win- •' kei fiet publiek alhier eri den farmers ann Dnnkbsar 1 voor het hem lot hiertoe geschonken vertrouwen. zal hij er zich voornamelijk op toe leggen oude kalanten te behouden en nieuwe te verkrijgen. .Alle artikelen dis men in een minufaclour- en krui- I denier» win kei kso verlangen xiju steeds naar Vérfcle 6 zing voor haotfea. ' t ■ . JOB. KKSKBF.RG. Sheboygan October 1856. tf 353 J GERMAN BANK ï ■ Deie bank heeft een kapitaal van -<* - - $2500(1. i jßankbiljetten in circulatie 22.0PQ.' al t Gedeponwrde Staat» EfTecten. 26.000. ""I Kaopt ea vorkoopt wissel' zoowel baitenlamfsche ""I ""» b!H«pulandsebegolden in nllt dcelén i*ï »an Anieriko-i 9' 'Interest teitp'n ut procent wardi betaald op gelden. 1 ■rplke minstens 6t) dagen gedeponeerd bllivco. "" ' 8 phehoygao.a Atof. Irtfi». JOHN BW ING. Pre». 9 ' 31U J. H. MEAD Kaatier M I»",http://resolver.kb.nl/resolve?urn=ddd:011021651:mpeg21:a0008:ocr,2,ddd:011021651:mpeg21:p002,De Sheboygan Nieuwsbode,420
3670368,1856/04/16 00:00:00,3536,ddd:011060024:mpeg21:a0011,http://imageviewer.kb.nl/ImagingService/imagingService?id=ddd:011060024:mpeg21:p003:image&x=2157&y=90&w=1038&h=3536,ddd:011060024:mpeg21,3195,3626,2157,90,4,"LIEFHEBBERIJ TOONEEL: tfbifimtng baart üunst VIERDE VOORSTELLING. Op t»OSDmnt»A€i den lZden AFMtEM M5.%6. DE BARBIER IFSTRAATSBIM OF DE FRANKFORTER LOTERIJ. BLIJSPEL MET ZANG IN DRIE BEDRIJVEN. Het bespreken en de prijzen der plaatsen als vroeger. Aanvang; teil Italff acht ure. De Secretaris (174) J. H. GRAUSS. De ondergeteekende heeft de eer te berigten dat hij zijn He eren-Modemagazijn en Kleedermakerij van Batavia herwaarts onder de firma HOUTBECKERS $ CO heeft overgeplaatst. Het magazijn zal steeds voorzien zijn van de nieuwste Mode artikelen en zal hij trachten door soliede behandeling ook hier dat vertrouwen van zijne geëerde begunstigers te winnen dat hij te Batavia zoo ruimschoots mogt deelen en waartoe hij zich beleefdelijk aanbeveelt. SOERABAYA 11 April 1856. K. J. HOUTBECKERS. ""ÖP NIEUW ONTVANGGN7 MARGAUX WIJN. PUIKE GENEVER. SELTZERWATER op heele en halve kruiken. JAPANSCHE. ZOIJA ld. ZAKY. Bij _(167) DB CHARON DE ST. GERMAIN. Geêle en witte MACARONI en VERMICELLI in kistjes. Alle soorten GELEIEN. EXTRAIT DABSINTHE. Bij (172) MARTENS & CO. WISSELS OP AMSTERDAM  (135) ADAM & CO. Fluweelen en Satijnen Linten en dito Coiffures. Fraaija Zakdoeken. Tarletan in alle Couleuren.■•».; <-... ~. Robes Baijadère. Witte en ruwe Heeren Sokken. Fijne Fransche Hemden. FÜ d'Ecosse Heeren Handschoenen. Stellen Pleetwerk. . Elegante Likeurstellen. • Victoria en vergulde Theeserviezen. Koetsiershoeden. Bij (173) MARTENS & CO. De ondergeteekende brengt ter kennisse van het geëerde publiek van Soerabaya dat hij als deszelfs agent daar ter stede heeft aangesteld den heer F. A. Nieuwe nhuijzkn die van af aandag den 14den April e. k. ten zijnen huize tegen over het Comediegebouw zal verkoopen Geraffineerde Suiker in het groot en in het klein tegen dezelfde prijzen als in zijne fabriek op dl Noijo als: N°. 1 b. f 35.— Ree. » 2 „ „ 30.— „ » ö » » *0«— » (165) J.F. RUST.;",http://resolver.kb.nl/resolve?urn=ddd:011060024:mpeg21:a0011:ocr,3,ddd:011060024:mpeg21:p003,"De Oostpost : letterkundig, wetenschappelĳk en commercieel nieuws- en advertentieblad",1038
269445,1856/04/02 00:00:00,345,ddd:010113007:mpeg21:a0033,http://imageviewer.kb.nl/ImagingService/imagingService?id=ddd:010113007:mpeg21:p003:image&x=2459&y=3993&w=781&h=345,ddd:010113007:mpeg21,3240,4338,2459,3993,4,ONDERWIJS OP Dl ZONDAGSCHOLEN ' I>e COMMISSIE van Orde en Toezigt o?er deze Scholen berigt dat de Aanneming van Leerlingen zul plaatshebben MOKGKN Donderdag 3 April 1856; elk die van het Onderwijs op de Zondagschool begeert gebruil' te maken mits den Ouderdom van 14 Jaren bereikt hebbende vervoege zich  des Avond len Zes Ure in het Locaal aan de,http://resolver.kb.nl/resolve?urn=ddd:010113007:mpeg21:a0033:ocr,3,ddd:010113007:mpeg21:p003,"Nieuwe Rotterdamsche courant : staats-, handels-, nieuws- en advertentieblad",781
1583815,1856/12/05 00:00:00,1831,ddd:010777210:mpeg21:a0018,http://imageviewer.kb.nl/ImagingService/imagingService?id=ddd:010777210:mpeg21:p004:image&x=1897&y=2435&w=865&h=1831,ddd:010777210:mpeg21,2762,4266,1897,2435,4,"-t&arktherigten. Rotterdam 4 December (innen. Tarwe 160 8 Hofll Kleefs. / 24i». Kogge: 144 . Archangel / 253. ücltitdatu  4 December. Granen. Verkocht: Kofl| 144 - Archangel / 231 kunt. / 233 6 w.  en H"" Beval / 2'jB C w. Gerst 130 u Manheini / 24S G/""- Motuwijn per Ned. vat zonder fust / 2250; id. / 28 UU; Amsteril. proef I 292.i zonder de be.asti-J' WAAK Meteorologisch Observatorium ie utrecht. „10l WiDd- j li«r.-mi Tber Atwijli Voet- <m> <_ ?! itgt kt b.j O"" r. d l.mr MSI reg»M-""» ; nT-I ~~ """" i ' 421 zzw. 1 r>!ï63.7i) 30.7!—10.6 0.91 0 ILigt bewoU»* 10 !i\r. 5.01 C 2.61 28.4| 93 0 jßetrokken. 5 8| z. 0.5 J 58.67(30.01 94] 0 jldem. PRIJZEN DER EFFEKTENAAiSTKKDAM 4 December 18_6. Nederland. Werkcl. Schuld .. . _'/a pCt. 63 63'/ 63 ditu dito 3 „ 74 Vg ""5 dito dito 4 „ 94% 94•""/ Kusland. Oblig. bij //o/jc en Co. ft „ 103 103/8 103'/» Obltgat. 1828 & 1829 5 „ tt»l% 101 Vg Certihkat. 1831 <_ 1833 5 „ 92/8 92% Certifikaten 1840. . . 4 „ B*% Inschr. in Assign. . . 6 „ 60% Po LEK. Aaud. 1835 fl. 500 152/4 bPASJK. Obligatie- l>/4 pCt. 23% 23% 23'/» Binnenl. Schuld ... 3 „ _7'/« 37% 3?r» Amortisable 6'/! 6/8 Bewijzen Koepons . . . 5% s'Vü OoSTtJIKIJK. ~ Oblig. Mctaliek ... 5 „ 74% T4Vi* 7\ OWig. H 5 „ 83 83'/ 83/1» dito dto La Ji. 54 . 5 „ 83 83% 83/"" dito duo .'/. „ -*""/u -~% I'IiAZILIK. Geldl. 1824 £ 100. . 5 pCt. 96 Vt POKTUOAL. | Obligatien 3 pCt. 44% ■»-'% **"" _____■_■_» Venez. Oblig. 6pCt. nu 4'/4 » 33'/ Mexiko 0b1.1854 £100 » ~ 20% 20Vu Snelperadruk van L E. BOSCH w ZOON-",http://resolver.kb.nl/resolve?urn=ddd:010777210:mpeg21:a0018:ocr,4,ddd:010777210:mpeg21:p004,Utrechtsche provinciale en stads-courant : algemeen advertentieblad,865
1338492,1856/05/08 00:00:00,852,ddd:010113043:mpeg21:a0030,http://imageviewer.kb.nl/ImagingService/imagingService?id=ddd:010113043:mpeg21:p004:image&x=85&y=1137&w=1571&h=852,ddd:010113043:mpeg21,1656,1989,85,1137,4,"- ¦¦ ¦— . ROTTERDAM-HAVRE. Afvaarten van beide havens: 4 £» 14 19» S 4 S 9 «ar. aate-» a""308""- „_„„„ i In re-binding yoorPASSAGIBBS en ©CEDEREN De Stoompaoket Scine Kapt. WITTEN- met dc geregelde Amerik. Postschepen tos- JBERG -wrt-eH i;aar Bfavr*"". Vrijdag 9 deser *&en SéVr* New Tori Pn New-Oriscm enmetde Transatlantische stoomsehepen tv» «chen Eavre en New-York en Eavre en Brazilië. ROTTERDAM-BORDEAUX. BIRECTE ©lEWST in 3 a 4 dagen. Ue Stoompacies Hollander Kapt. HALF- 1 In Correspondentie met den Spoorweg tusschen WEG vertrekt van Rotterdam den 8 Mei ca I Bordeaux en Bayonne en dc Stoombooten tuMchen van Bordeaux den 18 dito. I Bayonne St- Sebastien Bilbao en Santander.'^ ROTTERDAM-ST. PETERSBURG (CROMÜTADI) \ia Elseneur &. Kopenhagen. Het Stoomschip ül ronde Kapt. VAN EMMERIK vertrekt ran Rotterdam den 3 Jllllif. Adre» ten Kantore van SMITB A Co te Rotterdam P. QRANDIN te Sa-re ALBRECBT & FILS te Bordeaux (4171)",http://resolver.kb.nl/resolve?urn=ddd:010113043:mpeg21:a0030:ocr,4,ddd:010113043:mpeg21:p004,"Nieuwe Rotterdamsche courant : staats-, handels-, nieuws- en advertentieblad",1571
1504580,1856/10/14 00:00:00,1954,ddd:010113199:mpeg21:a0035,http://imageviewer.kb.nl/ImagingService/imagingService?id=ddd:010113199:mpeg21:p004:image&x=2524&y=107&w=770&h=1954,ddd:010113199:mpeg21,3294,2061,2524,107,4,APOTHEEK. Door Sterfgeval UIT DE HaND TE KOOP om onmiddelijk te aanvaarden: Eene hloeiicnde APOTHEEK met logeable Woonhuis Erf Oblangs bijna geheel vernieuwd Pakhuis en Eaboratorium. Het Huis waarin bovengenoemde Affaire nevens een Handel in DROOGERIJEN VEREWAREN enz. gedurende meer dan eene Eeuw met het beste succes is uitgeoefend is gelegen op eon der beste Standen van de Stad Edam. Nadere informatiën zijn in Persoon of op franco Brieven te bekomen bij de Eigenaresse de WED. J. VOLGRAAF of ten Kantore van den Notaris C. H. ZOUTMAAT BRUGMAN aldaar. (9145) Si fjj J«1 B f». * <~i omra.rr rr S-j f o S 5 u ?2 JS Sf S » o o rt-t. W 2oß_iE»o'sS..3n=: S. ara — Tip «^-s £j;S.*ös §!?!¦! b. cs.S»b«= i» ï roSf2--c?.^.»--' *r{3J-r~.rrtg*~7* .12. _ (D •* Qj <¦ Om- >» fD _ft-  -3 O m BLOEDZUIYERERD MIDDEL. Het is erkend dat de zaamgesteldo Salsaparilla Siroop veel voortreflelijker is dan dc Rob voor do genezing van Daauwworm Syphilis ontaarde Huidonstckingen Klieren Rheumatisme en al dc Ziekten der Huid en van het Bloed. Zij die gebruik maken van de Siroop van QUET ainé zullen gelijktijdig kunnen rekenen op een grooter resultaat en op eene mindere uitgaaf. Men eische altijd het zegel en de Handteekening van QUET AIKÉ Dépöt in alle wel voorziene Apotheken bij name te Rotterdam. P. E. ARENT West Nieuwland No. 79; 's Gravenhage. J. ü. VAN DEB. BURG; Leyden J. H. WÜNSTROOM; Amsterdam. F. G. OL DENBURG & ZOON en B. ADAMA; Utrecht X. VAN DORSSEN; Dordrecht 3. A. KNOOK; 't Hertogenbasdi. VAN DEN BOGAERT; Nijmegen. VAN BOER en VAN CRIMPEN; Arnhem F. F FROWIN. alle Apothekers. (2911),http://resolver.kb.nl/resolve?urn=ddd:010113199:mpeg21:a0035:ocr,4,ddd:010113199:mpeg21:p004,"Nieuwe Rotterdamsche courant : staats-, handels-, nieuws- en advertentieblad",770
968073,1856/11/24 00:00:00,617,ddd:010113240:mpeg21:a0045,http://imageviewer.kb.nl/ImagingService/imagingService?id=ddd:010113240:mpeg21:p004:image&x=102&y=1840&w=1569&h=617,ddd:010113240:mpeg21,1671,2457,102,1840,4,lam ii ii ii i ii • r i i ' —nra—ar liiAiißM Aan te vangen met den 3©aten dezer maand zal tot nadere aankondiging WORDEN GESTAAKT: Het VERTREK van ROTTERBABI 's morgens 3 ure ) naar den • IORDKECHT •¦ 5 - ) JHOERBIJK. » den BOERiBIJR 's Avonds Bu. 3©m. ; naar » DOR9B£CHT » Ou.SOm. j ROTTERBAM. De loop der Spoortreinen tussbhen den MOERDIJK ANTWERPEN en XJREDA blijft Voortduren » xoo nis die ia aangekondigd. (101701,http://resolver.kb.nl/resolve?urn=ddd:010113240:mpeg21:a0045:ocr,4,ddd:010113240:mpeg21:p004,"Nieuwe Rotterdamsche courant : staats-, handels-, nieuws- en advertentieblad",1569
1510516,1856/12/17 00:00:00,1478,ddd:010772049:mpeg21:a0029,http://imageviewer.kb.nl/ImagingService/imagingService?id=ddd:010772049:mpeg21:p002:image&x=2127&y=1834&w=1022&h=1478,ddd:010772049:mpeg21,3149,3312,2127,1834,6,ADVERTENTIEN. ■ _ .... ___s^ Natuurkundig Genootschap. Op HEDEN WOENSDAG den 17den Dec. te zes uur-. Sprekers: Prof. P. J. VAN KERCKHOFF en de Heer C. RÓ' MELINGH. A. W. ALINGS Secretari».^ Sociëteit DE HARMONIE^ Wordt ter kennis van de HEEREN LEDEN gebragt dat op HEDEN AVOND te 7 uur in de GROOTE ZAAi van de SOCIËTEIT eene Voorstelling zal worden gegeven door den Prestidigitateur H. P. MULLENS. Namens het Bestuur: B. TELLEGEN Secretaris. _~ Weldoende Menschenvrienden! Ten behoeve der Weezen van wijlen N. F. de HAB' TOGH is in dank bij de Commissie weder ontvangen: Van N. ƒ 1; J. T. O. ƒ 2; L. B. C. / 5 ; N. N. / 3ï R. B. J. ƒ 3; E. L. C. / 2.60; B. M. P. ƒ 2.60; J. ?• H. ƒ 2.60; H. J. K. ƒ 5.20; L. M. v. R. ƒ 2.60; Gebr*. L. ƒ 10; M. 1. L. ƒ 5.20; I. J. L. / 5.20; B. I. Vf 5.20; E. W. / 5.20; Dr. J. F. C. ƒ 10; H. J. V. R/ 2.60; H. P. ƒ 2.60; M. I. V. Z. ƒ 2.60; S. J. A. ƒ Ö. 20? H. B. K. f 2.60 ; B. I. K. ƒ 2.60; I. E v. C. ƒ 5.00 f S. D. H. ƒ 2.60 ; 1. A. C. ƒ 2.60 ; A. T. L. ƒ 2.60. Na U voor de zoovele milde gaven onzen opregten datt* betuigd te hebben nemen wij nogmaals de vrijheid d* ourierluuze kinderea in Uwe weldadigheid aan te bevelen en is ieder der ondergeteekenden volgaarne bereid elk» gift te ontvangen. Groningen  10 December 1856. Dr. J. ROZENBERG Brugstraat hoven den Heer KAPPERS- A. I. DRILSMA Heerestraat. L. I. AKKER Zwanestraat. I. H. NORT Folkingestraat.,http://resolver.kb.nl/resolve?urn=ddd:010772049:mpeg21:a0029:ocr,2,ddd:010772049:mpeg21:p002,Groninger courant,1022
5677226,1856/02/18 00:00:00,3018,ddd:010544717:mpeg21:a0021,http://imageviewer.kb.nl/ImagingService/imagingService?id=ddd:010544717:mpeg21:p004:image&x=1035&y=1786&w=1944&h=3018,ddd:010544717:mpeg21,2979,4804,1035,1786,6,"RIJKS-ONTVANGERS. Eene volledige verzameling van WETTEN en BESLUITEN der Directe Belastingen -tccynsen In- en Uitgaande Regten van 1823 tot 1 Jan. 1856 In zeer nette Randen  zijn voor een matigen prijs te bevragen bij den Boekhandelaar W. F. DANNENFELSER te Utrecht onder de Letters A. A.. Brieven franco. *„* Bij H. A. M. ROELANÏS t^Schiedam~~i^ het licht: Eene goedkoope uitgaaf DER GEZOCHTSTE -WERKEN VAN H ZSCHOKRE. Daarvan is reeds verschenen: UW HUISBOEK. Derde druk. In Linnen Band ƒ 150. V L A M 0 M A D E de Galeislaaf. Tweede druk. In Linnen Band ƒ150. MIJN LEVEN.DENKEN -» WERKEN. Berde druk. In Linnen Baud f 250. MIJN OMZIEN IN DE WERELD EN MIJN OP ZIEN TOT GOD. Tweede druk. In Linnen Baud f 250. GROOTE KLEINIGHEDEN. VERHALEN. Tweede druk ƒ 180. fßr^4Jrio_ï__K Van dez<> VOLKSBOEKEN zijn '_)'-__•? reeds duizenden Exemplaren ver«BUWi-By' verkocht en nog dagelijks wordt het debiet grooter waartoe de laag gestelde Prijs veel bijdraagt. _*** Nieuwe uitgaaf bij de Erven F. BOHN van van CARL SPINDLER In 36 Alleveringen a 16 Cent. De thans overleden Schrijver heeft in en buiten zijn Vaderland roem ingeoogst door zijne romantische voortbrengselen en geen daarvan is hooger geschat dan zijn Jood ; een werk  dat in het Duitsch bij duizenden verspreid en in de meeste beschaafde talen overgebragt is  terwijl zelfs de Hollandsche vertaling twee drukken heeft mogen beleven tot den prijs van /1030. De tegenwoordige uitgaaf stelt een ieder in staat om zich dit meesterstuk van SPINDLER op eene onkostbare wijze aan te schaffen. De Exempl. die voor 1 Maart e. k. besteld worden  zullen nog 1 Cent minder dus a 15 Cent de Aflevering berekend worden. HSTOUDE HET NIEUWE LICHT D"". L S.TMEYBO.M. Uit te geven in 12 Maandelijksche Afleveringen a 15 centen ieder. HH. Boekhandelaren die op dit werk Inteekenarcn bekomen  doch hiervan nog geen berigt gezonden hebben worden verzocht dit zoo spoedig mogelijk te doen  teneinde hun de tweede Aflevering getiteld : DE TWEE GELOOFVERBOADEN op 1° dezer verschenen ten vervolge te kunnen toezenden. Amsterdam Februarij 1856. H. J. FRIJLINK. V oor Gemeente-Besturen. Bij P. N. van KAMPEN te Amsterdam is verschenen: H. VEBWOEBT Klapper op de Staats-Regterlijke en andere Wetten Besluiten Aanschrijvingen en Regterlijke Uitspraken betreffende het ADMINISTATIEF BURGERLIJK BESTUUR - IN NEDERLAND. 1» Deel compleet ƒ 640; 2» Deel lc Afl. ƒ-70. In twee Deelen voorzien van een naauwkeurig Alphabetisch Register zal dit nuttige Werk geheel compleet zyn. *V Bij G. T. N. SURINGAR Uitgever te Leeuwarden  is verschenen : De derde Druk van het Eerste Deel der NIEUWE GEDICHTEN van' uitmakende het vijlde Deel der MINKOSTBARE UITGAVE DER GEZAMENLIJKE DICHTWERKEN VAN H. TOLLENS CZN. Voor da Koopers der geheele verzameling wordt deze Uitgave berekend tegen f 125 voor die van afzonderlijke Bundels of Verzamelingen onder eenen Titel tegen f 150 ; per Deel. ♦^By'A.C. KRUSEMAN te Haarlem komt van de pers : NICOLAAS BEETS Tweede minkostbare uitgave f 250. Als Prachtwerk met Staalgravuren - 10 M\ I. DA COSTA HESPERIDEN (Een nieuwe Dichtbundel) met Vignet ƒ 230. m. Mr. 11. J. KOENEN i niHiii M STICHTELIJKE LIEDEREN. Met Vignet ƒ 195. *** Eene behoeftige vrouw hier ter stede heeft gedurende twee jaren aan rheumatischc pijnen gesukkeld die zich voornamelijk in schouders en armen openbaarden en waartegen geen middel iets vermogt. Door een Goldbcrgerschen Ketting werd zij linnen acht dagen daarvan bevrijd. P. L. MIRANDE Pz. Harlingen 10 November 1855. G-oldberger's Kettingen genezen hoofdpijn  aangezigts- tand- en oorpijn krampkolijk maagkramp borstkramp hartkloppen  zenuwzwakte beving pijn in de lenden  stijfte in de leden  gewrichtpijn pootje handjicht vliegende jicht zwakte der oogen  hardhoorigheid en alle andere rheumatischc en zenuwziekten. Zij worden voor/180 f 270  ƒ 360 / 540 in het TERKOOPIUUS en de bekende Depots verkocht. (2/18 56.)",http://resolver.kb.nl/resolve?urn=ddd:010544717:mpeg21:a0021:ocr,4,ddd:010544717:mpeg21:p004,Opregte Haarlemsche Courant,1944
30420,1856/10/17 00:00:00,52,ddd:010924771:mpeg21:a0018,http://imageviewer.kb.nl/ImagingService/imagingService?id=ddd:010924771:mpeg21:p004:image&x=417&y=1825&w=585&h=52,ddd:010924771:mpeg21,1002,1877,417,1825,4,"- AÖ VERT-EMTIJBSr':-""--ji/.",http://resolver.kb.nl/resolve?urn=ddd:010924771:mpeg21:a0018:ocr,4,ddd:010924771:mpeg21:p004,Leydse courant,585
35400,1856/07/31 00:00:00,40,ddd:010777101:mpeg21:a0002,http://imageviewer.kb.nl/ImagingService/imagingService?id=ddd:010777101:mpeg21:p004:image&x=65&y=92&w=885&h=40,ddd:010777101:mpeg21,950,132,65,92,4,____._» -f.W: MHtTBL. HG fl _ _E ;__,http://resolver.kb.nl/resolve?urn=ddd:010777101:mpeg21:a0002:ocr,4,ddd:010777101:mpeg21:p004,Utrechtsche provinciale en stads-courant : algemeen advertentieblad,885
2160214,1856/04/07 00:00:00,2303,ddd:010251418:mpeg21:a0012,http://imageviewer.kb.nl/ImagingService/imagingService?id=ddd:010251418:mpeg21:p004:image&x=1005&y=87&w=938&h=2303,ddd:010251418:mpeg21,1943,2390,1005,87,4,k 41111i\ Ts^T_ i. lIF Iï. kortademisacid' helsen'be- t\ .15 Mti I't O 1 1 Uil Lil V naauwde borst hoest schorheid pijn in de keel pijn op de borst kugchen beginnende tering en alle andere borstkwalen geneest DU BARRY'S REVALENTA door hare inwikkelende verzachte eigenschappen zeker en spoedig. Zij is le verkrijgen in het VERKOOPHUIS en de bekende Depots voor 7. c. 2 'ó_ 8 en 16 Gulden de bus. De Heer PAREER Rapt. bij de Eng. Marine werd door DU BARRY'S REVALETA van slechte spijsvertering genezen waaraan hij vele jaren geleden had. De Heer JOHN MANNING NUTTING van hardnekkige kwellende hoofdpijn. Miss MARY JOLLY van aamborstigheid hoest winderigheid  krampen en zenuwtoevallen een harer Neefjes van een jeukend huiduitslag. De Heeren R. AMBLER van het Latijnsche School te Stevcnage — WALTER EEATING op Jersey — DAMPITS Queensterrace Londen ¦—¦ H. CLARE Catherinestreet Sommerset attesteren alle dat het een voortreffelijke voedsel is om er kleine kinderen mede op te brengen. Mejufvr. KATIIARINA STAHLE te Heidelberg werd van hevige diarrhaea en slapeloosheid door de REVALENTA genezen — W. ROST le Amsterdam van maagkramp — het Eindje van de lieer L. DE BOER. te Franeker van verzwakking — De Dochter van den Landman v. W. te Gellicum van de tering — W. DE WEERD te Bronkhorst van maagpijnen. (1972) (1968) Bij Gebr. VERHOEVEN te 's Bosch C. L.VAN LANGENHUYSEN te Amsterdam en bij hunne gewone Correspondenten op aanvraag verkrijgbaar: BIJVOEGSSL VAN HET GRADUALE ROMANUM Inhoudende: Dc ..lissen van het Lijden: Op het Feest der Onbevl. Ontvangenis. (8 Dec.) — — van de verwachting der 11. Maagd. flB Dec.) — — » ondertrouw der 11. Maagd. (23 Jan.) — — der HH. Zeven Instellers elc. (11 Feb.) — — van den 11. Gabricl. (18 Maart) — — » H. Franuiscus Carracciolo (4 Junij) — —- ii 11. Aloysius (21. Junij) — — » Alphonsus de Liguorio (2 Aug.) — — der 7 Droefheden van de H. Maagd. — — van O. L. V. van Bijstand. — — van den Bijstand van den H. Joseph. (3e Zondag na Paschen. j — — van het Allerh. Hart van Jesus. Formaat in 4°. Prijs f 1 25. ** j Mede verkrijgbaar in heele en halve banden* Goedgekeurd door Z. D. H. Mgr. J. Zwijsen. Aartsb. van Utrecht adm. Apost. van 's Bosch.,http://resolver.kb.nl/resolve?urn=ddd:010251418:mpeg21:a0012:ocr,4,ddd:010251418:mpeg21:p004,De Tĳd : godsdienstig-staatkundig dagblad,938
23996,1856/01/02 00:00:00,28,ddd:010776924:mpeg21:a0012,http://imageviewer.kb.nl/ImagingService/imagingService?id=ddd:010776924:mpeg21:p003:image&x=1892&y=2504&w=857&h=28,ddd:010776924:mpeg21,2749,2532,1892,2504,4,"___.___» ■_-""""_____)_________._____""___.___________r",http://resolver.kb.nl/resolve?urn=ddd:010776924:mpeg21:a0012:ocr,3,ddd:010776924:mpeg21:p003,Utrechtsche provinciale en stads-courant : algemeen advertentieblad,857
1387000,1856/10/17 00:00:00,1460,ddd:011084727:mpeg21:a0006,http://imageviewer.kb.nl/ImagingService/imagingService?id=ddd:011084727:mpeg21:p002:image&x=70&y=69&w=950&h=1460,ddd:011084727:mpeg21,1020,1529,70,69,4,Aangeslagen1 Fendntiëh.  Op Maandag den 20slen October 1856. Voor het Woonhuis van Mejufvr. flamwel. • Op D i ngsda g. den. 2 Isten October 1856. Voor het Sterfhuis van ' den Cbinccs Tan Koeici Soeij van ecnig'e vastigheden ten 10 ure precies.' ' '' : ■ Op Woensdag den B2sten October 1856. Voor liet Commissie-huis van Jan Schellema. Op Donderdag den 23sten October 1856. . Voor hel Commissie-huis van Kruttwffer Soesman & Co. < > ' Op Vrijdag en Zaturdag den 24 en 25sten October 1856. Bij den Pachter der-pandjeshnizen. &toertentiëiu • • • - ■ • • ♦ OP MAANDAG den S 2 Oclobcr 1U56 zal er in de S/iekslraat wegens vertrek van Mejufvrouw HAMMEL _ Tcndulic j»chouden worden van Meul>ilair en cenige andere GoefiSf deren. (878) JAN SCHEI.TEMA,http://resolver.kb.nl/resolve?urn=ddd:011084727:mpeg21:a0006:ocr,2,ddd:011084727:mpeg21:p002,Samarangsch advertentie-blad,950
24897,1856/01/31 00:00:00,43,ddd:000011358:mpeg21:a0015,http://imageviewer.kb.nl/ImagingService/imagingService?id=ddd:000011358:mpeg21:p004:image&x=1239&y=1650&w=579&h=43,ddd:000011358:mpeg21,1818,1693,1239,1650,4,AI»VEItTKXTIE_tT.,http://resolver.kb.nl/resolve?urn=ddd:000011358:mpeg21:a0015:ocr,4,ddd:000011358:mpeg21:p004,Dagblad van Zuidholland en 's Gravenhage,579
4504860,1856/10/23 00:00:00,4315,ddd:011192067:mpeg21:a0017,http://imageviewer.kb.nl/ImagingService/imagingService?id=ddd:011192067:mpeg21:p004:image&x=2202&y=84&w=1044&h=4315,ddd:011192067:mpeg21,3246,4399,2202,84,4,"HARI/VGyMAKRE en pUck-pin „ PLANKEN;-ge'durendeido Sasws! * «u«: *•»«fc *». s'i.' n "" r 1 «SV» HSfmiwM .K «?  wd| eerst volgende vol 2; ol«j o > maanden ivoor* de' piantagenuVreeland\ila(t\aix<en Johannesbursri n»»rinndipd ' ' "" "" ■* üurS\ benoouigu. Uc .ïiiisfchrn vingen .aangenoroenl ""A'«l . * "" nsfc"" irvtttnwro «wHmii :»« a !*; %.W. ten .kantoreïvanjdenj ondergeteekende uen zullen aldaar geopend worden op Vrijdag ««MM o""!! I 411 • »« Qr Q .1 ""SW* ** **ü» *': ij Ml uen oln.. üctober löso • des voormiddag» MW4M«%k Y». mm |a • 1 «ff tesllMure ; met vnilating» aan >de anschrn»  ■'***'«i^^JirryUii>•. fc*»±L*tA<m*ES»i*.. tw.wn..>.7 vsiA'' ivers om daarbn tegen woordig te - aunl ;: v Paramarttiö'/«té»I*22?'Octobêr'[1*22?'Octobêr'[ 1856. ■ (13819)n ïEG BERT van EMDEN qq.<; WÏIS... i. ■ 'A""' 'VI va ■■■..■f-.T;'Hr. i-Av';:;'...?'Ul-fe :.;• 1* oroj9 • r«w i^i<wtfiw|ihÉiiiwwM ""hpTw*i| ■ niiiwii|uw» ""mü«nii;Timl» «Mtom « *Mnn| urezal4 door-jen:tenihuizeivaiifden^yen? dumeesteriA. SALUMOINS worden;verkocht:; Ii• S Hetßl ent Kl*Figelegen fejj'Mï'? aan ilGi6aramacca straa t la. E:. No.. 6  .aaiiKOiiicnde den B oedel wijlen tóitó^jmsos:'' ■*■■ ■; (13301y Heden middag oai 4 ure ten • Sterlhm/e ;van ""nu willen den Heer IV-F RfXBY • "" ' «•»•.. r .iji ad i i . . . i;^VSn':;!?«rt»Bsl>lsKEW';!ién':SSi;A'.V ® «MSasaMMB! I133C0) ■ v..;. ; ■. . ik t* < i •' 1 0p <JW ;V;V.% OAt»SSüM• 27|Octobei\se. k;; Cóntimiatiu d< r VEMiV door den Vendumeester A: S VLOHONS  ten' huite van den-' Heer KOIIN aan de 'Watermolen straat:' •"" •■ ;' *>%? Zijnde! de (iOEDEREN van Heden!af tot o[>  (len ; verkoopdag' ;:te * bezigtigen; en ;; tegon COiVTA/V.Ti( CA»S/.)  UIT. I)Ë HIVNJ)iTE..KOOI\„ (13673) v •*; * j .>. ■ ' ; .**■ ■ ""-* '•• .' . •"" "" - ••«!'.•• 'V- Worden ih liuur gevraagd: :..;j üI tli 1111 Kür; pm Kqöij'fjte tplukken';(óp '*>-<i^fvi»?Tr.£A4mMy f--""; >-..■■.•■ .■ s .:•■■- ■ xygpMV* *11il ■ ** V< I i tla . iDiülH * «iw«.' J c/rEfcTi.¥« :J«Ï'fcCo.; v hebben ontvangen p«r de s«sa»na :; y  Puik «puike;«nieuwe IloLlandsche dox- IK'i» l'i:It11!..-| ïlnt«M« ;;i>v>«uvn» V?»! '1n <in < hooideq du bhele /prmeesso••: I »»..>«>» H-ltllM I.» -ttji s:■ -U! »« : ■: asHR ■■ ■ (ljolo) t; ~  . -J..U % E^BAKiKEK^I Commissie ontvangen '<'^EeiïïieatirawmQoi 4assortiment STAANDE LAlfimm biedtt dezelvebuitenqewoon goedkoop} aan en staat- voor! derzei ver 'aeusaelttKfma* va: (13811) ' '''• ' ''>■■. li. ■ ; . : :ïvril WÊÊÊÊÊkammÊÊnmanÊm—<<——————■■■■—> -rj .""'••• VPRPCTf?RIV(3i .-; :-V  ' V ; Jn.het stukover.do. Protestautsch f Sunnaarasche Mettrau \ vóorkmnende -in ons. No. 127  staat *op bladzijde? 3 « k<il<»ra '2 regel;' 18.van' boven: ge* zwegen' van huissetijke Hü c h t;»lèes :5 twist. i; ;i; ;H i --s'^ eïdrntt b# J. 'M(IUCBR!'A>--^.",http://resolver.kb.nl/resolve?urn=ddd:011192067:mpeg21:a0017:ocr,4,ddd:011192067:mpeg21:p004,Surinaamsche courant en Gouvernements advertentie blad,1044
805488,1856/10/06 00:00:00,1038,ddd:010113191:mpeg21:a0033,http://imageviewer.kb.nl/ImagingService/imagingService?id=ddd:010113191:mpeg21:p004:image&x=3253&y=106&w=776&h=1038,ddd:010113191:mpeg21,4029,1144,3253,106,4,"Dc Beurtseulppcr JOHs. BOUMAN Pz  van den Korendijk  maakt bekend dat hij we *- lijk. des MAANDAGS arriveert met j» BESTE WINTER-AARDAPPELEN- Monsters zijn bij hem aan boord te bp"""""".^ de 4de Schuit van de DraatstCCg »«n "" West-Nieuwland te Rotterdam (Bb/ ' LEIHBIBLIOTHEK van O PETRI Hooest lij dc gr. Markt <>""£ "" enthiilt über 4000 Bande Romane historische » || cher Klassiker etc: ferner viele ill. 'Wcr -j- Elietf. matter Riisseldorfer &* * natshef'tc illustr. Xeitung > *j mijn er van A.v. H. abokkemekt V'L » Jo — halbjahr ƒ3 — Catalog. gratis. r WORDT GEVRAAGD: b EENE MODISTCi ; P. G. die het STROOIIOEDEN M**^ e iv den grond verstaat. Adre. met franco B'Jj! r J onder Letter L. non de Boekhandelaren GEB™ 1 DERS EENDRIKSEN. (887JI 1",http://resolver.kb.nl/resolve?urn=ddd:010113191:mpeg21:a0033:ocr,4,ddd:010113191:mpeg21:p004,"Nieuwe Rotterdamsche courant : staats-, handels-, nieuws- en advertentieblad",776
1433124,1856/03/06 00:00:00,2068,ddd:010901411:mpeg21:a0027,http://imageviewer.kb.nl/ImagingService/imagingService?id=ddd:010901411:mpeg21:p004:image&x=777&y=107&w=693&h=2068,ddd:010901411:mpeg21,1470,2175,777,107,4,"Alles berekend per 5 Ons. De Theeën van no. I—9 eu de Groene soorten no. I—B'zijn verpakt in Pakjes van 2\ en 5 Ons; terwijl op elk Pakje prijs en noramer bemerkt is. SEitSGT AAN XPINKELIEIIS. ; De ondergeteekende geeft door deze aan zijne geëerde ' Stad- en Landgenooteu te kennen dat in den loop der aanstaande week en bij voortduring in Magazijn bij hem alle soorten van zeer fraai gewerkte üïans- en Vronwen-Ulompen te-bekomen zijn naar qualiteit tegen zeer civiele prijzen. "" __ - '. Adres bij P. DE ZEEUW In den Kortendelft en in de Korte Geere Lett. K 356. De ondergeteekende maakt zijne Stadgenooten bekend' dat hij van beden af zich aanbeveelt als Lijkdienaar belovende eene goede en prompte behandeling. J. LANDMAN Balans. Blijkens bovenstaande Advertentie zijn de ondergeteekende Ujkdienaren .binnen deze Stad overeengekomen hunne Tarieven van begraven gelijk te stellen; dezelve zijn zoo goedkoop mogelijk-berekend/Zij hopen vanhunne wel-;""' denkende Stadgenooten""hièfe ""het vertrouwen 'vereerd te worden en zullen van hunne zijde alles aanwenden om zich hetzelve waardig te maken. .-■-..■ Middelburg den 5 Maart 1856. H. J. DE WAARDT EELTEN- ■ . • J. LANDMAN Balans. Bij T. P. ROEST alwaar in de afgeloopene Loterij onderscheidene Prijzen zijn gevallen van / 100  ƒ2OO / 400 en f 1000 zijn voor de 229ste Loterij weder te verkrijgen Heele en Gedeelten van 1* ©X E Hf zoo in Koop als in Huur. ..t . Bij J. VERMAAS te Vlissingen is getrokken in de 228ste Staats-Loterij; op: No. 13162 een Prijs van/1000. Onderscheidene Prijzen van ƒ 100 en vele van / 70. B'y hem ziju weder te .bekomen voor de 229ste Staats- Loterij Heele en Gedeelten van LOTEW. MITZIJKWEEKEN: Plano  Piano-Zang  Fluit Viool Viploneelle rgel-Méiodium enz. de nieuwste uitgaven voorhanden bij HOUPT. ~ 'vraagt een of twee ordelijke Jongens.'"" NB. Recommandeert zich voortdurend zoo voor Taxeren als Inkoop van Diamant en Edelgesteenten. 130 Stuks Blaaawe VLOËRSTËBUWËW te Koop. — Adres Wal letter B no. 54. Ontvangen bij C. GOEREE te Vlissingen puik van Westfaalsche Ham en Saucise de Doulogne Te Koop CJorincHemsche Mest-Varkens van 4 tot 10 Maanden bij J. BARTO Seisstraat Een Schilders-Leerling benoodigd bij P. A. VERVENNK Vlasmarkt. .. Eeuo bekwaame SMenstmeid die met de Wasch kan omgaan benoodigd. Adres bij den Boekv. HENDRIKSE Met Mei eene Meid benoodigd. G 20",http://resolver.kb.nl/resolve?urn=ddd:010901411:mpeg21:a0027:ocr,4,ddd:010901411:mpeg21:p004,Middelburgsche courant,693
1293360,1856/03/07 00:00:00,816,ddd:010112983:mpeg21:a0042,http://imageviewer.kb.nl/ImagingService/imagingService?id=ddd:010112983:mpeg21:p004:image&x=940&y=2336&w=1585&h=816,ddd:010112983:mpeg21,2525,3152,940,2336,4,ROTTERDAM-HAVRE. Afvaarten van belde havens : 4 9 14  1» S_  %® van tedere maand. i In verbinding voor PASSAGIERS en GOEDEREN De Stoompacket Selne Kapt. WITTEN- met de geregelde Amerik. Postsehepen tus_.™« ... —. -  n «f 1 srheft Bavre New-Xorx en JSew-Orhans en met de BERG Tertrekt naar Matrre Zondag 9 Maart. 1 _faKigatlantische gtooni&chcpen tus* schen Bavre en New-York en Bavre en Brazilië. ROTTERDAiI-BORDEAUX. BIMECTE BIEWST in 3 U dagen. De Stoompacket üfordeaUS Kapt. HALF- I In Correspondentie met den Spoorweg tussehen WEG vertrekt van Rotterdam den 9 Maart I Bordeaux en Bayonne en de Stoombooten tussehen en van Bordeaux den 19 Maart. ! Bayonne St. Sebaslien Bilbao en Santander. Adres ten Kantore van SMITH & Co. te Rotterdam P. GRANDIN to Havre ALBRECBT & FILS te Bordeaux. (2122) ROTTERDAM - ST. PETERSBURG (chonstadt). Het Stoomschip &irO n d e  Kapitein VAN EMMERIK  zal bjj Heropening der Scheepvaart m de Oostzee en^rolf van Finland de «ESEdEïj©E BIEKST tussehen Rotterdam Copenhagen en St. Petersburg HERVATTE». De Afvaartdagen zullen later bekend gemaakt worden.,http://resolver.kb.nl/resolve?urn=ddd:010112983:mpeg21:a0042:ocr,4,ddd:010112983:mpeg21:p004,"Nieuwe Rotterdamsche courant : staats-, handels-, nieuws- en advertentieblad",1585
2213405,1856/01/25 00:00:00,2185,ddd:000012690:mpeg21:a0009,http://imageviewer.kb.nl/ImagingService/imagingService?id=ddd:000012690:mpeg21:p002:image&x=1114&y=2776&w=1013&h=2185,ddd:000012690:mpeg21,2127,4961,1114,2776,4,"BURGEMEESTER en WETHOUDERS saï ZWOLLE Ziju voornemens op -'•''""""udug den •_ Februarij ISS(J des middags te 12 ure op het Stadhuis bij inschrijving aan te len: 1"". het daarstellen vau eeaen E&aaïmuur aan den buitenkant; 2°. de levering van 70«4)0tQ stuks bckaptc ECeiJen ter dienste der stra 3». Het II [en en Onderhouden* jilaatsen in wegnemen dep Toestellen voor de BoteniKirkl jaren 1886—IBGI. En zulks op de voorwaarden  die ter Stedelijke Seeretarij ter lezing voorliggen en de informatien die bij den Siads Architect te bekomen zijn. Zwolle  24 .lanuarij 1850. . Burgemeester en V'el/ioui/ers voornoemd .1. A. G. Dt VOS vax STEENWIJK. K. N. SCII KEK MAM Secretaris. I'.K.UIKMKKSTKIt eeT \s KriIOI<DKKS van ZWOLLE  zijn voornemens 'ag J-n 2^ Januarij 185Ö des midte 12 unr bij inschrijving nan te besteden: I°. het onderhoud der Kleppermanshuiges en Gereedschappen ; 2°. het ond ertmuddcY Straat- Grind . Puin- en Zandwegen ouder deze _;oinecnte. En zulks voor deu tijd van ÜOH jaren op de voorwaarden die ter Seeretarij ter lezing voorliggen en de informatien  die bij den Siad.-'-Areliitcet te bekomen zijn. Zwolle  deu 21 Januarij 1856. Burgemeester ca Wethouders voornoemd .1. A. G db vos van STEENWIJK. L. X. SC! -'.'W-v. I.IiIKIK.Ur.ESTER en WEITIOU DERS der gemeenle IIAS-BELT- zullen op den 20 ./¦ . des middags lc 12 ure op het Raadhuis aanbesteden: Het bouwen van een Reenen Siaaimiiurcn s*i*ïvaat langs de rivier het Zwurlewater met alle daarmede in verband staande onderaardsche waterleidingen en baggerwerken  waarvan bestek en voorwaarden op het Raadhuis ter lezing'liggen en tegen betaling vnu/ 1 v<>or een ieder verkrijgbaar zijn. HASSELT den ?.? Januarij 1856. Burgemeester en Wethouders voornoemd A. M VCLAINE EONT Voorziller. ! . ('. 11. FREISLICH Secretaris. __^re- J)(; COMMISSIE tot het ontwerpen van \{aV^ ''rl I'lau van verdeeling van de ROSEN-* «fc2A m\^-~- GAARDER MARKTE roept bij dezen op alle diegenen die beweren mogten een of meer Waren in die Markte te hebben om zich vóór den 1 .!/((«/•(! 1856 aantemelden bij den Heer U. A. I. I. J'.aron van HAERSOLTE Ryks-Ontvanger in de Gemeente Zwollerkerspel wonende te Zicolle iv het Weczenland. C. JANSSEN R.CZoon op den Huize RUITENBORG",http://resolver.kb.nl/resolve?urn=ddd:000012690:mpeg21:a0009:ocr,2,ddd:000012690:mpeg21:p002,"Provinciale Overĳsselsche en Zwolsche courant : staats-, handels-, nieuws- en advertentieblad",1013
2144205,1856/07/13 00:00:00,2269,ddd:000011515:mpeg21:a0019,http://imageviewer.kb.nl/ImagingService/imagingService?id=ddd:000011515:mpeg21:p003:image&x=1087&y=1098&w=945&h=2269,ddd:000011515:mpeg21,2032,3367,1087,1098,4,De COMMISSIE door den Gemeenteraad benoemd tot het afnemen van het Evnmcn aan de Jongelieden  die wenschen toegelaten te worden op het Stedelijk Gymnasium roept du voormelde jongelieden op om zich op DINGSDAG don 15 JULIJ tusschen twaalf en twee ure  te vervoegen ten huize van den heer Rector van het Gymnasium alwaar hun berigt zal worden gegeven van den dag en het uur waarop het examen zal plaats hebben. Bij dit examen zullen de jongelieden bewijzen moeten geven dat zij wel bedreven zijn inliet Lezen Schrijven Rekenen  de gronden der Nederduitsche en Fransche telen en de beginselen van de Aaidrijks- en Geschiedkunde. Verder worden de belanghebbenden verwittigd  dat gemeld examen slechts éénmaal in het jaar gehouden wordt en dat niemand tot het examen kan worden toegelaten  tenzij hy voldoende bewijzen zal hebben bijgebragt dat hij  hetzij de natuurlijke kinderziekte beeft gehad hetzij do koepokinenting heeft ondergaan. 'sGravexiiage 10 Julij 1856. De Voorzitter der Commissie __^ W. M. de BRAUW. ~ Mm&zmm KRUIS. Afdeei.ixg 's Gravf.xiiage. AEG EHEE* E VERGAREREVG op Donderdag den 24 Julij 1856 des avonds ten.halt'acht ure. lElr hesotiatïe ~Jiil rentesute 4L percent '$Jaars. Het B E S ï UUR der V E R E E N I GIN G tot verbetering der woningen van de arbeidende hïasse te 's Gravenhage  adverteert dat vermits de door hetzelve len vorigen jare opengestelde NEGOTIATIE  groot ƒ 75000  tot dus verre niet geheel is geplaatst er bij voortduring gelegenheid bestaat töt het bekomen tan Aandeelen ieder groot ƒ250 en rentende vier per cont's jaars in dio Negotiatie  ten kantore van den lieer E. Ij. der Kinderen Commissionair in Effecten enz. Laax wijk W n°. 335 te dezer stede. De rento dier Aandeelen gaat in op den dag der storting van hun bedrag terwijl aan Makelaars of Commissionairs in Effecten wordt te goed gedaan eene premie van één vierde ten hónderd over de sommen  waarvoor zij in deze Negotiatie deel nemen. Nadere inlichtingen zijn te bekomen ten kantore van den Heer der Kinderen' voornoemd  en voorts te vinden in het Dagblad van Zuidholland én 's Gravenhage van Vrijdag den 23 Mei 1856 n°. 121. 'sGrwexhaoe 12 Julij 1856. Het Bestuur voornoemd J. P. DELPRAT Voorzitter. H. J. vax dek HEIM. Secretaris.,http://resolver.kb.nl/resolve?urn=ddd:000011515:mpeg21:a0019:ocr,3,ddd:000011515:mpeg21:p003,Dagblad van Zuidholland en 's Gravenhage,945
3043348,1856/06/26 00:00:00,3374,MMSADB01:000003437:mpeg21:a0006,http://imageviewer.kb.nl/ImagingService/imagingService?id=MMSADB01:000003437:mpeg21:p004:image&x=1119&y=188&w=902&h=3374,MMSADB01:000003437:mpeg21,2021,3562,1119,188,4,Advertentie GRIETJE POSTMA een dienstmeisje te Leeuwarden die ten gevolge eener verkoudheid de stem verloren had  zoodat zij een jaar lang niet verstaanbaar spreken kon is door een fSolcIbergerselien Meeting' genezen. Jufvrouw C. 1IEPP Schilderssteeg te Rotterdam van zware rheumatische pijnen door alle leden. De echtgenoote van Kapitein KLINGENSTEIN te Greuszen in Sclnvarzburg van chronische kies- en oorpijnen. Dr. F. HARTMANN Hofraad en geneesheer te Arnstadt in Sclnvarzburg verklaart dat men deze Kettingen met uitnemend goed gevolg bij rheumatische kwalen aanwenden kan. Dr. C011EN officier van Gezondheid bij het 4de bataillon van linie te Gluckstadt in Sleeswijk-Holstein-Lauenburg heeft ze in zijne praktijk steeds met gunstig gevolg aangewend tegen zenuwachtige aandoeningen vooral in het hoofd. Alle rheumatische ziekten verlammingen gewrichtspijn hoofdpijn oorpijn kiespijn maagkramp krampkolijk kramp in de borst en in de kuilen knubbeljicht verstijving in de leden aangezigtspijn zenuwziekten worden zeker en spoedig door Ci-oïclberg-er's Bietting-en genezen. Zij kosten ƒ 1.80—2.70—3.60—5.40. AMSTERDAM Verkoophuis; Breda Wed. Wier cx Folla cn Kannemans van Dashorst; Beryenopzoom D. Pouwels cn P. F. Appelboom; Boxmeer G. Muller; Eindhoven A. Beguin; Gemert II. A. van der Willigen; Helmond A. H. Martin; 's Heitogenbosch F. L. Welsch; liosendaal T. X. Kriiger; Tilburg G. H. Domhoff; Waalwijk F. van der Klokken; Tholen  T. J. Maas; Zevenaar J. S. Reijnders; en in de bekende Depóts in de andere Steden. (2178) DE PILLEK VAR! H0LL0WAY kunnen door Mannen en Vrouwen en op eiken leeftijd gerustolijk genomen worden derzelver werking is zacht maar bepaald en zeker. Daar zij in alle deelen des ligchaams doordringen zoo dienen zij ter wegneming van elke ziekte en bijzonderlijk voor lever- en maagkwalen gal enz. Zij zuiveren volmaakt het ligchaam en derzelver uitwerksels in gevallen van aandrang van het bloed naar het hoofd cn borstkwalen kunnen niet genoeg worden gewaardeerd. Om kort te gaan er zijn weinig ziekten en kwalen die bij eenige volharding in het gebruik aan derzelver weldadigen invloed kunnen weerstaan. £>oac tjet licnnecröerö SDcüiet zijn de Prijzen als volgt: DOOSJES PILLEN a/080 /• 185 ƒ 300 ƒ675/ 1 1350 ƒ2050 POTJES ZALF 4/ 080 ƒ 185 ƒ300 ƒ705 / 1385 ƒ2025. Zijn op franco aanvrage a contant te bekomen bij G. Does te Tilburg; bij II. J. van den Goorberg te Breda; bij P. J. Vertinden te Bergenopzoom en bij J. STRAAT3SAK1 Hoofd-Oepötlioiider te 's Hertoijenbosck alsmede in HÜLLOWAVS Etablissementen te Londen 244 Strand en te New-York 80 MaidenLane. (2179),http://resolver.kb.nl/resolve?urn=MMSADB01:000003437:mpeg21:a0006:ocr,4,MMSADB01:000003437:mpeg21:p004,Provinciale Noordbrabantsche en 's Hertogenbossche courant,902
2044326,1856/05/05 00:00:00,2274,ddd:010777027:mpeg21:a0018,http://imageviewer.kb.nl/ImagingService/imagingService?id=ddd:010777027:mpeg21:p004:image&x=52&y=2055&w=899&h=2274,ddd:010777027:mpeg21,951,4329,52,2055,4,"*J* Men verlangt tegen primo Julij 1856 een goed onderhouden HUIS te Huur voorzien van ze? ""Kamers Küuken Kelder Zolder en Binnenplaats of Tuintje gelegen in een vrolijk gedeelte binnen de stad Utrecht. Brieven franco adres onder lett. A. aan het bureau dezer Courant. TE HUUR V Een BOVENHUIS van zes Kamers Keuken vrijen Zolder gelegen op het vrolijkst gedeelte der Oude Gracht; franco te bevragen onder lett. P. aan het bureau dezer Courant. V ©I»RU1MIM„ van eene partij PENDULES BRONSWERKEN CRISTALLEN PORCELEINEN SPIEGELS enz. beneden fabrieksprijzen. M. A. F. REUSER. UITVERKOOP. *„* De Ondergeteekende gaat steeds voort met den uitverkoop van zijnen voorraad GARENS LINTEN gebreide en geweefde GOEDEREN MANUFACTUREN en MODE-ARTIKELEN tegen fabrieksprijzen. A. BRESSLER Oude Gracht St. Jansbrug. \* Er wordt een kapitaal gevraagd van f ft&OO.— om bij maandelijksche betaling af te doen van f 100— of/ 200 naar verkiezing met rente naar overeenkomst  met 2 soliede borgen. Adres aan het bureau dezer Courant lett. O. HET M?m VAN YSSELSTEiN. *m* De ondergeteekende maakt aan het geëerde publiek bekend dat zijn K.OFF IJIIUIS HET WAPEN VAN YSSELSTEIN ingerigt is tot Logement en Uitspanning;. Ysselstein Mei 1856. N. A. FREERICKS. V Het kantoor der Mieuwe meer gelijkmatige _ran<l-V« aardweg llaatseliappjj te Loenen a/d Vecht is op heden verplaatst naar Amsterdam op de Keizersgracht bij de Reestraat K. K. 355. VERHUISD: V van de Oude Gracht naar dc Lijnmarkt bij den Heer VAN BOEKHOVEN G. J. VAN EYKEX.",http://resolver.kb.nl/resolve?urn=ddd:010777027:mpeg21:a0018:ocr,4,ddd:010777027:mpeg21:p004,Utrechtsche provinciale en stads-courant : algemeen advertentieblad,899
2881317,1856/10/13 00:00:00,2617,ddd:010086747:mpeg21:a0015,http://imageviewer.kb.nl/ImagingService/imagingService?id=ddd:010086747:mpeg21:p004:image&x=1160&y=77&w=1101&h=2617,ddd:010086747:mpeg21,2261,2694,1160,77,6,"MUIT DB HAND TE KOOP VOOR /"" 12500 waarvan 6/Mille n; op Hypotheek kan gevestigd blijven : ;S Een hecht  sterk en modern doortimmerd HUIS met BINNEN n- PLAATS staande op de Prinsengracht bij de Reguliersgracht Z. Z r- bevattende 8 Kamers 2 Provisiekaraertjes Dienstbodenkamer Zolder' ik Vliering ruimen Provisiekelder Keuken met Regenwateispomp; alsmec le een Kantoor en Pakkelder; verders alle mogelijke Gemakken; te bevrage N met Franco Brieven bij de Makelaars G. H. BROEKHUIJSEN en J. . 1- MEIJERINK MEIJER Singel over de Warmoesgracht. (16939) "" Men biedt terstond TE HUUR aan voor een HEER: Twee HAMER) met ALCOVE voorzien van Kleeden en Gordijnen in den omtrek va de Munt. Adres bij den Boekhandelaar W. WILLEMS Vijzelstraat b de Heerengracht X 553. (16909) LEES HIER! Bij toeval TE HUUR een HUIS met alle Gemakken voorzien e een OPEN PLAATS staande in de Plantaadje; te bevragen b > A. H. SCHAKEL in de Plantaadje hoek Badlaan en Lijnbaan! ;* gracht NQ. 174. (16885) Door vertrek naar Buiien biedt men TE KOOP aan: Eene florissant p' TABAKS- en SIGAREN-AFFAIRE  gelegen in eene zeer volkrijk - Buurt alhier. Reffecterenden gelieven zch te adresseren met Franc . Brieven Lett. A. Z. bij den Boekhandelaar G. D. BOM Damra H 117 alhier. (16989) BANKETBAKKERS. Er worden gevraagd twee BANKETBAKKERS-BEDEEN DEU en een LEERLING met pr. Nov. e k. Verzoeke opgave van Religie bij wien en hoe lang gewerkt met Franco Brieven onder Lett. A. B. y bij de Boekhandelaren J. G. VAN TERVEEN & ZOON t . Utrecht^ (16920) a Eene JUFVROUW 23 Jaren oud zag zich gaarne geplaatst TEI  ADSISTENTIE in eene HUISHOUDING of ter Verzorging vai - JONGE KINDEREN of ter Gezelschap eener BEJAARDE DAME er zal meer op Goede Behandeling gelet worden dan wel op Salaris Adres Lett. J. W. in den Kantoor-Boekwinkel en Koperplaat-drukkerj van R. B. DEWESEN op den Haarlemmerdijk bij de Eenhoornsluis No. 189 te Amsterdam. (16941) j Tegen io. Mei 1857 vraagt men IN HUUR: Een HUIS  bevattend . zes ruime KAMERS DIENSTBODENKAMER ruime ZOLDER _ KEUKEN en PROVISIEKELDER in het midden der Stad gelegen als Reguliersgracht Kloveniersburgwal Oudezijds Voorburgwal Singel enz.; den HUURPRIJS van ƒ 850 niet te boven gaande. Adres ondei : Lett. X. IJ. Z. Bureau Handelsblad. (16954) ! DESVERKIEZENDE ZONDER SALARIS  ' biedt zich eene Fatsoenlyke WEDUWE aan  ter adsistentie of ter geheel: waarneming eener Fatsoenlijke HUISHOUDING met of zondei 1 Kinderen of wel tot GEZELSCHAP EENËR DAME; hetzy 1 binnen of buiten deze Stad en aangezien men hoofdzakelijk eene Fatsoenlijke behandeling verlangt zoude men die des noods prefereren boven eene gcldeiyke belooning. Reflecteerende gelieve zich S. V. P. Franct te adresseren onder Lett. H. S. bij den Boekbinder H. WILLEMS - St. Janstraat 278. (16936) Een HEER VERLANGT: Twee goed GEMEUBILEERDE KAMERS. Inelinerenden gelieven zich te adresseren onder opgave var Stand en Prijs onder Lett. E. F. bij den Boekhandelaar C. G. VAN DEB POST  Kalverstraat over het Spui alhier. (1K922) Door Vertrek naar Elders wordt in ecne der Hoofdplaatsen van ons Rnt ter OVERNAME aangeboden : Eene Affaire in TABAK SNUIF SIGAREN KOFFIJ en THEE het Huis voor een matigen prijt i er bij TE KOOP. Om nadere informatien vervoege men zich met'France  Brieven bij den Heer C. J. BEIJER te Amsterdam of bij den Boekh H. A. TJEENK WILLINK te Arnhem. (16890) OVER DE REGTMATIGE EN GEPASTE VERVULLING DEB HUWELTJKSPLIGT  door eenen PASTOOR. Prijs 60 Cents. GEENE OVERBEVOLKING MEER ! door Dn. F. W. Rü MER Prijs 20 Cents. Te bekomen b« S. DE GREBBER Boekhandelaar Egelantiersgracht over de derde Leliedwarsstraat NN 96. (16605)",http://resolver.kb.nl/resolve?urn=ddd:010086747:mpeg21:a0015:ocr,4,ddd:010086747:mpeg21:p004,Algemeen Handelsblad,1101
2365344,1856/03/21 00:00:00,3056,ddd:010112997:mpeg21:a0037,http://imageviewer.kb.nl/ImagingService/imagingService?id=ddd:010112997:mpeg21:p004:image&x=1663&y=81&w=774&h=3056,ddd:010112997:mpeg21,2437,3137,1663,81,4,"Publieke Onderhandsche AANBESTEDING Te Dordrecht in het Nederlandsch Koffijhui. bij J. Zahn op Vrijdag den 4den April 1856 des middags ten 12 ure van eene SLEEPHELÜNG „ TOEBEHOOREN op den grond beoostcn den Veerdam te Papendrecht gelegen. Het Bestek en de Voorwaarden zullen von af den 26sten Maart 1856 ter visie liggen bij J. Zahn voornoemd en verder bij de Heeren DX Riddbb  Boüdieb en Mast. Dezelve ziin verkrijgbaar bij de Boekhandelaars BLUSSÉ en""VAN BRAAM tot den prijs van ƒ 1.50. De Teekenineen liggen ter visie bij den Heer J. M. van DEB Made  Civiel-Ingenieur aan de Gaz-Fabriek te Dordrecht van des voormiddags tien tot des namiddags vijf ure. Dc aanwijzing in loco zal tvree dagen vóór de Aonbesteding van des voormiddags tien tot des namiddags twee ure . geschieden. (2598) AANBESTEDING. De CUMMISöIE VOOK HET BURGERLIJK ARMBESTUUR te Rotterdam is voornemens onder nadere goedkeuring van Burgemeester en Wethouders op 27 Maart 1856 des avonds ten 6 ure in het Oude Mannenhuis aldaar in het openbaar aan te besteden. .„_„ De .Levering van de navolgende ARTIHEIjE-V voor de dienst van dat Armbestuur benoodigd  als : Rijst Grutten Haveigort Groene en Graauwe Erwten Witte en Bruine Boonen Vleesch Rundvet. Beenderen Zoete- Tapte- en Karnemelk Boter Kaas Koffijboonen Koffijsiroop Siroop Zout Peper Bierazijn Turf Hout Sunderlandsche en Rührkolcn Zeep Stijjsel Soda Gelijnd en Ongelijnd Schrijfpapier Schrijfpennen Raapolie Ongebleekt Katoen Wit Engelsch Machinaal Blaauw en Ruw Linnen Zwarte Leydsche Sayet Kal/s en Zoolledtr en Groenten  en zulks overeenkomstig de Voorwaarden van Aonbesteding welke von des morgens 9 tot 11 ure voor Gegadigden ter lezing liggen op het Bureau van het Burgerlijk Armbestuur in het Oude Mannenhuis op de Hoogstraat te Rotterdam alwaar ook voor zoo veel noodig de Stalen en Monsters ter bezigtiging zijn. De voorloopige toewijzing zal geschieden den 28sten Maart 1856 des avonds ten zes ure. (2324) ' "" TE KOOP: Een IJzeren thans alhier in Aanbouw zijnde SCHEOEF-SIOOISCHIP. van de navolgende afmetingen: Lengte 155 Voet | Breedte 23 » \ Engelsche Maat Holte 13 ¦- \ Hetzelve heeft ruimte voor Ca. 470 Kubiek Ton GOEDEREN eene elegante Kajuit voor 18 a2O PASSAGIERS alsmede eene HUT op het Dek en buitendien KAJUITEN voor Kapitein en Bemanning. Machines van 60 Paardenkracht welke bij een Kolenverbruik van 7 a 8 Cnt. per uur 10 & 12 Mijlen vaart zullen maken. Beladen zijnde is de diepgang 10 4 10% voet Engelsch. Beiden Schip zoowel als Machines worden van de beste Materialen en Constructie onder het opzigt der Lloyds gebouwd en daarvan een Certificaat voor 12 jaren A. 1. klasse te bekomen kunnende binnen ééne maand geheel voor vertrek noor Zee gereed geleverdworden. Aangaande den Prijs]Betalings-Voorwaarden enz. zijn nadere Inlichtingen te bekomen bij Glasgow (Schotland) L. LEFFMANN 14 Maart 1856. (2601) Scheeps-Makelaar. UIT DE HANU TE KOOP: Eene IJzeren SLOEP gediend hobbende als Redding-Stoot. Te bevragen en te bezigtigen bij den Heer FOP SMIT wonende aan den Kinderdijk. (2631) ' UIT DE HAND TE KOOP: Een Dubbel HUIS staande te Zierikzee op de Appelmarkt thang inserigt voor SOCIËTEIT en zeer gelegen en geschikt voor KOFFUHUIS WINKELNERING of hijzondere WONING. Adres bij Mr. C. J. FOKKER  te Zierikzee. (2600)",http://resolver.kb.nl/resolve?urn=ddd:010112997:mpeg21:a0037:ocr,4,ddd:010112997:mpeg21:p004,"Nieuwe Rotterdamsche courant : staats-, handels-, nieuws- en advertentieblad",774
1943444,1856/12/13 00:00:00,2498,ddd:010113259:mpeg21:a0006,http://imageviewer.kb.nl/ImagingService/imagingService?id=ddd:010113259:mpeg21:p004:image&x=77&y=2722&w=778&h=2498,ddd:010113259:mpeg21,855,5220,77,2722,6,"Stoomboot-Dienst TUSSCHE» ROTTERDAM EN GRANGEMOUTH. In Directe Verbinding met GLASGOW door het EOETH en CLYDE KANAAL. Voor PASSAGIERS enGOEBEREW. Het Snebarende IJzeren Schroefstoomschip Therese  Kapt. A. BEUCE vertrekt van Rotfffdam naar Grangemoutlt Woensdag den 17den drzer des morgens vroeg. Ligplaats.: Willemskade. (10996) Adres ten Kantore van D. BUEGEE & ZOON. ""_t_^élÈÈÊ^r ROTTERBAM  ;i*__^^^^^MlDD__Lßi;i.C! en daar tusschen gelegene Plaatsm. (712) December 1856. Van EOTTEEDAM. Van MIDDELBUEG. Dingsdagl6 's morg. B>^u Woensd. 17's morg. 7 „ Donderd.lB » 8j» Vrijdag 19 » 7 » Zaturdag2o . 10^» Zondag 21 » 7 « DE STAD GOES. (1335) December 1856. Van GOES : I Van EOTTEEDAM: Dingsd. 16 's morg. 6 u.l Maand. 15 's morg. Bin Zatnrd. 20 . 7 »|Woensd.l7 » 9 » De DEVENTER STOOMBOOT heeft hare geregelde Dienst GESTAAKT maar zal het weder zulks toelatende nog eene of twee Reizen doen. Informatiën daaromtrent hij de Agenten 10979) G. P. ITTMANN & ZOON. *7jNl Te Rotterdam fe*w^v JiS* in Lading ll™^rPv\ TAFEL.BAAB en HMiIföLXX ALGOABAAI liillM^WVoor G0BI)ERE:l!f enPAS- HgÏEwaartoe hetzelve uitmuntend ingerigt het Extra snelzeilend Engelsch Gekoperd Barkschip Star of Peace Kapt. J. J. Holdswobth om den 20sten December te vertrekken. Adres ten Kantore van KÜIJPER VAN DAM & SMEER. (10937) -~-| T Waar CURACAO •>*s^r~%Éè*\. *""""' ""P d""l2osten Decemb. 1856 /^|jésp]fr\ van Amsterdam \_Y \\W\ \y\ \H6' Snelzeüend Gezinkt Ne""_ESpÜn W\h X^ derlandsch Schoenerschip ;SJË gjfelgßgtjja den Amstel ! Kapitein H. Weytuïga **""""*""*' '""■ |M 'linlilii mii eene geschikte gele- K?* nm pABSAGIEES over te voeren. Adres O4iV/^f|adOOTB B- WINDE O UWER en JAN stfrd-m m y'°nZ** « ARBMAN te Amtlera'm' (10892)",http://resolver.kb.nl/resolve?urn=ddd:010113259:mpeg21:a0006:ocr,4,ddd:010113259:mpeg21:p004,"Nieuwe Rotterdamsche courant : staats-, handels-, nieuws- en advertentieblad",778
8102842,1856/01/17 00:00:00,5246,ddd:010086118:mpeg21:a0021,http://imageviewer.kb.nl/ImagingService/imagingService?id=ddd:010086118:mpeg21:p003:image&x=63&y=77&w=3286&h=5246,ddd:010086118:mpeg21,3349,5323,63,77,4,"_„ . . - v ***? » ¦ -—i"" WAARSCHUWING. Een ieder wordt GEWAARSCHUWD offi ?ooder Yoorkeni)is van mij of mijne Echtgenoot aan niemand eenige GELDE*? of GOEDEREN op onzen naam af te geven zullende geene betaling geschieden o„ De Inten^l mn deQuarantaineplaats te Wierinaen. I 842) N._ W« JAGER. ' A. W. ABRAHAjJISZ en JÖBTWENT MakelaarsTzullënTpTan: staanden Maandaggen 21sten Januarij 1856 des Avonds ten 5| Ure ln pet voormalig O. Z. Heeren-Loaement te Amsterdam ten overstaan van den Notaris E. BAAK presenteren te Verkoopen: N"". 1. Ken kapitaal hecht sterk weldoortimmerd en voor weinige jaren aanmerkelijk verbeterd en verfraaid KOOPMANSHUIS ACHTERHUIS. TUIN en »«?«. aldaar op de Keizersgracht W. Z. tusschen de Leidsche.- en :.SPWstëti*»l Buurt CC N«. 716 Kad. Sectie I N"". 1737; en N<>. 2 Een toot ZOMER- en WINTERVERBLIJF ingerigt logeabel HUIS  • ÜBN en ERVE alleraangenaamst gelegen te Driebergen aan den straatweg in de nabijheid van het Station van den Rijnspoorweg Kad. Sectie B No. 214 215 en 216. Beide breeder bij Biljetten omschreven en te bezigtigen N». 1 0p vertoon van een Toegangbiljet bij bovengenoemde Makelaars verkrijgbaar/en N<>. 2 Vrijdag en Maandag aanst. van 11 tot 2 Ure des Namiddags. De Bewijzen van Eigendom en de Veilconaitien liggen ter inzage ten Kantore van den Notaris E. BAAK te Amsterdam en extracten der laatste betrekkelijk N<>. 2 ten Kantore van de Notarissen Mr. H. A. R. VOSMAER te Utrecht en J. C. SCHADÉE te j6eyst. ' ™WLLSrSE VEHR®OPMe op~Woensdag en™ Donderfag'tol 30|ten en 31sten Januari] 1856 des Voormiddags ten 10 Ure ten 'Sterf- SKSÊrSï? T?6n He?r. ""SÏISR ALENBEEK. tegenover de Roomsch yatnoiijKe Kerk te Ankeveen ten ovesstaan van den te Naarden residerenden Notaris J. P. DE ROEPER van MEUBELEN en INBOEUM.  bestaande uit Gladhouten en Witwerkers Ledekanten Mahoniehouten en andere Kabinetten Secretaire ronde en vierkante Eet- Speel- bervies- en Bedtafels Hoek-Buffett gebruineerde Eikenhouten Gladmangels Fauteuils en Stoelen met Trijpte en Matten Zittin-ren IJzeren geldkist op houten Voet heldere Kamerspiegels en Prenten""in vergulde en andere LJjstcn Hangklokken Weerglazen Bedden Matrassen Katoenen en Wollen Dekens Onderkleeden Gordijnen Vloerkleerten en Karpetten Lijnwaden oude blaauwe en keurige Japansche Porceleinen Lak- en trlaswerk zwaar Koper- Tin- IJzer- Blik- Hout- en Mandenwerk en een partijtje BOEKEN. De Goederen zijn Maandag en Dingsdag 18 en 29 Januarij 1856 des Morgens van 10 tot Namiddags 3 ure te zien. n'S^f Informatien zijn te bekomen bij den Boedelbeschikker UjiCHARFF te Weesp en aan het Sterfhuis te Ankeveen. _(762) EDELE MENSCHENraiENDEN. Eene ONGELUKKIGE WEDUWE met ZES HULPBEHOE- V-biNJJJi KUNDEREN wier brave Man kortelings aan den toen heerschende Ziekte bezweken is roept UWE MEDELIJDENDE HULP in daar zij thans van haar Zevende Kind bevallen is. Niet alleen vau alle Inkomsten tot onderhoud van hare Kinderen ontbloot is zij thans buiten S^t^48 °f Wat te kunnen verdienen tot leniging van den HOOGEN NOOD der haren en ziet met bekommering op haar KROOST neder ra de bede dat het den Hemelsehen Vader behage bet hart der Mensehen eene KLEINE LIEFDEGIFT in hare KOMMERVOLLE OMSTANDIGHEDEN. De Heer P. KOOL gewezen Buurtmeester in de Kleine Oostenburgerstraat en de Heer H. SC BOEMAN Boekhandelaar ra de Beerenstraat die ten volle met de omstandigheid bekend zijn hebben zich bereid verklaart alle verlangde inlichtingen te geven en üe Liefdegaven in ontvangst te nemen. (819) M™£°L y«teekTrTT_DE""HANr7TE KOOP: Een goed geschikt WINKELHUIS met TWEE BOYENWONINGEN gelegen op het beste gedeelte van den Nieuwendijk. Te bevragen bij J. MULDER op den Zeedijk N<>. 340 bij de Nieuwmarkt. te Amsterdam. (820) n«/™^^T;ri'EßS""A''l'AllftE verlangt men eene WINKELUUI.HII.K van de P. Gemeente die reeds met dit Vak bekend is; niet beneden de Twintig Jaren oud. Adres bij A. BREEMAN Hoogstraat l 260 zoo spoedig mogelijk. (72a T?mTTTpRÏkj!;K :NAAT? BUITEN wordt voor ƒ 160 tegen^rüno~Meï a V^a™?^?11 : Een vriJ waarbij desverkiezenae de lAPIJTEN kunnen worden overgenomen. Franco te bevragen .'jW-™ VAN MAARSCHALKERWAART Makelaar Weesperstraat NQ. 42. (744) MAN en VROUW van de Prot. Godsdienst zonder 'Kinderen zagen zich gaarne metFebruarij ofMei geplaatst als HUISBEWAARDERS. Daar zij reeds vele jaren in die Betrekking zijn geweest kan men de beste informatien daarvan bekomen. De hierop reflecterenden gelieven zich te adresseren onder Lett. E. E. Z„ Bureau Handelsblad. (742) «•/J&Ül**""*' DÜzonder ervaren in de~bëhand(ding der PASTELKUIP wenscht eene GEREGELDE DIENST liefst in Maart of April onverschillig waar zijnde Ongehuwd R. K. middelbare jaren. Aanzoek wordt verzocht door gefrankeerde Brieven  onder Lett. J. M. J. Bureau_Handelsblad. - (gO7) DOOR BUITENGEWONE OMSTANDIGHEDENbtedtmen m eene der Hoofdstraten alhier TER OVERNAME aan: Eene sinds jaren gevestigde en met goed succes gedreven AFFAIRE in GAREN en BAND benevens WINKELOPSTAL STAND etc volgens Inventaris waarbij het HUIS voor matigen Prijs TE HUUR. lemand hierop reflecterende gelieve zich Franco onder Lett A. te vervoegen bij de Boekhandelaars P. C. L. VAN STADEN. Cz. Rokin hoek Langebrugsteeg. (801) Een JONG MENSCH van Fatsoenlijke Huize te Amsterdam woon^ achtig wenschte zich belast te zien met den verkoop van ARTIKELEN voor rekening van BINNENLANDSCHE of BUITENLANDSCHE HUIZEN tegen eene matige Provisie in het bezit van vele relatiën tot plaatsing derzelve zijnde mede genegen daarvoor kleine REIZEN te doen. Adres Franco Brieven  onder Lett. A. 8. bij de Boekhandelaars IPENBUUR & VAN SELDAM te Amsterdam. (781) Eene uitmuntende en eenige~FABRIEET7IrATwifK^ ZAAK alhier (in communicatie met den HAARLEMMERMEERPOLDER) en met genoegzaam FONDS voor de GROOTSTE UITBREIDnïG vatbaar wordt benevens de daarbij behoorende KAPITALE PANDEN  het geheel voor 25/ m de helft voor IS/m met Associatie en het Deelgenootschap alleen  voor 5/m aangeboden. lemand en vooral in OLIEZADEN of GRANEN handelende of daarvan kunde hebbende hiertoe inclinerende  adressere zich onder N°. 758 franco en met geteekende Brieven Bureau Handelsblad. 809) MEN VRAAGT in een FatsoënlijkllUlSGEZlN bij 6 Kinderen waarvan de Moeder is overleden: Eene JUFVROUW  van de Prot Godsdienst tot bestiering der HUISHOUDING. Men gelieve zich te adresseren liefst met opgave bij wien informatien zijn te bekomen met Franco Brieven onder Lett. R. in den Kantoorboekwinkel van de Wed. J. ELLERMAN te Amsterdam. (795) MorologießHaker. Een HOROLOGIEMAKER het DAGELIJKSCHE WERK hoofdzakelijkClJLlNDEßS grondig verstaande kan dadelijk of met Februarij VAST WERK bekomen; op te geven waar men zich informeren kan  als ook op hoeveel Salaris aanspraak gemaakt wordt. LOOPJONGENS gevraagd a EÉN GULDEN per Week. Duidelijke en Franco Brieven Lett. A. D. 11. X. Bureau Handelsblad. (756) ~^ÏSTËR^HSGHBnPIJP-GASGOiiIPA6NIE ~ SCHANS TEGENOVER DE ELANDSTRAAT. DE PRIJS DER KOKE aan .deze Fabriek is gesteld op 80 Cents per 32 Ned. fi? (Circa eene Mudde) zoo lang de voorraad duurt. Amsterdam 17 Januarij 1856. (836) Vöor~lee#se«elBcïiappeßÜ De Boekhandelaars de Wed. L. VAN HULST en ZOON hebben in den loop van 1855 uitgegeven • 'S LEVENS GROOTE WE6 OF HINDERPALEN EN STRUIKELBLOKKEN. Naar den VIERDEN DRUK uit het Engelsch van S. W. FULLOM.. Twee Deelen ra gr. BU.8U. met Vignetten: Prijs/4.90. RUTH HALL  EEN VERHAAL UIT ONZE DAGEN. Uitliet Engelsch van FANNY FERN. In gr. B°. met Vignet. Prijs/2.90 HERINNERINGEN UIT VRKEMDE i.ANDEft. Uit het Engelsch van Mrs. HARRIET BEECHER STOWE. 2 Deelen in gr. B°. met vignetten. Prijs/6. Van dezelfde Schrijfster: TAFEREELEN EN OMTREKKEN. In Postformaat met Vig ¦ net. Prijs/1.20. Vroeger verscheen: EENE GESCHIEDENIS ZONDER NAABfc Uit het Hoog- duitsch van F. W. HACKLANDER 1 tDeelen iri «'•; 8"". compres gezetmet Vignet. Prijs/7.20. (728) Blijkens onderhandsche ACTE van dato Amsterdam den Eersten Januarij 1856 is door de Weduwe en Erfgenamen van wijlen den Heer GEORGE ELIAS ANDREAS VON SCHMIT aan de Ondergeteekende MARGARITA HELENA CATHARINA KOK Weduwe van den Heer CAREL CONRAD VON SCHMIT  wonende alhier het regt afgestaan om den Handel in Kousen en wat verder daartoe behoort alleen of met anderen onder de Firma GEORGE WILHELM VON SCHMIT en ZOON of G. W. VON SCHMIT en ZOON voort te zetten zonder dat de Zaken of Verbindtenissen na ult°. Januarij e. k. op de voormelde Firma gedaan of aangegaan de Weduwe noch Erfgenamen van den genoemden Heer GEORGE ELIAS ANDREAS VON SCHMIT zullen betreffen noch eenigzins aansprakelijk stellen waarvan aankondiging wordt gedaan ingevolge de Wet. Amstekdam Po. Januarij 1856. M. H. C. KOK  (826) Wed. C. C VON SCHMIT. Z. J. H. RD3TBERG Makelaar presenteert ten overstaan van den Deurwaarder B. D. BEETS op Maandag 21 Januarij 1856 des Middags ten 12J Ure ten Huize van A. VAN ES in de Brakke Grond in de Nes  te Verkoopen : 73 Ceeoenen HAVANA 28 ii VARA 14 ii CUBA 56 Pakken JAVA (MALANG) 25 » MANILLA BLADEN TABAK. Liggende als bij Notitie nader zal worden aangewezen. (852) De KOLONEL PLAATSELIJKE KOMMANDANT der Vesting Nijmegen brengt ter kennis van de Gegadigden dat onder nadere goedkeuring van het Ministerie van Oorlog op Woensdag den 30sten Januarij 1856  des Middags ten Twaalf Ure ten zijnen Burele op de Ridderstraat Wijk C N°. 338  te Nijmegen zal worden AANBESTEED : De Leverantie van Vijftien Lasten RIJN TARWE wegende minstens 77 Ponden en Vier Lasten Inlandsche of Pruisische ROGGE wegende minstens 72 Ponden bestemd voor de Garnizoens-Bakkerij aldaar. De Voorwaarden van Aanbesteding zullen van af den 16den dezer tot den dag van Aanbesteding in het Bureau van genoemden Kolonel ter lezing liggen wordende de Gegadigden bij deze uitgenoodigd om de aan te bieden Monsters en den omslag van het Insehrijvings-Biljet van hetzelfde merk te voorzien. Nijmegen 12 Januarij 1856. De Kolonel voornoemd: (794) VAN HEEMSKERCK. NEDERLANDSCHE RHIJN-SPOORWEG-MAATSCHAPPM. De DIRECTIE is voornemens TWINTIG STUKS te Utrecht staande en buiten dienst gestelde LOCOMOTIEVEN van het breede Spoor bij ONDERHANDSCHE INSCHRIJVING aan de meestbiedenden te verkoopen. De Bepalingen en Voorwaarden onder welke bovenbedoelde LOCOMOTIEVEN zullen worden verkocht liggen ter inzage aan de Bureaux van de Station-Chefs te Amsterdam Rotterdam en Arnhem en te Utrecht bij den Werkmeester den Heer J. VERLOOP door wien ook de verdere inlichtingen zullen gegeven worden. De Inschrijvings-Billetten moeten vóór den 7den Februarij 1856 vrachtvrij aan de DIRECTIE der NEDERLANDSCHE RHIJN-SPOORWEGMAATSCHAPPIJ te Amsterdam ingezonden worden. • Amsterdam  De Directie voornoemd : 12 Januarij 1856. B. DONKER CURTIUS  President. (696) JK. C. s'JACOB  Secretaris.",http://resolver.kb.nl/resolve?urn=ddd:010086118:mpeg21:a0021:ocr,3,ddd:010086118:mpeg21:p003,Algemeen Handelsblad,3286
3630468,1856/10/03 00:00:00,3854,ddd:010251567:mpeg21:a0015,http://imageviewer.kb.nl/ImagingService/imagingService?id=ddd:010251567:mpeg21:p004:image&x=1939&y=80&w=942&h=3854,ddd:010251567:mpeg21,2881,3934,1939,80,4,"IHpil V I*l*l fff in de bijzondere School der Eerste Klasse lïltll llttügl voor R R Jongens te Zwolle een Hulponderwijzer bij voorkeur lemand die in eene  talrijke school is -werkzaam geweest. Adres met franco ! brieven onder letter L. bij den Boekhandelaar J. M. W. I Waanders le Zwolle. j (2594) Bij Gebr. VAN LANGENHUYSEN te \ Hage is ter perse om binnen weinige dagen te verschijnen: Christus Jesus de éénige middelaar Gods en der IHensehen. — Handhaving mijner leerrede over I Tim. 11 5; tegen de beide brieven van J. C. Zaalberg Pz. door A. Frentrop. Pr. lic zalf en Pillen van Holleway zijn een uitmuntend middel voor huidziekten. J Z te Rotterdam leed sedert vijfjaren sterk aan huidziekte zoodat zijn aangezigt hals armen en handen steeds met eene soort van uilslag gelijk pokken bedekt waren. Hij riep den geneeskundigen raad in van onderscheidene bekwame mannen welke !iem verklaarden dat hij eene zware ziekten le wachten bad hetwelk hem steeds zeer verontrustte. Toen begon hij de pillen van Holloway te gebruiken en de lijdende deelen met de zalf te bestrijken waardoor in twee weken tijds de huiduitslag verdween en zijn gestel aanmerkelijk verbeterde. Door dit mildel worden de hardnekkigste wonden en zweeren genezen al hadden zij reeds twintig jaar bestaan. Door het vermeerderd debiet zijn de prijzen als volgt: Doosjes Pillen a f 0.80 f 1.85 ƒ3.00 ƒ675 ƒ13.50 ƒ20.50. Potjes Zalf a ƒO.BO ƒ1.85 ƒ3.00 /7.05 ƒl3 85 ƒ22.95. Zijn op franco aanvragen a contant te bekomen bij jB. Adama Apotheker Heerengracht hoek Utrccbtschc» straat N°. 22 te Amsterdam bij L. J. Grootendorst dépóthouder te Utrecht G. Verhaart dépólhouder te Prinsland en bij J. Straatman hoofd-dépót houder te 's Bosch alsmede te Londen Strand 244 llollowag's Etablissement. (2592) Bij G. L. VAN LANGENHUYSEN zijn de volgende werken verkrijgbaar: Le Mois dc saint Joseph  pieux exercices ponr obtcnir I'appui de ce giand patriarche. Traduit de J. Pedini par M. I'abbé Joseph Antoine I'oullan; in-16 ƒ0.20. Konve.lll KLecneïl dc Cantiqiics pour les léunionS d'hommcs et spécialement pour les réunions de militaires. Edition revue et corrigée par M. le comte A. ds Ségur avec Ia musique des quarante-sept camiqueJ qni compusent ce reeeuil; in-16 .... ƒ O.'iO- Pélerinage a la Salettc  par VL I'abbé Lemeunier 9e édilion avec les gravures de I'appaiition et de l'église; in-16. ƒ0.20. Psauticr de la sainte Vierge traduit de sainj Bonaventure; in-16 de 140 pages. .  . ƒ0.20- Récits du temps passé par le baron de Nilinse et quelques autres in-16 de 220 pages . . ƒ0.20. Les Saintes Jloies de Tame fidele traité de Ia joie chez les chrétiens par le P. Arabroise de Lombezf in-16 ƒ 0.20- Les Biens dc I'Eglise comment on met la muit dessus et ce qui s'ensuit par le baron de Neliusei in-16 ƒ0.15- La Chasse aux Prêtres profils de ceux qui la fon! et ce qu'ils en retirent par le baron de Nilinsci i in-16 ƒ0.13 Les Exemples de Ia sainte Vierge. Nouvelle éd' lion 24 gravures; in 16 ...-•• ƒO.l- Les Fleurs de Marie par M. I'abbé Thiébaut in 1* 'l illustre • . . ƒ o.l| Gustave ou I'Ange des petits écoliers par M. I'abb* Gemard; in-12 ƒ 0.0 Instruetion Pastorale sur Ie Pouvoir a IV! casiondu rélablissemeiil de f Empire par Mgi. Anfoil' I de Salinis évêque d'Amiens. In 16 . . . ƒ O.l^j Pauline ou la jeune aveugle par M. I'abbé Hunckl^ in-16 figures ƒo.l''' Trésor «lu Chrétien ou la scienee du salut «' imagos texte orné de 32 gravures (dessins des _lè«f de Rubens); in-16 ƒ 0.13 La Vie de sainte Adélalde impératrice 1601{ ges in-16 f O-i"" ¦ ____ . y",http://resolver.kb.nl/resolve?urn=ddd:010251567:mpeg21:a0015:ocr,4,ddd:010251567:mpeg21:p004,De Tĳd : godsdienstig-staatkundig dagblad,942
1721709,1856/11/18 00:00:00,1581,ddd:010086784:mpeg21:a0019,http://imageviewer.kb.nl/ImagingService/imagingService?id=ddd:010086784:mpeg21:p006:image&x=117&y=777&w=1089&h=1581,ddd:010086784:mpeg21,1206,2358,117,777,6,"De belanghebbenden bij de onbeheerde Nalatenschap van GERARDUS ROMPELMAN worden uitgenoodigd om na te zien de Rekening en Verantwoording welke gedurende 14 dagen ter Visie zal liggen bij den Ondergeteekende wonende Nieuwendijk bij de Oudebrugsteeg L 105. Mr. Ph. H. VERBEEK. (19250) Curator. ADMINISTRATEUREN der Negotiatie ten behoeve van de Evangelisch-Luthersche Gemeente te Helder c a. adverteren hiermede dat de JAARLIJKSCRE UITLOTING door de Synodale Commissie heeft plaats gehad en alzoo de volgende Aandeelen zijn Uitgeloot als: Wo. 14 59 15 96 en 150. De Houders dier Aandeelen worden dien ten gevolge uitgenoodigd het beloop daarvan tegen overgifte der door hen gekwiteerde Bewijzen van Aandeel te doen ontvangen ten Kantore van den Heer B. ZUR MüHLEN op de Brouwersgracht bij de Keizersgracht N°. 543 en zulks bepaaldelijk des Maandags Dingsdags en Vrijdags. (19268) Rentebetaling en Aflossing VAN UITGELOTE OBLIGATIEN DER LOMBARDfHEITIAAICHE LEENING VAN HET JAAR 1850. De ONDERGETEEKENDEN adverteren als daartoe gemagtigd door de Heeren M. A. VON ROTHSCHILD & ZONEN te Frankfort a/M. en in overeenstemming met de authorisatie van het K. K. Ministerie van Financien te Weenen dat op den lsten December aanstaande en volgende Werkdagen TEW HAWTOHE VAN BE ASSOCIATIE CASSA zal worden gevaceerd ter betaling der op 1 December 1856 verschenen en te Amsterdam betaalbaar gestelde COUPONS der spCt. LOMBARDOVENETIAANSCHE OBLIGATIEN van het jaar 1850 en wel op ; den voet van ƒ6 Holl. Cour. voor 15 Lire. Zijnde de COUPOWS van Lire 2} met ƒ 1 Holl. Cour. n n n n u 7\ „ u Z ii n u n n r n 22} u n 9 n n n r v ii n 37} "" // 15 // „ ut n ti n 75 ii ii ZO n u alsmede ter terugbetaling van het KAPITAAL van de te Amsterdam betaalbaar gestelde OBLIG ATIEW der op 1 Junij deses jaars te Milaan uitgelote 6db SERIE der voornoemde LOI»IBARB©«VENETIAANSCHE LEENING van het jaar 1850 op denzelfden voet als boven vermeld. Amsterdam 17 November 1856. BECKER & FULP. (19254)",http://resolver.kb.nl/resolve?urn=ddd:010086784:mpeg21:a0019:ocr,6,ddd:010086784:mpeg21:p006,Algemeen Handelsblad,1089
1631443,1856/03/06 00:00:00,1529,ddd:010086167:mpeg21:a0027,http://imageviewer.kb.nl/ImagingService/imagingService?id=ddd:010086167:mpeg21:p004:image&x=2277&y=80&w=1067&h=1529,ddd:010086167:mpeg21,3344,1609,2277,80,4,"Op cïe HOËDEN-FABRIEK van A. SCHOKTE # Cie3 worden gevraagd: MONTEURS en GALLETTIERS. (3794) INGEWORTELDE VERSTOPPINGEN gSSSfS gestiën  duizeligheid  stuipen  hersenontstcking zenuwziekte hoofdpijn  hartkloppingen aandoeningen van lever en nieren maagkramp spanning misselijkheid hartwater slijm oprispingen loomheid hangerigheid ontijdige vermoeidheid lusteloosheid gal spleen en eene menigte andere ziekten die üit slechte sappen ontstaan  worden Spoedig door het gebruik van Du Barry's smakelijk meel ;.:r.ie_r. . De tööb-r_id..ig ls p.nai-Lelijk en het is eer ecne bezuiniging dan eene uitgave s_ii.it daarmede te genezen. Ecrr lepel vol geeft een ontbijt en cenc bus van 8 guldens is voorraad voor minstens drie maanden. VERKOOPHUIS en dc bekende Depots. (3804 6/3 56)  llllliA. IILM A_NÏÏRWAM_ VAÏÏH.' lEMAND  Ongehuwd  van de P. G. in bovengenoemde Vakken werkzaam zoekt een MEDEWERKENDEN of COMMANDI"" TAIREN VENNOOT van de P. G. en liefst Ongehuwd die over een Kapitaal kan disponeren ; van dc soliditeit der sedert vele jaren ge* vestigde en winstgevende Zaak in dc provincie Gelderland  kan men zich overtuigen door eenigen tijd daarin werkzaam te zijn alvorens bepaalde Conditien aan te gaan. Voor een JONG MENSCH die wenscht opgeleid te worden met het vooruitzigt van deelname is deze eene zeldzaam voorkomende gelegenheid. Nadere informatiën met franco brioveli  onder Lett. A. A. bij den Boekverkooper J. C. VAN RESTEREN Water H 131 te Amsterdam. (3740) _¥ÏTlO_¥4L£ MILITIE.' A. B. VAN KAM beveelt zich in de Gunst van alle Gegadigden tot het BEZORGEN VAN PLAATSVERVANGERS voorde NATIONALE MILITIE onder belofte en vaste verzekering van goede en solide behandeling; verzoekende een ieder stipt te letten ojr Naam en Woonplaats. Adres^bezijden_^eJlroote Kerk Wijk '2 NQ.282 te Hoorn. (3441 J Bij P. C. L. VAN STADEN Cz.'Rokin Hoek Laifgebrugsteeg kwam van de pers en is alom te verkrijgen: VOLKB-ALIAHAK VOOR HET SCHRIKKELJAAR 1856. Uitgegeven door de Maatschappij : Tot Nut van 't Algemeen 180 Pagina's met verscheidene Houtsneden ii 40 Cts. (3786)",http://resolver.kb.nl/resolve?urn=ddd:010086167:mpeg21:a0027:ocr,4,ddd:010086167:mpeg21:p004,Algemeen Handelsblad,1067
3232859,1856/01/10 00:00:00,2947,ddd:010086111:mpeg21:a0023,http://imageviewer.kb.nl/ImagingService/imagingService?id=ddd:010086111:mpeg21:p003:image&x=2274&y=2439&w=1097&h=2947,ddd:010086111:mpeg21,3371,5386,2274,2439,4,"PUBLIEKE VERKOOPING OP TEXEL. CONINCK WESTENBERG & C°. Scheeps-Makelaars te Texel als lasthebbenden van Kapitein AUGUST TOFTE gevoerd hebbende het Engelsche Barkschip Matilda Luckie van North Shields naar Demerarij gedestineerd geweest. doch op 30 Dec. 11. in de Eijerlandsche Gronden gestrand presenteren op Woensdag 16 Januarij e. k. des Morgens ten 11 Ure te De Cocksdorp ten overstaan van den te Texel residerenden Notaris JOHANNES LUDO VICUS KIKKERT publiek te Verkoopen: 38 Stuks meerendeels nieuwe JEEÏS.EN  3 zware ANKERS 2 ARIttERÜETiriRIG* ieder lang 90 vadem 2 zware TROS&EN 30 stuks diverse ÜETTINÜEN 2 iIEREN eiieenS-UCRR&D 2 SCUEEPftBOO-EN. Eene aanzienlijke partij gekapt staand eu loopend TOUWWERK een tï.UMkSUm P^MIMSM  HOK._-CO._IHA_IEWA_T  eenige VAATJES met VERFSTOFFEN en hetgeen verder gepresenteerd zal worden en Eindelijk het kopervast gezinkte BW» of CASCO van voornoemd Barkschip  met inhebbende lading STEENKOOL zoodanig als hetzelve in de Eijerlandsche Gronden is zittende. Nadere informatiën zijn op Franco aanvragen te bekomen bij voornoemde Makelaars CONINCK WESTENBERG & C°. <___) ZEGT HET VOORT. Oggggg^» UIT DE HAND TE KOOP: W Een extra mooije BAZEWINDHOIND van echt Engelseh ||fcjj^^Ris. Te bevragen met franco brieven bij H. KOSTER «¦ans» '-""""-^Boekverkooper der Koninklijke Akademie te Delft. (453) Door Toevallige Omstandigheden wordt alhier op aannemelijke Voori waarden  tegen Mei of eerder  ter OVERNEMING aangeboden : Eene van ouds gerenomeerde AFFAIRE in GAR^N  BAND  WOLLEN en SAUiBK'ï""B""EN  enz. enz.  gelegen op een der drukste en gunstigst gelegen Standen. Adres met Franco Brieven onder Lett. A. B. bij den Boekh. G. THEOD. BOM  Kalverstraat E 10. (490) Een NOTARIS te Amsterdam verlangt op zijn Kantoor een K LERK  reeds in gelijke Betrekking geplaatst geweest niet jonger dan 18 jaren en .in staat bewijzen van goed gedrag te kunnen overleggen. Adres Franco i onder Lett. O. F. Bureau Handelsblad. (501) ~DEPOT GEVKAAGD7~ Men verlangt voor lEIWANB» . met het vak zeer goed bekend een DEPOT VAN GEMAAKTE KLEEDEREN in de Prov. Zuid-Holland op een voorname stand gelegen tegen soliedè Borgstelling. Franco Brieven Lett S. P. bij den Boekhandelaar A. A. RENSINK. te Leyden. (486) KRUIDENIERS-AFFAIRE. Er wordt TE KOOP AANGEBODEN de OPfeTAND eener zeer druk beklante ï4RUI-_E^ïESiS-AFFAIIsIE. Het geschikte HUIS met ZOLDERS  WINDAS  eet. voor eenige Jaren te Huur of ook wel te Koop. Te bevragen bij den Makelaar JOHs. VAN DIJK Prinsengracht over bet Amstelveld. (487) ¦ __tß__m» 25 Jaren oud van de P. G.  goed met de FRANSCHE en een weinig met de ENGELSCHE en HOOGDUITSCHE TALEN bekend in HANDELSZAKEN bedreven  zag zich gaarne snedig geplaatst  hetzij hier of elders als REIZIGER ofookalsOPïMG.Ï'Eß en BOEKBOÏIRiivR in eene Fabriek. Adres Franco onder Letti R R bij den Heer P. C. L. VAN STADEN Cz. Boekhandelaar Rokin hoek Langebrugsteeg. ' (480) Mangelwartelen TE KOOP op DE BADHOEVE in de Haarlemmermeer bij Sloten gemakkelijk vervoerbaar te Land en te Water. Prijs f 13.50 de 1000 N. fi?. Brieven Franco aan den Heer MILDERS aldaar. (494) A. C. LE GBAID IN I'ORCEÜf». Amsterdam . Rokin E 171 over het Rembrantsplein  herinnert zijnen geëerde Begunstigers  dat hij ruim gesorteerd is in GESCHILDERD VERGULD en EFFEN PO _CE_KIN alsmede in VOORWERPEN geschikt tot LIEFHEBBERIJ-SCHILDEREN. Hij bakt dezelve en Schildert en Verguldt voor alle Gelegenheden. (492) Bij VAN LANGENIIUrSENTtiT.Hage is va_~de pers gekomen de Tweede Druk van: CBRÏKTï'S JÏEZÏTS BE ÉÉNIGE IHIOBELAAR GORS EN DER MENSCHEN LEERREDE over I Tim. II: 5 door A. FRENTROP. Naar aanleiding van J. C. ZAALBERG'S Feestrede gehouden 31 October 1855 ter gedachtenis der KERKHERVORMING a 30 Cents. (477) In alle Boekwinkels verkrijgbaar: NIEUWSTE RAD VAN AVONTUUR. Een alleraardigst Boekje uitnemend geschikt om een gebeel Gezelscbap aangenaam bezig te houden. De Prijs is 50 Cents. (19425)",http://resolver.kb.nl/resolve?urn=ddd:010086111:mpeg21:a0023:ocr,3,ddd:010086111:mpeg21:p003,Algemeen Handelsblad,1097
2901934,1856/12/05 00:00:00,3026,ddd:000011656:mpeg21:a0020,http://imageviewer.kb.nl/ImagingService/imagingService?id=ddd:000011656:mpeg21:p003:image&x=2036&y=131&w=959&h=3026,ddd:000011656:mpeg21,2995,3157,2036,131,4,SPUI STRAAT over het Platenmagazijn van deu heer vv_ Goo-H berigten dat zij eene ruime sortering FANTAISIE-ARTIKELEN ontvangen hebben  geschikt voor ST. MCÖUAS GESCHENKEN. zij bevelen zich bij deze beleefdelijk aan. TE HUUR GEVRAAGD togen 1°. Februari) 1°. Mei of vroeger een klein _-__\_D_\- of BOVE_HUI.  met aparten ingang of een HUISJE  geheel Gemeubcleerd of Ongciiicubeleerd  op een' fatsoenlijken stillen stand Ongfineuhelccrd echter den prijs van ƒ 200 niet te bovengaande. Men ad rossere zich met opgave van prijs ond. t letter L hij den Boekhandelaar K. W- Pickhardt Schoolstraat alhier. Wïift^^i_WJ~:* Wordt tegen Mei aanstaande in hnur __.__¦ _.«^_a gevraagd een HUIS en T LTI _  bevat tende 7 il 8 Kamers op een goeden stand dezer stad. Adres onder letter F bij den Boekhandelaar M. J. Visser Vlaniingstraat alhier. Wordt in Hl l R gevraagd te 's Gravenhage  tegen Mei eer..tk. eene latsoenlijke 0\(_E_f EUBEEEEBBE WOXI__» voor een klein gezin; den huurprys van drie honderd gulden niet ver te boven gaande liefst Bezuidenhout of Zeestraat. Opgaaf van huur localiteit enz. met gefrankeerde brieven onder letter A bij de Boekhandelaars Geb. van der Hoek te Leiden. UIT DE HAND TE KOOP een goed onderhouden en wel ter nering staand HIIII en ___ lt F bij de Groote Markt bevattende zeven kamers  twee dienstbodenkamers droog- en turfzolders kelder keuken en verdere gemakken. Te bevragen en te bezigtigen  Laan  .rijk W n 352. De Boekverkooper J>. M. XOOHDEXDOHI* heeft uitgegeven: KINDERLIJKE DICHTST OKJES VAN UITGEGEVEN TEN VOORDEELE DER BEWAARSCHOOL TE RIJSWIJK. J»rtf# f I. 'Vollen* verzamelde dit Dichtbundeltje ten voordeele der Bewaarschool te BiJ_w|)k. Uit zijn  in de laatste dagen van zijn leven geschreven voorrtde blijkt het hooge belang door hem in deze Inrigting gesteld. Hy hoopte op een' ryken oogst. Moge die hoop niet te leurgesteld worden en ook door de ondersteuning van dit boekske de bewaarschool als een gedenkteeken opryzen zoo geheel in den geest en naar den wensch des ontslapenen. — Het Bundeltje is gedrukt in hetzelfde formaat als de nieuwe editie van des dichters weiken  door Suringar uitgegeven bij welke verzameling het gewis niet mag ontbreken  en waaraan het waard is te worden toegevoegd.,http://resolver.kb.nl/resolve?urn=ddd:000011656:mpeg21:a0020:ocr,3,ddd:000011656:mpeg21:p003,Dagblad van Zuidholland en 's Gravenhage,959
2595780,1856/03/06 00:00:00,3135,ddd:010112982:mpeg21:a0039,http://imageviewer.kb.nl/ImagingService/imagingService?id=ddd:010112982:mpeg21:p004:image&x=3299&y=918&w=828&h=3135,ddd:010112982:mpeg21,4127,4053,3299,918,4,"ZELDZAAM GOEDKOOP AANBOD. Voor f 1 por stuk van ca. 200 stuks zeer s'erk* en zwa-e vierkante met IJzer beslage' i HOUTEN BUSSEN  voorzien van precieu»» dubbele SLOTEN. HENGSELS. K.ETTINGS' IJZEREN PLATEN enz. eDZ per stuk wegend» ca. 7 Ned. Ponden. Bij het overnemen in eens der geheele Partij wil men tevens nog wel ecu goed rabat verleenen Nadere informatiën te bekomen bij den Heer ö- P. POESCBMAN Boekverkooper Hoogstraa' hoek van de Goudsche Wagenstraat met brieven franco onder Letter R. (2150) tf(—_3___c.-_-E""£-i*B__ e Heer I SOULOSSER fj*>-* < Hheeft op verzoek van ef» %\ igroot aantal Ingezetenen va» V^ X\ tßotterdamen Omstrekener& W. V -N. i-oégéstemd zijn vertrek va» A\ -^?_*> Idaar tot 10 Maart uit te stel; J§B_Bw»3^l>-**^ Ilnn; irinnr na dien tijd zal h'J ¦M_^Bam^ggmSHMr-'•""'¦'•'¦r<i""'"" bepaaldelijk vci"" laiu.. De meest ingewortelde Eksteroogen worde» radicaal genezen in 3 a 4 minuten  zonde' bloedstoiting en zonder eenige pijn. Hij is in l'e bezit van talrijke Certificaten va"" aanzie-.lijke P_* sonen uit HtUand die hem^_—^~—|————¦•— hi.nne algeheele tevredenheid . hebben betuigd. (2015) «S^X Is dagelijks ten zijnent te spreken  vnn 's morgens fl V'iVy^^ tot 's namiddags 4 ure bij de ERVE A. PEIJPERS lfc_fc3^ Hoogstraat wijk 10 Ko 67. _•""¦ _— •V_a_a__B—¦¦•*•'* liSTITÜÖT-ZWAMMERpAfIf De Ondergeteekende brengt ter kennis van nO„ belanghebbende OUDERS en VOOGDEN dat er»/' zeer aanne-nelijlce Voorwaarden met Mei e. k. weder één© Open© Plaats zijn zal» van het op zestien vastgestelde getal Kostleerlingen. (8142) 3. RUNENBERG. __ ---.-TE-ggBH———w_ aannemelijke voorwaarden  ¦ifl _fc^worrtt 'n ecne SIGA»E*"" ¦MfMjjjr er. TABAKS-AFFAIRE ""*""***• tegeu Mei aanstaande in eene der voornaamste Steden van ZuidEoltan-l GEVRAAGD : Een BEDIENDE tussehen de 20 a 30 jaren oud groi.riig bekend met het Vak goed geschikt voor den Winkel en de kennis bezittende om de Sigaren - FabrleK naar eisen te kunnen beêturen. Zy die hiertoe iö' eliceren  en van goede getuigschriften zijn voorzien. ndresßeren zich met. franco Brieven onder het Nommér dezer Advertentie  aan het Bureau deze* Courant. (2154) ffiÊSÊÊË*'' Em (>EHTJWD PERSOON van ëéo PPis|j» onbesproken gedrag 25 jaar oud «*S zich gaarne geplnats ineen PAKHUIS- OF ALS WIIELOECHT of iets DERGELIJKS. Hierop reflecterende gelieve zich te adresseren onder het Nommér deze* | Advertentie aan het Bureau dezer Courant. (2147) I EEN BEKWAME BEMNGEMS-KNECHT Werk begeerende vervoege zich bij den Heer T). EGGINK. Delfschevaart wijk 7 No 283. (2163) j^*pw-qgW| Een PERSOON 25 jcaroud biedt |~jjL -;?gKËzich bij de aanstaande Loting voor de B-^-*a«a».\ATIONALE MILITIE aan als : REMPLAQANT OF PLAATSVERVANGER. Adres bij ARIE DE PEE te Maasdam. (2146 J MEN VRAAGT TEGEN MEI: Eene MEiD } gesel.ikt om te dienen voor Meid alleen  die goed | met Kinderen kan omgaan. Adres hij de Wed. j KRAP & VAN D UYM Boekhandelaren naast de | Beurs. (2151) H ii i ¦ ¦ —»»_».._fy—-_",http://resolver.kb.nl/resolve?urn=ddd:010112982:mpeg21:a0039:ocr,4,ddd:010112982:mpeg21:p004,"Nieuwe Rotterdamsche courant : staats-, handels-, nieuws- en advertentieblad",828
2126932,1856/07/18 00:00:00,2069,ddd:010771984:mpeg21:a0008,http://imageviewer.kb.nl/ImagingService/imagingService?id=ddd:010771984:mpeg21:p004:image&x=2114&y=1821&w=1028&h=2069,ddd:010771984:mpeg21,3142,3890,2114,1821,6,Attentie. Ondergcteekende  Schoolonderwijzcr te Zuidbroek verlangt om dadelijk in dienst te treden  eenen O»OERMEESTER van den 3den of lilen Ran g. Brieven franko doch liefst in persoon. G. HEERES. EEN BAKKERSKNECHT Mzijn Werk ten decle verstaande H. G. van goede Getuigschriften voorzien kan dadelijk geplaatst worden bij N. KLAZINGA. s» te Oudwoude bij Kollum. Brieven franko. Twee Koperslagersknechten hun Werk grondig verstaande kunnen dadelijk tegen goed loon VAST WERH bekomen te Winschoten  bij de Wedw. J. van WEELDEREN. COCOS-ZEEP. Deze ZEEP schuimt sterk reinigt oogenblikkelijk i* bevorderlijk voor de gezondheid  heelt schrampen en schavingcn zeer spoedig zuivert en ontneemt alle scherpte aan do huid maakt haar zacht en blank en geeft haar een jeugdig frissehen tint. Men koopt een groot stuk voor 15 cents. Zij is ook verkieslijk boven andere Zeepen voor het wasschen van gekleurde Goederen en Zijden en Wollen Stoffen daar zij van eene zuiverder en minder scherpe loog bereid de kleuren minder aandoet en de wol niet hard maakt. De goede echte soort die in onderstaande Depots altijd kersversch te verkrijgen is heeft den naam H. KERCKHOEF zoowel op de Zeep als op het Etiqnet. Zij onderscheidt zich bovendien van de nagemaakte soorten door zuivere kleur en bewerking minder scherpte en vettigheid. Brabiinder's Chocolade-Koekjes met worm-afdrijvende zelfstandigheden zijn uitmuntend in hunne werking en worden gaarne door dc kinderen genomen. De Geneeshccren BEU ER GEERLING HOPMAN en FAHRMEISTER hebben ze met het beste gevolg aangewend en spreuken er met veel lof van. Zij kosten 40 cents het doosje. Amsterdam VERKOOPHUIS; Assen H. P. A. VAK GORCUM; Appingedam S. RITSEMA ; Delfzijl T. H. MUNTJES; Groningen C. REKKERS M. GAASBEEK J. F. OTTÉ O 'COITNGA en FELDBRUGGE en Co.; Hoogezand F. M. DIKEMA; Meppel A. JEULEN en Co.; Noordbroek W. B. TEDINGA; Pekela J. T. FELDBRUGGE; Sappemeer  Wedw. S. SCHELTENS ; Stads-Kanaal H. KREKEL; Steenwijk K. TIMMERMANS ; Uithuizen J. SCHUURMAN NIEVEEN; Veendam S. SAVENIJE; Winschoten G. AVASMAN en W. VERMAAK en in de bekende Dépóts in de andere Steden.,http://resolver.kb.nl/resolve?urn=ddd:010771984:mpeg21:a0008:ocr,4,ddd:010771984:mpeg21:p004,Groninger courant,1028
1599864,1856/12/10 00:00:00,1869,ddd:010777214:mpeg21:a0019,http://imageviewer.kb.nl/ImagingService/imagingService?id=ddd:010777214:mpeg21:p004:image&x=1883&y=2411&w=856&h=1869,ddd:010777214:mpeg21,2739,4280,1883,2411,4,"Moutwijn per Ned. vat zonder lust / 2350; Jen* iJ. I 2000; Amsterd. proef / 30.2) zonder de behll ERRATUM. ""* In de adv. der Courant van gisteren staat $ sievelijk lezing van Mr. I. DA COSTA ten * acht ure moet zijn ten acht ure. -=_ WAAK.\r__U_.üK.N  guüttaii j/.. ii_ Mcteiroloïincli ObnervatoriuDi ;a U'reehl • - Win-- Biraa. Thar. Alwigk Voch- G.T. 1 | ? rigt. | kr. b. o°. F. d t.mi ugi r<__\AaumerUm ___.. _ _. 9 2 z. 10 0 753.50J55.2 + 15.8 0.73 0 il.ewolkt. 10 Z..1.0 51.87 54.5| I 71 0 jldem. 10 B z.| 7.5 50._6'52.2l I 77 0.2 Zw. beWol»J ""AMSTERDAM 9 DecerobarTsfi-r- Nhderland. Werkel. Schuld .. . !•ƒ pCt. 62% 62% 6-7» dito dito 3 „ 74% 74% ?47' dito dito 4 „ 93% 93% 93"" Rusland. Oblig. bij Hope en Co. ! „ 102% 102% IÜ-J* Obli-at. 1828 & 182 U 5 „ 101% 101% 10l7' Certifikat. 1831 & 1833 5 „ 92 Certifikaten 1840. .. 4 „ 83% Cert. bij Slieylitz . . 4 „ 82% ~ » »• * „ 81% dito Adm. te liond. 4'/ „ 92% Cert. van Assign. . . 6 „ 62% Polen. Aand. 1835 fl. 500 150 152 Obligatien 4 pCt. 76% Spanjh. w. Obligatien 1'/4 pCt. 23% 23»/ *f/_! Binnenl. Schuld ... 3 „ 36% 36% -6/p Bewijzen Koepons ... 5% 6 Oostenrijk. Oblig. bij Goll en Co. 4 pCt. 62% ~. Obl.g. Metaliek ... 5 „ 73% 73% l/J! Oblig. N 5 „ 82% 82% »*£ dito dtoLaß. 54 . 5 „ 82% 82% si"" dito dito 2'/ „ 38% 38% D_i ais. Cer;.l':k. bij Rotschild »% pCt. 51% 51% PoKTDOAL. Obligatien 3 pCt. 44 44% 4 Amerik.. Venez.Oblig. 6pCt. nu 4% „ 32% 32% .fe Grenada Oblig. ... » „ 20% 20% z Mexiko. Obl. 1854 t 100 •.. I9y 19% Bnelpersdruk van L. E. BOSCH EX ZOOÏ*'",http://resolver.kb.nl/resolve?urn=ddd:010777214:mpeg21:a0019:ocr,4,ddd:010777214:mpeg21:p004,Utrechtsche provinciale en stads-courant : algemeen advertentieblad,856
905856,1856/09/11 00:00:00,1011,ddd:010078562:mpeg21:a0019,http://imageviewer.kb.nl/ImagingService/imagingService?id=ddd:010078562:mpeg21:p004:image&x=1010&y=3008&w=896&h=1011,ddd:010078562:mpeg21,1906,4019,1010,3008,4,De Pillen van tiFQLLÜWAY zijn een onwaardeerbaar geneesmiddel voor Mejufvrouw W H... te Assen oud 45 jaren was sedert eenigen tijd zeer ongesteld en er vertoonden zich alle kenteekenen van WTatcrzucht. Haar echtgenoot verontrustte zich deswegen zeer en daar de ziekte zeer toenam twijfelde hij sterk aan hare genezing Daar alle aangewende middelen zonder gevolg bleven gaf baar de heer Huntley eindelijk de Pillen van Holloway. Na drie weken tijds verbeterde haar toestand zeer en ruim eene maand later was zij geheel hersteld.,http://resolver.kb.nl/resolve?urn=ddd:010078562:mpeg21:a0019:ocr,4,ddd:010078562:mpeg21:p004,De Noord-Brabanter : staat- en letterkundig dagblad,896
362375,1856/12/05 00:00:00,325,MMKB08:000070739:mpeg21:a0014,http://imageviewer.kb.nl/ImagingService/imagingService?id=MMKB08:000070739:mpeg21:p002:image&x=133&y=5062&w=1115&h=325,MMKB08:000070739:mpeg21,1248,5387,133,5062,2,Advertentie ALLM & ¥01 LHKGERKE maken aan het geëerde Publiek bekend dat zij wederom ontvangen hebben een groot assortiment beste Amerikaanscke Overschoenen in alle qualiteiten en grootten.,http://resolver.kb.nl/resolve?urn=MMKB08:000070739:mpeg21:a0014:ocr,2,MMKB08:000070739:mpeg21:p002,Delftsche courant,1115
4689660,1856/10/14 00:00:00,3326,ddd:010584511:mpeg21:a0011,http://imageviewer.kb.nl/ImagingService/imagingService?id=ddd:010584511:mpeg21:p004:image&x=93&y=1942&w=1410&h=3326,ddd:010584511:mpeg21,1503,5268,93,1942,4,"WINTER-ARTIKELEN. ITkc Ondergeteekende berigt door deze dat hij weder ruim voorzien is van Ijl zeer fijne en andere net bewerkte en onbewerkte PELTERIJEN; verandert dezelve naar den nieuwsten smaak en zuivert dezelve van de mot. Heeft op nieuw ontvangen eene schoone sortering LAKENS  PALLETOS BROEK- en VESTEN-STOFFEN; beveelt zich minzaam aan tot het leveren daarvan. D. H. van ERP Kleermaker en Pelterijiverker te Dokkum. B.ViptiBHAZBHI te bekomen a 75 Cents per Ned. <ffi bij den Vleeschhouwer J. de VRIES bij de Dubbelde Pijp te Leeuwarden. Er wordt gevraagd ongeveer 17000 ffi best KLEI-HOOL Brieven met ! naauwkeurige opgave van prijs onder de letters A. B. C. franco aan het Postkantoor te Beesterzwaag. <3Ï5m» STOOMVAART i■ J*l ""X^^ïjaJP^j^jfl Yk VAN HAraLIjVGrEN op lIUIX. Ifl| J Het Nederlandsch IJzeren STOOMSCHIP MINISTER THORBECKE Kapt. NEPPERUS vertrekt van HABliia>GKlsr naar BBJJLBj op aanstaanden JBatnrdag den 18 Oct. Adres voor Passagiers Goederen en Vee bij I. & S. WIARDA. Harlingen den 13 October 1856. MgSigz* ALGEMEENE POSTWAGEN-OMERMMIG WW^mr? rjN QEND <$• LOOS. De ADXHXISTRITIG berigt hiermede  dat ten gevolge van overeenkomsten met de Heeren W. &A. Visscher en A. Kiesbrink  te Zwolle A. Budde te Deventer en H. Bogaerts & CO. te 's Bosch zij van af 1 October onder hare firma zal exploiteren de navolgende DILIKEI'CË.DIKXSTËI  als: Van ARNHEM na aankomst der Spoortreinen van Amsterdam Rotterdam en Utrecht als: Iste Trein 's morgens circa 8""; uur naar Doesborgh en Zutphen. 2de Trein  's morgens circa 11 uur naar Nijmegen Grave en 's Bosch Tilburg Breda Doesborgh Zutphen Deventer Zwolle. 3de Trein circa 3i 's namiddags naar Doesborgh en Doetichem Terborgh Genderingen Aalten Varseveld Winterswijk Zutphen Deventer Zwolle Nijmegen en Kleef. Van UTRECHT 's avonds 10 uur over Amersfoort en Harderwijk naar Zwolle /''savonds 7"" uur naar Utrecht na aankomst der Diligenl ces van Groningen en Leeuwarden. i's morgens 8""r uur over Meppel naar Groningen en Leeu- J warden na aankomst van de Diligence van Utrecht. Van ZWOLLE \'s morgens BJr uur naar Deventer Zutphen Doesborgh J Doetichem  Terborgh  Genderingen  Aalten  Varseƒ veld  Winterswijk en Arnhem correspondentie op den | Spoortrein naar Amsterdam en Rotterdam. L's avonds 7 uur naar Deventer en ('s morgens 7 uur naar Zutphen Doesborgh en Arnhem Van DEVENTER| correspondentie op den Beurstrein naar Amsterdam en ( de Diensten naar Nijmegen en 's Bosch. Van ZUTPHEN 's namiddags 4i uur naar Doesborgh en Arnhem. Van GRONINGEN en LEEUWARDEN 's morgens 8J uur over Meppel naar Zwolle. Van NIJMEGEN naar Arnhem 's morgens 9 en 's namiddags circa 2 uur. Van 's BOSCH 's morgens 8""; uur over Grave en Nijmegen naar Arnhem. Van WINTERSWIJK naar Dieren 's morgens ten 4± uur en van GENDERINGEN ten zes uur te Dieren in verband met de Diensten naar Arnhem en Zwolle. iover Lemmer naar Sneek Leeuwarden en Groningen 's morgens 10 uur 15 min. na aankomst van den eersten Rijnspoorwegtrein van Rotterdam en Utrecht over Harlingen naar Leeuwarden en Groningen 's morgens 7 uur. Van GRONINGEN 's morgens 5 uur naar Leeuwarden Sneek Lemmer en Amsterdam. Van LEEUWARDEN 's morgens 5 uur naar Harlingen en Amsterdam. De vertrek-uren der Diensten van Utrecht naar 's Bosch en over Gorcum naar Breda vice-versa Breda en 's Bosch en der Nacht-Diligence van Amsterdam naar Rotterdam vice-versa blijven als tot hiertoe geregeld zoo als ook de correspondentiën met de Koninklijke Pruisische Posten over Emmerick en Kleef en die naar België Frankrijk enz. Behalve het vervoer met eigene middelen worden aan de Kantoren der Onderneming ook Goederen enz. ter verzending met de verschillende Spoortreinen aangenomen terwijl speciale Agenten aan de grenzen met de in- en uitklaringen belast zijn. Do Tarieven naar de verschillende rigtingen zijn zoodanig gesteld  dat dezelve met alle bestaande inrigtingen van vervoer te Lande kunnen wedijveren. B®° GOEDEREN moeten een liair uur vóór den tijd van vertrek der diensten aan de Kantoren bezorgd worden  bij latere bezorging worden zij met de volgondo dienst vervoord.",http://resolver.kb.nl/resolve?urn=ddd:010584511:mpeg21:a0011:ocr,4,ddd:010584511:mpeg21:p004,Leeuwarder courant,1410
3076070,1856/10/03 00:00:00,2213,ddd:010584508:mpeg21:a0020,http://imageviewer.kb.nl/ImagingService/imagingService?id=ddd:010584508:mpeg21:p004:image&x=93&y=67&w=1390&h=2213,ddd:010584508:mpeg21,1483,2280,93,67,8,FABRIJK EN MAGAZIJN VAN KAGCHELS EN HAARDEN. De Ondergeteekende heeft de eer te berigten  dat hij ruim voorzien is van zeer soliede en naar den laatsten smaak vervaardigde HAARDEN KAGCHELS en KOOK-FOURNUIZEN  extra fijne HAARD-GARNITUREN IJzeren TURFVAATJES etc. etc; dat hij zich bij voortduring belast met het leveren en plaatsen van Porceleioen KAOCHELS waarvan de Teekeningen op franco aanvrage te bekomen zijn. Leeuwarden 25 September 1856. J. van der WIELEN. MAGAZIJN VAN GESLAGEN EN GEGOTEN HAARDEN EN KAGCHES. De Ondergeteekende neemt bij deze de vrijheid te berigten  dat zijn Magazijn ruim voorzien is van eene groote collectie HAARDEN en KAGCHELS ROOKMACHINES  fijne Engelsche HAARD-GARNITUREN TURFVAATJES KOLENBAKKEN en wat verder tot het vak vereischt wordt; belovende eene allezins civiele bediening. C. van DUIJSEN Leeuwarden. Vleeschmarkt letter F no. 5. KAGCHELS EN HAARDEN. De Ondergeteekende heeft de eer te berigten dat hij uit de Fabriek van J. W. Kramps te Sneek voorzien is van KAGCHELS en HAARDEN naar den laatsten smaak. Bolsward den 2 October 1856. A. de BLAUW. VAN OUDS GEVESTIGDE GIETERIJ METALEN TORENKLOKKEN EN BRANDSPCITEN-EABRIJK te Midwolde in het Oldambt prov. Groningen. Ondergeteekende Firma recommandeert zich in het gieten en hergieten van TOREN-LUIDKLOKKEN. Harmonische KLOKKENSPELEN MOLEN- SLUIS- SCHEEPS- en alle andere METALEN GIETWERK BRANDSPUITEN met twee en vier Cilinders werkende ingerigt met perpendiculaire colbenbeweging door messing aangebragt waarvan vier onlangs vervaardigd door hoogst opvoerende werking en beste constructie der In- en Uitlandsche Geleerden proefondervindelijk uitmuntende; — Gutta-Percha en rondgeweefde hennippen SLANGEN van de beste kwaliteit en deugd; dito geweefde hennippen BRANDEMMERS welke door hunne doelmatigheid en deugd bijzonder zich aanbevelen. A. H. van BERGEN en COMP. u *M» DIENSTWIJZIGING der FRIESCHE- en OVERIJSSELSCHE i^msÊmm- vroiHiisoo r i_i:i:i>i:isi.i WXXTRMBIRIVST aanvangende den 3 October 18£ G. Van HARLINGEN naar KAMPEN Zondagsmorgens 8 uur. „ KAMPEN „ HARLINGEN Dingsdagsmorgens 7 uur. „ HARLINGEN „ ZWOLLE Donderdagsmorgens 8 uur. „ ZWOLLE „ HARLINGEN Zaturdagsmorgens 7 uur.,http://resolver.kb.nl/resolve?urn=ddd:010584508:mpeg21:a0020:ocr,4,ddd:010584508:mpeg21:p004,Leeuwarder courant,1390
3715072,1856/04/18 00:00:00,3628,ddd:000012713:mpeg21:a0020,http://imageviewer.kb.nl/ImagingService/imagingService?id=ddd:000012713:mpeg21:p004:image&x=91&y=1349&w=1024&h=3628,ddd:000012713:mpeg21,1115,4977,91,1349,4,"VERPACHTING van HOOILAND. Woensdag 30 Jpril 1856  des namiddags ten 2 ure  zal «vorden verpacht* ten huize van HELLENDOOHN l* Wilsurn  voor den tijd van één jaar. Jt >r\^» 1°- DE GROOTE WEL—>____=_aBL = ___rffi_jySr____ LE in Westra onder Wilsurn —•-^2: 2o> ])E KOELUCHBTWELLE onder Kamperveen.  in 4 perceelen. Aanwijzing der uitgezette perceelen daags te voren door DRIES van DIJK. Maaïsc¥app]Tvan^ Nijverheid. M^o^ De fliunstlilt'St van deze Mantschap- BjH E» pij  blijkt door de beste resultaten in het I*s» verbruik  dat steeds toeneemt uit de edelste beslnnddeelcn zomengesteld te zijn  en de meest gunstige invloed op de landen eu derzelver producten uit te oefenen. Zij is de helft goedkooper als de Guano benoodigd voor dezelfde oppervlakte en zeker voordeeliger als elke andere Mestspecie. Prijs f 20.— per 100 Ned. P en slechts 150 Ned. P. benoodigd voor een Bunder. Bovendien zeer gemakkelijk in vervoer en bewerking. Verkrijgbaar bij den Agent J. H. BCHELLWALD Jr. te Zwolle die alle verlangde inlichtingen geeft. '~~aßÊSOtt^tt- Het van ouds bekende S|li('K('lma- Mp~*~ Zijn «an de firma J. G. .MAZZUCHI is gS^f^^^^ is thans ruim voorzien van alle soorten van Fransche en Duitsche Spie» {{-els. niemve en antieke modellen. Spiegels verkiezende «velke niet in het Magazijn mogten voorhanden zijn  kunnen door hem in een korten tijd geleverd «vorden. Dezelve zijn door hein aanmerkelijk in prijs verminderd  verzoeke UEds. gunst. Diezerstraat bij hel Gouvernemfn/shuis. ii? VERLAKTE GOEDEREN^ M Moderateur en Spaarlam- | _PyV pen .in ruime keuze voorhanden. De ° prijzen zijn civiel  de bewerking net en solide mk JOH. VOEKERS Jz. A Lampemaker Koper- en Blikslager • ""ÊA Diezertiraal N"". 1119. T. KOOIJMAN. 2f2?»_i«_^sr«» Mr. Schilder is verhuisd van de Buiten%_^_*.!^_^4_j kant naar de Nieuws/raat het derde huis van de Roggestraat en blijft zich beleefdelijk aanbevelen. ___ Voor te Zaaijen dn^^Kit Zijn bij de ondergeteekenden verkrijgbaar alle soorten van IBaver. Gerst. '•M'^'iCir B'aardrbooneil enz. alsmede zuiver nicu«v Klaverzaad • tot de minste prijzen. van WIJHE Si TROOSTWIJK. Steenstraat oude firma I. vax UNEN. J^.v In een Brood- en Kleingoedbakkerij wordt ge|g_j!i vrnagd om dadelijk in dienst te treden een *______ Knecht* in staat de «verkznamheden alleen te kunnen verrigtcn. P. G. Adres franco  Lett. R. bij DE ERVEN J. J. TUL te Zwolle. mrp^<^^> Men verlangt te HURIi'N te Zwolle 3a 4 i__ii|(H^__^i ongemenbileerde KAMEBSS* binnen of buiten de Stad waar een Tuint*je bij is voor t«vee menschen van leeftijd. Adres onder lett. H. bij den Boekhandelaar TJEENK WILLINK te Zwolle. mg/t^^lZlZi_» en fatsoenlijk JONG MENSCH ruim TflT 9 jaren in het Koloniale vak werkzaam  *¦• '¦—•¦W**^ zag zich gaarne tegen Augustus verplaatst in Overijssel of Gelderland. Er zal minder op Salaris dan «vel op eene goede behandeling gelet «vorden. Men gelieve zich te adresseren onder letter K. K. bij den Boekhandelaar W. E. J. TJEENK WILLINK. jfcz^^SjpSi» Op den Dijk te HUUR een Stal * voor ¦Bffit^__pi drie Paarden  Koetshuis en berging voor Hooi en Stroo te bevragen bij de ERVEN J. J. TUL  te Zwolle. VERKOOP in ODEON van Mobilaire Goederen Rijtuigen enz door de Deurwaarders KOEKOO* JAASEI! en TOETELII'K. op Dingsdag 6 Mei 1856 des morgens om 9 uur. Te bezien daags te vorea van 10—12  en van 2—5. AR. Bij dezen verkoop kunnen meer Goederen «vorden ingebragt.",http://resolver.kb.nl/resolve?urn=ddd:000012713:mpeg21:a0020:ocr,4,ddd:000012713:mpeg21:p004,"Provinciale Overĳsselsche en Zwolsche courant : staats-, handels-, nieuws- en advertentieblad",1024
4758927,1856/10/27 00:00:00,4757,ddd:010544926:mpeg21:a0014,http://imageviewer.kb.nl/ImagingService/imagingService?id=ddd:010544926:mpeg21:p003:image&x=56&y=74&w=2919&h=4757,ddd:010544926:mpeg21,2975,4831,56,74,4,"X H B B. De ondergeteekenden hevelen zich voortdurend aan tot het leveren van alle soorten van THEEËN welke in hun Dépót verkrijgbaar zijn gesteld in verzegelde Pakjes van 2£ N. ffi 1 N. ffi 5 21 en 1 ons waarop nummer en prijs van af 80 Cent de 5 ons en hooger zijn vermeld Prijs-Couranten zijn gra ti slverkrijgbaar. B. 11. Hoeksema Sparen te Haarlem. 6"". Bakker Langestraat te Alkmaar. T. A. Pool te Hoorn. C. de Wolf te Purmrenede. P. Pronk te Edam. J. Drost te Medemblik. W. N. van der Veer te Enkhiiizeu. Jb. Jut te Wormerveer. NB. Door de goedkoopere Theeprijzen is de kwaliteit op nieuw van alle soorten aanmerkelijk verbeterd. BE KALF EX PILLEN XXX HOLLOWAY zijn een zeker werkend middel voor wonden en zweren. D. K-;y» te Genemuiden was over het geheele hgchaam bedekt met zweren eu was ellendig voor zichzelven en een last voor zijne vrienden en betrekkingen In de hoop eenige verlichting van zijn lijden te verwerven  raadpleegde hij onderscheidene geneesheeren en heelmeesters doch zijne ziekte werd door allen voor hopeloos verklaard. In dezen toestand gebruikte hij de Zalf en lillen van Holloway en in drie maanden tijds was hij volmaakt hersteld verheugende hij zich thans met de beste gezondheid. Zijn op franco aanvragen a contant te bekomen bij J. M. van Renesse te 's Hage j bij 11. J. Giltay te Dordrecht; J. Schoon te Alkmaar; B.Adama te Amsterdam ; en bij J. Straatman Hoofd-Depót-houder  te 's Hertogenbosch; alsmede in Holloway 's Etablissementen te Londen 244. Strand en te New-York 80 Muiden Lane. Door het vermeerderd debiet zijn de prijzen als volgt ■ Doosjes Pillen k f 080 f 185 ƒ300 ƒ675/1350 ƒ2O 55 Potjes Zalf k . 080 - 185 . 300 > 705. . 1385 . 20.20. V PAPIER VA\ ALBESPEIRÈS onderhoud zonder reuk of pijn te veroorzaken de lontenellen  zijnde gedurende meer dan 35 jaren door de Ge neeskundige School te Parijs voorgeschreven; Blaartrekkende Pleisters om zich binnen eenige uren een Fitsel te trekken; ÏV om de Fontenellen te ververschen ■ Zuimgheids-Compressen die de voorkeur boven de Linnen verdienen; verbeterde Arm- en Beenbanden van Gom- Elastiek en Plated. Men adressere zich aan het Hootd-Depót van Holland by den Heer F E. van Santen Kolf of bij de volgen' de Heeren Depothouders: J. Schoon te Alkmaar B Boom te Almelo ; C. B. Kok te Amersfoort; F Romeyu te Arnhem; J. J. Verluiden te Bergen op Zoom ; van den Goorberg te Breda; W. de TisserJr. te Deventer; van Wageningen te Dordrecht; P. J. B. Schultz teGo'cum; J. Mouton en Zonen te 'sGraveihege; P. H.N. vrn Wei me» kerken .e Groningen ; Kt'-nkert .£ Heyns1 >.» te Haai.'cm ; Schryt Best te Hoo^n ; O. A. van Tricht te Leyden ; Biasc.'e de Ligny te Middelburg ; J. 11. Coenen te Nijjiegen ; c""e W?d. van Rijis""l en Zoon te Tholen; A. J. Fcaisen .e Tiel; L. J. Grootendorst ApoJieVer te Uitent; Ochimans en de Bal te Zleiikree; D. J. Mu.ü?.idcm '.e Zd.>ben. Ge'd ei Brieven fianco. %* Op een Prot. Dorp in Gelderland vrij van overstrooming wordt de gelegenheid eangeboden aan een Heer voor KOST en INWONING a ƒ 18 'smaands. Adres franco Letter K. bij W. BECKING Boekhandelaar en Boekdrukker te Doesborgh. *#* Door gevorderden leeftijd UIT de HAND te KOOP: Een welbeklante SCHILDEKS-WINKEL met een net HUIS ruime WERKPLAATS en TUIN op eene we'varende plaats. Nader informatie te bekomen  mits Brieven franco onder Letter A. bij den Heer RODELSTURT op de Neude te Utrecht. ""~V UIT de HAND te KOOP: Een hecht sterk en weldoortimmerd dubbel WINKELHUIS ERVE en TUIN staande en gelegen in eene der hoofdstraten te Haarlem. Men adressere zich met franco Brieven  ten Kantore van den Makelaar W. J. ELSENHORST in de Anegang aldaar. •«» l IT DE HANB TE HOOP: Een TJALKSCHIP groot vier en veertig Ton. Te bevragen franco bij K. H. KANT Scheepmaker te Hoorn. UIT D! HAID Tl KOOP: Een zeer fraa'ne en zuiver geteekende ZWART LAKENVELDSGHE STIER geboren 15 Julij 1855 uit eene Koe en Stier van dezelfde kleur : benevens een bijzonder hardlocpend Tilburry Paard zijnde eene BRUINE «.KL BKR MC HE MERRIE oud 5 jaren welke zeer mak en zonder gebreken is. Beide zijn te zien en te bevragen op de Boerderij van Hilverbeek te 's Gravpland  Provincie Noord-Holland. Brieven franco. ~%*""UIT de HAND te KOOP: Een Inlandsche vette os zwaar omstreeks 2200 Nederl. Ponden hoog 2 Ellen 2 Palmen lang bijna 4 Elleu en in omvang 3 Ellen  7 Palmen. Te bevragen bij den Bouwman C. POUW te Achthoven bij Montfoort. *„.* In eene der voornaamste Hoofdsteden van ons Vaderland wordt ter overname aangeboden : Eene sints jaren gevestigde en soliede BOEKHANDEL en BINDERIJ  waaraan een ruim bestaan verbonden is. Brieven franco Letts. A. V. aan A. KNOOP Klein Heiligland te Haarlem.",http://resolver.kb.nl/resolve?urn=ddd:010544926:mpeg21:a0014:ocr,3,ddd:010544926:mpeg21:p003,Opregte Haarlemsche Courant,2919
44485,1856/02/15 00:00:00,35,ddd:010788578:mpeg21:a0014,http://imageviewer.kb.nl/ImagingService/imagingService?id=ddd:010788578:mpeg21:p004:image&x=738&y=4257&w=1271&h=35,ddd:010788578:mpeg21,2009,4292,738,4257,4,TE 'S GRAVENHAGE TER ALGEMEENE LANDS-DRUKKERIJ.,http://resolver.kb.nl/resolve?urn=ddd:010788578:mpeg21:a0014:ocr,4,ddd:010788578:mpeg21:p004,Nederlandsche staatscourant,1271
4056984,1856/01/15 00:00:00,2088,ddd:010544688:mpeg21:a0020,http://imageviewer.kb.nl/ImagingService/imagingService?id=ddd:010544688:mpeg21:p004:image&x=1022&y=69&w=1943&h=2088,ddd:010544688:mpeg21,2965,2157,1022,69,4,%* leder die eenig belang stelt in het regt verstand van den Bijbel. Eu door de geschiedenis der Christelijke Kerk zijne kennis als Christen wenscht te vermeerderen en te verhelderen  zal daarvoor voldoening vinden i» het nieuw op te rigten Tijdschrift waarvan het eerste uoinuier algemeen verspreid is getiteld: GODSDIENSTIG HUISBLAD STICHTELIJKE LECTUUR VOOR VERSTAND EN HART ONDER HOOFDREDACTIE VAN IK. E. J. MEST LORGION EN MEDEWERKING VAN EEN GROOT AANTAL MET ROEM BEKENDE VADERLANDSCHE GELEERDEN als onder anderen Prof. P. HOFSTEDE de GROOT en Dr. C. H. van HERWERDEN C. Hzu. te Groningen . J P. de KEIJSER te Arnhem  J. R. EILERS KOCH te Ar. Pekela; J. H. SONSTRAL  te Helder  P. PARSON te Steenwijk -. Dr. M. van STAVEREN te Leeuwarden. Dr. J. C. ZAALBERG Pz. te 's Hage. Wenschende zoo veel mogelijk ieder in de gelegenheid te stellen voordeel te doen voor zijne Christelijke kennis en met het oog alzoo op een algemeen groot debiet hebben de Uitgevers den geringen prijs van VIER fiüLDEN voor een Jaargang van 26 vellen roijaal formaat gesteld. De wijze en voorwaarden van uitgave zijn nader op de Prospectussen omschreven. De Inteekening is bij alle Boekhandelaren opengesteld. Door dezelfde UITGEVERS is mede voor korten tijd verzonden het 2©ste Vel van: M HUISVRIEND. GEMENGDE LECTUUR VOOR BURGERS IN STAD EN LAND VERZAMELD DOOR IVHOI'D : De Sporen onzer daden. Eene oudejaarsavond-symphonie. — Over duizend jaar. — Jan de Rijmer op St. Niclaas. —De geheimzinnige gast. — Het menschelijk leven. — Vogel en Dichter door S. J. van den Bergh. — De geschiedenis van eene Moeder naar 11. C. Andersen. — De hondentaai. — De nieuwsgierigheid der Kinderen. — Een winter in Erserum naar Karl Koek. De inhoud van den geheelen Jaargang wordt onder de volgende hoofdrubrieken gebragt: Verhalen Schetsen Volksoverleveringen enz. — Bijdragen tot Natuur- Landen- en Volkenkennis. — Ons Maatschappelijk Burgerlijk en Huisselijk Leven betreffende. — Van Gemengden inhoud. — Gedichten en Rijmen. De buitengewoon lage PrJJs van den HUISVRIEND is BBIE GUEBEN. Van den nu gesloten Jaargang zijn nog eenige weinige Exemplaren tegen dezen prijs te bekomen. Men kan bij alle Boekhandelaren voor den volgenden Jaargang den veertienden van dit veel gelezen Tijdschrift inteekenen. De Uitgevers DE ERVEN C. M. VAN BOLHUIS HOITSEHA.,http://resolver.kb.nl/resolve?urn=ddd:010544688:mpeg21:a0020:ocr,4,ddd:010544688:mpeg21:p004,Opregte Haarlemsche Courant,1943
1121100,1856/10/29 00:00:00,555,ddd:010397741:mpeg21:a0047,http://imageviewer.kb.nl/ImagingService/imagingService?id=ddd:010397741:mpeg21:p004:image&x=34&y=4140&w=2020&h=555,ddd:010397741:mpeg21,2054,4695,34,4140,4,_ z — - ■ „ B AHLM Aj\ lV & C.lE HOOGSTRAAT e* STEIGER berigten hunne geachte Begunstigers dat zij van PA BJJ S ontvangen hebben de NIEUWSTE MODELLEN van DAMES MANTELS dewelke van af HEDEN «9 OCTOBER worden gepresenteerd. Ook is hun MAGAZIJN wederom ruim gesorteerd in de NIEÜTTSTE ARTIKELEN voor het WIHTERSAIZOEN.,http://resolver.kb.nl/resolve?urn=ddd:010397741:mpeg21:a0047:ocr,4,ddd:010397741:mpeg21:p004,Rotterdamsche courant,2020
4991880,1856/08/08 00:00:00,4894,ddd:000012753:mpeg21:a0018,http://imageviewer.kb.nl/ImagingService/imagingService?id=ddd:000012753:mpeg21:p004:image&x=65&y=53&w=1020&h=4894,ddd:000012753:mpeg21,1085,4947,65,53,4,"25. Een Peiceel GROEN- en HTETCROND met daarop staande JoHge DENNEO een tre.leelle van de znno-e iniainde Zomp Karlrster Sectie D Nos. lis:! i:_:jfi en L'i.'iT :red.  e-root 8 Runders 34 I'oe 7u Kllen. 26. Een Perceel HOOI- eu WEILAND de Sotioltenmtth genaamd  Kad. Sectie D Nos. 42 en 1179 groot 3 Bunders 50 Roe 50 EUen. 27. Een Perceel WEIDELAND in Behanebroek het eerste gedeelte van den westkant van den Middenweg langs de waterleiding Kad. Sectie B No. 128 ged. groot 2 Bunders 7 Boe. 28. Een Perceel WEILAND aldanr nan den Oostkant van den Middenweg Sectie B No. 129 ged. groot 2 Bunder 2 Boe. 29. Een Perceel WEILAND  gelegen naast het voorgaande Sectie B No. 129 ged. groot 2 Bunders 3 Roeden. 30. Een Perceel WEILAND gelegen naast het voorgaande Sectie B No. 129 ged. groot 2 Bunders 2 Roe.' 81. Een Perceel WEILAND aldaar Sectie B No. 129 ged. groot 2 Bunder 2 Roeden. 32. Een Perceel WEIDELAND aldaar Sectie B. No. 129 ged. groot 2 Bunders 1 Roe. 33. Een Perceel WEILAND aldaar Sectie 1! No. 129 ged.. groot 2 Bunders. 34. Een Perceel WEILAND aldaar Sectie B No. 129 ged. groot 2 Runders 5 Roe. 35. Een Perceel WEILAND aldaar Sectie B No. 129 ged. groot 2 Bunders. 36. Een Perceel WEILAND aldaar Sectie B No. 129 ged. groot 2 Bunders. 37. Een Perceel WEILAND aldaar Sectie B No. 129 ged. groot 2 Bunders. 38. Een Perecel WEILAND de Aclitenwite genaamd Kad. Sectie C No. 78  groot 1 Bunder 2 Roe 40 Ellen. 39. Een Perceel WEI LAND de Achtermate «jennamd  Kad. Sectie C No. 80 srroot 1 Bunder 54 Roeden 70 EUen. 40. Een Perceel HEIDEGROND hei Lageveld genaamd aan den ouden Twentschen weg Kad. Sectie C No. 884 ged.  groot 2 Bunders 41 Roe 20 Ellen. 41. Een Dl'l'o Perceel gelegen naast het voorgaande  Sectie O No. 884 ged. groot '2 Bunders 41 Roe 20 Elleu. 42. Een DITO Perceel aldaar No. 881 ged. groot 2 Bunders 41 Roe 20 Ellen. 43. Een stuk HEIDEGROND  de Dopplas genaamd  Kad. Sectie C No. S6B groot 2 Bunder 25 Roeden 60 Ellen. 44. Foor Afbraak: cenc SCHUUR staande op Perceel 1. 45. Ecu Perceel Opgaande DENNENBOOMEN met den ONDERGROND' Kad. Sectie C Nos. 867 en 875 groot 40 Roeden 20 EUen. I)e Nejfen eerste perceelen zullen den Eersten dag- en de overige perceelen den Tweeden dag van verkoop jjeveild worden. Voorts zullen op Donderdag den Iü Augustus 1856 's morgens tn 10 uur bij KUTSCiIRUTTER in DEN ZWARTEN AREND te Raalte worden verkocht: v*Bj6s<Sfc De op voorschreven Perceelen staande EIKEN-  iJ$>M BEUKEN- en DENNENBOOMEN welke door de BT Koopers van den Ondergrond zullen kunnen worden benaderd tegen betaling van 3°/n. Aanwijzer zoowel van de Perceelen als van de Boomen do Werkbaas TEUNIS SPIJKERMAN wonende op het 2de; Perceel; terwijl inmiddels nadere informatien te bekomen zijn ten Kantore van voornoemden Notaris alwaar de Boekjes  inhoudende de Lijst der Perceelen eu Boomen van ai Maandag aanstaande verkrijgbaar zullen zijn en de Kadastrale Plans van af heden ter visie zullen liggen. De Notaris «. ___4l_il_JVEK^ te Hellendoorn zal op Dingsdag den 12 Augustus 1856  des voormiddags te 11 uur; ten huize van den Logementhouder MANSIER te Ommen doen inzetten  en 14 dagen later aldaar finaal verkoopen : jft *y » Dc volgende onder de STAD *M /s% jyß_-_ OMMEX gelegene «^fe GRONDEN als: 1. Sectie B Nos. 147 148 149 150 151 en 152 Hooiland DEN HOOIKAMP genaamd groot 94 Roeden 57 Ellen. 2. Sectie B. Nos. 1249 en 1250  Kouwland eu Tuiu . aan de Hofte groot 4.24 EUen. 3. Sectie B No. 544  Kouwland  in de Strange  groot 59.30 EUen. 4. Sectie B No. 993  Kouwland  op den Hum groot 25 Boeden. 5. Sectie B. Nos. 1055 en 1056 Kouwland. aan de Mars groot 11.40 EUen 6. Sectie B No. 673 Kouwland bij de Esclimohn groot 15.70 Ellen; en 7. Sectie B No. 104 Kouwland op de Looze groot 26.50 EUen. De aanwijzing zal gedaan worden door ZWIER KAMI'- MAN te Ommen terwijl nadere informatien verkrijgbaar ziju ten Kantore van voormelden Notaris. ~De Notaris «. KLUVKKH te Ilellendoorn zal op IHngsdag den 12 Augustus 1856 des voormiddags te elf uur ten huize van den Logementhouder MANSIER te Ommen doeu inzetten  en 14 dagen later aldaar finaal verkoopen de volgende in en onder de stad Ommen gelegen ONROERENDE GOEDEREN: ml"". Een wel doortimmerd Heeren Huift aan de Markt tevens een fraai uitzigt hebbende over de rivier de Fecht op de grindweg nanr Zwolle 2°. Een Huis in de Bruggestraat mede uitzigt hebbende over de Markt en de rivier de Fecht. 3"". Een Schuur tevens tot Woonhuis ingerigt aan de Mars. -I°. Een Tuintje aan voormelde Schuur gelegen  groot 3 R. 50 E.  en s°. Een stuk Hooiland in den Garsten Kamp  groot 13 Roeden. Nadere informatien zijn te bekomen ten kantore van voormelden Notaris en ten kantore van den Notaris MULERT te Ommen. UITVERKOOP van af heden van diverse gekleurde Zijde Fluweelen «alons. Zijden Franjes en dito Iknoopcn  ver beneden Fabrieks prijzen. J. 11. DECKERS & C°. Groote Markt en Sassenstraat.",http://resolver.kb.nl/resolve?urn=ddd:000012753:mpeg21:a0018:ocr,4,ddd:000012753:mpeg21:p004,"Provinciale Overĳsselsche en Zwolsche courant : staats-, handels-, nieuws- en advertentieblad",1020
548952,1856/09/27 00:00:00,712,ddd:010113182:mpeg21:a0007,http://imageviewer.kb.nl/ImagingService/imagingService?id=ddd:010113182:mpeg21:p003:image&x=3295&y=4526&w=771&h=712,ddd:010113182:mpeg21,4066,5238,3295,4526,6,"(8596) DEELEEBBEES in de'*Gravenhaagsche Maatschappij ter verzekering tegen Brand- en Zeegevaar worden uitgenoodigd tot het bijwonen der JAARLIJKSCHE ALGEMEENE VERGADERING op Zaturdag den 4den October 1856 ten half twee ure in het Gebouw Diligentia in het Lange Voorhout  te 's Gravenhage. H. H. VAN DAM Directeur. flßÜlMjV'""""' Heden Avond ten ï uur {S^Sr precies! BIJEENKOMST van HE. ABONNENTEN der BUITENLANDSCHE LEES-INEIGTING. E. van Vliet Az.  (8572) Deiftsche Vaart.",http://resolver.kb.nl/resolve?urn=ddd:010113182:mpeg21:a0007:ocr,3,ddd:010113182:mpeg21:p003,"Nieuwe Rotterdamsche courant : staats-, handels-, nieuws- en advertentieblad",771
4099560,1856/08/03 00:00:00,4035,ddd:010771991:mpeg21:a0002,http://imageviewer.kb.nl/ImagingService/imagingService?id=ddd:010771991:mpeg21:p001:image&x=2100&y=816&w=1016&h=4035,ddd:010771991:mpeg21,3116,4851,2100,816,4,"Estrikken of Vloersteenen I de 50 ffi - 050.^"" de 1000 stuks 600. Id. pakjes beneden de 20 tt - 035. Eijeren 500 stuks - 060. Manufacturen van zijde F. de 50 « - 080. Flesschen ledige de 1000 Meekrap de 50 tt - '030. stuks 050. Meel id 030. Forte Piano in eene kist Menie id - 030. per stuk 500. Meubelen kabinet of kast - 650. Foelie de 50 tt 045. ld. bureau met bovenstuk - 300. Fusten (ledige) een aam - 030. Id. secretaire of chiffonière - 300. Id. id. andere groote of ld. stoelen per stuk 030. kleinere per 100 kan.. - 015. Militaire goederen kleeö. ditigstukken randsels Galnooten desott - 040. chacots per équipement Garen (alle soorten van) 0f enkele stukken 050. de 50 tt - 050. Molensteenen de grootste - 1600. Geele oker de 50 U' 030. ld kleinere naar evenre- Geld (onverz.) p. 100 gl. - 025. digheid ld. (verzeg.) p. 100 id. - 020. Mosterdzaad het Ned. md. - 040. (Gedeelten van 100 gulden Mout het last - 600. te rekenen voor 100 gl.) id. per mud als granen. Gember de 50 tt 050. r n. Geweren p. kist v. 50 st. - 200. Nagelbollen de 50 tt 040. Id. losse bij het stuk... - 020. Notciimustaat id 040. Glas (venster-) per kist - 080. j{oten (Wal-) het Ned. md. - 040. Id. id. per halve kist 050. o. Id. (gruis van) de 50 tt - 030. Oesters de ton... - 130. Glaswerk per mand - 050. ld. de halve ton - 070. Gort groote hoeveelheid id. de kwart ton - 050. perlast 700. oker de 50 « - 030. Id. (per mud) als granen. olie het kwart deel per Granen tarwe rogge 100 kan - 050. erwten boonen p. last - 700. Td.  bet vat van 100 kan - 060. Granen boekweit gerst Oranjeschil de 50 tt - 050. haver per last - 600. p ld. Bij mindere hoeveel- Papier de 50 vl.'. - 040. heid per mud (doch zoo Pelterijen de 50 tt - 100. dat voor minder dan een Peper id - 040. last niet meer dan voor Pijpen het mandje - 015. het last wordt betaald).. - 030. potlood de 50 w - 025. H- Pruimen (gedr.) desott.. - 030. Haar (Koe- of Paarden-) n_ de 50 tt - 060. aeuBel TOt of smeer'desott - 030. Hagel 50 tt - 030. Kiet (Spaansch) de 100 Haring per last van 12 ton - 800. stokken - 085. Id. per ton - 070. Ri;Bt de 50 tt- - 030. Harpuis de 50 tt - 035. RoZjjnen id 035. Harst id - 035. Kun (gemaien) het mud Hazelnooten het mud— - 060. vaii gn jrcd u- . 040. Hazen vellen in vaten of g balen de 50 « - 050. Salpeter de 50 tt 035. Hennep de 100 Ned. Tt - 080. sjcharren het mandje van Hoepels de 1000 van ƒOBO tot 140. 240 stuks - 040. Hoeden in kisten - 100. gcmi (drooge) de 50 tt - 050. Honing de 50 tt - 040. genebladen de 50 tt 060. Hop de 50 tt - 080. Siloopi id - 050. Huiden (gedroogde Kalfs-) Snuit id - 040. per stuk ... - 005. SpiegelSj de grootste - 300. Id. (nat of gezouten Kalfs-) id_ j middelsoort - 200. per stuk - 008. id kleinere naar even- Id. (natte of gezouten Os- redigheid sen-ofKoe-) per stuk.. - 020. Staai m Btaven de 50 tt - 025. Id. (gedroogde Ossen- of Steentjes (bonte of witte) Koe-) per stuk ...... - 015. de lüoo stuk 3 . 150. Id. (Schapen-) met de wol Stijfsel de 50 tt 035. per stuk .............. - 006. Sulker (gerarHn.) de 50 W' - 040. ld. (dito) gebloot het pak Id. (ongeraffineerd) id.. - 030. van 50 stuks..... - 085. Id (Metisbrooden) id.... - 0.45. J. 'f. Jeneverbessen de 50 « - 070. paDak jn vaten per vat - 250. Indigo id...... - 060. j-di) in bladen de 50 tt - 040. t j ™£' nAn ld- gekorven en eigareu Kaarsen de 50 tt - 040. do |0 . 060. Kaas id. O-40- Teer of Piï""dè""ton - 070. Kagchels (geslagen) naar Terpentijn de flesch - 120. grootte..... -1a200. Th(£ dJe nalve kist - 100. Id. (gegoten) als grof Id de kwart kist . 070. ijzerwerk ld. de achtste kist - 050. Kandij (de pot) 020. roJwwerk de 50 tï - 025. Id. (in kistjes) ~. 040. rraan het kwartdeel per Karotten de 50 tt 030. foo'kuu f.. - 050. Karweizaad id.... ... - 050. [d .tvatvan'iö()Ned.kan. - 060. Karkassen (zie kramerij.) ij Katoen (ruwe) in geperste Uurwerk (Vriesche klok)  - 060. balen de'so tt - 040. Id (Btoelkiok) - 1-00. \J 'h m on&ePerBte nRn ld. (staande Hok) - 2.00--balen id............... - 080. 'öcb.warzwalder of klok- Klaverzaad de 50 tt 030. ' . ~-.„„ /•„]„ Knoll.n het mud - 0 40. £en 1!1 kut™' v Koek de 50 tt - 040. kramerlJ van iout° Klk<ïnnn(LiJn"" °f ' 600 Vederen (Bed-) de 50 «.. - 100. KotiTnü^n^-.-.-./itotlo: jm* £""■»*•id- - »$■ gji.. «?»• ••- 00f0-^gn%rmatjel.d::::::: $$: Komijn id.............. - 050. J» laBt_ . 8)00 Koper in platen de 50 8 - 030. Jfa . 2)00. Koperrood ue 50tt...... - 030. y 60 u. . 045. Koperwerk (zie kramerij). (gezouten) of ger. Kousen Mutsen Hand- « hlimmell 50 »• - 050. schoenen (zie mauufact.). vloersteenen (geslepen) Korenten de 50 U - 030. de m 0 . 6ioo. Krijt id-..-.-- ••••-•• - 020. d (marmeren)i Vau 5 tot KTkenn(lefdlfbronwater)' lnn 20 vierkant*l palmen de 100 stuks - 100. r . 012. K=fTmkersrpS: Vormen - 060. r^.^d:.C.°.bSn.e: - 040. Wannen het *«*...... - 020 ld. Neurenberger de 50* - 050. Was de 50 a. _ ""-^ K-k"" 50«-£ - °-90-it; E-SM!.::::- - S Lakens (ziemanufacturen.) £}•» het kwart aam ..... - . • Lak de 50 « - 040. ™- -?P ttes-cheup. anker o»u. Lakmoes en Bergblaauw  ""■ 5 ld- hu"" anUer . o'Bo de 50 8- - 030. Wol de 50 tt. . Leder de 50 « - 050. rr 1J- . Leliën de 1000 stuks (of Wzer grof ijzerwerk als. 500 Ned. «) - 250. aambeelden koekepauu. Lijm de 50 VI 050. staven spijkers enz. Likeuren (alle) op flesschen « 50 « <*»• per anker - 080. Id. Zie Kramerij. Id. id.  per half anker.. - 060. f Linnen de 50 tt - 050. Zaad (kool- of hjn-) ge- Lint (zie manufacturen.) stort of 111 zakken het 1. - 70 U. Lompen om papier ■te ld. (hennep  het last.. - 600. maken de 50 « - 050. 1d.. per mud als granen. Lood de 50 * - 025. Zalm het 5tuk.......... - 060. Loodwit id - 025. Zeep (zachte) de vier kw. t. - 80. Leijen schrijf het pakje - 040. Zink de 50 tt.. - »>-™- M. Zooileer het vel - "".""j- Manufacturen"" Lijnwaden Zout de 50 tt.... .. - °Zo. Linterijen van Katoen Zwartsel in tonnetjes de Wol enz.; Laken 50 tt - ASO. Kousen Mutsen Hand- Zwavel de 50 tt........ - o*>. schoenen en dergelijke IZwavelstokken de 100 bos - 030.",http://resolver.kb.nl/resolve?urn=ddd:010771991:mpeg21:a0002:ocr,1,ddd:010771991:mpeg21:p001,Groninger courant,1016
4371510,1856/06/17 00:00:00,4290,ddd:000012732:mpeg21:a0025,http://imageviewer.kb.nl/ImagingService/imagingService?id=ddd:000012732:mpeg21:p004:image&x=77&y=665&w=1019&h=4290,ddd:000012732:mpeg21,1096,4955,77,665,4,"ZWOLSCHE STOOMBOOT- / \-\-i  HAATSCII.4PPIJ- AiGEMEENE 1 'EKG ADEilß**i van de Aandeelhouders der Zwolsche Stoomboot-.Maatschappij op Zaturdag den acht eu ticiul'ii/s/eu Juuij e. le. 's avonds te r.VWn uur in de N 1 KA'IVE STADS-'IIERRERG tV Zicolle. Nederlandscßie Handel-Maatschappij. De in de Vergadering van Commissarissen goedgekeurde llulaii!-» over het Boekjaar 18&5 benevens die van liet Iteserve-Foi.'.* over hetzelfde tijdvak  zullen voor de Aandeelhouders ter visie liggen eau den 14- 10l eu mei den 30 dezer ter Secretarie van de Dirctic te Amsterdam  bij de Agenten der Mnatsclmppii '- ttmurdutn  Dordrecht en Middelburg en bij de Kameis van Kooplmndel en l'alirijken te leiden en 's Gruceuhuae. Amsterdam deu .2 Junij ippfi. toé^^^^A Mr' M. *i. tt«»t<€lt Notaris S^tL~jÈÈ'a°fT:i ¦?%*» Ir Dereuier zal aldaar ten liui/.c van »lb'-'^i^'^r.'.*^Sr den kastelein 1)1' 1.1 M op Dingsdag deu 24 Junij ] 85U  des morgens om 10 uur overgaan lot de Vmling ter uiterlijke toewtjemg in Perceelen Koloimnen en Massa's van het Erf DE 'ftRAKE in Liuilerlhe onder Raalle groot Ui. 59. 00. Een stuk Iloüi-li^roiid . Sectie A. No. 30 groot 0.25.t50 IV Katerstede? *>—CHXtretl de in Tongeren onder Wijke groot 3. CO. 00. cv de helft in een llooilaiirl. ÜE GOEDKOOP aldaar irroot 3. «2. 10 ingeeet in l'ereeelen: het I. op/9000. 11. f 1400. 111. f 350. IV / 1975. v. /200. vi./isoo. vu. f ma. vm. /-no. ix. ƒ 800. X. f 90. XI. ƒ 210. XII. f 2100. XIII. MSUO. He aanwijzing geschiedt op de Erven op Zaturdag deu 21 Juuij  's morgens om 9 uur en 's middags om 2 uur. ONDERWIJS. ?CTM £»fela» e ondergeteekende gemagtigd door liet *^ E. A. Bestuur dezer Stad  brengt ter kenül nis van belanghebbenden dat 'hij zich te dezer Stede zal vestigen als Onder* Wijzer in de lIOLLANPSOHE PRANBCHE 1100(1- DUITBCHE en ENGELSCHE TAAL MATHESIS GK-BCHIEDENIS enz. Veeljarige ondervinding als Onderwijzer op een Instituut langdurige studiën en de vroegere door hem v ilbragte  gelukkige opleiding van vele jonge lieden voor de Academie von Breda en die ""van Delft (tellen hem in staat met vrucht jonge lieden voor den Handel de Academiën en de Telegrapliie op te leiden  waartoe hij zich bescheiden aanbeveelt. Zwolle 16 Junij 1556. J. VRUGGIN-K. Adres den Heer 11. MIDDENDOIU' llz. Eetlilelieinsehe Kerkplein. Ziekenfonds etc. i7~""gtfBjff-to»*f 00r p'~n Nederl. Maatschappij voor WKmm WÈ& KELIJKSCHE UITKEKKING bij ziekte Ml • LEVKNSI.ANIiI-; (per kwartaal) bij zuarc rampen en in eens van BEGRAFENISKOSTEN worden in alle Steden en Gemeenten van Overijssel opzeer aannemelijke voorwaarden ISODEI gevraagd. Activiteit en het stellen eener kleine cautie zijn eerste yereischten. Hiein bediening bij het gemeentebestuur zijn komen het eerst in aanmerking. Adres franco onder lett. (' (' bil DE ERVEN J. .T. TUL te Zwolle. ' J &tijf£ï\ Er wordt gevraagd een ISroufl- en KoeK-1 bakkt-r* li.iH>elit van de I. G. om «cfö^ïiL. «-adelijk in dienst te treden  liefst iemand die eenigen tijd bij liet vak werkzaam is geweest en van goede gctiiiarschriften voorzien. Adres met franco Brieven onder Lett. 15. bij den Boekhandelaar A. van BEVERWIJK te Kampen. «yjjaw—'*""7-~^^r Er wordt tegen den 1 .-Itigustusgevraagd een Mkk-L t&* of twee ')C>k''anic bakkers knt-cii»< ï^*^-*-u*w* ton en is ook gelegenheid tot liet plaatsen van een leerling-. Nadere informatiën zijn te bekomen bij de Wed. W de HAER te Zwolle. JS~—-**\^ Men vraagt tegen 1 November bij of in i JoiVßl. eene Cer ste(len Zwolle Zutphen of Arnhem gypp|lj|p TE lIBILIt. een goed f luis met 5 a èraS-=^"".:!«¦ G KAMERS en Overige gemakken op een goeden stand liefst met een Tuintje de huurprijs van 3 a 400 gulden niet te boven gaande. Brieven franco adres lett. K. bij den Heer E. J. BEUNK firma G.BRGU» AM'llt Boekhandelaar te Deventer. «R-feï^^g---» Er wordt TE HUUR gevraagd tegen primo Swt\%K«£&^ November of eerder een a twee gemeubileerde H.itiners met bediening op een vrolijken stand  voor iemand die zijne werkzaamheden buiten 's huis heeft. Adres onder lett. A. O bij 1)K ERVEN J. J. TUL te Zwolle. Bl^ Een Schilderskneclit die zijn vak goed verstaat  kan dadelijk tegen goed Wa ¦ loon vast werk bekomen bij D. J. PRUIM. Schilder en Behanger le Zicolle",http://resolver.kb.nl/resolve?urn=ddd:000012732:mpeg21:a0025:ocr,4,ddd:000012732:mpeg21:p004,"Provinciale Overĳsselsche en Zwolsche courant : staats-, handels-, nieuws- en advertentieblad",1019
2767968,1856/12/03 00:00:00,2746,ddd:010772043:mpeg21:a0006,http://imageviewer.kb.nl/ImagingService/imagingService?id=ddd:010772043:mpeg21:p004:image&x=53&y=2891&w=1008&h=2746,ddd:010772043:mpeg21,1061,5637,53,2891,6,"*** Ten overstaan van Mr. JV. H. «EERTBKÜIA  Notaris te Groningen zullen op MISr'OSRACr den lGden Oecember (in plaats van VRIJDAG den 19den December 1856) des avonds te 7 uur ten Huize van den Kastelein TIDDENS in de Korenbeurs te Groningen publiek worden verkocht : « I. Eene roijale HEEREK it BKHVIKISi« met fraaijen ga. __Stk TUIN daarachter en ruime 80--m VENWONING met VRIJEN OP- hunrd ordenden WOONKELDER staande en gelegen Westzijde in de Pelsterstraat te Groningen lett. F no. 78 door Mevrouw de Weduwe VERSCHUIR in eigendom bewoond. 11. Een PAKHUIS met ruime ZOLDERS en STALLING  staande ten Noorden van het voorgaande Perceel lett. T no. 79 thans door de Gebroeders CATZ in huur gebruikt wordende. 111. Een KOETSHUIS met STALLING en BOYENWONING en met OPEN PLAATSJE daarachter staande Westzijde in de Pelsterstraat te Groningen lett. F no. 76. IV. Eene groote HEEREN BEHUIZING hebbende BOYENWONING met VRIJEN OPGANG  OPEN PLAATS en afzonderlijk SCHOOLGEBOUW daarachter MANDEELIGEN GANG ten Zuiden en uitgang in de Butjesstraat staande in de Oude Ebbingestraat te Groningen  lett. A no. 79  door den Heer H. LOFVERS MEIJER in eigendom bewoond. Alles te aanvaarden den lsten Mei 1857. Te bezien Perceel I II en 111 daags vóór den Verkoopdag van 10—12 en van 2-4 uur; Perceel IV vóór en op den Verkoopdag van 10—2 uur; en een en ander op Bewijzen VAN Toegano ten Kantore van den Notaris verkrijgbaar. . J. H. GEERTSEMA C.z. *** Ten overstaan van Mr. J. W. Q.UISJTUS Notaris te Groningen zullen op MAANDAG den 15den December 1856 des avonds te 5 uur ten Huize van den Kastelein R. ABELS te Haren publiek worden verkocht: *&:____ l- Eene HEHUIBSISTCJ  get. B 183 be- ÉfiiM staande uit twee WONINGEN met grooten TUIN JBLjBj er achter staande en gelegen aan de Westzijde van de straat te Haren door J. H. van OOSTEN in eigendom bewoond. H. Ongeveer 10* Bunders HOOILAND de OSSEBRINKEN genoemd  gelegen te Haren ; in twee gedeelten. Om te aanvaarden Perceel 1 op den lsten Mei 1857 en Perceel 2 dadelijk na den toeslag. *** Mr. C. HAHTRAST RUSRASTST  Notaris te Sappemeer zal op VRIJDAG den oden December 1856 ten Huize van B. van der HUIZEN Kastelein te Kiel- Windeweer publiek te koop presenteren : _gto%ttft-?m L Een H*llB en EHE  groot 6w2ia* * 9 R.  70 E.: staande en gelegen aan den Zwartenweg te Kiel- WindeiTT^r^ —""-—=** weer  Oostkant. 11. Eene Plaats LAND groot 4 8. 94 R. mede aldaar gelegen en 111. Eene Plaats LAND  groot 3 B.  28 R. gelegen aan de Kalkwyk Westkant alles onder de Gemeente Hoogezand; m eigendom bezeten bij de Erven van wijlen CHRISTIAAN C. BOER en CONS. In de maand JANUARIJ 1857  tijd en plaats nader te bepalen zal er ten verzoeke van P. N NANNINGA en CONSS. publiek worden verkocht  in perceelen: .** Eene BOEREN BEHUIZING met de VASTE EN IN ALLE LINIRN VERERVENDE BEKLEMMING """"""—^""""' van pi. m. 44 Bunders Binnen- Uiterd\jks- en Polderland met Kwelder en Aanwas staande en gelegen te Uithuizen  en gedeeltelijk te Uithuistermeeden. Mr. A. H. WERUMEUS BUNING Adv. en NoU.",http://resolver.kb.nl/resolve?urn=ddd:010772043:mpeg21:a0006:ocr,4,ddd:010772043:mpeg21:p004,Groninger courant,1008
11480248,1856/04/25 00:00:00,4342,ddd:010788637:mpeg21:a0020,http://imageviewer.kb.nl/ImagingService/imagingService?id=ddd:010788637:mpeg21:p008:image&x=107&y=32&w=2644&h=4342,ddd:010788637:mpeg21,2751,4374,107,32,8,"t~ ._ ____ ........ ■ . ■- ___..._________________________________>> Bedrag van den aanslag GEBOORTE- Dagtee- in e.lke belasting afzonderlijk Gemeentewaar ïa kenin"" inbegrip der rijksopcenten. | NAMEN. VOORNAMEN. Woonplaats ■ der ___. . de aanslag heeft g naturali- . S '__„_______ Satie* Grond- Person. Paten- T. ~ plaatsgehad. -3 plaats. dagteekenmg. belasting belasting ten. lotßaU **"" 54 Haersolte van Johan Cbristiaan baron Zwolle Zwolle 9 Julij 1809 f 9.275 f 9.275 Avereest Haerst van 0.055 0.055 Nieuwleuzen 13.24 13.24 IJsselmuiden 68.99 163.36 232.35 Zwolle 184.595 114.01 298.605 Zwollerkerspel. 276.155 ""277.37 553.525 55Nagell Jan Arend baron van Zwolle Vollenhove 7 Julij 1807 129.24 422.70 551.94 Zwolle. 56Scheuer Johannes Bernardus Zwolle Koevorden 4 Oct. 1807 112.70 277.80 f 152.32 542.82 Zwolle. 57Lamsweerde mr.Franciscus Wilhel-Zwolle Zutphen 11 Nov. 1798 162.62 162.62 Dalfsen mus Johannes Arnol- 16.40 16.40 Heino dus baron van 79.61 201.84 181.45 Zwolle 80.33 80.33 Zwollerkerspel. 338.96 201.84 540.80 58 Eindhoven Lambert Zwolle Zuidveen 23 Julij 1781 214.26 174.84 143.36 532.46 Zwolle 0.28 ■-_ _ - 0.28 Zwollerkerspel.' 214.54 _ 174.-84' 143.3G_ 532.7?~ 59;Lamberts Nicolaas Antonius Deventer Deventer 22 Maart 1783 37.91 .-.84.48 .;10.24 -.132.63.. Deventer 390.155"" "" 5.89.' _____ ï. 3ÜC.OP Kaalte. \  • ':--428.065 ;r-90a7-» . -10.24: -V' 60Helmieh Johannes Bernardus Zwolle Zwolle 4 Jan. 1792 120.86 l[ ""' 341.00 Zwolle - Wm* -■■■„■ "" £jgs_j 304.651 ■.:17^<5) ■.-;■ .-525.396 61 Houck mr. Maurits Ernst Deventer Arnhem 1 Aug. 1790 1852 3C:54 : ~~~:: 36.54 Bailimen 77.51- 124.32'- 83.20' 285.03 Deventer 9-80 V 9.80 Diepenveen ï(Mm ';l Ifi' tómvoTq .ad lm 16f» iioi.-eh- "" 71.yi. i9bno .rsmmedeJ 031 riftgii Baalte.: __ _____ . . ■;.... i... fKi ot fn. — !_v-i. -.f. ' ~ "". .- ) e.s;l____ 124.32 ~83.20. 505.98: 62 Helmich- mr. Arnoldus Johannes Zwolle Zwolle 29Aug.1784 1.905 ; .. \ - i.>jt»a 4vercest »» «mnba w tiss a Wilsurn '*»;#*« *0 nav ïrrnj .udjft i„ Ji88.0'7-. Zulk ■ ' - -i '<\7&.M''>s4&M fieefib ob *i5L815.22-'Z*olle 139.89 5 .lebnA-- •::!-139.895 Zwollerkerspel. .3T34T47- -1-40:88- -— 505.35 63Kriimer Mathieu Joseph Victor Zwolle Aken 15 Aug. 1799 37.78 166.02 291.97 ~ 495.77 Zwolle.' * —- • ■■. —- ■■ - '' '~ ■ j . - ' 64Visscher Willem Zwolle Zwolle 10 Oct. 1785 8.34 ö\ 8.34 Dalfsen 37.07 37.07 Heino 5.68 5.68 Raalte 12.725 12.72 5 Wijhe 57.42 62.70 271.36 391.48 Zwolle 33.725 33.725 Zwollerkerspel. 154.96 62.70 271.36 489-OT 65Dedem mr. Coenraad Willem Nieuwleu- Zwolle 30Julij 1811 11.815 11.815 Avereest baron van sen 24.28 24.28 Dalfsen 145.28 156.84 58.75 . 5G0.87 Nieuwleusen 85.885 85.885 Staphorst 351-5 3.515 Zwollerkerspel. 270.775 156.84 58.75 486.3-65 66Ketten Franciscus Justus van Dalfsen Zwolle 15 April 1787  271.83 133.13 404.96 Dalfsen 'der 78.87; r 78.83' Kampen. 350.70 133.13 483.83"" 67Cate Lambertus ten . Enschede Enschede 16 Mei 1796 24.12 '5 Al .-f rï =-"" : 24.12 Denekamp 49.92 122.22-15744; -..32 9.58; Enschede 33.85 : 33v35' Haaksborgen. 8.45 5.57 -. -;. 1.4.02  Lonneker 0.78 ~ 0.78 Tubbei-gen. 17.465 17.465 Eibergen 62.74 6274 .Winterswijk.' 196.82:5 '127.V9' 157.44 482.05-5 68 Berkhout jhr. Jan Willem Hen-Deventer Vollenhove 14 Julij 1797 - 41.71 246.48 ~~ 28819 Deventer drik Teding van 52.69 - 52.69 I.lss'eltu.uidcn 55.58 ■ 55.58 Wijhe 79.715 79715 Zwollerkerspel- J 229.695 216.48 476175 69 VosvanSteenwijkHenri baron de Zwoller- Nice 18Jan 1812 158.835 158.835 Homo kerspel 69.43 239.12 308.55 Zwollerkerspel~22B.26s 239.12~ ~467~385 70Schlingemann Coenraad Willem Zwolle Zwolle 6 Sept. 1778 58.49 58.49 Kampen 89.34 89.34 Wijhe 77.82 183.72 261.54 Zwolle 55.485 55.485 Zwollerkerspel-281.135 183.72  464.855 i. Gelasten dezelve te doen plaatsen in der Nederlandsche Staats-courant en'm de Provinciale Overijsselsche en Zwolsche Courant wordende ter kennis ""** de ingezetenen gebragt dat de bezwaren die men zou meenen tegen deze lijst te kunnen inbrengen vóór den 15den Mei aanstaande bij v zoekschrift door de noodige bewijsstukken gestaafd bij Gedeputeerde Staten moeten worden ingediend. Gegeven te Zwolle den 16den April 1856. De Gedeputeerde Staten voornoemd C. Backer  Voorzitter. J. M. va:ï Rhijx Griffier. TE 'S GRAVENHAGE TER ALGEMEENE LANDS-DRUKKERIJ.",http://resolver.kb.nl/resolve?urn=ddd:010788637:mpeg21:a0020:ocr,8,ddd:010788637:mpeg21:p008,Nederlandsche staatscourant,2644
3580524,1856/01/30 00:00:00,3483,ddd:011060013:mpeg21:a0007,http://imageviewer.kb.nl/ImagingService/imagingService?id=ddd:011060013:mpeg21:p002:image&x=2158&y=112&w=1028&h=3483,ddd:011060013:mpeg21,3186,3595,2158,112,4,VENDUTIE Op Dingsdag den \2den Februari} 1856 Voor het woonhuis van E. Martens van een welgeconditionneerden Inboedel waarbij Gepolitoerde Mahonyhouten Meubelen fraaije Spiegels en Schilderijen  Banken  enz. ' (37) • MARTENS & CO. ■■■ ■ - — ■ i ■■ —... ■ . - n Nog zal op bovenstaande Vendutie verkocht worden een' Engelsche Vis*a-Vis met 4 groote hardloopende Wagen Paarden. (38) Evenzoo zal op bovenstaande vendutie verkocht worden. Een Piano van Collaiid & Collard expresse-1 ijk voor dit Jdimaat vervaardigd. (52) VENDUTIE. Op een nader te bepalen dag zal alhier bij publieke vendutie door de ondergeteekenden worden verkocht eene partij RONDHOUT aangebragt per het Amerikaansche schip Waterman bestaande in masten stengen en ligtere rondhouten of sparren. Nadere informatiën te bekomen bij (53) FRASER EATON & Co. Al degenen dia iets verschuldigd zijn aan H. C. GE UK EN Mr. Kleedermaker te Soerabaya worden verzocht hun debet binnen zes weken af to dragen aan en op kwitantie van de ondergeteekende als daartoe door den Raad van Justitie alhier gemagtigd zullende na dien termijn de pretentiën geregtelijk worden ingevorderd. Soerabaya G. P. GEUKEN 30 Januari) 1856. (49) geb. terpstra. Bij acte den 16den Januarij 1856 ten overstaan van den ondergeteekenden Notaris te Soerabaya verleden is tusschen Mejufvrouw .Marie Elza Martens en den Heer Dirk Mauritz Martens beiden to Soerabaija eene vennootschap aangegaan tot het drijven van handel in het algemeen onder de firma MARTENS 6b CO gevestigd te Soerabaija voor den tijd van twee jaren ingegaan met den eersten Januarij 1856 en waarvan beiden de handteekening hebben. EEKHOÜT Notaris. ■- - — — .... i.i Van af ultimo December 1855 heeft de firma E. Martexs opgehouden te bestaan voor de liquidatie zal als vroeger worden geteekend met bijvoeging in liquidatie. Dank zeggende voor de begunstiging tot dus verre genoten beveelt zich de ondergeteekende'voor onderstaande firma op nieuw aan. Soerabaya  (40) E. MARTENS. IQ Januarij 1856. - ; • . De zaken tot dus verre onder de firma E* Martens gedreven zullen van af 1° dezer door ons beiden voor gezamentlijke rekening onder de firma IVÏartens & CO worden gecontinueerd terwijl wij ons minzaam aanbevelen. Soerabaya  (39) E. MARTENS. 16 Januarij 1856. D. MAURITZ MARTENS. De Aanspreker C. LUFTING houdt zich onledig met het Graveren van uitstekende en instekende Letters. (31) Wordt verlangd voor de terugreis naar Nederland een geëxamineerd SCHEEPSDOCTER  zullende hem verleend worden vrije passage benevens verdere voordeelen nader te bepalen. Adres bij den uitgever dezes. (34),http://resolver.kb.nl/resolve?urn=ddd:011060013:mpeg21:a0007:ocr,2,ddd:011060013:mpeg21:p002,"De Oostpost : letterkundig, wetenschappelĳk en commercieel nieuws- en advertentieblad",1028
1418528,1856/07/01 00:00:00,1552,ddd:010078531:mpeg21:a0010,http://imageviewer.kb.nl/ImagingService/imagingService?id=ddd:010078531:mpeg21:p004:image&x=33&y=2467&w=914&h=1552,ddd:010078531:mpeg21,947,4019,33,2467,4,Zlbvettentiën. De Curator in de onbeheerde nalatenschap van wijlen den Heer DIRK WILLEM LÉON in leven boekhandelaar te 's Hertogenbosch heeft de eer alle bekende en onbekende Schuldeischcrs in dien boedel op te roepen tot het ontvangen der gelden  in die nalatenschap voorhanden en wel op Zaturdag den 12 Julij 1856  des morgens ten tien uur le 's Herlogenbosch in eene der zalen van het Koffijhuis  genaamd de Korenbeurs  bewoond door Mejufvrouw de Wed. van Vliet. MASMAN. Op een Dorp in Noordbra- S- «. _^_^-_Malt^a vraagt men een E^^ST K. li. J ufvrouw FFmßßy^fp van middelbaren leeftijd ter verzorging van 1 a 2 Kinderen. Voor nadere informalien vervoege men zich onder letter S aan bet Bureau dezer Courant. Brieven franco. Jfafrrtefe IJZERGIETERIJ & SMEDERIJ te Bergenopzoom Tegen vast werk a f 120 per dag worden verlangd twee BANK- en twee VUURWERKERS. „ Adres in Tcrsoon of franco Brieven aan den Heer A. Asseluehgs Fabriekant le Bergenopzoom^,http://resolver.kb.nl/resolve?urn=ddd:010078531:mpeg21:a0010:ocr,4,ddd:010078531:mpeg21:p004,De Noord-Brabanter : staat- en letterkundig dagblad,914
3771196,1856/06/17 00:00:00,2717,ddd:010584477:mpeg21:a0005,http://imageviewer.kb.nl/ImagingService/imagingService?id=ddd:010584477:mpeg21:p003:image&x=110&y=2582&w=1388&h=2717,ddd:010584477:mpeg21,1498,5299,110,2582,4,Het PLAATSELIJK BESTUUR van SMALLINGERLAND  daartoe door Kerkvoogden der Hervormde gemeenten van Boornbergum en Kortehemmen uitgenoodigd roept bij dezen op de stemgeregtigde Floreenpligtigen in die Gea. Om in gecombineerde Vergadering te verschijnen in de Kerk te Boornbergum op Vrijdag den 27 Junij e. k.  des voormiddags ten tien uren ten einde: I°. in overweging te nemen een door Kerkvoogden te doen voorstel tot Vertimmering van de Pastorie te Boornbergum. 2°. bij aanneming van dat voorstel over te gaan tot de wijziging der Begrootingen van 1856. b. Die van Boornbergum aldaar op dien dag des voormiddags ten elf uren  ten einde: I°. op te nemen de Rekening van Kerkvoogden over 1855. 2°. vast te stellen de Begrooting over de dienst van 1857. c. Die van Kortehemmen in de Kerk te Kortehemmen op dien dag des middags ten 12 uren  ten einde : I°. op te nemen de Rekening van Kerkvoogden over 1855. 2°. vast te stellen de Begrooting voor de dienst van 1857. 3°. over te gaan tot de benoeming van eenen Kerkvoogd in die Gemeente in plaats van Hattam Alderts Zuiderhof overleden. Dragten Het Plaatselijk Bestuur voornoemd  den 14CJunij 1856. M. MANGER CATS. De Secretaris  F. S. REI DING. Op den 5 6 en 7 Mei 1856 op Ameland aan strand gespoeld zijnde tien tonnen TEER gemerkt P. L. B. en E. O. S. zoo wordt een ieder die vermeent daarop regt te hebben  uitgenoodigd dezelven te reclameren bij den Burgemeester van Ameland. De HKIRUT van SPANNEN SCHOONE TUIGPAARDEN en de HARDDRAVKRIJ met PAARDEN onder den MAN zullen te APPINGEDAM dit jaar wederom plaats hebben op den eersten Uonderdag in Juli) en alzoo op den derden dier maand. Namens Burgemeester en Wethouders  H. J. BEBINGH  Secretaris. Aan de belanghebbenden wordt bekend gemaakt dat de Bolsivarder-Witmarsumer Vaart strekkende van af de Bolswarder-Makkumer Vaart bij Bolsward tot aan het Oosteinde van Hantjeterp bij Witmarsum  uithoofde der slatting te beginnen met Maandag den 23 Junij 1856 voor de Scheepvaart zal zijn AECSESK-ÖTEÏtf. Commissarissen uit de Gemeente-Besturen van Bols- Bolsward ward en Wonseradeel en Gecommitteerden uit de den 14 Junij 1856. Onderhoudpligtigen tot bevordering van voorschreven Slaltingswerk J. HAITSMA MULIER Voorzitter. Het DIJKS-BESTUUR van de Zeven Grietenijen en de Stad Sloten c. z. gedenkt bij geslotene briefjes aan te besteden: Het leSßen van eenen HOUTEN GRONDDUIKER onder de Haven der Tacozijl; waarvan het Bestek en de Voorwaarden van af den 23 Junij 1856 ter lezing zullen leggen in de Logementen: de YVildeman in de Lemmer de »»ijnl»erg te Sneek en liet Post Huis te Heerenveen terwijl de briefjes vóór den Jylij daaraanvolgende moeten worden ingeleverd ter Secretarie van opgemeld Dijks-Bestuur in de Lemmer. Het Dijks-Bestuur voornoemd W. van ANDRINGA de KEMPENAER. Ter ordonnantie van Hetzelve WAUBERT de PUISEAU Secr. AANBESTEDING. POLDERBESTUURDERS van de Noorder-Stavorensche Meer  zijn voornemens  op Zaturdag den 28 Junij e. k. des namiddags 2 ure aan het Molenhuis bij den Molen  aan te besteden: Het maken en leveren van één NIEUWE SCHROEF in den Molen van genoemden Polder; waarvan de Voorwaarden ter inzage liggen bij L. KEETELAAR te Workum on bij D. J. de BOER aan den Molen bij laatstgenoemde tevens inlichtingen te bekomen. AANBESTEDING. DE VOOGDEN van het NIEUWE STADS-WEES HUIS te Leeuwarden gedenken aan de minstinschrijvenden aan te besteden  de levering van : RUNDVLEESCH RUNDERVET WITTE KOOL KOOLRAPEN WOR-,http://resolver.kb.nl/resolve?urn=ddd:010584477:mpeg21:a0005:ocr,3,ddd:010584477:mpeg21:p003,Leeuwarder courant,1388
32256,1856/02/02 00:00:00,64,ddd:010251365:mpeg21:a0018,http://imageviewer.kb.nl/ImagingService/imagingService?id=ddd:010251365:mpeg21:p004:image&x=2161&y=801&w=504&h=64,ddd:010251365:mpeg21,2665,865,2161,801,4,Advertentien.,http://resolver.kb.nl/resolve?urn=ddd:010251365:mpeg21:a0018:ocr,4,ddd:010251365:mpeg21:p004,De Tĳd : godsdienstig-staatkundig dagblad,504
50160,1856/10/14 00:00:00,60,ddd:000012777:mpeg21:a0019,http://imageviewer.kb.nl/ImagingService/imagingService?id=ddd:000012777:mpeg21:p003:image&x=2222&y=71&w=836&h=60,ddd:000012777:mpeg21,3058,131,2222,71,4,AD V E RT E JS 'T I E IV.,http://resolver.kb.nl/resolve?urn=ddd:000012777:mpeg21:a0019:ocr,3,ddd:000012777:mpeg21:p003,"Provinciale Overĳsselsche en Zwolsche courant : staats-, handels-, nieuws- en advertentieblad",836
3625782,1856/10/21 00:00:00,3246,ddd:010086756:mpeg21:a0032,http://imageviewer.kb.nl/ImagingService/imagingService?id=ddd:010086756:mpeg21:p008:image&x=50&y=2138&w=1117&h=3246,ddd:010086756:mpeg21,1167,5384,50,2138,8,; STEKEBAKKERS. Tegen primo Maart 1857 VRAAGT MEN een BEKWAMEN KNECHT tot het BALLETJES of STEKEBAKKEN. Adres Franco onder Lett. A. Z. Bnreau Handelsblad. (17480) T-Ta n u f a g t u r e n. lEMAND met het Manufactuurvak bekend solide relatiën bezittende kan tegen goede Provisie een HUIS VERTEGENWOORDIGEN bestaande in COURANTE ARTIKELEN; geene zullen in aanmerking komen dan die welke bewijzen van gedrag en eerlijkheid kunnen overleggen. Reflecterenden adresseren zich onder -Lett. A. A. bij den Boekhandelaar B. EISENDRATH. O. Z. Voorburgwal bij de Halsteeg. (17377) RIIII € Ë M. Een MAN van gevestigden leeftijd Hollander van geboorte bekend met vreemde Talen en in den Handel in het algemeen ervaren biedt Eich aan als REIZIGER onverschillig in welk Vak. Adres Lett. K.M. franco bij den Boekh. G. D.BOM Amsterdam Damrak H 117. (17615) Eene Fatsoenlijke WEDUWE P- G. middelbaren leeftijd zag zich gaarne geplaatst als KRAAMBE WAARSTER HUISHOUDSTER bij ( een eenig Heer of Dame HUISBEW AARDSTER of tot Adsistentie eener Ziekelijke Dame. Tevens voor haren ZOON met de Fransche en Engelsche Talen bekend eene goede hand Schrijvende eene BETREKKING zoekende op een KANTOOR of in eenige andere ZAAK hier of elders. Hierop reflecterenden gelieven zich met Franco Brieven te adresseren onder Lett. H. bij den Boekh. A. VAN STARRENBURG Brouwersgracht bij de Prinsengracht. (17557) Carl üaclitlgall CHEMIST en POTOGRAAPH uit BERLIJN maakt bij deze aan het Kunstminnend Amsterdamseh Publiek bekend dat hij op heden zijn PHOTOGRAPHISCH ATELIER geopend heeft en er dagelijks ten zijnent gelegenheid bestaat tot het vervaardigen van PORTRETTEN. Het onnoodig achtende zijnen arbeid aan te prijzen  daar de reeds door hem vervaardigde Portretten enz. genoegzame aanbeveling voor zijnen arbeid zijn zoo noodigt hij alle Kunstkenners uit zijne werkzaamheden in de Photographie te komen bezigtigen. Ook bestaat er onder zeer aannemelijke voorwaarden gelegenheid voor HH. Liefhebbers en diegenen welke deze Kunst wenschen te leeren de Dagelijksche CURSUS in de CHEMIE en PHOTOGRAPHIE bij te wonen. Adres: PRINSENGRACHT bij de Weteringstraat BB 410. (17605) NIVELLEER OF WATERPAS-INSTRIIENTEN volgens de nieuwste en doelmatigste constructie allernaauwkeurigst bewerkt» zijn steeds voorhanden bij Th. FINGER  (17657) Mechanicus te Utrecht. TURFMANDEN van ƒ 1.75 1.90 2.10 en 2.40. Zeer net bewerkte rustique TURFKISTEN. Engelsche fijn gepolijste Stalen en Koperen HAARDSTELLEN van ƒ4.50 ƒ 5 ƒ6 ƒ 7 ƒB ƒ 11 en hooger. BLAASBALGEN en HAARDSTOFFERS LAMPENKAPPEN in alle prijzen en modellen echte Engolsehe TAFEL- en DESSERTMESSEN met Hoornen en Ivoren Hechten tot zeer billijke prijzen. GEBROEDERS DE HAAN ' (17670) Kalversiraat Ide huis van de St. Luciensteeg. BAARDEN- IN KAGCHELFABRIEK. Bij den Ondergeteekende zijn voorhanden alle soorten van HAARDEN en KAGCHELS alsook Engelsche insluitende HAAR- ' DEN fijne en ordinaire Engelsche HAARDSTELLEN TURF- en ' KOLENBAKKEN enz. enz. (17644) B. MCIJDERMAN. NIEUWE OORSPRONKELIJKE ROMANS. Bij J. M. E. MEIJER te Amsterdam zijn van de Pers gekomen en is alom verzonden: 1. JAGOBA VAN BEIJEREN. HISTORISCH ROMANTISCH TAFEREEL. Dooe J. J. LAMBRECHTS. Met fraai gelithogr. Portret en Vignet. In een Deel compleet gr. B°. 'J 422 Bladz. Prijs ƒ 3.80. ] Wie kent haar niet die schoone ongelukkige Vorstin zeker de vermaardste Vrouw uit de Geschiedenis vau ons Vaderland. Zij werd gebo-  ren den 25sten Julij 1400 en overleed den Bsten October 1436 na tot vier malen gehuwd te zijn geweest. In bovenstaand Werk is haar levensloop naar waarheid in een Historisch-Romantiseh Verhaal geschetst en ver- c dient werkelijk in elk solied Leesgezelschap te worden opgenomen. il mmm en nevel ' * UIT HET LEVEN VAN EEN STUDENT. EEN VERHAAL UIT HET WERKELIJK LEVEN door E. B-ERIAU. g 1 Met fraai gelith. Vignet. In een Deel kompleet gr. 80. 394 Bladz. 't PRIJS ƒ3.70. -<Jlet is een zeer bocijend en belangwekkend Verhaal dat zoowel door - ï^fcfaren stijl als karakterschilderingen uitmunt. (16987) 1 S-l . 1,http://resolver.kb.nl/resolve?urn=ddd:010086756:mpeg21:a0032:ocr,8,ddd:010086756:mpeg21:p008,Algemeen Handelsblad,1117
1954275,1856/09/27 00:00:00,1775,ddd:010086732:mpeg21:a0025,http://imageviewer.kb.nl/ImagingService/imagingService?id=ddd:010086732:mpeg21:p004:image&x=1167&y=69&w=1101&h=1775,ddd:010086732:mpeg21,2268,1844,1167,69,6,fcecos-JMEP. DEZE 25EEP schuimt sterk reinigt oogenblikkelijk is bevorderlijk voor de gezondheid heelt schrampen en schavingen zeer spoedig zuivert en ontneemt alle scherpte aan de huid maakt haar zacht en blank en geeft haar een jeugdig frisschen tint. Men koopt een groot stuk voor 15 cents. Zij is ook verkieslijk boven andere Zeepen voor het wasschen van gekleurde Goederen en Zijden en Wollen Stoffen daar zij van eene zuiverder loog bereid de kleuren minder aandoet en de wol niet hard maakt. De goede echte soort die in het VERKOOPHUIS en de bekende Depots altijd kersversch te verkrijgen is heeft den naam H. KERCKHOFF zoowel op de Zeep als op het Etiquet. Zij onderscheidt zich bovendien van de nagemaakte soorten door zuivere doorschijnende kleur vaste bewerking minder scherpte en vettigheid. Om aan den wensch van eenigen onzer begunstigers te voldoen hebben wij ook de nagemaakte ordinaire COCOSZEEP in het Verkoophuis genomen en kost die bij ons maar 10 c. De consumenten zullen zich echter op het eerste gezigt overtuigen dat de echte voor 15 c. voordeeliger is ia alle opzigten. Brabanders Chocolade-Koekjes met worm-afdrijvende zelfstandigheden zijn uitmuntend in hunne werking en worden gaarne door de kinderen genomen. De Geneesheeren Beijek  Geekling  Hopman . en Fahkmeisteb hebben ze met het beste gevolg aangewend en spreken er met veel lof van. Zij kosten 40 cents het doosje. (16139 27/9 56) De SPOORWEGKAART zoo loffelijk aanbevolen in de Amsterd. Courant van Woensdag 24 dezer is te verkrijgen ad fl. 1.30 in Etui en fl. 1.20 in Plano bij den Uitgever Boekhandelaar WïLH. GÏLEF.RB Warrnoesstraat Hoek Oudenbrugsteeg M 474 te Amsterdam alsmede bij de voornaamste Boekhandelaren in het geheele Bijk. (16134)) GEMEUBILEERDE KAMERS TE HUUR. Tegen matigen Huurprijs gelegen in de Kalverstraat. Te bevragen bij den Boekhandelaar H. A. FRIJLINK Singel over de Driekoningstraat G 374 te Amsterdam. (16084) IpjfciFS GELEZEN HEBBENDE eene <iÉtfci*lmPi> ADVERTENTIE van 25 September van J&ÈÊÊÊmt$i üai Heer W* STRAATMAN  De'pfit- T^^^^S« houder van ERARB& PSANO?S op ie„*____m^^^_M_ Heerengracht naast de Handelmaatschappij fHjlliii^ __f_fflï&£_*lf zco wordt gemelde Heer W. STRAAT-JISE™! ËX&ïwSB&ÊlSr MAN en het geëerde Publiek en alle Mu-üllSßi ziekliefhebbers verzocht om op het MAGAZIJN vanCONSTANTIN DE PROÜW de PIANO'S van ERARD en de Correspondentiën van het Huis ERARD te komen bezigtigen. (16108),http://resolver.kb.nl/resolve?urn=ddd:010086732:mpeg21:a0025:ocr,4,ddd:010086732:mpeg21:p004,Algemeen Handelsblad,1101
2122456,1856/02/09 00:00:00,2114,ddd:010980334:mpeg21:a0016,http://imageviewer.kb.nl/ImagingService/imagingService?id=ddd:010980334:mpeg21:p004:image&x=1065&y=67&w=1004&h=2114,ddd:010980334:mpeg21,2069,2181,1065,67,4,"Met overleg van de DIRECTIE zal W op aanstaanden Dingsdag den 12 dezer ter gelegenheid van de Feestelijke Opening van den Rhijnspoorweg van Arnhem naar Emmerik de KOFFIJKAMER op het STATION voor het Publiek GESLOTEN zijn. De REIZIGERS zullen zich evenwel in de ""Wachtkamers van de noodige Ververschingcn kunnen voorzien De Restaurateur o =•  ™ g/- L VAN DIJKSHOORN. 8 Februari] 1856. J •' lïiiniiiißir der COMMISSIE ter Bevordering van het Onderkoelt naar de Werae.Mjntelen on den Oceaan  op HEDEN den 9 FEBRUARIJ 1850 des avonds ten 8 ure  in het Verenigingsgebouw der Koninklijke Ifederlandsche Tachtclub te Rotterdam. Heeren REEDERS GEZAGVOERDERS en STUURLIEDEN en verder allen die in de Zeevaart belang stellen  worden uitgenoodigd tot de bijwoning dezer I MiBGAKtEBIXG . waarin de Uitreiking zal plaats hebben der uitgeloofde Medaille  voor den besten Diepzee-Koker. De Commissie voornoemd  JOOST VAN VOLLENHOVEN Voorzitter. J. P. A. FRANQOIS Lid en Secretaris. V De INZENDERS van ANTWOORDEN op de Prijsvraag betreffende BMEPZ EE - KOKEBS uitgeschreven door de Commissie ter Bevordering van het Onderzoek naar de Verschijnselen op den Oceaan worden uitgenoodigd de OPENBARE VERGADERING op Zaturdag 9 Febrnarij 1856 BIJ TE WONEN. Namens de Commissie  J. P. A. FRANQOIS Lid en Secr.s Conservatie der Oogcn. De Gezigtkundige B. A. REEDfS is dagelijks te spreken of te ontbieden ten zijnen Huize  Hoogstraat wijk 7 n.° 71. In het bijzonder maakt hij Ooglijders opmerkzaam op zijne Nieuwe AVONDRRILLEN welke door de grootste Oogartsen voor de beste gehouden worden alsmede eene Nieuw soort LORGNETS die bijzonder doelmatig zijn om er door te kunnen Lezen.",http://resolver.kb.nl/resolve?urn=ddd:010980334:mpeg21:a0016:ocr,4,ddd:010980334:mpeg21:p004,Rotterdamsche courant,1004
424434,1856/05/21 00:00:00,557,ddd:010113055:mpeg21:a0020,http://imageviewer.kb.nl/ImagingService/imagingService?id=ddd:010113055:mpeg21:p003:image&x=57&y=4657&w=762&h=557,ddd:010113055:mpeg21,819,5214,57,4657,4,"beloond 0- "" IÏT^_^_^—¦ Zuster. Hf'J- het af«fTele bewijzen van deelneming O- MoWh iu^ouw !""8n H*<* hartelijk geliefd Eamilie-Betr viuiB ik VJVÉ' Weduwe den Heer Rott*) *iogen . namens hare wederzijdsche 21 Mei 72' tn'Jn6n welmeenenden dank. S-iHl_ M. DTJVÉ _^e*Clrte~^-^___Wed^ J. VAK E-PBL. daaflrto?*^ deren welke*}?8. d^ dfe »J""* •»«»• *™™ ¦ moest *eiwL„e J»ng «h„ urfheid met mÜ»""' Kin- CO_NrT-D> 4 J*>n S«§» te beseften V_-„_AD bMlo7«iU» geliefde Echtgenoot «-A.au Kapitein ter Koop-",http://resolver.kb.nl/resolve?urn=ddd:010113055:mpeg21:a0020:ocr,3,ddd:010113055:mpeg21:p003,"Nieuwe Rotterdamsche courant : staats-, handels-, nieuws- en advertentieblad",762
5332758,1856/08/05 00:00:00,4606,MMKB08:000070619:mpeg21:a0009,http://imageviewer.kb.nl/ImagingService/imagingService?id=MMKB08:000070619:mpeg21:p002:image&x=2340&y=823&w=1100&h=4606,MMKB08:000070619:mpeg21,3440,5429,2340,823,2,"Advertentie JJURGEMEESTER en WETHOUDERS van DELFT daartoe door den Gemeenteraad gemagtigd noodigen een iegelijk daartoe genegen uit tot deelneming bij Inschrijving in eene NEGOTIATIE ten bedrage van ƒ50000— op de Voorwaarden die dagelijks ter inzage op de Secretarie gereed liggen. De Inschrijvingsbiljetten zullen worden ontvangen in eene geslotene Bus ter Raadkamer op Vrijdag den 8 Augustus 1856 des voormiddags tusschen 10 en 12 ure om onmiddelijk daarna in het openbaar te worden geopend. Deift  29 Julij 1856. De Secretaris De Burgemeester  J. J. MOLENBROEK l.S. VAN KUYK. Brood Prijzen in te gaan met Dingsdag 5 Augustus 1856. Bruin Brood per Ned. pond 27Cts. Ongebuild Tarwe Brood. . » 22 « Erop Brood (zoo als't gemalen wordt)"" "" 19"" Rogge Brood >> » 12 "" Tarwe Bloem per Kop 19 "" Tarwe Meel ..... per Ned. pond 25 * Dei.ft  5 Augustus 1856. N. DE BOOY. Schiedamsche ^STOOMBOOT VEREEMGIXG TUSSCHEN SCHIEDAM EN LONDEN voor Passagiers Goederen en Vee. Het Nieuw gebouwd en welingerigt Nederlandsch STOOMSCHIP SCHIEDAM Kapitein G. S. ZEEMAN zal van Schiedam naar Londen vertrekken Donderdag den 7 Augustus 1856 des morgens ten 3 ure. Nadere informatien zijn te bekomen ten Kantore van SEEUWEN & C"". 'Cargadoors te SCHIEDAM en ROTTERDAM. De bekende Nederlandsche Snelzeilende Clipper KOSMOPOLIET ( Kapitein J. BOUTEN  die op zijne jongste reis van Nederland naar Batavia in 76 dagen afgelegd bewezen heeft zelfs voor den Engelschen Stoomclipper the Royal Charter niet onder te doen zal bij behouden te huis komst onmiddellijk weder zeilvaardig gemaakt worden ten einde in September andermaal de Reis naar JAVA te kunnen aanvangen. Die van deze gelegenheid  welke in spoed met de Landmail weinig maar in kosten en ongemak veel verschilt wenschen gebruik te maken voor den overtogt of verzending van Goederen worden verzocht zich in tijds aan te melden bij de HH. VISSER & VAN DER SANDE te Dordrecht KUYPER VAN DAM & SMEER te Rotterdam  J. DANIELS & ZOON & ARBMAN te Amsterdam  en VRIESENDORP & GAADE te 's Hage alwaar Teekeningen van de Inrigting voorhanden zijn. MEN VRAAGT Een Kindermeisje van de Prot. Godsdienst niet beneden de 14 jaar. Men vervoege zich aan het Bureau dezer Courant. PIET KEMPE Zandschipper op Amsterdam heeft acht jaren 200 erg aan rheuinathiek geleden dat hij amper op dc beenen kon komen cn is nu zoo rad dat hij wel over een tafel springen kan. Hij is dooreen GOLDBERGERSCHENKETTING daarvan genezen dien hij 100 in waarde houdt »dat hij liever zijn vaartuig als dat ding missen wou indien er niet ineer te loop waren."" Door een zijner vrienden heefl hij ons zijne tevredenheid doen boodschappen. Amsterdam  15 Julij 1856. VERKOOPHUIS. Alle rheumatischc ziekten verlammingen gewrichtspijn  hoofdpijn  oorpijn  kiespijn  maagkramp  krampkolijk  tramp in de borat en in de kuiten knubheljicht verstijving ii» de leden aangezigtspijn zenuwziekten worden zeker en spoedig door GOLDBERGER'S KETTINGEN genezen. Zij kosten ƒ.1.80—2.70—3.60—5.40. Amsterdam Verkoophuis. Delft J. T. Wagner. Maassluis P. Poortman. Schiedam E. van Bart. Schiedam M. J. de Lange. En in de bekende Depóts im de andere Steden.",http://resolver.kb.nl/resolve?urn=MMKB08:000070619:mpeg21:a0009:ocr,2,MMKB08:000070619:mpeg21:p002,Delftsche courant,1100
1322892,1856/03/08 00:00:00,1361,ddd:010482906:mpeg21:a0004,http://imageviewer.kb.nl/ImagingService/imagingService?id=ddd:010482906:mpeg21:p001:image&x=1116&y=894&w=972&h=1361,ddd:010482906:mpeg21,2088,2255,1116,894,6,Vendutien. Maandag 10 Maart voor het sterfhuis van wijlen den Chinees Khouw Oe op Jacatra. Dingadng 11 Maart voor het commissiehuis van van Slooten Morgan <ƒ• Co. Woensdag 12 Maart voor het commissiehuis van B. J. Leon. Donderdag 13 Maart ten huiie van mevrouw de wed. Wegener door gebr. Roselje d/- Co. Vrijdag 14 Maart voor het commissiehuis van Abeelen Dennison f Co. Oproeping van Crediteuren. In de Javasche Courant van heden worden opgeroepen de debiteuren en crediteuren in do navolgende boedels: Door het collegie van boedelmeesteren te Batavia: van wijlen den inlander Soemu en van wijlen rien inlander Mochamad Djoenij Adie ook genaamd Mochamat Joen Ai'jdir. Door de Gecommitteerden in Onchristen Sterfboedels te Tangerang : van den chinees Kwee Seng Vertrekkende Personen. W. S. M. tan Schmid. Aangekomen Vreemdelingen. Van 4 tot en met 6 Maart 1856. ROTTERDAMSCII HOTEL. //. Lash  11. Waardenburg. HOTEL WILLEM 11. P. ff. / van g van de Reede. — J. E. ff. Jur.h C. B. P. Orly. HOTEL DER NEDERLANDEN. Thomson van Buitenzorg. Advertentien.,http://resolver.kb.nl/resolve?urn=ddd:010482906:mpeg21:a0004:ocr,1,ddd:010482906:mpeg21:p001,"Java-bode : nieuws, handels- en advertentieblad voor Nederlandsch-Indie",972
962247,1856/08/19 00:00:00,2243,ddd:011021829:mpeg21:a0016,http://imageviewer.kb.nl/ImagingService/imagingService?id=ddd:011021829:mpeg21:p004:image&x=919&y=581&w=429&h=2243,ddd:011021829:mpeg21,1348,2824,919,581,4,"! MWE1MTS I M/Dli W I 31 li B: li  'I JSXÏ33^0YC3i-^.lSri s-\ Kenen groolen nieuwen cii wenschclij- ' i  n v""orraai' ijzerwaren nicdegcbiagt (2 | j hebbende wilde ik c!e aandacht inroepen \s van hel volk van Sheboygan en ni'ordclijK Witcoiisin op den goedkoopeii winkel waar beste Koeleren zoo goedkoop verkocht \vort!cn als in eeiiigon winkel iu 1 dezen Slaat. Gij zult liier alles vinden \\ at lot ijzcrwa- Zak ca tafelmessen l lepels sloten hangsels. schroeven houwmansgpreed. schappen. schoppen zadelmakersbehoeften. spader . vorken liomveclon cradles cullivniors en cugen. gtoI' smid*. kuipers en timmermans liKUEKOSCIlAl'- l'l'.N in rille soorten. Glaswerk spijkers wagenassen 1JZ KR. enz. enz. g&ttiHcr en KcukctikagclH-ls O -TV i"" üroolo verscheidenheid en van do beste r ftfit All.anv modellen die zoo GOUDKOOP ALS |>K G O KI > K <>0 PSTK. N' zullen verkocht wori den. en waarvoer in allen opzigtc als zij voorgc~!cld zijnword iugcstain. Blik- Plaatijzer- en Kopenv.iren i voorhanden.of volgens bestelling gemaakt. *£T"" r-eel niet Lnicrtncc's I.Jzrric'rnhrl te bezoeken naast het IIriek liloel."" daar hij do meeste zijner goederen reglr sirceks van de fabriekante» koopi en do/.elve tegen ccn lagen prijs kan verkoopen. i jijt Hier wordt de i/ollandscho laai gespreken. . 295 tr F. LAWRENCE. ! la» lioopcrs en Vcrkoopcrs van Land. r De ondcrgetcekende beveelt zich hij vemicn wing in I de gunst zijner Landgcnootcn lol hel schrijven van • ) DKEDS MORTGAGES LAM) CONTRACTEN'. Door zijne olTiciüIe betrokking als Cirri; ran ilr t llrfjll»ml* iu Ui] iu Hluat uostvld Uo-leloos do verschil - 1 i lende registeis der County na te zien of de eigou j dommeii vrij en onbelast zijn—iels hetwelk voor koopcr* van land eeiic zaak van veel tiewigi is. alvorens . : -/ij den koop sluiten. Mijn Kantoor is iu liet groote ••Brick Hui»"" twee trappen hoog. SiicBoTtus. J. QUIXTUS  lli April I855. Xolaris \ Ziinl:ic<iameiii?r. ( 7garen! Cigaren! A. F. KOBXBÜIC»; l /hfl: ran Je Achbtc Strant \ l'iniiii/lriiniii Arciw. . Heeft ei-no groote hoevecllieid uilmuiilclido ('itra< ren Viin eigen fabrikaat zoowel als gcimporlecrdc i die hij in 'l klein ol' bij de kuit tot lage prijzen ; wenrclit te verkoopen. Sheboygan £7 Ju lij I £53. 50 If isa.vk. of «iïï:iïov(;a\. lïi-7.0 inslellinjr uil van ntf nnnslaimden Mantidn'j L-eopeiid riiu. tot liet tlilocfcMcn vuil een ubrcluecu ■ 1IA.N IvlERS- en WJSSKI.KANTOOR. J'ii;i . : i . ui-N: U'. \Y. King. Van E|.s Young. Warren Smilii ('lias. T. Moore. Wanen IIdl. Win. R. 1 Gorsline Godfrev Sl'-mm en J. F. Kirkl ind. Shebovgnu. ' VV. W. KING l're-idcnl I l'J Mant 1855. VAN EPS YOING. \ ice Tics. F. It. TOWNSEXD Kassier. r sorr?-'ttOTTw. ' I Verkoopt en repareert allerhande soorten van i KL o A' A' /: x. li o /.• o i. o <; /1: .v /: v i I UOUü- (• '/.111'EU II'/.'/{A'. . | Hij betaalt contant geld voor mul goud en zilver. •: iSj tf SIIEItOYCl.AN WIS. | HIEUW Mf CSV- Jb. 5S X«T r*5"" cllcwarcn Kruidcuicrswarcn Moudi behoeftcu en Ijzerwaren KI)WARD DÖIIING | aan Jen hoek der 8 Straat tn Pennsylvania j Avenue lcr/en overhel postkantoor. ( sur.nuYOAX. ïmscoxsrx.} 1 lieimede wordt bekend gemaoht. dat wij ouder ] boven vermelde tinna in het vroeger door Anable ; ! gebruikte lokaal c-enen winkel hebben geopend in ' j welken zoo wel /■iiiiltnuicers als f*l'Ht*li""lrii hunne!' I l'cliorftt'ii voor hl/in. Imtrn on rrht /fond on billijk j koope.n kunnen. I Van ELLEWAREN houden wij er sleclits goe- j ! de cii duurzame artikels op na en hebben een groot  i assortiment voorhanden. ( Huisvrouwen kunnen wij onze Suikers KolHj's | en Tbcc's teu beste aarbeviden; vooriiamclijk is on- ' j ze Thee van eene iiilslekcndc goe do hoedaiiiglicid. j | Haringen Sardclloii Zwitsersclio eu ilainburgsche kans enz zijn steeds voorbannen; '■ Cigaren Rook en l'ruim Tabak zijn ous rcgelrcgl uit hel zuiden aangevoerd. Ijzerwaren cu Werktuigen voor Ambachtslieden ' en l.andliouMeis. Wij bieden verder best Meel van Milwaukip aan. 'Jfi~ llrmirlcicijh Whishri (%n nuderc gccslriilto drunken ontbieden wij van do bebto liuizou. ülli tf. """,http://resolver.kb.nl/resolve?urn=ddd:011021829:mpeg21:a0016:ocr,4,ddd:011021829:mpeg21:p004,De Sheboygan Nieuwsbode,429
1315671,1856/01/02 00:00:00,1333,ddd:010482887:mpeg21:a0012,http://imageviewer.kb.nl/ImagingService/imagingService?id=ddd:010482887:mpeg21:p004:image&x=71&y=123&w=987&h=1333,ddd:010482887:mpeg21,1058,1456,71,123,6,Ooslenrijksche Lloyds Stoomvaart Maatschappij. Het vertrek der stoombooten dezer maatschappij van Alexandrië direct naar Triest is bepaald omstreeks den 6 en 21 van iedere maand na aankomst der passagiers van Indie en China. De reis wordt gewoonlijk volbriigt in minder dan 5 dagen en bestaat er geen oponthoud voor quarantaine. Passagiers die hunne passage hier bespreken betalen voor eene hut der eerst klasse ƒ 200— • • •» • tweede » t 138— Een zeker aantal hutten wordt steeds in reserve gehouden ten gerieve van passagiers van Java die langs dezen weg naar Europa vertrekken. (477) MACLAINE WATSON & Co. Batavia i Maart 1855. Jl Naar Samaraug en Soerabaya -j\ wordt passage aangeboden met het Ned. bark- U2JT schip Provincie Drenthe. kapitein ü. i^&Beckering voerende een geëxamineerden doctor om in het laatst der volgende week naar eerstgenoemde plaats te vertrekken en zich aldaar slechts eenige dagen op te houden. Adres bij den gezagvoerder voornoemd in het Java Hotel en bij de Agenten alhier (2560) TIEDEMAN £- VAN DER BURG. Batavia  29 December 1855.,http://resolver.kb.nl/resolve?urn=ddd:010482887:mpeg21:a0012:ocr,4,ddd:010482887:mpeg21:p004,"Java-bode : nieuws, handels- en advertentieblad voor Nederlandsch-Indie",987
1106190,1856/12/30 00:00:00,510,ddd:010086825:mpeg21:a0028,http://imageviewer.kb.nl/ImagingService/imagingService?id=ddd:010086825:mpeg21:p004:image&x=69&y=4854&w=2169&h=510,ddd:010086825:mpeg21,2238,5364,69,4854,4,Boor een aantal Afbeeldingen opgebelderd. PACÜETVAAI-T van LONDEN naar de KAAP DE GOEDE HOOP MAURITIUS POINT-DE-GALLE (CEYLON) MADRAS en CALCUTTA. De Dienst zal verrigt worden door ACHT PRACHTIGE voor die Vaart expresselijk gebouwde STOOMSCHEPEN van uitgezochten bouw en groot Stoomvermogen die alles in zich vereenigen wat de veiligheid den spoed en het comfort der Reizigers bevorderlijk kan zijn. Het vertrek waarvan de punctualiteit gewaarborgd is doordien deze Schepen tevens met den overvoer van Hr. B. Ms. Brieven-Mail belast zijn is bepaald van LONDEN den lsten en van DARTMOUTH den 6den van elke maand. Voor verdere Informatiën gelieve men zich te adresseren bij VV. S. LINDSAY & C°.  8 Austin Friars 54| Old Broadstreet te Londen. * (20884) en HUDIG fc BLOKHUYZEN te Rotterdam.,http://resolver.kb.nl/resolve?urn=ddd:010086825:mpeg21:a0028:ocr,4,ddd:010086825:mpeg21:p004,Algemeen Handelsblad,2169
2216004,1856/10/13 00:00:00,2294,ddd:010544914:mpeg21:a0031,http://imageviewer.kb.nl/ImagingService/imagingService?id=ddd:010544914:mpeg21:p006:image&x=50&y=65&w=966&h=2294,ddd:010544914:mpeg21,1016,2359,50,65,6,"••* HAARLEMMER - MEER. VERKOOPING om contant geld op Donderdag den 16d-n October 1856 des voormiddags ten elf ure aan de Ringvaart bij het Stoomwcrktuig de Lynden ten overstaan van den Deurwaarder S. J. HOEKSTRA van eene aanzienlijke partij BEZAAGDE en ONBEZAAGDE HOUTWAREN bestaande in: 300 Dennen Platen grootendeels lang 7 El breed 40 a5O Duim en dik 7 Duim ; 50 a 60 Vuren Balken lang van 2 tot 9 El zwaar 25 a3O Duim; ruim 20 bezaagde Gordingen lang 6 a 7 El zwaar 20 a 25 Duim; 120 Greenen Heimasten grootendeels lang p. m. 13 El ongeveer 250 zware IJzeren Bouten; benevens eene partij Amsterdamsche Steigeraarde; de Goederen zullen minstens twee dagen voor de Verkooping behoorlijk genommerd voor een ieder te zien zijn. *7*~ VERKOOPIIV» VAW-I]ITMIL\TE\DE UITERWAARDEN. Mr. W. J. C. PUTMAN CRAMER Notaris te Zutphen zal op Donderdag 23 October 1856 des voormiddags om 10 ure ten huize van Mejufvrouw de Wed0. Swartjes in het Nederlandsche Koffijhuis aan de Markt te Zutphen doen inzetten en op Donderdag 6 November 1856 terzelfder uur en plaats finaal Verkoopen: De ITITERWAARnS WEILA VBE-V  BE AUIBTMAXStVALARBEX genaamd onmiddelijk aan elkander gelegen aan de Rivier den IJssel en den Veerweg van Brummen naar Bronkhorst onder de Gemeente Brummen te zamen groot 22 Bunders 27 Roeden 30 Ellen door derzelver ligging tevens uitstekend geschikt tot aanleg eener Houtwal of Stapelplaats en zulks in zoodanige 3 Percelen Onder- Massa en Massa als op de gedrukte Biljetten breeder is omschreven. De aanwijzing dezer Goederen zal geschieden door B. BELTMAN Bode van het Gemeente-Bestuur te Brommen  terwijl nadere informatien op franco aanvrage ten Kantore van genoemden Notaris PUTMAN CRAMER te bekomen zijn. •#* BELA_tX.RI.9KE _-UI-HVEKKOUPI_G te (MIDDELBURG op Maandag den 20ste"" October 1856 en volgende dagen zullen de Boekverkoopers Van BENTHEM & JUTTING te Middelburg Veilen : Twee belangrijk e verzamelingen HOEKESf waaronder vele voorname Werken over Godgeleerdheid Kerkgeschiedenis Regtsgeleerdheid Staatkunde Genees- Natuur- en Wiskunde Kunsten en Wetenschappen Algemeene en Vaderlandsche Geschiedenis  Reis- en Plaatsbeschrijving  Dichtkunde Romans Grieksche en Latijnsche Klassieken Taalkunde enz. Voorts Muzijkwerken Kaarten Prenten Prentwerken Gedenkpenpenningen Munten  Liefhebberijen en Boekenkassen. De Catalogus is verzonden en zoo lang de voorraad strekt op franco aanvrage franco door genoemd Verkoopers te bekomen.",http://resolver.kb.nl/resolve?urn=ddd:010544914:mpeg21:a0031:ocr,6,ddd:010544914:mpeg21:p006,Opregte Haarlemsche Courant,966
2894320,1861/09/02 00:00:00,2783,ddd:011060925:mpeg21:a0002,http://imageviewer.kb.nl/ImagingService/imagingService?id=ddd:011060925:mpeg21:p001:image&x=183&y=2587&w=1040&h=2783,ddd:011060925:mpeg21,1223,5370,183,2587,4,"Wordt bekend gemaakt dat op Vrijdag den Cden September a.s. ten Residentie bureele eene UITBESTEDING zal worden gebonden voor den overvoer van Onrust naar Paiang en Ttpanolie respectivelijk van 500 en 300 tonnen Mteeukolcu. De voorwaarden liggen ter inzage op gemeld bureau. Soirabat*  Namen» den Resident 23 Angtutut 1861. Le Secretaris (1338; C'ns. T»u.itP. Op Zaturdag den 7dcn September 1861 zal ten burele vsn den Resident van Soerabaija EENE UITBESTEDING worden gehouden voor den orervoer van f 1.13 Aliiks' van Boenga naar Citrhon. De voorwaarden dezer uitbesteding liggen 0{) gemeld bureau ter inzage. ■'■■'■ Soekabaya Namens den Resident. ■'.■ 19 Augustus 1861. De Assittent Resident .. (1274) W. lIAPPE. Vfoidt bekend gemaakt dat op Woensdag den Uden September a. s. ten 10 ure des voor. middags ten residentie burele eene UITBESTEDING aal worden gehouden voor het was?cheu van de kleeding der dwangarbeiders en andere personen ter verpleging opgenomen in het sttdaverband alhier. De voorwaarden liggen ter inzage op gemeld bureau. SoERABAYA NAMENS DEN' RESIDENT den 2lslen Augustus 1861. De Admtent Resident Q313) w. BCAJrPiF»:^; Met referte a an de advertentie dd. 15 Julij jl. opgenomen in de Javascki Courant van den 31 sten daaraanvolgende No. 61 maakt de Resident van Soerabaija bekend dat de daarbij bedoelde UITBESTEDING voor de levering van benoodigdheden ten behoeve der verschillende departementen alhier gedurende het jaar 186.2 en vpordejaren'TBr2iIS63 en 1564 in den dalm vanden Regent «art Soerabaija zal word jh gehouden op tien Uden September a. s. des morjjenV ten'l Of ure.'• '■ .._ ' ' ■'•'-'- :■- De voor*awthitr--+liér.fuitbesteding/liggéïi ter"" lange op het residentie kantoerjalhier.. J-'')■>  // T**-* -Svp' V >■  • y i SoERABAYA XMm AutpttttU 1861. Namens dk.v Resident: Ik adtitUnt tetideni mor de Comptabiliteit 0*28) W. HArPIVK.",http://resolver.kb.nl/resolve?urn=ddd:011060925:mpeg21:a0002:ocr,1,ddd:011060925:mpeg21:p001,"De Oostpost : letterkundig, wetenschappelĳk en commercieel nieuws- en advertentieblad",1040
1704348,1861/10/30 00:00:00,2202,ddd:010112052:mpeg21:a0043,http://imageviewer.kb.nl/ImagingService/imagingService?id=ddd:010112052:mpeg21:p004:image&x=53&y=2941&w=774&h=2202,ddd:010112052:mpeg21,827,5143,53,2941,8,LASDB(]ISH(HIDKI]_DI6E HIMIIIK) te Beerde  Prov. Gelderland. De Ondergeteekende «edert vrr»cheidene jaren eerst te Hengelo en later alhier met hot vertrouwen van vele Ouders vereerd ter Opleiding van Jonge Lieden voor den Landbouw heeft gemeend naar de behoef:e van den tegenwoordigen tijd eene verandering en uitbreiding aan ijjne Inri^ting te moeten geven. De uitvoerige Proipectu» bij hem op franco sanvraag te verkrijgen deelt de aanmerkelijke uitbreiding van het Theoretiich en Practiich onderrigt mede. Door bijzondere overeenkomsten met Heeren Profe»«oren te Deventer zal het Theoretisch gedeelte van het Onderwijs uitgebreid worden tot dat in de Bchci- Natuur- Dier- en Veeartüenjjkunde Bo thanie Geologie Waren kenni» en Houtoultuur Door eene naauwletttndc zoo reei mogelijk vaderlijke opleiding hoopt bjj zoo wel het stoffelijk als zedelijk belang der Jonge Lieden die aan zijne zorgen worden toevertrouwd te bevorderen. Nadere Informatiën z\j-i te bekomen bjj de Heeren B. VAS OORDTenDr.P.a.HUGiïNBOLTZ ie Rotterdam Mr. G. _. DE kEVPËNAER te 's Gravenhage en ./. B. VAN HOUTEN Notaris te Amsterdam. Buitenzorg Hj Beerde lb October 1861. (13212) A._»___>TOPP£;_.A_.__. DREANUS-PILLEN BEBEID VOIi&ENS HET ALOUDE EN ECHTE EECEPT  WAABOP MEN IN HET BIJZONDEB ATTENT MAAKT Zijn zeer nuttig in ongesteldheden der Maag en werken heilzaam op de Spijsvertering zij zijn uitmuntend tegen de Gal Scherpte In het- Bloed en uitslag der Huid zij zijn Zacht-J-axeerend en Slijm-afdrijvend. Verzegelde Doozen van 37%  75 en 150 Cent zijn verkrijgbaar te (11852) Amtterdam 3. Alsteede LeksmondH.Glinderman. Drog. HeüigewegD 321. Legden T. Hooijberg. A»del H. Reriert Uaattlnit P. Poortman. Berg-op-Zoom D.Pouwels Middelburg 3. F. Stade». Breda Henri Sprecger». Neuzen (Ter) Houtzager. Bretkens D. van Male. Nieuwveen D. van Hulst. Brielle. 3. H. Mathol. Overschie A. Hijmans. Delft de Krurff Apothek. Oud-Beijerland v. d. Sijde. Dokkum. 3. 3. Hom ma. Rosendaal M. v.Leeuwen. Dordrecht3. A.van de Ven Rotterdam A. v. d. Toorn Eindhoven A. Beguin. Apoth.Weste-Wagenst. Gorinchem H. Boder.. SoJiedam.Maltha Drogist. Grave A. van Dieren. Steenbergen 3. v. d. Kar. '_Gr__rt!*a?evJ._..vanße- Utrecht F. Altena Apone*se. Apotheker Boek theker Steenweg horatatraat. Veen Branderhorst. Helmond Erven Martin. Vlaardingen W. Pleijsier. 's/lertogtmb A J Everf». VlissingenS^mit Buchel. Hemden G. H. Malingré Voorburg Vf. Ligthelm. Buist Th. Annaert. {Waalwijk 3. Klperg. Leeuw  Erven Beintema.|i_«_i„_s* F. V la Brand.,http://resolver.kb.nl/resolve?urn=ddd:010112052:mpeg21:a0043:ocr,4,ddd:010112052:mpeg21:p004,"Nieuwe Rotterdamsche courant : staats-, handels-, nieuws- en advertentieblad",774
184158,1861/07/25 00:00:00,234,ddd:010111920:mpeg21:a0042,http://imageviewer.kb.nl/ImagingService/imagingService?id=ddd:010111920:mpeg21:p003:image&x=24&y=3524&w=787&h=234,ddd:010111920:mpeg21,811,3758,24,3524,4,i-ET WEL. 'XJ2SUF9 Jordcn geen Advertentiën meer ter ¦^'•atsïng aangenomen voordeUorarant van den volgenden dag. —...,http://resolver.kb.nl/resolve?urn=ddd:010111920:mpeg21:a0042:ocr,3,ddd:010111920:mpeg21:p003,"Nieuwe Rotterdamsche courant : staats-, handels-, nieuws- en advertentieblad",787
1502490,1861/12/31 00:00:00,1570,ddd:010545936:mpeg21:a0030,http://imageviewer.kb.nl/ImagingService/imagingService?id=ddd:010545936:mpeg21:p004:image&x=2007&y=3178&w=957&h=1570,ddd:010545936:mpeg21,2964,4748,2007,3178,6,"50 CT. ÏÏEDEIV VERSCHIJXT: 30 CT. DE VIJFDE KLEINE SPOTVOGEL OF HOUD OP! IK ZOU MIJ ZIEK LAGCHEN! Eene nieuwe Verzameling van ANECDOTEN  GEE$' TIGE GEZEGDEN HUMOR SATIRE enzenz. in Proza eu Poezy. In alle Boekwinkels te bekomen. V Bij den Boekhandelaar M. J. VISSER te 's Gravenhage  ziet heden het licht: HET UITNEMEND GELIJKEND PORTRET van den Wel-Eerw. Zeer-Gel. Heer «f. RlO-Lli Jzn. Predikant bij de Hervormde Gemeente te 's Gravenhage- MET FACSIMILÉ. Prijs f 125. _^ %* Uitgegeven bij H. HOVEKER te Amsterdam: CHRISTELIJKE OVERDENKINGEN <>P iedere dag des jaars door J. GOSSNER. ƒ120 i"" Linnen Band ƒ 150. HET CHRISTELIJKE JAAR of een woord dot H Schrift overdacht op iedereu dagdesjaars door J. *' LOBSTEIN met Voorrede van J. H. GUNNING V. D. M* te 's Gravenhage. ƒ 220 in Linnen Band ƒ 250. CHRISTELIJK GEDENKBOEK of opmerkingen en overdenkingen voor iederen dag des jaars getrokke"" uit de geschriften van de meest geachte Schrijvers Wet Voorberigt van C. C. CALLENBACH V. D. M. te Elburg. ƒ 150. STICHTELIJKE GEDACHTEN op alle dage» des jaars (Poëzy van bekende Dichters na aanleiding v»"" ecu Schriftwoord). 4e Druk 90 Cent in Linnen ƒ 12""- Sedert 70 jaren wordt dit boekje aanhoudend begeert^.",http://resolver.kb.nl/resolve?urn=ddd:010545936:mpeg21:a0030:ocr,4,ddd:010545936:mpeg21:p004,Opregte Haarlemsche Courant,957
1979049,1861/04/13 00:00:00,1993,ddd:010485271:mpeg21:a0002,http://imageviewer.kb.nl/ImagingService/imagingService?id=ddd:010485271:mpeg21:p001:image&x=84&y=2927&w=993&h=1993,ddd:010485271:mpeg21,1077,4920,84,2927,10,VENDUTIE op Maandag 15 April 1861 voor het Commissiehuis van €. H>r. . HOMKELJfIü & Co.. van PUIKE BOTER AARDEWERK diverse LIJNWADEN Heeren HEMDEN SCHEERMESSEN enz. Voorts : K. &C. No. 3-8-11-15-16-18. 6 ku. h5O p. 6/4 Ë W- & c; MADAPOLLAMS. „ No. 2/4-7/9-11-13-18/20.11 kn. b. 50 p. Ongebl. KATOEN. Beschadigd alhier aangebragt van Nederland per Bilderdijk. Alsmede: P. 26 balen beschad. ROOD GAREN No. 28. AB. C. 3 kisten „ 5/4 RUW KATOEN. „ 1 // // 6/4 „ „ (1180) De ondergeteekenden zullen op hunne VEIWIHJTIE van Maandag 15den dezer verkoopen: SPEELGOED in dozen  POP PEST etc. een partijtje PUIKE ll\ltl\4. (1224) Gebrs. ROSELJE en Co. ~~CHMHï VENDUTIE van Maandag 15 dezer zullen mede worden verkocht: ten 10 i. ure 4 Aandeelen in de Javasche Bank. (1216) GEBRS. ROSELJE & Co.,http://resolver.kb.nl/resolve?urn=ddd:010485271:mpeg21:a0002:ocr,1,ddd:010485271:mpeg21:p001,"Java-bode : nieuws, handels- en advertentieblad voor Nederlandsch-Indie",993
680463,1861/11/26 00:00:00,441,ddd:010112079:mpeg21:a0048,http://imageviewer.kb.nl/ImagingService/imagingService?id=ddd:010112079:mpeg21:p004:image&x=850&y=4103&w=1543&h=441,ddd:010112079:mpeg21,2393,4544,850,4103,6,"FABRIM ¥iN SERIPHIi-OBIELS J. VAN DEE TAK VPEHEN'VISCHMAaiT Rotterdam Vemardigd alle .o;-!en van SEUAPIUN-OIIOEI-S  aieniede QtlC!El_§ a Pcrcus- Slon  waarop men met het grOotite gemak de vlugate Viriatien even als op de Piano kan uitvoeren door een bijzonder aangebragt Mechaniek wordende dere've voort? »ebeel naar keuze der kooper» vervaardigd"" zoowel tot betrebkiut; dsr Regiiters als tot het Meubel. (14367 J",http://resolver.kb.nl/resolve?urn=ddd:010112079:mpeg21:a0048:ocr,4,ddd:010112079:mpeg21:p004,"Nieuwe Rotterdamsche courant : staats-, handels-, nieuws- en advertentieblad",1543
2515043,1861/04/06 00:00:00,2393,ddd:011192732:mpeg21:a0008,http://imageviewer.kb.nl/ImagingService/imagingService?id=ddd:011192732:mpeg21:p004:image&x=2232&y=2163&w=1051&h=2393,ddd:011192732:mpeg21,3283,4556,2232,2163,4,"To bekomen bij' ; « B * - * . ' • ' « OppeÉeiiiseK >4i) ■ >.'. •} •^•w®9pS®BßB6fe».t 15 initlë; STEEWEIV met KALK 'en.'MMËNT ;te«en goedkoopen pnis van bojrd af tc halen. (4395) Hollowaij's ZA LF7~~"" • - «I Alle j soorten van bindende waters met 1 kwikzilver / toebereide? Zalven en delf stoffelijke medicijnen worden gedariglijk te Java en andere Oost Indische eilanden; en kus- tenï ingevoerd en men- kan onmogelijk be•rekenen< wat; nadeel • dezelve ' uitoefenen on de1.; gezondheid • zoop inboor* lingen als Luropcers. Zulke medicunea uitwendig gebruikt v zijn meer of mm eevaarluk want wanneer.ze .de uitbarstingen der huid doen: verdwijnen drijven ze da ziekte naar binnen. ;'' Ilollóway's Zalf echter gansch ëa ' 1 1« ''■ f' . 1 1 '•. f.' 1 I 1 ♦ -0 - al te zamengestcld uit altreksels van. krui* <wyfac>St^É: 1 ** • 1 1 1 |»*| pxiiwii*'■ **-iH den\is r eenr;heelmiddel' tcffelnkertiid orischa* delnk en. krachtdadig voor  alle huidziekten zeren / builen wonden en. kneuzingen ; Dezelve dringt door tot den zetel der kwaal ... ft -nwri 1 rrrnT■ ifrif nint  irt|MMiiwliiwsiii|iii«ii wnar ijff werkt' zoowel uit- als inwendig veroorzakende ■* door ] d«ze£ dubbele ;handebng eeno volkomen# en voortdurende genezing zon» der dat men het; minste gevaar te vreezen heeft. : ' ■ - ' • ■- •"" GfiisMai M'U > : Dezè ZAI.F is alhier verkrijgbaar ge1-» steld bij den Apotheker A. B.: de VRIES V aan de  dA i  de PILïiEIV d/ï: ƒ3 en /5. ■ ( .■) ~ - . Gedrukt bij Ji C» Sluller Az« ■",http://resolver.kb.nl/resolve?urn=ddd:011192732:mpeg21:a0008:ocr,4,ddd:011192732:mpeg21:p004,Surinaamsche courant en Gouvernements advertentie blad,1051
605077,1861/08/02 00:00:00,737,ddd:010981102:mpeg21:a0027,http://imageviewer.kb.nl/ImagingService/imagingService?id=ddd:010981102:mpeg21:p003:image&x=908&y=935&w=821&h=737,ddd:010981102:mpeg21,1729,1672,908,935,4,"245ste Staats-Loterij. 4de Klasse 4de Lijst. Trekking op 1 Augustus. GETROKKEN PR IJ ZEN. Prijs van ƒ 100: N.° 1498 1560 13577 Prijzen van f' 65 : 225 2148 3778 7501 8798 12105 14034 16093 377 2466 3957 7735 BSO 3 12171 14333 16151 469 2709 4561 7748 9030 12359 14468 17027 714 2744 4779 7871 9266 12523 14604 17433 766 2748 483/"" 7980 9534 12819 14661 17818 798 2812 5021 8071 9690 12820 14696 18081 854 2872 5364 8101 9918 12875 14918 18674 966 2936 5631 8307 9995 13049 14926 19028 1386 3121 6051 8315 10431 13453 15297 19053 1532 3192 6426 8512 10812 13506 15313 19179 1621 3236 6940 8558 11067 13805 15447 19378 1807 3242 7146 8780 11627 13836 15979 19538 1866 lIHSSST 1 'fl S l— >'■",http://resolver.kb.nl/resolve?urn=ddd:010981102:mpeg21:a0027:ocr,3,ddd:010981102:mpeg21:p003,Rotterdamsche courant,821
3978574,1861/09/24 00:00:00,4153,ddd:000022900:mpeg21:a0006,http://imageviewer.kb.nl/ImagingService/imagingService?id=ddd:000022900:mpeg21:p004:image&x=1969&y=515&w=958&h=4153,ddd:000022900:mpeg21,2927,4668,1969,515,6,":;¦ V^üw Van wege de voornaamste LEES*'(£» INRIGTINGEN van Couranten hier *""** ter stede wordt hot BAGBEAB ihet inbegrip van de Bijbladen behelzende het li-er dag van de Zittingen van den Gemeenteraad den eersten dag tor lezing rondgezonden voor f'£ in de drie maanden. M. A^VOGSK-S berigt de ontvangst van nieuwe ZIJDEN en afldere STOFFEN voor Robes alsmede de nieuwe Mantels shawls en Omslagdoeken. Eenige Mantels van den vorigen Winter zijn tot veel verminderde prijzen voorhanden. HEDEN VERKRIJGBAAR bij 11. HARTMAAN TWEEDE WAGENSTRAAT 106 een geheel Nieuwe Catalogus VAK ZIJNE lioogduilsclic Engelsche en Fransche Lccsinrigting. Ir ijs •».» Cents. «PJ^Js NEDERLANDSCHE M STOOMBOOTREEDERIJ. ZOMEBBEENSE van af 2E Mei EHGI. DAGELIJKSCHE DIENST tussehen Rotterdam -Mannheim. ROTTERDAM afvaart Boompjes. Van Rotterdam naar Ng mogen en Emmerik 's morgens ten 10 ure. Van Emmerik naar Keulen 'smorgens ten 7 ure. „ Keulen „ Mainz 's nachts „12 „ „ Mainz „ Mannheim 's morgens „ 4 „ „ Mannheim „ Mainz 's middags „ 3 „ „ Mainz „ Keulen 's morgens „ 7 „ „ Keulen „ Nijmegen 's avonds „ 8 „ „ Nijmegen „ Rotterdam 's morgens „ 9 „ Vracht van Enkele reis. Heen en terug O. K. V. K. G. K V. K. Rotterdam naar Nijmegen ƒ 1.80 ƒ1.20 f 2.70/1.80 „ „ Koulen -4.70 -2.95 - 7. 470 „ „ Mannheim - 9.35 - 5.85 - 14.60 - 9.95 de STOOMBOOTEN dezer Reederij hebben op het dek Glas-Paveljoen en ieder 2 slaapkamertjes welke laatste voor eene reis AF TE HUREN zijn. STOOMBOOTDIEI\ST TELEGRAAF. SEPTEMBER 1861. Van Rotterdam : Van Antwerpen : 24*Dingsdag 's morg. 10.30 24 Dingsdag 's mqrg. 3.—¦ 26 Dond. 's n. 25/26 12.— 26 Donderdag „ ' 4.— 28 Zaturd.'sm.27/28 2.-28 Zaturdag „ 6.— * Deze afvaarl-uren staan in verbinding met de treinen van den Hollandschen en van den Rijnspoorweg die ten Bu. 15 m. 9u. 15 m. 9u.55 m. en 11 u. 5 m. des morgens te Rotterdam aankomen. Rotterdam  Boompjes  1 21. VEHIVEtJ «$• COMP. Te ROTTERDAM ligl in lading tik NAAR BATAVIA --Jr^lF\\llet cAMpAGNE-BAKKycHip (ÊÊË& JANNETJE ¦^Mf^mmm KaPl- A- DÜPCKE *^|^wHßßFiiii) •» November tevertreltlten hebbende uitmuntende inrigtingen voor Passagiers varende eenen geëxamineerden Scheepsdoctor on eene melkgevende Hoe. Adres bg W- RUYS $ ZONEN Rotterdam. VERTREK OEK *1» OOK TUE IN EN. HoUanilschc Spoorweg. — Zomerdienst. Van 'sllage naar Rotterdam: 8.30 10.18 12.31 3.44 6.42 B.—  9.44. Van 'sllage naar Amsterdam: 7.51  10.22 12.30 4.24 8.37 Van Rotterdam naar 's Hage: 7.—  9.30 11.50 1. —  3.30. 7.4 5 9.35. Van Amsterdam naar'sllage: 7.308.05 10.40 1.30 4.30 7.30. Nederl.-Belgische Spoorweg. (Zomerdienst.) Van Antwerpen naar Rotterdam en llreda: 7 u. 50 m. 12 u 20 m. 3 u. 50 m. 5 u. 35 m.( Moerdijk en Breda). . Van Rotterdam naar Antwerpen en Breda: 4 u. 30 m. 10 u. 15 m. 3 u. Van Breda naar Antwerpen en Rotterdam: 6u. 45 m. 12 u. 35 m. 4u. 15 m.",http://resolver.kb.nl/resolve?urn=ddd:000022900:mpeg21:a0006:ocr,4,ddd:000022900:mpeg21:p004,Dagblad van Zuidholland en 's Gravenhage,958
2358985,1861/02/08 00:00:00,2315,ddd:010584958:mpeg21:a0036,http://imageviewer.kb.nl/ImagingService/imagingService?id=ddd:010584958:mpeg21:p007:image&x=139&y=222&w=1019&h=2315,ddd:010584958:mpeg21,1158,2537,139,222,8,"""BBKBNDHAKINB. "" nscl:ST_.l» en niTIIOIIIKIW van Leeu- II*1* _ 'by dozo tor algemeen» konnis dat met da garden .ren""._' Broggelden ala belasting voor het draaffen invordering ovef ([o Utirlin^or Vaart by do voormaligo der ijz*>ren on QftmBtrabnr«ll alhier overeenkomstig de Vrou*9°P° toe Tagtgestel(l door don Raad  in zyne vergabesluitcn .^ 3 Qiei on 9 Augustus 1860 goedgekeurd deringe0 ™ b_gluit van den 19 Decombor 1860 zal worden bv D""!en op Woensdag don 6 February e. k. en dat als **Dg_Vft_1 ""tot de inning dezer belasting goregtigd zijn : ëlOutoe van der Veen van do Brug over de Harlingor Jrtter 'Bdnja van de Brug by de voormaligo Vrouweno Mpke'de Ruiter van de Brug by Camstraburen. r ar arden Burgemeester en Wethouders voornoemd 1861. J- H. BEUCKER ANDRi. en 5 JJeDruaiy Secretaris M. S. dk WAL. - JOURE. Ne Ondergeteekende heelt de eer aan Ouders en Voogden Wisten dat er bij voortduring aan zyne _nrlclitiiiK eenheid bestaat tot plaatsing van KOSTLKERLINGEN. Ook vraagt hij nog op voordeolige voorwaarden een boi.-__..n SECONÜA>T. Brieven iranco. kwamen WW F. W. HELLEMA. ""^TJ^CTEIJKKN van het D.partemont Harlingen der Nejl derlandscho Maatschappij ter bevordering van % IJ 1 _.(t Hl II» i"" dezen als Sub-Commissie werkziam herinneren belanghebbenden dat in de maand July 1861 te Haarlem eeDe »lKeiiieene !%»»tion»le TentoonHtellinff van KlJrerheld zal gehouden worden waartoe de voorwerpen vóór den lsten July e. k. moeton wordeD ingezonden. Directeuren noodigen door deze alie ingezetODen van Barlinaen en omliggende plaatsen uit om by die gelegenheid voorwerpen in te zenden tot den tak van nijverhoid door hen beoefend behoorende; en mede ta dingen naar de uitgeloofde bekrooningeo. De voorwerpen moeten vrachtvrij te Harlingen worden ingezonden ; van de kosten der opzending naar Haar- Itm zyn de inzenders ontheven. Terwyl Directeuren om eene naauwkeurige opgave dar in te zenden voorwerpen vóór den 25. ten April verzoeken uiten zy den wensch dat veelvuldige inzending  maar bovenal uitnemendheid daarvan  het vernieuwd bewijs moge opleveren dat Friesland in beoefening van nyverheid bij geen der andere gewesten van ons vaderland behoeft ten achter te staan. Belanghebbenden  nadere inlichtingen verlangende kunnen dia op franco aanvrage bij een der o;idergeteokenden erlangen. Directeuren van hel Dep. Harlingen der Ned. Maatschappij van Nijverheid J. van HULST. L. HOUTSMA. C. TEVES. JACs POSTHUMA. S. HINGST.",http://resolver.kb.nl/resolve?urn=ddd:010584958:mpeg21:a0036:ocr,7,ddd:010584958:mpeg21:p007,Leeuwarder courant,1019
980818,1861/07/08 00:00:00,487,ddd:010131452:mpeg21:a0012,http://imageviewer.kb.nl/ImagingService/imagingService?id=ddd:010131452:mpeg21:p004:image&x=1097&y=1990&w=2014&h=487,ddd:010131452:mpeg21,3111,2477,1097,1990,4,Magizijn Keizersuot Door het vergevorderde Saizoen zullen de nog voorhanden zijnde ZOMER-ARTIKELEN tot veelverminderde prijzen worden OPGERUIMD. SCHADE * OLBENKOTT.,http://resolver.kb.nl/resolve?urn=ddd:010131452:mpeg21:a0012:ocr,4,ddd:010131452:mpeg21:p004,Nieuw Amsterdamsch handels- en effectenblad,2014
28560,1861/05/27 00:00:00,56,ddd:010252667:mpeg21:a0016,http://imageviewer.kb.nl/ImagingService/imagingService?id=ddd:010252667:mpeg21:p004:image&x=278&y=830&w=510&h=56,ddd:010252667:mpeg21,788,886,278,830,4,Advertentiên.,http://resolver.kb.nl/resolve?urn=ddd:010252667:mpeg21:a0016:ocr,4,ddd:010252667:mpeg21:p004,De Tĳd : godsdienstig-staatkundig dagblad,510
1449844,1861/09/04 00:00:00,1826,ddd:010111996:mpeg21:a0063,http://imageviewer.kb.nl/ImagingService/imagingService?id=ddd:010111996:mpeg21:p004:image&x=2433&y=3309&w=794&h=1826,ddd:010111996:mpeg21,3227,5135,2433,3309,4,"TE KOOP: Een Snoekharige KETTINGHOND zjjnde Ren 1% jaar oud. Te bevragen bij A. PIJL in het Rechtbuis te Alblasserdam of met franco Brieven onder Lett. L. (10842) (10864) De Ondergeteekende N. DE WAAL heeft door deze de eer te berigten dat hij zioh bij zijn Handel ln Muntspecien en Coupons ook heeft gevestigd als KASSIER zoowel voor Binnen- als Buiten 's lands en beveelt zich ook als zoodanig minzaam den Handel aan zullende door billijk gestelde Tarieven en Soliede Handelwijzen het vertrouwen hem zoo ruimschoots in zijne Wisselzaak geschonken steeds meer en meer trachten waardig te maken. Botterdam  1 September 1861. W. DE WAAL Kantoor: Boompjes Wijk 1 N°. 131. BELANGRIJK BERIGT. Eene der voornaamste Europesche Levensverzekering - Maatschappij en  die 18 jaren bestaat en met een Kapitaal van 88 millioen Francs in Polissen van Assurantiën welke in 12 Koningrijken gerealiseerd zjjn biedt aan soliede Personen in het bezit van goede Relatiën het HOOFD-AGENTSCHAP aan in de Steden en groote Localitciten van Nederland en België waar zoodanig HootH-Agentschap nog niet bestaat. Adres met franco Brieven of in Persoon bij M. GOBLIEB Inspecteur-Generaal 16 Rue du Marche te Brussel. De correspondentien moeten in het Fransch gevoerd worden. (10831) fflMflH^B °P «o Cargadoors-Man- HH Sr toor te Liverpool wordt GE""» """" VRAAGD: Een Fatsoenlijk JONG MENSCH van 20/23 jaar bij voorkeur bekond met de Noordsche Talen-tegen genot van Salaris. Adres met franco Brieven onder hot Nommer dezer Advertentie aan het Bureau dezer Cauront. (10853) m&___msam» J. F. EISELE BeUcrsch iPK^ Bier- en Hoff^huls aan de *¦' w Hoogstraat te Botterdam VRAAGT: Een KOFFIJHUISBEDIËNDE Bekwaam voor die Betrekking. Adres in Persoon.. (10866)",http://resolver.kb.nl/resolve?urn=ddd:010111996:mpeg21:a0063:ocr,4,ddd:010111996:mpeg21:p004,"Nieuwe Rotterdamsche courant : staats-, handels-, nieuws- en advertentieblad",794
3950832,1861/10/07 00:00:00,4659,ddd:010981160:mpeg21:a0034,http://imageviewer.kb.nl/ImagingService/imagingService?id=ddd:010981160:mpeg21:p004:image&x=1763&y=374&w=848&h=4659,ddd:010981160:mpeg21,2611,5033,1763,374,6,"DU BARRY'S Revalenta Arabica. Men schreef ons: Eene Jufvrouw te Terheyden % uur van Breda heeft bij mij 2 Bussen Revalenta van 1 tD gehaald voor haren Mau die gedurig aan maagpijn leed en de genuttigde spijzen telkens uitbraakte. De Revalenta at bij echter gaarne en gevoelde alsdan ook geene neiging tot braken zoodat hij tbans na de 2 Bussen gebruikt te hebben geheel vau zijne maagkwaal welke hem dikwijls 3 weken lang aan het bed kluisterde volkomen genezen is. Den naam van dezen Heer kennende zal ik deDzelven op aanvraag gaarne mondelings mededeelen. Breda (get.) HENRI SPRENGERS. 7WA _T f.* I? AIAfPV ce S?eenen substantiëlen kost _iill\l\_ Jlli_lïljLlf| verdragen kunnen moeten DU BARRY'S Revalenta gebruiken om hunne krachten te herwinnen. De Revalenta is geen Medicament maar een voedsel dat zeer gunstig op de spijsverteringsorganen werkt en daardoor eene menigte ziekten en onpasselijkheden genezen en voorkomen kan. Er zijn voorbeelden in .roote menigte dat zij ZONDER HULP VAN MEDICIJNEN langdurige ongtsteldbeden genezen heeft. Duizenden hebben openlijk verklaard dat zij hunne genezing aan baar te danken hebben. Men kan ze zonder niconvenitnt gebruiken en de genezing volgt gewoonlijk spoedig. De echte Revalenta van de Heeren BARRY DU BaRKY en Co. 77 Re.entstreet Londen wordt alleen verkocht door bet Verkoophuls tn deszelfs Depöls. 1 ffi 2 ffi 5 ffi 12 ffi De Prijs is: ƒ2.—. ƒ3.50. ƒB.—. ƒl6.—. Kleine Bussen om er de proef mede te nemen kosten 87. Cent. Men lette er vooral op dat iedere Bus tot waarborg der echtheid door „F. VON WINDHEIM & Co. VERKOOPHUIS"" geteekend is. Amsterdam VERKOOPHUIS. Rotterdam. J. A. KLING ER & Co. Bergen-op-Zoom D. POUWELS. „ P. F. APPELBOOM. Brouwershaven G. ALING. De[ft J. T. WAGNER. Dordrecht J. VETH Jr. Goes Wed. C. VREEKE. Gorinchem H. BODERIJ. Gouda A. GOEDRAAD. „ Wed. A. C. SCHOUTEN. „ H. P. VAN FRANKENHUIZEN. 's Gravenhage. SACK & Co. Leyden L. C. DIRKS Verkttoph. Donkerstee.. Hellevoetsluis H. G. VAN STEEDEN. ! „ ALEX. BRUCH. Maassluis P. POORTMAN. Middelburg J. C. KRUISSE. Oostburg Wed. P. J. GEELHOED. Schiedam M. J. DE LANGE. Sluis Gez. JANSEN. Steenbergen W. VAN DER KAR. Vlaardingen J. LAGERWERFF. Vlissingen A. M. KALBFLEISCH. Willemstad B. FRIDERICHS. En in de bekende Depots in de andere Steden. PATE DE CERISES j POUR LES DENTS. i \|«M La meillenrc mnrch« et la mem ■ j |o| % f\ )_»■ préparation pour les tlcnts. i \-_ \ I \ lt**U Seula propriétalrea | JOM GOSIÏELI & co+ 4 Londre». I Messr» JOHN GOSNELL & Co. Parfumeurs de S. M. seront htureux d'exécuter les ordreg qui leur seront adressés et d'appointer I des Ageiits pour la voute des produiU de leur roanufacture. KERK KROONEN. I Wegens a.n te brengen Gaskroonen worden te koop aangeboden VIJF IJZEREN KERH. KROONEN met bijbehoorende IJzeren llan. gers en _odubbeleHAl--.OL.II_LAMPES . met franco Brieven te bevra.en bij den Voorzitter  van het Bestuur der Hervormde Kerk te Oud-Beijerland ' den Heer B. M. VAN DAM aldaar. Openbare Verhuring van 13 Partijen extra best WEILAND respectivelijk gelegen in de Spangensche en Blijdorpsche Polders onder Overschie op Dingsdag den BOctober 1861 des namiddags ten 5 ure in de Herberg de Vergulde Valk te Overschie. Nadere informatien zijn te bekomen ten Kantore van den Notaris L. C. DIJXHOORN te Overschie alsmede ten Kantore van den Notaris L. P. RIETSTAP aan de Korte Hoogstraat te Rotterdam. PUBLIEKE VEILING ! te ROTTERDAM • op Maandag 7 October 18(11 de» voormiddags ten ' half elf ure in het Logement de Zon aan den Steiger van: Ca. 60 Last - witbonte Poolsche TARWE op 1542 N. ffi; : alhier liggende. Nadere informatie te bekomen ten Kantore van • SCHADEE & Co. ' Openbare Verkooping te SCRIERAR op Woensdag 9 October 1861 des namiddags ten één ure binnen de Koopmansbeurs van: C* 115 Lasten ROGGE door Zeewater beschadigd van Riga aangebragt met het Schip Aglaja Kapit. J. Sommer; liggende in Ligters. Nader onderrigt bij L. W. JANSEN te Schiedam en Wm. & ALBs. SMALT & Co. te Rotterdam.",http://resolver.kb.nl/resolve?urn=ddd:010981160:mpeg21:a0034:ocr,4,ddd:010981160:mpeg21:p004,Rotterdamsche courant,848
1760640,1861/11/09 00:00:00,1680,ddd:011060984:mpeg21:a0001,http://imageviewer.kb.nl/ImagingService/imagingService?id=ddd:011060984:mpeg21:p001:image&x=73&y=1096&w=1048&h=1680,ddd:011060984:mpeg21,1121,2776,73,1096,4,VERTREK DER LANDMAIL ! Ia de maand November den 25sten. ADVERTEWTIEN. I Veiling van doorgekapt Kopergeld; De Resident van Soerabaija maakt bekend dat op j Maandag den lOden December 1SÖB bij 's land» pakhuizen te Soerabaija  in het openbaar Bullen worden opgeveild 400000 AMSTERDAMS-IIE j PONDEN DOORGEKAPT KOPERGELD waarvan een monster bij gemelde pakhuizen ter bezigtiging ligt. De verkoop zal geschieden op de voorwaarden bedoeld in de Javasche Courant van den 23sten dezer No. 85. Soerabaija Namens den Resident 23 October 1801. Le Amstenl-Resident voor de Comptabiliteit (1715) -\W. _E3Cj_\__EP_E=*_E__. j 1 Op Woensdag den 13den November 1861 des namiddags ten twee ure zullen voor JABacasser en de Itlo» lukkos btieveupakketten worden gesloten. SOEKABAYA  De Poslkommies  den Men November 1861. C. WEJLTTE-flï. (1786),http://resolver.kb.nl/resolve?urn=ddd:011060984:mpeg21:a0001:ocr,1,ddd:011060984:mpeg21:p001,"De Oostpost : letterkundig, wetenschappelĳk en commercieel nieuws- en advertentieblad",1048
667212,1861/04/24 00:00:00,676,ddd:010485274:mpeg21:a0019,http://imageviewer.kb.nl/ImagingService/imagingService?id=ddd:010485274:mpeg21:p002:image&x=2159&y=4278&w=987&h=676,ddd:010485274:mpeg21,3146,4954,2159,4278,10,"I PHOTOSRAPHISfiH ATEUEB I 11 RIJSWIJK. § VAN H WALTER WOODBIRI. g| g| Dagelijks geopend van half acht tot 12 _£_ S uur- i 1311) *« is & SafeWWWWWWWawwww »__ <M_> _M"">__f_wi",http://resolver.kb.nl/resolve?urn=ddd:010485274:mpeg21:a0019:ocr,2,ddd:010485274:mpeg21:p002,"Java-bode : nieuws, handels- en advertentieblad voor Nederlandsch-Indie",987
1214450,1861/05/22 00:00:00,1070,ddd:110532112:mpeg21:a0003,http://imageviewer.kb.nl/ImagingService/imagingService?id=ddd:110532112:mpeg21:p001:image&x=5&y=1514&w=1135&h=1070,ddd:110532112:mpeg21,1140,2584,5,1514,8,g _4 Mei i i -i . ' . ?s Mei voor bel noonhi Woens klei vooi ket Koonhnia van -Je:: Uil: U Hei voor ■  .'. \. ij la_ SI Mei ï Zalnrdat I Junij _ hel lei,http://resolver.kb.nl/resolve?urn=ddd:110532112:mpeg21:a0003:ocr,1,ddd:110532112:mpeg21:p001,Bataviaasch handelsblad,1135
862312,1861/02/21 00:00:00,956,ddd:010079260:mpeg21:a0015,http://imageviewer.kb.nl/ImagingService/imagingService?id=ddd:010079260:mpeg21:p004:image&x=1944&y=70&w=902&h=956,ddd:010079260:mpeg21,2846,1026,1944,70,4,.AMSTERDAM 18 Februarij. Tatwe onveranderd; 131 p. Pools f 452; 127 p. dito f 412 415; n. Rijn f 375 p. 2400 kilo; Hongaarsche f 300 p. 2400 kilo bij party. Rogge dadelijk prijshoudend ; 125 p. Pruis 'f 243 ; 119 120 121 p. n. Petersb. f 207 210 213; 115 117 p. j. dito f 197 200; 118 p. Koersche f 208; 119 p. n. Petersb. f2OB bij gerijf op levering lager; in Maart f f 197 195; Mei fl9B f 196; Junij f 197; Sept. fl9l 197. Boekweit aan kons. als voren verkocht; 118120 121 p. Holst f 251 258 261. Koolzaad 1.2 p. fl. lager; Friesch op 9 vat 68 I_2 p. fl.; op 9 vat in April 691.2 Okt 70 p. fl. Lijnzaad zonder handel. Raapolie dadel.k en op levering iets flaauwer; op 6jw f 39 3.4; vlieg. f381_2; Mei f 381.2 a 1.4—381?4; Sept. f 39 a 1.2; Okt. f 391.4 a I_2; Nov. en Dec. f 39 3.4 a 40. Lijnolie dadelijk en op levering niet williger; op 6_w f 311.4; vlieg f3O; Maart f3O; April f 301.2; a I_4; Mei f 303.4 a 1.2; Okt. Nov. en Dec. f 311.2. Hennepolie op 6.w f 381.4; vlieg f 37. Raapkoeken f 86 a 88; Lijnkoeken f 131;2a151_2,http://resolver.kb.nl/resolve?urn=ddd:010079260:mpeg21:a0015:ocr,4,ddd:010079260:mpeg21:p004,De Noord-Brabanter : staat- en letterkundig dagblad,902
3060828,1861/03/01 00:00:00,2412,ddd:010782885:mpeg21:a0013,http://imageviewer.kb.nl/ImagingService/imagingService?id=ddd:010782885:mpeg21:p004:image&x=1423&y=1941&w=1269&h=2412,ddd:010782885:mpeg21,2692,4353,1423,1941,22,"%* President en Directeuren van de Nederlandsche Bank herinneren de belanghebbenden dat er geene overschrijvingen van aandeelen ten hunnen overstaan zullen kunnen plaats hebben van den 15den tot en met den 31sten dezer maand. Amsterdam 1 Maart 1861. Namens de Directie. De Secretaris .Mees. GEREGTELIJKE AANKONDIGINGEN. *„* De Officier van Justitie te Leiden maakt bekend dat bij Vonnis der Arrondissements-regtbank aldaar in dato 26 Februarij 1861 Leendert Bode Bouwman wonende in de gemeente Zwammerdam op eigen verzoek is gesteld onder Curatele. Leiden 26 Februarij 1861. De Officier van Justitie ' F. Pont. *0* Bij behoorlijk geregistreerde Acte verleden bij het Kantongeregt te Edam (Noordholland) den 9den Januarij 1861 heeft Neeltje Leegwater Weduwe van Jan de Wit het Boerenbedrijf uitoefenende wonende te Katwoude Handligting verleend aan haren Zoon Cornelis de Wit oud 21 jaren tot het uitoefenen van Boerenbedrijf met daaraan verbonden Handel het aangaan van Vennootschappen en beschikken over zijne inkomsten in den meest uitgestrekten zin behoudens de bepalingen omtrent het vervreemden van onroerende goederen. Geschiedende deze aankondiging ingevolge Art. 486 van het Burgerlijk Wetboek. TELEGRAPHISCHE BEU RSBEBIGT EN. Donderdag 28 Februarij 1861. Amsterdam. pCt. Nederl. Werkelijke Schuld. 21/ 633/4 637 — Dito dito 3 76<7i» 76 Vs — Dito dito 4 98""/ 98 V. Handel-maatschappij .... 133 133 3/3 133 3/s Spanje 13A 41% -< — Binnenlandsche .... 3 47 % 473/3 47'/ Portugal oude 3 467< — — Rusland oude 5 — — — Nieuwe 5 101 s/s — — Hope 4 75 — — Stieglitz 4 — — — Dito sde serie .... 5 835/s 833/4 — Dito 6de serie .... 5 947S — — Leening 1860 47 89% — — Oostenrijk Metalliek . . 5 417» 4113/16 41'% Dito . . 27 22% — — Zilveren. 5 64 74 — — Nationalen 5 48 7S 48 74 48% Londen Consols. . . . 91 % Antwerpen Metalliek. . 507S Spanje — Spanje — Parijs Fr. rente . . . 67.85 Weenen Metalliek. . . 65.20 Spanje 43% Wissel Londen. . . . 146.75",http://resolver.kb.nl/resolve?urn=ddd:010782885:mpeg21:a0013:ocr,4,ddd:010782885:mpeg21:p004,Nederlandsche staatscourant,1269
3977418,1861/07/20 00:00:00,3606,ddd:110532129:mpeg21:a0017,http://imageviewer.kb.nl/ImagingService/imagingService?id=ddd:110532129:mpeg21:p003:image&x=57&y=2875&w=1103&h=3606,ddd:110532129:mpeg21,1160,6481,57,2875,7,"IXG KAXTOOIi VA\ -< < * Engelsche üoi Australia p  ' Oud Goade DüK Nieuwe ;/ Idem  Dobbelde  Idem nsche Gond '; ml 00 fr«. . ren M \ - RS  PILAAR MATTI alle soort""i v.iri vreemde Gouden en Zilveren SPECIE rorden ten Kantore va de i Ie verwisseld Usen Indische Courant. (2686) J. SPEET. als- VESTINGE ."". KAMERS STALLEN KEUKENS WINKELS THEATERS POLICHINELLE BOÜWDOOZEN bij (•>rBS) VAN WALCHREN & VAN DORP. ..'._^*_ï__\as/W -^•*2n Een eroi op heden door 1 I (26 'Ij W. S. VAN"" II (GEZAND Sr. oa Sao©© Eene STEi_PELF£RS raet losfo Letters Marmeren Tegels. Te bevragen Marine Hotel (2070) Kapt. .!. VAN ZANTEN. vau verschillende afmetingen. T\ ""■""' ■ 'S omdraaijende Snikerpannen me' Aulds gepatenti rde klep; voorts: eene kleine Stoommachine met noini) - Stoi i VaUrpijpi (tien n enz om die Voor nadere informatiën gelieve men zich ti rervoegen bij (2642) MACLAINE WATSON .V Co.",http://resolver.kb.nl/resolve?urn=ddd:110532129:mpeg21:a0017:ocr,3,ddd:110532129:mpeg21:p003,Bataviaasch handelsblad,1103
64974,1861/12/21 00:00:00,98,ddd:010485263:mpeg21:a0001,http://imageviewer.kb.nl/ImagingService/imagingService?id=ddd:010485263:mpeg21:p001:image&x=241&y=2126&w=663&h=98,ddd:010485263:mpeg21,904,2224,241,2126,10,GFFG,http://resolver.kb.nl/resolve?urn=ddd:010485263:mpeg21:a0001:ocr,1,ddd:010485263:mpeg21:p001,"Java-bode : nieuws, handels- en advertentieblad voor Nederlandsch-Indie",663
2866040,1861/01/04 00:00:00,2615,ddd:010584948:mpeg21:a0013,http://imageviewer.kb.nl/ImagingService/imagingService?id=ddd:010584948:mpeg21:p003:image&x=1181&y=105&w=1096&h=2615,ddd:010584948:mpeg21,2277,2720,1181,105,6,en bevoorregt met medegebruik van Steen daarnevens ; nagelaten door Antje J. Solksma; 12 Mei 1861 te aai vaarden. 2. Een STOEL en VROUWEN ZITPLAATS no. 19 in de Kerk der Hervormden aldaar ; dadelgk te aanvaarden. De Motaris OOSTERBAAN te Dockum zal in gevolge regterljjke magtiging op Zaturdag den 5 Januarij 1861 des namiddags 4 uur ten hu.s van den Kastelein Steringa te Rinsumageest finaal verkoopen : 1. Een stuk vruchtbaar GREIDLAND te Sgbrandahuis  gemeente Birdaard sectie D no. 54 groot 1-53-10 (4$ pond.); staande per 36J r. op / 321. 2. Een stuk DITO aldaar sectie D no. 53 groot 1-34 10 (41 pond.); eigen aan de Erven IJkje H. Halbesma; geboden per 36} roede f 318. . Dadelgk na de toawgziog te aanvaarden. HERBERG EN BAKKERIJ te _HH_nWOIIDE De Notarissen W. van RIESEN te Dantumawoude en OOSTERBAAN te Doekum zullen Woensdag den 16 Januarij 1861 'savonds 6 uur in de na te meldane herberg te Akkerwouda fi-.aal verkoopen: De HLIZINGEmet HERBERGen BAKKERIJ SCHUUR «rond en verdere aonexen ta Akkerwouie bij Aodries W. Djjkstra in huur zoodanig dazalve den 27 December 11. in veiling is gabragt; waarop geboden is / 2257. Aanvaarding 12 Mei 1861. VERKOOP eener HUIZINGE en TIMMER .VISIJHLKI_ De Notaris E. J. ATTEMA te Dragten zal verkoopen: Voor de Wed. M. J. dk JONG c. f : Eene hechte HUIZINGE en TIMMERWINKËL met ruim Erf en Tuin c. a  aan den Straatweg te Dragten  groot 5 roede 60 el. In 2 perceelen  bij billeteta omschreven. Voor A. en H. E. de JONG: Ruim -^.j over hoog en laag in 4 kampen Land achter den Slingeweg te Dragten  groot p. m. 4 bunder; behoorende overigens aan Durk Wouda c. s. De veiling is Za'urdag 5 Januarg 1851 's avonds 7 uur in 't Graauwpaard te Dragten VERKOOP eener H IHHKUIJ te DRIQTEI. De Notaris E. J. ATTEMA zal na bakomene autorisatie verkoopen: Eene hechte HUIZINGE en zeer ter staande wel ingerigte BAKKKRIJ met Erf Hok enz. nabg de Nieuwe Draai te N.-Dragten; gebruikt door den eigenaar Gurbe R. Kuipers. Aanvaarding Mei 1861. De veiling is Maandag 7 Januarij a. s. 's avonds 7 uur in 'tlogemnnt bg Jonker te Dragten. VERHURING voor G jaar bij briefjes eaner beste GREID- en BOUWPLAATS aan deo Straatwag te N - Dragten . groot 17 bunder waarbij nog 7£ bunder uitmuntende MADEN bg de Veenhoop; thans gebruikt door den eigenaar M. P. van der Vlugt. De conditien liggen ten Kantore van Notaris ATTEMA te Dragten bij wien de briefjes franco moeten ingediend worden den 10 Januarij 1861.,http://resolver.kb.nl/resolve?urn=ddd:010584948:mpeg21:a0013:ocr,3,ddd:010584948:mpeg21:p003,Leeuwarder courant,1096
2609925,1861/03/16 00:00:00,2047,ddd:010782898:mpeg21:a0016,http://imageviewer.kb.nl/ImagingService/imagingService?id=ddd:010782898:mpeg21:p004:image&x=61&y=107&w=1275&h=2047,ddd:010782898:mpeg21,1336,2154,61,107,10,BERIGT AAN ZEEVARENDEN. De Minister van Marine brengt ter kennis van belanghebbenden dat het Klokbakenschip bij de Schouwenbank van zijn ankertuig is weggeslagen en zoo spoedig mogelijk zal worden herplaatst. 'sGravenhage den 6den Maart 1861. De Minister voornoemd  J. S. Lotsij. BKRIGT AAN ZEEVARENDEN. De Minister van Marine brengt bij deze ter kennis van belanghebbenden de navolgende bekendmaking der regering van Griekenland als: GIEKENLAND. Haven van Catacolos. In de haven van Catacolos op het uiteinde bijna der in aanbouw zijnde kaai 220 mètres van den oever zal den 6den Februarij 1861 een rood licht ontstoken worden hetwelk vervolgens alle nachten van zons-ondergang tot zons-opgang zal branden. Het licht geplaatst op eenen opstand van 10 mètres boven de zee zal op 4 Engelsche mijlen afstand zigtbaar zijn. 'sGravenhage den 28sten Februarij 1861. De Minister voornoemd J. S. Lotsij. kennisgeving. Dijkgraaf en Hoogheemraden van den Krimpenerwaard doen te weten: Dat in voldoening aan art. 31 van het reglement voor den Krimpenerwaard de verkiezing van Hoofd ingelanden en Hoofdingelanden-Plaatsvervangers ter vervulling der plaatsen die in het afgeloopen jaar zijn opengevallen en tevens van die welke op den lsten Mei 1861 ingevolge den bestaanden rooster moeten openvallen zal plaats hebben op Vrijdag den sden April 1861 van des voormiddags 9 tot des namiddags ten 2 ure in de hoofdplaatsen der lste 2de en 3de kiesdistricten in art. 25 van meergemeld reglement aangewezen en wel in de Gemeentehuizen te Bergambacht Stolwijk en Ouderkerk aan den I.Tssel. In het lste district hoofdplaats Bergambacht. Voor de heeren Cornelis Verkleij Hoofdingeland en Pieter Pons Hoofdingeland-Plaatsvervanger beiden aan de beurt van aftreden in 1861. In het 2de district hoofdplaats Stolwijk. Voor den heer P. K. Drossaart Hoofdingeland-Plaatsvervanger aan de beurt van aftreden in 1866 doch deszelfs ontslag hebbende ingediend. In het 3de district hoofdplaats Ouderkerk aan den IJssel. Voor den heer Hoofdingeland P. Cente Jongebreur aan de beurt van aftreden in 1861. Vastgesteld door Dijkgraaf en Hoogheemraden van den Krimpenerwaard in hunne vergadering van den lsten Maart 1861. En zal hiervan afkondiging geschieden waar het behoort. Dijkgraaf en Hoogheemraden van den Krimpenerwaard Bisdom van Vliet Dijkgraaf. Smits v. d. Goes Secretaris.,http://resolver.kb.nl/resolve?urn=ddd:010782898:mpeg21:a0016:ocr,4,ddd:010782898:mpeg21:p004,Nederlandsche staatscourant,1275
488898,1861/02/06 00:00:00,519,ddd:010545968:mpeg21:a0012,http://imageviewer.kb.nl/ImagingService/imagingService?id=ddd:010545968:mpeg21:p003:image&x=98&y=1302&w=942&h=519,ddd:010545968:mpeg21,1040,1821,98,1302,4,"Schouwburg buiten de Hout-Barrière te Haarlem. Op Vrijdag den *_. """" Februari) 1861. DOMME STEVEN Tooneelspel in drie Bedrijven. Daarna: EENE DIENSTMEID WIE MEN DE HUUR OPZEGT. Aanvang ten half zeven ure. Nieuwe Schouwburg in de St. Jansstraat te Haarlem. Maandag 11 Februarij 1861. DE VERWARRING Blijspel in 5 Bedrijven.1 Daarna: 9» BEESTEN en 1 BOER Vaudeville in 1 Bedryf. Aanvang ten zeven ure. - M  ■ - - - ■ ■■■■__. ■■■Il_.||||||.M.|||M|.|||.l.ll",http://resolver.kb.nl/resolve?urn=ddd:010545968:mpeg21:a0012:ocr,3,ddd:010545968:mpeg21:p003,Opregte Haarlemsche Courant,942
4971718,1861/10/19 00:00:00,4717,ddd:110532155:mpeg21:a0011,http://imageviewer.kb.nl/ImagingService/imagingService?id=ddd:110532155:mpeg21:p002:image&x=1188&y=9&w=1054&h=4717,ddd:110532155:mpeg21,2242,4726,1188,9,7,"Van de Vers gekomen : ZAK-ALHANAL ■ ■ - .j. ■ n •i"" 'W **Jr iO a Prijs f 150 franco per post f 2—. Éanloor-Almanak KLEURENDRUK. Vrijs f I—. Opgeplakt f 150. (Ho?) BRUINING. Ontvangen in het Mo4e-lag4Zija Barège üniaiidic en eeborduurde j<;p;mut?!r PEACHT2GS Zl I ROBES. - Coiffures Handschoenen IJumous Man fi/fes Schoenen etc. 69) Pasaroeaogschc Aimß w inct bij behoorend Recept voor het gebruik ia llOt liollaudsch per dozijn/ 48—. vin m - Sniphas dniaini per Bacon inhoudende een on» 3 1 lGewigt/8i — • -7 Bij L. 1 LATON & Co. De Zalf en Pillen van Holloway. i al lijst van : n. .1 heer !/ •■■ de mester en verklaar! echter dal geen enkel dezer geneesmiddelen nis zi ker mi 1.1. l kan ten. D Miren te sten is hei algemeen bek* loway'a pillen van de tien ziekten .■-. Ileti wel n zen worden en Beestal gevallen waarop de : geput is in wel te vergeefs. Dil blijkt uit de menigvuldige attesten van alle natiën. Alle gezwellen en vereweringen alle aaudoeniugen der Baag ingewanden en van den levir geven toe aan den invloed van dit verzuiverond middel dit is buiten tegenspraak. Deze beroemde Pillen alsmede de Holloway Zalf zijn op franco aanvrage te bekomen tegen de ondervolgende prijzen a contant : Doosjes Lillen @/ I— f.' —  f 5—. Potjes Zalf  - 1- -5.— - 5-. Te SueTubai/u bij LX ROÏ 5; Co. ( „ „ MOSSEMREKKER S.- Co. „ „ „ I). MAURITZ MARTENS.  Banjoemaat  M. S. CHERIM VN. „ „ „ J. S. MARI IV  Probolinao ~ ZIMMERMANS. „ Bjacjokarta „ DECKENS & Co. „ r i Wed. C. W. VAN DER LAAN.  Soerakarta „ M. J. HANSSENS. ( 'Fagal ~ Wed. \AN DORT.   „ A. J. VAN DER VOORT. "" "" P'sCHRFÜDÉB ""„ Bamarama '~ DE (iKool' KOLFF i Co. „ ;/  H. L. DE LYON. „ „ „ JOOSTEN fc Co.",http://resolver.kb.nl/resolve?urn=ddd:110532155:mpeg21:a0011:ocr,2,ddd:110532155:mpeg21:p002,Bataviaasch handelsblad,1054
1185723,1861/01/31 00:00:00,1239,ddd:010545963:mpeg21:a0052,http://imageviewer.kb.nl/ImagingService/imagingService?id=ddd:010545963:mpeg21:p006:image&x=2014&y=1209&w=957&h=1239,ddd:010545963:mpeg21,2971,2448,2014,1209,6,"%* Uitgegeven door A. ter GUNNE te Deventer: I. Dr. J. VAN VLOTEN Nederlandsch Dichten Ondicht der 19de eeuw. I. Bloemlezing uit de Nederl. Dichters; voor Hooger-en Middelbaar Onderwijs voor Rederijkers  en allen die in de Vaderlandsche Poëzy belang stellen. le Dl. f 3.60. 11. Uit de Dierenwereld. Humoristische Legenden in rijmelende Kreupelverzen door een Ex-Schoolmeester ƒ-.90. „Het Boekje bevat zooveel fijne zetten geestige opmerkingen vernuftige en puntige invallen dat wij het een goed onthaal bij onze Landgenooten durven voorspellen. Wie dus in een vrij oogenblik zich wil ontspannen en zijn geest boven de koude eentoonigheid van het dagelijksch leven wenscht te verheffen hij ga zich hier vermeijen."" enz (Europa 1860 N°. 8.) „ Men vindt hier eene ruime mate van humor eu geest in bevallige vormen enz. Ook voor het reciet achten wy den inhoud bijzonder geschikt enz."" (H. B. 10 Ap. 1860.) 111. De politieke gedragslijn onzer volksvertegenwoordigers sedert 1848. ƒ 175. Voor Leesgezelschappen. IV. MISS YONGE (Schrijfster van „de Erfgenaam van Redcliffe"" „Violette"" enz.) de twee Voogden/3.05. gag"" Volgeus bevoegde beoordeelaars is dit het fraaiste werk dezer geachte Schrijfster. V. O. FEUILLET Dagboek van een arm Jong Mensch. Naar den VEERTIENDEN Druk. ƒ 2.75. Een veertiende druk heeft geene verdere aanbeveling noodig.",http://resolver.kb.nl/resolve?urn=ddd:010545963:mpeg21:a0052:ocr,6,ddd:010545963:mpeg21:p006,Opregte Haarlemsche Courant,957
1080231,1861/08/17 00:00:00,1077,ddd:010485231:mpeg21:a0031,http://imageviewer.kb.nl/ImagingService/imagingService?id=ddd:010485231:mpeg21:p006:image&x=1082&y=125&w=1003&h=1077,ddd:010485231:mpeg21,2085,1202,1082,125,12,STOOMBOOT OEN-MM. \fT** De vertrekdagen dezer Stoomboot _Bgsfeg|_ zijn voor de maand Augustus bepaald als volgt: nan Biatavia naar Samarang den 18den - SaÈnarang naar Soerabaija den 21sten ii Soerabaija naar Samarang den 25sten ii Samarang naar Biatavim den 27sten telkens des morgens ten 8 ure. Nadere Informatiën bij de Agenten (2737) LANDBERG BEZOEÏ DE BIE & Co.,http://resolver.kb.nl/resolve?urn=ddd:010485231:mpeg21:a0031:ocr,6,ddd:010485231:mpeg21:p006,"Java-bode : nieuws, handels- en advertentieblad voor Nederlandsch-Indie",1003
81180,1861/11/27 00:00:00,90,ddd:010778622:mpeg21:a0012,http://imageviewer.kb.nl/ImagingService/imagingService?id=ddd:010778622:mpeg21:p004:image&x=67&y=70&w=902&h=90,ddd:010778622:mpeg21,969,160,67,70,4,jeu» _c_e__t _c__ jkjw,http://resolver.kb.nl/resolve?urn=ddd:010778622:mpeg21:a0012:ocr,4,ddd:010778622:mpeg21:p004,Utrechtsche provinciale en stads-courant : algemeen advertentieblad,902
1594292,1861/02/25 00:00:00,679,ddd:000010058:mpeg21:a0041,http://imageviewer.kb.nl/ImagingService/imagingService?id=ddd:000010058:mpeg21:p004:image&x=1671&y=3748&w=2348&h=679,ddd:000010058:mpeg21,4019,4427,1671,3748,4,B\j H. 1. M. ROELANTS  te Schiedam wordt uitgegeven t EENE BVITENGEWOOI GOEDKOOPE UITGAAF I'AÏI DE NEDERLANDSCHE WETDOEEEN. BENEVENS DE GRONDWET EN EENIGE ANDERE WETTEN BESLUITEN EN REGLEMENTEN. * UIT VEEWIJZINQ NAAB SB TOT lEDEB ABTIKEL BETBBKKBLIJKB BEPALINGEN IN SB NBBEBLANDSCHB OP FRANSCHE WET  VOOBZIEN VAN EEN ALPHABETISCH REGISTER. Deze Volks-Uitgave van de Nederlandiche Wetboeken die onder toesigt van een allezin» bekwaam Eegttgeleerde bewerkt is onderscheidt zich van alle beataande Uitgaven niet alleen door hare naauwkeurioheid volledigheid en uitvoerigheid maar ook door den zeldzaam lagen prijt. Zij bevat ruin» 900 blad-tijden (1800 kolommen druks) - 1» gebonden ln heel linnen band en kost slechts EEN GULDEN ZEVENTIG CENTS. Door dezen laag gestelden pry» ia ieder Nederlander van welken rang of «tand in de gelegenheid gesteld zich de wetten zijns land» waarnaar hg zioh dagelyks te gedragen hoft aan te schaffen. (2569),http://resolver.kb.nl/resolve?urn=ddd:000010058:mpeg21:a0041:ocr,4,ddd:000010058:mpeg21:p004,"Nieuwe Rotterdamsche courant : staats-, handels-, nieuws- en advertentieblad",2348
1615224,1861/05/21 00:00:00,1612,ddd:010131405:mpeg21:a0002,http://imageviewer.kb.nl/ImagingService/imagingService?id=ddd:010131405:mpeg21:p004:image&x=2140&y=98&w=1002&h=1612,ddd:010131405:mpeg21,3142,1710,2140,98,4,mm. r^OEM-ljSÈ^ Bederf van het Bloed PPjtoroggjJ HUIDUITSLAG. TgËx&È&JuMïlÊy^ Spoedige genezing en in het geheim $fjf%y van Prim*t»evfl of constitutionnele ziek-^--«^^^ ten d6r beide seksen door de BISCUITS DÉPURATIFS VAN Dr OIiIiIVIEJU te Pari/s In dit aangenaam en gemakkelijk geneesmiddel zijn de actieve beginselen chemisch verbonden met de voedende bestanddeelen wat hunne vertering gemakkelijk maakt en oorzaak is dat zij doordringen tot in alle organische vezelen waar zij den wortel van het kwaad wegnemen waaruit radicale genezing voortvloeit. Dit belangrijk resultaat dat uitsluitend de zoogenaamd aiimentaire methode van Dr. OLLIVIEB kenmerkt zou door geen ander geneesmiddel onder de gewone pharmaceutische vormen verkregen kunnen worden. Nadat vier jaren lang openbare proefnemingen genomen en met den besten uitslag bekroond waren zijn de Biscuits Olllvjer goedgekeurd door de Académie impériale de Médecine geautoriseerd door de Begering en is botendien eene belooning van 24000 francs toegekend aan Dr. OLLIVIEB. — De Biscuit* worJen met goed gevolg aangewend tegen alle ziekten welke voortspruiten uit bederf van het bloed of uit scherpte der vochten. — Vooral genezen zij zeer spoedig de geheime ziekten den huiduitslag de scrofuleuse ziekten van welken ernstigen aard van welken vorm of hoe verouderd ook herhaalde accidenten aan mond neus oogen en ooren rhcumatieke pijnen jeukingen roode vlekken in het aangezigt enz. — Te Parijs rue St. Honoré 274 (op de lste étage). Consulten gratis met gefrankeerde brieven. Hoofddépdt voor Nederland t bij HH. ULOTH Apotheker Zeedijk te Amsterdam. Dépöts bij de Apothekers VAN SANTEN KOLFF te Rotterdam; CLOOS in 't Hang te Rotterdam; VAN RENESSE te 's Gravenhage; VAN DE KAMER te Middelburg; GROOTENDORST te Utrecht en STRAATMAN te 's Hertogenbosch. (21785*),http://resolver.kb.nl/resolve?urn=ddd:010131405:mpeg21:a0002:ocr,4,ddd:010131405:mpeg21:p004,Nieuw Amsterdamsch handels- en effectenblad,1002
3521652,1861/01/31 00:00:00,2074,ddd:010980945:mpeg21:a0050,http://imageviewer.kb.nl/ImagingService/imagingService?id=ddd:010980945:mpeg21:p004:image&x=46&y=3017&w=1698&h=2074,ddd:010980945:mpeg21,1744,5091,46,3017,4,GEKERAL STEAMIVAVIGATION COHPAW. ROTTERDAM en LONDEN. De Stoom-Schepen vertrekken met Passagiers en Goederen geregeld iederen Dingsdag Donderdag en Zaturdag. HEDEN Donderdag 31 Januarij 's namiddags 1 ure VRACHTEN: Groote Kajuit £ 1.10.— heen en terug £ 2.5.—. Voor-Kajuit „ —.17.6 „ „ „ „ 1.6.6. GEBROEDERS SMITH Agenten. Msgang voorbehouden. ROTTERDAM-BORDEAUX. Het Stoomschip GIRONDE Kapit. van Emmerik vertrekt naar BORDEAUX Zaturdag den 3 Februarij. Deie AFVAART correspondeert met de 9IAIEBOOT die 25 Februarij van BORDEAUX naar PERNAMBUCO BAHIA en RIO vertrekt. — Goederen voor BKAZIEIE worden te Rotterdam met directe Connossementen aangenomen. Nadere inlichtingen bij SMITH & Co. te Rotterdam. ROTTERDAM HULL en GOOLE De Engelsche Rader-StoombootNOßFOEK Kapit. James Leetham vertrekt van ROTTERDAM naar HULL en GOOLE Zaturdag den 2 Eebruary. Adres HUDIG & PIETERS. ROTTERDAMSCHE SToofyATßT:yEiiïll.' Den HANDEL wordt hiermede kennis gegeven dat het Stoomschip RAASSTROOItf Kapitein J. J. HANSEN van af Heden In Lading ligt naar MAUBUiIG en MAMBURG. om xoodra de Rivier de Elve vrij van Us is derwaarts te vertrekken. De Agenten P. A. VAN ES & Co. ST§ÖMMRf:ml™iTTElArsr Het Stoomschip CORNELIA Kapitein J J. Muntendam vertrekt Donderdag 9 Eebruai-g naar GENUA LIVORNO NAPELS en PALERMO. Het Stoomschip RALMORAL Kapitein D. Lovius vertrekt Woensdag O Eebruarjj naar BRISTOL en CARDIFF. Adres JOHs. OOMS Ez. & Co. — ROUTMY & Co.,http://resolver.kb.nl/resolve?urn=ddd:010980945:mpeg21:a0050:ocr,4,ddd:010980945:mpeg21:p004,Rotterdamsche courant,1698
1341780,1861/02/21 00:00:00,1284,ddd:011192713:mpeg21:a0001,http://imageviewer.kb.nl/ImagingService/imagingService?id=ddd:011192713:mpeg21:p001:image&x=60&y=1341&w=1045&h=1284,ddd:011192713:mpeg21,1105,2625,60,1341,4,"Gouveriieiuenls secretarie.' 'Paramaribo  den: 2ö Februari) 1861. ww^&T^ÊK^xßmm^sfm&ef^r. '■< -- v Bii .Gouvernements-resolutie : van ; gister. Ivo. J  znn  onder de nadere goedkeuring  • T ' •'. • ~. '. O' r; .» '■■•- i' .. des f Konmgs bil de! Schutterij;» te Para-; mar lbo  . .;. ... • _;  i 'al bevorderd : - tot Kapitein d la. suite de le. Lui tenant J. P. Ka me r 1 i ng en tot le. Luitenants de 2e. Luitenantsi'E. Soesman en E. G. IW ese n- HBBnlha'ff e n.:>--.  . SPywwBß»^Wqi""<i' In i. benoemd : V tot 2e./Luitenants de Héeren : :'5 J. A.!; 86. de Mesnuita ; ""F: D. Dai|ï - - ■ \* r> » - J. M. Schuster * •o ' i • ' ■'• ■ iJ. aalomons Jl. van Me er ten w #1* . .Mr.' C..J. .Heijl i d ij. fV ' ; J/; ' ■  .» r '1 • De: Gouvernements-Secretcrris  ■: E. A Van EMDEN. "";r.*js :y: ■■:v:?' ■ .. •",http://resolver.kb.nl/resolve?urn=ddd:011192713:mpeg21:a0001:ocr,1,ddd:011192713:mpeg21:p001,Surinaamsche courant en Gouvernements advertentie blad,1045
2789948,1861/11/05 00:00:00,2693,ddd:011060980:mpeg21:a0001,http://imageviewer.kb.nl/ImagingService/imagingService?id=ddd:011060980:mpeg21:p001:image&x=89&y=1122&w=1036&h=2693,ddd:011060980:mpeg21,1125,3815,89,1122,6,"Hij deze Courant behoort een Bijvoegsel VERTUEK DER LANDMATL In de maand November den Oden en 25sten. (Foor het land) 4ir» Zaitirdag den 9 ftoveaaï>cr e. Ei. zal ingevolge bekomen magtigiug in het openbaar voor afbraak worden verkocht het reeds voltooide gedeelte van het BOMVRIJ BUS K HUID.MAGAZIJN voer 50.000 N.<ffi nabij Bastion IV der Oosterlinic dezer vesting. De voorwaarden van verkoop liggen dagelijks zon- en feestdagen uitgezonderd van 7 tot 1 ure ten bureele van den ondergeteekende ter lezing bij wien tevens nadere inlichtingen te bekomen zijn. Sokkabaya den 12 Octoler 1861. De Luitenant Kolonel On ler Directeur der Genie in de 3e Mili» taire a/deel. op Java (1620) J. C. R. STEINMETZ. De Resident van Soerabaija zich refererende aan de ter zake betrekkelijke Gouvernemants publicatien optrenomen in de Javascïie Courant van den loden dezer No. 83 maakt bij deje bekend dit op de daarbij ver» meldt* voorwaarden de openbare verpachting van de ver*c'iil|piiiic zoogenaamde kleine middelen in de residentie Soerabaija en liet regt tot den verkoop van AMFIOEN jn het klein in de residentie Soerabaij-i en Keihie over 1562 zal plsats hebben in den dalui van den Regent van Soerahoijt op jKnitirriag dcu Oden November a. s. des morgens ten 8 ure precies. Soeuabata Namens den Resident; den ZSisti n Cctober 1861. De Secretaris  (1716; Chs. VEBOIMP. Veiling van doorgekapt Kopergeld» De Resident van Soerabaija maakt bekend dat op RSanndng de» flGden I9cccmbcr I§BS bij 's lands pakhuizen te Socrabaija  in het openbaar zullen worden opgeveild 400.000 AMSTERDAMSCHE PONDEN DOORGETAPT KOPERGELD waarvan een monster bij gemelde pakhuizen ter bczigtiging ligt. De verkoop zil geschieden op de voorwaarden bedoeld in de Javasche Courant van den 23sten dezer No. 85. &ocrabnij.l Namens den Resident 23 Octoler 1861. De Assistent-Resident voor de Comptabiliteit (1715) ""W. S3IJ&J=»F>JÉÏ.",http://resolver.kb.nl/resolve?urn=ddd:011060980:mpeg21:a0001:ocr,1,ddd:011060980:mpeg21:p001,"De Oostpost : letterkundig, wetenschappelĳk en commercieel nieuws- en advertentieblad",1036
16276,1861/11/04 00:00:00,26,ddd:010136930:mpeg21:a0006,http://imageviewer.kb.nl/ImagingService/imagingService?id=ddd:010136930:mpeg21:p002:image&x=328&y=2673&w=626&h=26,ddd:010136930:mpeg21,954,2699,328,2673,8,ADVERïE H ï I E M.,http://resolver.kb.nl/resolve?urn=ddd:010136930:mpeg21:a0006:ocr,2,ddd:010136930:mpeg21:p002,Algemeen Handelsblad,626
3093122,1861/06/11 00:00:00,2611,MMKB08:000113963:mpeg21:a0016,http://imageviewer.kb.nl/ImagingService/imagingService?id=MMKB08:000113963:mpeg21:p002:image&x=2304&y=1591&w=1142&h=2611,MMKB08:000113963:mpeg21,3446,4202,2304,1591,2,"Advertentie INLEIDING tot de KENNIS VAN DEN ISLAM ook met betrekking tot den Indischen Archipel door G. K. NIEMANN. Wordt uitgegeven en is verzonden door M. WIJT & ZONEN  te Rotterdam. Prijs ƒ450. VOOR""PASSAGIERS EN GOEDEREN direct naar SOERABAYA ligt te AMSTERDAM in lading het bijzonder snelzeilend Gekoperd Nederlandsch Clipper Fregatschip ELEC TR A Kapitein H. WEGMAN  uitmuntende door deszelfs ruime en gemakkelijke inrigtingen voor Passagiers en varende eenen bekwamen Scheepsdoctor. Voor nadere informatien gelieve men zich te vervoegen bij de Kargadoors D'ARNAUD & C D . te Amsterdam. Leeuwarden 20 April 1861. »Gisteren hadden wij een lieer bij ons die eene bus Rarey's Voeder voor zijne paarden had gebruikt en wien het zoo goed beviel  dat hij ons op nieuw l bussen van 90 rantsoenen bestelde. Adverteert  dat het bij ons te bekomen is en dat bij ons getuigschriften over de goede uitwerkselen van Rarey's Voeder ter inzage liggen."" Gebrs. de GlUiFÏ. Rarey's Paarden- en Vee-Verbeteringsvoeder. Dit Voeder heeft de bijzondere eigenschap de Paarden  Koeijen Ossen  Kalveren  Schapen en Varkens  in slechten staat zijnde hun voorkomen te verfraaijen  hunne waarde te verhoogen. Bij paarden voornamelijk verbetert het de verteringsorganen  zoodat zij  aan krachten winnende  veel meer werk verrigten kunnen. Zelfs oude  versleten en zwakke paarden geeft het nieuwe kracht en aanzien  bij het vee in het algemeen verbetert het de hoedanigheid van het vleesïh en van de melk der koeijen en maakt de beesten vatbaar de geheele voedingstof uit hun voeder te trekken. Binnen eene maand verhoogt dit voeder het uiterlijke en de waarde van paarden en vee met 20 a 30 pCt. De Engelsche veefokkerij is aan dit voeder tegenwoordig hare groote vorderingen verschuldigd. Voor zieke beesten is dit middel onbetaalbaar omdat het eene menigte ziekten geneest. In blikken bussen van 45 rantsoenen ƒ 450 ; van 90 r. ƒ9; in vaten van 450 r. f 40; er van 1000 r. ƒ75 zijnde 7£ cent ieder rantsoen. Rarey en C°. St. Jame'* Chambers  Regent's Quadrant London  en in Holland bij Vlaardingen  Lagerwerf!. En in'de bekende Dépöts in de andere Steden. Amsterdam  Verkoophuis. Delft Wed. J T. Wagner. Maassluis P. Poortman. Schiedam M. J. de Lange.",http://resolver.kb.nl/resolve?urn=MMKB08:000113963:mpeg21:a0016:ocr,2,MMKB08:000113963:mpeg21:p002,Delftsche courant,1142
1051980,1861/08/15 00:00:00,591,ddd:010778533:mpeg21:a0013,http://imageviewer.kb.nl/ImagingService/imagingService?id=ddd:010778533:mpeg21:p004:image&x=960&y=53&w=1780&h=591,ddd:010778533:mpeg21,2740,644,960,53,4,NEDERLANDSCHE HYPOTHEEKBANK. NAAMLOOZE VEMOOTSCüAP Gevestigd te . Goedgekeurd bij Koninklijk Desluit van 524 November 1860 No. 33. maatschappelijk kapitaal: Drie Millioen Gulden. Inliclitiiigen zijn te bekomen bij den Hoer A. EBELIiNG Oudegraclit Jacobiebrug C. N'o. 94 Agen' der Nederlandsclie Hypotheekbank te Utrecht.,http://resolver.kb.nl/resolve?urn=ddd:010778533:mpeg21:a0013:ocr,4,ddd:010778533:mpeg21:p004,Utrechtsche provinciale en stads-courant : algemeen advertentieblad,1780
2658432,1861/11/30 00:00:00,1472,MMKB08:000088259:mpeg21:a0012,http://imageviewer.kb.nl/ImagingService/imagingService?id=MMKB08:000088259:mpeg21:p004:image&x=89&y=2094&w=1806&h=1472,MMKB08:000088259:mpeg21,1895,3566,89,2094,4,"Advertentie Oorspronkelijke en Echte Rogge Gczoiièeidsbloem. HET GOEDKOOPSTE GEZONDHEIDS- EN"" VOEDINGSMIDDEL uit de STOOM GRAAN- en MEELZIIYERING van !. IMMINK te Zwolle wordt met het beste gevolg gebruikt als ONTBIJT en DRANK  door BORSfZIEKEN  IIOES TENDE TERINGACHTIGE ÉNGBORSTIGE  ZWAKKE GESTELLEN en KINDEREN MAAG"" en KEELPIJNLIJDERS enz. wordt afgeleverd in Pakjes van 15 en 30 Cent voorzien van Cachet' Gebruiksaanwijzing en Enveloppe  is mede verkrijgbaar bij de Heeren  te Arnhem S. Roelofsen Apeldoorn J. P. van Dijk Barneveld J. Heineman Doesburg J. M. de Roo Epe J. Vis Elburg F. Sipkes lieerde W. K. Brederode Nijmegen F. J. Hubscher Scherpenzeel Wed. P. van Witteveen . Tiel W. A. Caron Voorst B. C. Kroon Westervoort F. E. van der Mee Zutphen C. F. P. Soetens /alt-Bommel H. G. Diesel en de bekende Heeren in de andere Provinciën. STEDELIJK MUZIJKKORPS TE ARNHEM. r P MATINEE MUSICilE ONDER DIRECTIE VAX DEN HEER r. 2 VAN HET ABONNEMENT. Op Zondag den 1 December 1861 ten T/ 2 ure in l)ct (éeboxm MUSIS SACKÜM ingang aan de VELPÉR STEENSTRAAT. ENTREE BUITEN ABONNEMENT 25 CENTS PER PERSOON.",http://resolver.kb.nl/resolve?urn=MMKB08:000088259:mpeg21:a0012:ocr,4,MMKB08:000088259:mpeg21:p004,Arnhemsche courant,1806
2694163,1861/11/02 00:00:00,3559,ddd:000023812:mpeg21:a0027,http://imageviewer.kb.nl/ImagingService/imagingService?id=ddd:000023812:mpeg21:p004:image&x=2432&y=1609&w=757&h=3559,ddd:000023812:mpeg21,3189,5168,2432,1609,4,_^ Op Maandag 4 November 1861  £f des voormiddags ten 11 ure zal inKa. teu overstaan van den Deurwaarder VSjSZ^S^- P. F. ASMUS aan llet Hraliiiis. genaamd de Zoeten Inval IIBBHPt™ aan de Mallemolen . te 's Gravenhage . publiek worden verkocht. eenige MOBILAIRE «ÏOEDEREN als: Tafels Stoelen Spiegels Buffet Kagchels Glaswerk  eenige Schilderijen in Olieverw eene aanzienlijke partij Broeiramen en meer. Te bezigtigen Zaturdag en Zondag 2en 3 November van des voormiddags 10 tot snamiddags 3 ure. .o-. Op Donderdag 7 November _£f 1861 des ochtends ten 10 ure wWj|Lj^M\ zal ten overstaan van den DeurnfisMEMo waarder B. IjKOX  publiek SÉOMilp^nl en om contant geld ten huize van Mejufvrouw de Weduwe Switzar in de Houtstraat alhier worden overgegaan tot den publieken verkoop van Manshocden en Petten  Fournlturen voor Hoeden en Petten Kast Spiegel en meer . terwijl na afloop van dien ver-koop dadelijk in het huis in de Eerste Wagenstraat  No. 41| mede de publieke verkoop zal geschieden van Winkelkasten Toonbank en Gastoestellcn  behoorende alle die goederen tot den Faillieten boedel van Henry Reuters Jr. Fabrikant in Hoeden en Winkelier. Zijnde die goederen te zien daags te voren ten gemelde huizen  en wel van elf tot drie ure. Op Vrijdag 8 November 1861 des voormiddags ten 10 ure  zal traHCfr. N door Chris fiaan Pfeiffer |«li^^T*^Deurwaarder te Delft voor of in rwSBHÖfr'h- huizing aan de Groote yiarkt f-BHHBIW Wijk 4  No. 355 aldaar worden overgegaan tot den openbaren verkoop (om contant geld) van : JUWEELEN  -_OI II en ZILVERWERKeuMOBILAIRE GOEDEREN. alles behoorende tot den faillieten Boedel van W. D. Ilcken  en zijnde te bezigtigen Donderdag 7 November 1861  van 10 tot 3 ure. F. OP.BM_f.HT HOOGSTRAAT hoek PAPESTRAAT. ONTVANGEN CHEVREAUX HANDSCHOENEN lste qualiteit WINTER HANDSCHOENEN en DASSEN  HANDSCHOENEN PEAU NAPLES  voor Uecren ƒl Dames f 0.00 en f 0.00. Jan van Hees en Zoon TE ZWOLLE hebben hunne THEEËN verkrijgbaar gesteld bij J. L. F. C. SNABILIÉ. Spul No. 43 's Gravenhage; om derzelver zuiverheid plaatsen zij hunne DEPOTS bij diegenen  welke een goed oordeel er over kunnen vellen  en dezelve beproeven; deze Theeën munten uit door kracht geur en waterhoudendheid zijn in verzegelde pakjes voorhanden voorzien van stempel prijs en nummer terwijl PRIJSCOURANTEN te bekomen zijn. Jan van Rees en Zoon le Zwolle. ƒlOOO a ƒl2OO. Bijaldien lEMAND van relatien en invloed  genegen mogt zijn die aan te wenden om aan een gehuwd man  van goede familie  Protestant eu gepromoveerd aan eene onzer Hoogescholen eene. niet zoo zeer lucratieve als wel honorable VASTE HETREKKINC. te verschaffen renderende pl. m. f SOO a ƒ SOO 'sjaars (liefst ten platten lande) zou men gaarne bovengemeld bedrag als cadeau ter zijner beschikking stellen. Offertes verzoekt men onder belofte van strikte discretie franco. onder lett. X X in te zenden aan 't Bureau van dit Dagblad.,http://resolver.kb.nl/resolve?urn=ddd:000023812:mpeg21:a0027:ocr,4,ddd:000023812:mpeg21:p004,Dagblad van Zuidholland en 's Gravenhage,757
2762916,1861/12/17 00:00:00,2587,ddd:011061016:mpeg21:a0022,http://imageviewer.kb.nl/ImagingService/imagingService?id=ddd:011061016:mpeg21:p003:image&x=1179&y=99&w=1068&h=2587,ddd:011061016:mpeg21,2247,2686,1179,99,4,"■:■' . ... '-i .; SAUCIS&3 TEÜÏFEE3-. ƒ 3.3* BOUILLON GRAS. „ 1.50 LAIT DOÜX. „ 1.35 CHAMPIGNONS. „ 3.— j CELÉRI3 AU JUS. » 1.75 ! CAPItES FINES. .. 1.26 OLIVES. „ 1.10 DIVERS HOLL ZUUR in witte ttopff. „ 2.— DO. DO: DO; do. g«vronc do. m 1.75 DO. DO. DO. do. kleiafr do. m 1.25 DO; ENG. DO. Jo. do. do. „ 1 DO. DO. SAUSEN'. „ I.— GEMBER in potten. „ 3.25 ENGELSCHE MOSrARD. „ 1.10 SMIRNA VIJGEN in- blikken. n 5.-~ DIVERSE VRUCHTEN AU JUS franwhe. „ 2.50 DO. DO. DO. BRANDY do. „ 2.50 DO. DO. DO.XATURELhollandscLa» 1.50 GEDROOGDE PRUNES d'ENTE fraasche „ 3.— DO. PEREN in «top flfsschea „ 3 DO. APPELEN7 „ 2.50 DO. TAFEL ROZIJNEN „ B.— DO. KRENTEN „ 2.— DO. SNIPPERS „ 3.— GENUA SUCADE „ 5.25 VERMICELLI „ 2.25 SOEP FIGUREN -« B 3.— POEDER CHOCOLADE ik vanille „ 2.50 j DO. DO. gewone „ 3.— DIVERSE fransche GELEI in flescuje» „ I.— DO. enpelsch DO. „ potjes „ 1.50 EAU DE FLEURS D'ORANGERS H 1.10 GESORTEERDE fr?nsche SIROPEN' „ 2.50 SIKOP DE I'ITNCH franrxhe „ 2.50 DIVERSE LIKEUREN vak Fcckisk i botteli ~ 1.50 DO. fransche ]/i do. . „ 350 MARAS( HINO „ 2.50 ROSOLIO LIKEUR „ 2.00 ZAKKIJ „ ».— i BOONEKAMPS BITTER i fl. M 2.— i MAAG DO. i „ „ 1.50 ! POMMEBANS SPIRITUS 4 flescï.je. voor „ I.—: VLIEGENDEKSELS DIVERSE grootte p«r»t«l rau 13„ ll.— : WIT PORSELEINEN THEE SERVIES „ 13.—  KOPERENKANTOOR LAMPEN „ 3.— ; GROENE ZEEP in stopflesscben n 3.50 ! GItOOTE HANGSLOTEN voor pakhuizen „ 4.— STELLEN van fi stuks GESCHILDERDE BLIKKEN TROMMELS „ IS— RHUM DE LA JAMAIOUE in i fl. „ 1.50 . DIVERSE IJZERENKEUKEN [ '■ PEN DO BLIKKEN CAFETIÈRES met Vfgen """" I KOMFOOR Jlageprnien ENG. JAGTKRUID in Vi blikken „ 2.— ! ; DO. DO. DO. „ i do. „ I.— Deze provisien van Albeedikgk Imix Schalekamp  Niecweniiüijs Theyssonnau Chauvet enz. worden voor zeer puik gegarandeerd. bij | (1555) öï'. STimiiCll & FACiHOTYS. I",http://resolver.kb.nl/resolve?urn=ddd:011061016:mpeg21:a0022:ocr,3,ddd:011061016:mpeg21:p003,"De Oostpost : letterkundig, wetenschappelĳk en commercieel nieuws- en advertentieblad",1068
1380972,1861/09/07 00:00:00,1800,KBDDD02:000212866:mpeg21:a0004,http://imageviewer.kb.nl/ImagingService/imagingService?id=KBDDD02:000212866:mpeg21:p003:image&x=1150&y=529&w=774&h=1800,KBDDD02:000212866:mpeg21,1924,2329,1150,529,4,Advertentie OOR de milde bydragen in de 1. 1. maand gehouden Collecte welke f 305. 68^- heeft opgebragt betuigt de kerkeraad der Ver. Prot. gemeente aan zyne geloofsgenooten zynen welmeenenden dank. Cura^ao 3 September 1861. Uit ifaain des kerkéra&cts voorn. S. VAN DISSEL h. t. S. pr. SCoutaiit by de levering. § XE oiidergeteekende verwacht elk oogen* blik eene lading van ONDERSCHEIDENE SOORTEN WP. PLANKEN j en biedt dezelven tegen den billyken prys | vau 10 centen per voet te koop aan ; zullende j degenen die zich het eerst by hem vervoegen i de voorkeur hebben alsmede : voorhanden EENE 1JOE VEELHEID PP. BALKEN en RIBBEN welke tegen den boveugemelden billyken prys by hem'te bekomen is. Cura<jao den 6 September 1861. J b . A bm . JESURUN. Dienstbeurten by de Spaarbank. Zaturdag den 7 September 1861. Bestuurder de Heer R. Raven Gz. Commissarissen de Heeren Daniël Jesurun Jr. en David M. Jesurun. Q VERLEDEN alhier op den 4 Sep tember 1861 in den ouderdom vau byna 39 jaren HENDRIK ESKILDSEN. Cura(;ao den 6 September 1861. S. E. ESKILDSEN geb. MOLLER. Kennisgeviug aan familie vrienden en bekenden.,http://resolver.kb.nl/resolve?urn=KBDDD02:000212866:mpeg21:a0004:ocr,3,KBDDD02:000212866:mpeg21:p003,De Curaçaosche courant,774
2154562,1861/11/21 00:00:00,2242,ddd:010545903:mpeg21:a0019,http://imageviewer.kb.nl/ImagingService/imagingService?id=ddd:010545903:mpeg21:p004:image&x=1019&y=2637&w=961&h=2242,ddd:010545903:mpeg21,1980,4879,1019,2637,4,%* Uitgave van .1. van WEERDEN te's Gravenhage. EEN WEDSTUIJD VANGT AAN VOOR JONGE LIEDEN DIE GEABONNEERD ZIJN OP DEKINDER-GOURANT Lectuur voor de Nederlandsche Jeugd. 52 BLADEN EST 52 ft ROOT E PLATEN. a 7 % Cent het Blad met de Plaat. Men verbindt zich voor een geheel Deel en kan inteekenen bij alle Boekhandelaren in liet Rijk. V De fi_êSïiiff~op den Christelijken Huisbijbel staat open tot 3i December 1861 nadien datum zal de prijs die voor het complete werk thans ƒ9 bedraagt op ƒl2 gebragt worden. De Boekhandelaar M. J. VISSER te'sGravenhage verzendt heden: Chi'isteïijke Muïsbijbei. DS TBÏSf DER GE «E «F STATESOVERZETTING ftEOR D E N » EN INGERIGT VOOR DE HUISELIJKE BIJBELLEZING EN HET GODSDIENSTIG ONDERWIJS DOOR ' C. IS. van Koetsveld*. VIERDE STUK bevattende de Poëzy des Ouden Verbonds Job—Hooglied. (14 8 Btad#ijden.~) PRIJS: /1. Benet-ens lO_- Badzijden ALS GRATIS AFLEVERING VOOR DE INTEEKENAREN bevattende: Volledise Inhoudsopgave en Algemeene Titel (Eerste Beel.  benevens Plan van het werk. fIET-*^*_iittCTBr Met **ezelnle-d'ngenz. ishetlcDeel 'jgj (Aflevering 1a 3) van den Huisbijbel geheel compleet. De prys van het le Deel 636 Bladzijden is ƒ3.,http://resolver.kb.nl/resolve?urn=ddd:010545903:mpeg21:a0019:ocr,4,ddd:010545903:mpeg21:p004,Opregte Haarlemsche Courant,961
546804,1861/10/20 00:00:00,747,ddd:000023798:mpeg21:a0029,http://imageviewer.kb.nl/ImagingService/imagingService?id=ddd:000023798:mpeg21:p003:image&x=69&y=4111&w=732&h=747,ddd:000023798:mpeg21,801,4858,69,4111,4,"MOOO a 0000 Nederlandsche kanne zoeten melk  en 30000 a 3SOOO Nederlandsche kannen gekamde melk alsmede 5 a lilMI Nederlandsche Mudden aardappelen voor winterprovisie van af primo November 1861 tot ultimo .lu""!) 1562. De voorwaarden van Aanbesteding liggen ter lezing op het Oude Vrouwen- en Kinderhuis van af Maandag tot Vrijdag aanstaande van des Morgens negen tot des Namiddags ten vijf ure terwijl de inschrijving-biljetten op den 25 October eerstk. vóór zes ure zullen moeten gestort worden in de daartoe bestemde bus. De opening der biljetten zal plaats hebben op voormeld gesticht in tegenwoordigheid van de inschrijvers op Vrijdag  den 25 October  des avonds ten acht uur.",http://resolver.kb.nl/resolve?urn=ddd:000023798:mpeg21:a0029:ocr,3,ddd:000023798:mpeg21:p003,Dagblad van Zuidholland en 's Gravenhage,732
2080176,1861/03/12 00:00:00,1968,ddd:010584967:mpeg21:a0014,http://imageviewer.kb.nl/ImagingService/imagingService?id=ddd:010584967:mpeg21:p004:image&x=93&y=2220&w=1057&h=1968,ddd:010584967:mpeg21,1150,4188,93,2220,4,Voorloopige Aankondiging. Het nOKI/eOGD ten huize van OBE S. BA.NGMA te Nieuwland is bepaald op Woensdag den 27 Maart 1861. e Deurwaarder T. KUIPERS te Hindeloopen gedenkt mede ten verjoette van den Heer K. M. ALTBUISIUS Gemeente-Secretaiis te Stavoren op Donderdag den 14 Maart e. k. des voormiddigs 9 ure ton sterfhuize van wylen do Weduwe Arend Arende Postuma te Stavoren  by boelgoed te verkoopen: MEUBELEN en HUISGERADEN . bestaande hoofdzakelijk in: 1 Kabinet 1 Chiffonnière 1 Pulpiturn Tafels Stoelen  1 Spiegeltafeltje 2 Bedden met toebehooren 1 Kolomkookkagchel Mangel 2 Trappen koperen Ketels en Gootlingen Porselein  Glas Koper Blik IJzer en Aardewerk zoomede eenige Wlnbeljyere-d.cliappen  benevens S_lnicn  HLleede»en en r_ljrdr_.gt  zoodanig als in een netten Inboedel is behoorende. ~boélgoeldTtëTÊXMÖMA7 Vriidag den 15 Maart a. e. des nademiddags ten 2 uren an huizo van de Wed. Tjalke J. Tal.ma bestaande in: MEUBELEN en HUISGERADEN TIMMER-eo BOEREGEREEDSCHAPPKN enz. Van NOORD Deurw. H] S.st__i'l_B*«-  bij geoloten brief jen van een T perceel uitmuntend GBKIDLAND gelegen to Baard kadastraal bekend gemeente Baard  sectie B no. 201  voor eene groette van 2 bunder 78 roede 80 el (7i pondemate)  vry van reed en drift voor den tyd van driejaren eindigen do met St. Petri 1800 vier en zestg. — Da briefjes moeten vrachtvrij worden ingezonden ten Kantore vao Mr. G. van WAGENINGEN Advocaat le Leeuwarden  vóór of uiterlyk op den 22 Maart e. k ; zullende inmiddels de voorwaarden aldaar ter inzage liggen. BAKRËÜÏT TE HEMEMJÜT Verhuring bij gesloten briefjes: van eene voor weinige jaren nieuw gebouwde HUIZINGE __ beklante BAKKEKIJ  met het daarby behoorend Pakhnla. Srond en Krr staande en gelegen zeer geschikt in de Bunrt en achter uitkomende aan de Vaart te Hemelum; benevens twee stukje* zeer vruchtbaar Greirtland gelegen aldaar te zamen groot 1 bunder 44 rcele 10 el; een en ander thans by Jelle Jans Breimer in huringe en zulks voor den tyd van 3 jarea  ing-arde het Land dadelyk en de Huizing en Bakkery op den 12 Mei 1831. Conditien te vernemen ten Kantore van den Notaris G. ZANDSTRA te Balk by wien de briefjes franco moeten zyn ingeleverd vóór of uiterlijk op den 24 Maart 1861.,http://resolver.kb.nl/resolve?urn=ddd:010584967:mpeg21:a0014:ocr,4,ddd:010584967:mpeg21:p004,Leeuwarder courant,1057
2468487,1861/01/14 00:00:00,2867,ddd:010980930:mpeg21:a0036,http://imageviewer.kb.nl/ImagingService/imagingService?id=ddd:010980930:mpeg21:p006:image&x=1783&y=2204&w=861&h=2867,ddd:010980930:mpeg21,2644,5071,1783,2204,6,SPOORWEG antwerpenIrotterdam. BERICT AAX BE REIZIGERS. Door <le hevige vorst geschiedt de Overtogt der Rivieren te ROTTERDAM en DORDRECHT met groote gemakkelijkheid. Te MOERDIJK worden de Reizigers voortdurend met ile Stoomboot overgebragt. Vertrek van ANTWERPEN ten 7 u. 50 m. 'smorg. „ „ BREDA „ 6 u. 50 ra. „ Aankomst te ROTTERDAM ongeveer ten 3 ure. Vertrek van ROTTERDAM (Pontegat) ten 10 ure 15 win. des morgens. Aankomst te ANTWERPEN ongeveer ten 4 u. 30 m. Geachte Stadgenoot en! De COMMISSIE tot het Inzamelen van Bijdragen voor de Noodlijdenden door den Watersnood berigt dat zij met vriendelijke dankzegging van de Vcrcenlffing van Dames ontvangen heeft de volgende RLtEEttlXIÏSTURREN en EETWAREN: Van Mevrouw W. G. HERKLOTS: 4 Pakken inhoudende tene menigte Mans en Vrouwen onder- en bovenkleedingstukken ; C. T.. 1 Pak diverse Kleeding-^tukken; A. V.. 1 Dito. Van Mevrouw H. W. A. VAN OORDT.- 1 Pak Kleederen van A. H.; door Mevr. R. A. M. diverse Vrouwen- en Kinderkleedinjrstukker.; 12 groote en kleine Pakken met Kleeding door Mevr.C; < diverse Vrouwen- en Kinder-Kleedingstukken; van I N. N. 1 Pak Kousen 17 Hemdrokken Laken en i Vrouwenkleeding; W. C. L. 1 Pak Kleederen; N.N. i Idem; door een Weesjongen uit het Gereformeerd 1 Burger Weeshuis verzamelt! 42 Hemden  57 paar 1 Kousen 15 Borstrokken. Van Mevrouw J. J. VAN OOSTERZEE.- < van S. 1 Baal rClee.ïiogstukkeu;' N. N. 1 Pak { Kleederen; N. N. 1 Dito in een rooden Luijer; vaii L. 1 Pak Wollen Mansbovenkleederen ; VD. L. 1 Pak Kleederen; van Mevr. K. 6 Dekens (i baaijen Rokken; i VD. E. 1 Baal Goed; uit 's Hage 2 B.len Dito; i N. N. 5 Zakjes Erwten en Boonen; N. N. Sokken Doeken Rokken; B. & E. 2 pair Kousen; V. H. Kousen en Halsdoeken; R. 1 Bial R.sl- van K. | 4 Manden Brood (75 stuks); >an II. A.C. J. M. & W. i 1 Pak Diversen; II. C. 1 Pakje Kousen 1 Pak Kleêren. < Van Mevrouw M. RETEMEIJER: diverse Pakken met Kleedingstukken zoo onder als 1 boven. Mans Vrouwen en Kinderen. I Win Mevrouw A. P. J. VAN ROSSEMi 1 Pakket Kleederen VR.; 1 Dito I. M.; 6 Dekens door W. S.; 1 Pak diverse Kleedingstukken. I Van Mevrouw VAN VOLhENHOVENi een zeer groot Pak verschillende Kleederen. i Terwijl de Gelden bij de Dames-Vereeniging ont- ■ vangen grootendeils aangewend zijn tot den aankoop i van Kleedingstukken. ' Deze Goederen zijn alle verzonden naar Zalt-Bommel Zuilichem en Brakel en daarmede eenigzins voorzien in de zeer dringende aanvragen van die plaatsen ontvangen. Maakt de Commissie daarvan met dankbaarheid melding zij wenscht tevens mede te deelen dat de behoeften dagelijks grooter worden en zij de verdere betooning der liefdadigheid ten dringendste aanbeveelt. In naam der Commissie Rotterdam Mr. A. BAKKER Voorzitter. 12 Januarij 1861. M. WIJT Jr. Secretaris. De Hecren N. OSTI te Delfshaven. en A. H. C. VAN SENUS te Kralingen hebbeu zich bereid verklaart! in hunne Gemeenten Liefdegaven te verzamelen en die aan de Commissie ter hand te stellen. NB. De Heer H. VAN RIJCKEVORSEL verzoekt vermelding dat zijne Bus geplaatst is ten zijnen Kantore Leuvehaven Oostzijde 1—245.,http://resolver.kb.nl/resolve?urn=ddd:010980930:mpeg21:a0036:ocr,6,ddd:010980930:mpeg21:p006,Rotterdamsche courant,861
622832,1861/03/07 00:00:00,664,MMKB08:000087996:mpeg21:a0005,http://imageviewer.kb.nl/ImagingService/imagingService?id=MMKB08:000087996:mpeg21:p004:image&x=170&y=383&w=938&h=664,MMKB08:000087996:mpeg21,1108,1047,170,383,4,Advertentie ADVERTENTIES. Burgemeester en wethouders dek GEMEENTE ARNHEM  zijn voornemens Woensdag 20 Maart 1861 's middags 12 ure ten Raadhuize in het openbaar in 2 Perceelen aan te besteden: Het maken en leveren of plaatsen van : lo. 254 El VOETPAD (Trottoir). 2o. 2 URINE-HUISJES  op het Roermondsche Plein. Gedrukte Bestekken en voorwaarden zijn ter Gemeente-Secretarie te bekomen.,http://resolver.kb.nl/resolve?urn=MMKB08:000087996:mpeg21:a0005:ocr,4,MMKB08:000087996:mpeg21:p004,Arnhemsche courant,938
199948,1861/03/31 00:00:00,259,ddd:000010096:mpeg21:a0017,http://imageviewer.kb.nl/ImagingService/imagingService?id=ddd:000010096:mpeg21:p002:image&x=1682&y=4931&w=772&h=259,ddd:000010096:mpeg21,2454,5190,1682,4931,6,*___i__TRIEST. Kapt. Bt/zs ' naar Triest en de Havens aan de Adriatische Zee  zal ook laden voor Genua Ititsorno en Napels. Adres SEUCHLIN en DUTILE Botterdam \ en VAN DEN BEU & Co. Amsterdam. (4226),http://resolver.kb.nl/resolve?urn=ddd:000010096:mpeg21:a0017:ocr,2,ddd:000010096:mpeg21:p002,"Nieuwe Rotterdamsche courant : staats-, handels-, nieuws- en advertentieblad",772
1760682,1861/02/13 00:00:00,2849,ddd:011021912:mpeg21:a0020,http://imageviewer.kb.nl/ImagingService/imagingService?id=ddd:011021912:mpeg21:p003:image&x=44&y=78&w=618&h=2849,ddd:011021912:mpeg21,662,2927,44,78,4,"van LWéhaal tvfAdfiXitT: 4 Maait 1858 JAQKSON. -* Waard* Hittt 1 Ik was eenigen lij I nitt eem wkoudl* id ca kwade hoest gekweld geweest. Ik dUeht er niet* aan te doeti eu dal hel wel ran ■elf **i orergann meer in plaate tan beier te wordéfl fc*rd hel etfpr tol dat mijoe Jong «oo •«gesteld gerankte dnt ik érr.atig ongerust werd. Op aanbeveling vnn J. D. Jitmes uw agent inde a« plaats nam ik eene flnich ran uw Cordial en foor die op wm wat mijne b <est geheel uter. — Ik geloof dal héi *1 béste middel *oor h<» st ia dal ik ooit tag en heb hel eodert allen mijnen Vrienden aanbefoleu dia op die eijie gekeeld werden! t4V De uwe «westelijk D TAUQART Tw»ereJd tlecbta d»>or 0. M. Jackson No 418 Areß Street fblladelphla; en te ko->p bij droo gisten en winkelier» in dn «anscbe Vereenigdo bimen e» Cafeds. Prys 76 Cctii* de fl«*M I» J9PT Agéhtèn v<W»r di-tf rerko-.)> van L/r Hoof ltnd $ Baltantic Cordial:—J.J Hr.-wndtCo. W K. Uavix. en A. F. Whaler te 3beb»ygnn; N C BheU.y/an Falls; P. II (Smith dfc Co. te Plymouth; Keneh dt Stephens'le Gr«*obush' *u A. J. Drickner dt Co te Cnscalc. eÈ» YRlfvNp VAN VERHETËRINQ % v SCHRIJFT ALDU9: ♦ WiLTóa N. H  10 B*pL 1857. Ta gelegenheid geweest cijmh' om de Waftrte «nn Prof. O. J. Wo «d'a lieir Ileal oral ivo te èn beu ik bereid ie seLgen dnt hei aan ujt e aanbevelingen goed beam w<K>rdt. dooi haar idel di»s ouderdom grijs geworduti of ver ble«%t ie tot meerden .leaself* g«wooen glans te Hei maakt hel hanr «acht en buig» I •aam ""en wat *nn meer belang is bet brengt bet 10l g**Mi4bet<i terug; hut got (i aan hel gansehe gestel sijne vernieuwen le. heeJende eigende happee ea beeft eene strekking om de. getondli«>id te hertellen en bet leven te verlangen en aan l»ejaydrn bet. voorkotw* ren jeugd i« ge vee. —  Des«ttjftji galij k«d»jke eigenschappen moert*>n | hfl r|jfc aanbe»el-n. B''pr>*f bet gij ! die »4|geenigH hoofd lekte lijdt en gij su l nim i tn»r van desself* aanwending berouw hebben Waarsciiowihc». — Who lit u vtx»r niets waar i de nnannakiHfls daar er re»»du vcrwlieidetien <>p do mèrlr Hij.. die vr-ichillend»* iia iirti dragon. (iebrlijkt g'««n middel. sis niet d<- w Kirden (Profes*' »o« Wood's ilair Realorntive Dej»-»t Bt. Louis M..„ eu New Yoik ) iu dv &cseli gebliueii zijn. Verkocht bij alle droogislen eu Patent Medicijnen verkooj>era. Al* mede bij alle verkopers van gaUuierien en.-V'iU'i g»edeieu in d-' Vereeaigdo Stalen 'en Canada. HET GROOT OB NEESMID DEL VOOR t*\f * VKOÜWKJT; . . 9§u-—• D« ligi let) ftnn 'U t«akkflre aekse eig.*n w xden onveranderlijk solider pijn of ongemak verholpen duor het gebruik van Mouiilftin Herb Pilln. Zij zijn hét Veilig«le eu lekerste geneesmiddel to t alle siekten waarvoor vrouwen van allerlei leeftijd bloot slaan en meer bijtowderlijk iu di; klimaal. VitiUêhi; die gesifiidheid wentiohen le gcflle- Isn moeten de«e pillen altij i hebben. Nie mand die dotelven ooit eeas gebruikt heeft lal er ton ler willen wJja. Xi] nemeu alle teraloppin gen weg Buiveten het blt»ed én geven aan de huid dat schoone frissohe en g< tonde vooikomen o*l arlioone en gezonde vrouwen zoo teer It In i'-kere t jdperken lijn de»o onmisbare medgeiel. Van een tot *\JFftmeten ellen dng ingeiiomen worden tot dat er verlijrting komt. Van lij I lot lij-! co-1 nigo gifiett Bullen het gestel ion getond houden ' • n h«l bloed too «uive  dat tieklen niet in hel ligchaatn kunnen komru. Judson's Mouniain Herb Pills worden yerlocbt | bij d|^%inedi«|}Nkoojmi. Aanwijzing van bot gebruik der pillen. | Gewoonlijk uefinl mon slechts drie pillen;—doch ■ wakke perst ne i moeien met een of twee beginnen; sterke kunnen er xes op eens nemen.",http://resolver.kb.nl/resolve?urn=ddd:011021912:mpeg21:a0020:ocr,3,ddd:011021912:mpeg21:p003,De Sheboygan Nieuwsbode,618
812754,1861/09/13 00:00:00,783,ddd:011089306:mpeg21:a0025,http://imageviewer.kb.nl/ImagingService/imagingService?id=ddd:011089306:mpeg21:p005:image&x=2067&y=28&w=1038&h=783,ddd:011089306:mpeg21,3105,811,2067,28,8,""" PASSAGE NAAR NEDERLAND wordt aangeboden niet het snelzeilend Nederrriapy \ landsche Campagne BABKSCHIP 'y Kapt. M. RADEMAKERS. Aan boord van dit keurig ingerigt Schip bevindt zich een bekwaam geëxamineerd Geneesheer en eene Badkamer' terwijl de ruime en luchtige inrigting der. hutten Üe meeste 'aanbeveling verdient. Deze bodem zal tegen half October de te huisreis aanvaarden.  ' ' Nadere informatiën bij De Agenten > (1347)' JACOBSON &O. <",http://resolver.kb.nl/resolve?urn=ddd:011089306:mpeg21:a0025:ocr,5,ddd:011089306:mpeg21:p005,Samarangsch advertentie-blad,1038
3255072,1861/03/30 00:00:00,3308,ddd:010131356:mpeg21:a0007,http://imageviewer.kb.nl/ImagingService/imagingService?id=ddd:010131356:mpeg21:p004:image&x=3096&y=2076&w=984&h=3308,ddd:010131356:mpeg21,4080,5384,3096,2076,4,"_ PUBLIEKE VERMAKELIJKHEDEN.^ STADS SCHOUWBURG. j Zaturdag 80 Maart en Maandag 1 April wegens het Pa»»0*3 het Tooneel gesloten. Italiaansche Opera-Gezelschap. j Dingsdag 2 April. Ten voordeele van Mej. Noëmi de !!¦•' .. J Eene eerste voorstelling van: MARIA Dl ROHAN oper» 'V bedrijven. Muziek van Donizetti. (Nooit hier te lande vert»o^ Na het eindigen der opera zal Mej. Noëcni de R-issi in co'^rf eene scène zingen voor haar gecomponeerd door den Heer Me. Venzano getiteld: Za Zingarella. (8 a $ La Direction de I'Opéra Italien a I'honneur d'informer le P% qu'il ne reste plus que quelques Représontations è. donrer » le départ de la Compagnie. Za Direction de VOpéra .R""* F. CAUCCI. Woensdag 3 April. (N°. 85 van het Abonnem.) Eene derde *^| stelling van: MATHILDE op HET LIJDEN EENER Joi ? VROUW tooneelspel in 5 bedr. naar den roman van Eugène Soe'^ het Fransch voor dit tooneel bewerkt door L. J.Veltman. Gevolg( eene zesde voorstelling van: PANTALON BLOEMIST o* A*""* QUIN BEGUNSTIGD DOOR AMOR EN MOMCS groot (url'C nado ballet-pantomime in 11 tafercelen door den balletmeester &> Voitus van Hamme nieuwe decoraiiën van de heeren Plaat d«°""' teurs aan dezen schouwburg machii eriën door don heer J- S'o'y co»tumes van den heer J. G. Dur.vou gedeeltelijk muziek V»* f heer Joh. M. Coenen orchestmeester aan dezen schouwburg- I 0 finale zal door de familie Eoussct gedanst worden. (139<) Aanvang ten B%>*y. SALON DES VARIÉTÉS in de Nes. ifflT' Zaturdag wegens de Paascbfeesten geene voorstel U""»""'* (1375) JJ. IS. »UPO»»' Sociëteit de MMereeniging. Maandag 1 April. Bui gewone Bijeenkomst.  SALON DES VARIÉTÉS in de AmsitUtraat. Zaturdag wegens het Paaschfeest gesloten. a Maandag 1 April (2de Paasehda?). Buitengewone Biieenko11 het Collegio i JVut en Vermaak. (1394) BOAS & JUDE*'* Verwacht Dondordag 4 April ter benefice van den heer ?-$° J eene eersfo opvoerine van: DE RIDDERS VAN DE E*l' ACHTER DE TOONBANK EN OP DE PLANKEN &""j kluohtige vaudeville in 6 tafercelen; voor welke voorstelling af heden nog plaatsen te bespreken zijn. GRAND THÉATRE DES VARIÉTÉS in de AmsteU^ Sociëteit MSendragt maakt JfMagt. Maandag 1 April (2de Paaschdag). Vergadering des aroud' 8 ure. Dingsdag 2 April. Voorstelling ten voorJeele van H. A. V-4*P Bebo A. Pietebsen en J. Bebsé'e. g Verwacht Maandag 8 April door het Hoogduitsche Oper?'. zelschap van Rotterdam Directie J. Eduaid de Vries: EüE*^ THE romantische opera in 4 bedrijven. Muziek van C. Weber. ('393) A. VAN HEgaj^> THÉATRE FRANCAIS mr le Singel. Samedi 30 Mars et Lundi 1 Aviil retache pour le» de Paques. g Mardi 2 Avril. öme représentation de: LES EFPRONT^' médie nouvelle en 5 aetes par M. Emilo Augier. Entree fl. 1. (8 )ieures-)y Le bureau de location avec dix cents do supplément pt* % est ouvert les jours de la représentation de midi a trois be°r""j Le soir de la représentation la salie et le bureau s'ouvr% iept heures et demie. (lil ' Jeudi 4 Avril. Représentation extraordinaire au benefice de ""^ Blanche Dobsat : DANIEL LAMBERT. FRASGATI. j Maandag i April l»6l. GROOT INSTRUMENTAAL COltf' waarop zich zullen doen hooren de Heeren W. C. DEN DEKKER 5. H. C. VAN V** Jf. HEUC KEROTH A EEKHOF Jf. W. SCHÜ^' DER en H. HEITCKEROTH. 2de en 4de gedeelte der Sinfonie van A. BERLIJN; Oa^p» Guerrière Zindpaintner; Fantaisie la Beine de Chypre; Cs&.p de I'Opera la Gazza Zadra Ave Maria et Traumbilder t*o^  Entree fl gedeeltelijk in vertering. Aanvang 3 VL (1405) Jf. EDUARD STLiHP'*^",http://resolver.kb.nl/resolve?urn=ddd:010131356:mpeg21:a0007:ocr,4,ddd:010131356:mpeg21:p004,Nieuw Amsterdamsch handels- en effectenblad,984
3556096,1861/11/12 00:00:00,3832,ddd:010079371:mpeg21:a0017,http://imageviewer.kb.nl/ImagingService/imagingService?id=ddd:010079371:mpeg21:p004:image&x=1930&y=66&w=928&h=3832,ddd:010079371:mpeg21,2858,3898,1930,66,4,"Jaarmarkten in Noordbrabant. 12 November. Cuijk en St. Agatha beeslen en linnenmarkt. 12 November. Esch Gilze beestenmarkt. 12 November. Klundert paarden en beestenmarkt. 12 November. Sprang jaarmarkt. 13 November. Helmond Zevenbergen paarden en beestenmarkt. 13 November. Nuland Roosendaal beestenmarkt 14 November. Leende Herheijden beestenmakt. 15 November. Stratum Waalwijk jaarmarkt. 17 November. Ossendrecht. kermis. 18 November. Alphen en Riel Uden paarden en beestenmarkt. 19 November. Cui|k en St. Agatha beeslen en linnenmarkt. 19 November. Dinther beestenmarkt. 19 November. Mierlo St. Oedenrode paarden en beestenmarkt. 20 November. Lith Waspik Zevenbergen paarden en beestenmarkt. 20 November. Roosendaal Beestenmarkt. 20 November. Rosmalen Jaarmarkt. 21 November. Terheijden Beestenmarkt. SIAUKTBKHIGTËiV. SCHIEDAM 7 Nov. Moutwijn per Ned. Vat zonder fust f 12.50 zonder bel Jenever » » » » » »18.00 » « Amst. Proef » » » » » »19.25 Spoeling per ketel. . . » 1.50 Beurstijdingen. BEURS VAN \JISTERDAM. 9 Noveinher. ] Laagste j Hoogste ! Koers. I Koers Neuerl. Certilik. W. S. a 2 1/2 pCI. 03 3/4 • Dilo dito dito • 3 • 701/4 I Dilo rtilo dilo . 4 • 99 1/4 .99 5/10 Amortisatie Synrtikaal • 3 1/2 • 93 België. Cerl. Adin. Belg. li. .4 1/2 • ; Dilo ¦ Rolscb. -2 1/2 Fuanki.uk Ori£ Certilik. • 3 ( N'Anje. Obligatien. . . • 2 • 41 15/16 42 Duo . ...... 3  501/2 Dilo Binnenl a 6/111. .• 3 •I 47 3/4 47 7/8 Coupon Bewijzen. . . 17 5/8 17 3/4 Amörtisahele Schuld . 67/16 j 0 11/16 PoitTDiiAL. Oblig. te Lond.. • 3 Dilo 1856 -3 •I 45 3/4 4513/16 Rusland. Bij Hope en Co. ¦ 5 ¦ JO2 j Dilo A"" 1828-182° . • 5 • s Negot. 1831 en 1833 . » 5 ¦ j Insch. bij Stieglitz. 5e S. .5 ¦ j 82 1/16  Dito idem 0e S. ¦ 5 ¦ I 93 7/8 Polen And. melL. 11.500 Schatkist Obligatien. . > 4 . Oostenrijk Melahek. .-5 . 45 13/16 45 7/8 Dilo renle te Amsterd. • 5 > 68 7/8  Dito Natienale .... 5 . 547/8 5415/16 Dilo . ..... 2 1/2 • 24 1/16 .24 i/8 Mexiko. te Londen. ... 3 ¦ 251/8 \ 251/4 Grenada .3 1/2 . / 14 1/4 . 145/16 Dilo Uitgestelde .... 41/2 • ¦ 53/8 1 EcuAnoit .1 ¦ Venezuela te Londen . ¦ 3 -19 l/6 I Dilo Uitgestelde . ...» J 1/2 | CiuziLD J 824 . . . .-4 1/2 99 7/8 ' Laatste Prijzen ten 5 ure: Integralen 64.3)16; Spaansrhe 2 pCt. 4.113/16; BinoeuJ. 3 i»Ci 47 5/1 6; Molall. 2 pCt. 4513/16; Dito Nationale 541/516 PRIJZEN DER COUPONS. Metalliek. ... f 21.30  Dito Nationale . I 29.10 Div. Eng. per L. - 11.85 i Eng. Rus. per L - 11.85 Fransche - 56 Belgische .... - 50 Pruissische. . .- 33 ' ilamh. Russen .- 32 11/16 Russen in Z. R. -33 Russen i. P. R. - —._ I'ools. 111 Fl. .. - —.— Napelsche . . - — — Spaans in Piast. - Spaansche Fr - 2.39 PRIJZEN DER SPECIËN. 10 Gld. St. . . 1980 a t' 9 9ü;Brah. dito . . r 265 a I 2.70 Oer. Dkt. . . . -5.55 il -s.6.ssFrancs . . . -2.33 a -2 38 Frans. Kroon . -2.70 a -2.75 Pruiss. Th. . -1.75 s - 1.76 WATERHOOGTE TE GRAVE EN's BOSCH. GRAVE 9 Nov. 0 el 00 rt. hoven AP; gew. 00 dmrn. ]0 Nov 0 e! 00 rt. hoven AP; gev. 00 dmm. De middelbare rivierstand te Grave is 0.75 el hoven A.P sBOSCH 10 Nov. 02 el 21 d. hoven AP; 'gew. 06 duim 11 Nov. 02 el 15 rt. hoven AP gev 06 rt'iim ARNHEM 7 Nov. 7 el 03 rt hoven AP; gew 00 duim KEULEN 8 Nov. 37 el 08 rt. hoven AP: gew. 02 fluim MAASTR. 8 Nov. 41 e! 80 rt. boven AP; 'gew. 02 duim",http://resolver.kb.nl/resolve?urn=ddd:010079371:mpeg21:a0017:ocr,4,ddd:010079371:mpeg21:p004,De Noord-Brabanter : staat- en letterkundig dagblad,928
985050,1861/11/14 00:00:00,1194,ddd:010981193:mpeg21:a0034,http://imageviewer.kb.nl/ImagingService/imagingService?id=ddd:010981193:mpeg21:p004:image&x=946&y=3491&w=825&h=1194,ddd:010981193:mpeg21,1771,4685,946,3491,6,lederen WOENSDAG an ZATURDAG. Met de ) Enchantress Kapit. Thb. Farr. Stoomschepen ) Ocean Uueen „ Chs.Hardy. Het Stoomschip KNCRAÏUTRKSS vertrekt van ROTTERDAM naar HULL Zaturdag 16 November des morgens vrotg. De Agenten SEEUWEN Sr Cc Kaar NEW-YORK het snelzeilend Hanover Schoenerschip ;: CBBISTINE Kapitein H. -%t Altmeppen. Vertrekt 25 November. Adres bij WAMBERSIE & ZOON en CHr. CORNELDER & ZONEN. ■rJfeeA Kaar «HVIW-TORL het shëïïeflend Mecfcelènhurgscn FREGATSCHIP BENNY Kapitein H. Ohlerich. Vertrekt medio November. Adres bij WAMBERSIE & ZOON.,http://resolver.kb.nl/resolve?urn=ddd:010981193:mpeg21:a0034:ocr,4,ddd:010981193:mpeg21:p004,Rotterdamsche courant,825
4695604,1861/03/10 00:00:00,5074,ddd:000010073:mpeg21:a0049,http://imageviewer.kb.nl/ImagingService/imagingService?id=ddd:000010073:mpeg21:p004:image&x=1638&y=92&w=1574&h=5074,ddd:000010073:mpeg21,3212,5166,1638,92,6,"HET HOLLAND COHPOUND is cm onontbeerlijk artikel om te WASSCIHEN daar het alle sohadelijko producten vervangt welke thans gebruikt worden  100 als Bleekpoeder enz. Twee theelepels met een weinig Zeep is voldoende voor een emmer water; voor het bleeken van Garens enz. is het ze.^r doelmatig. De Pakjes a 6 ets. zijn b(j alle voorname Drogisten en Kruideubrs te bekomen. (3195) R. SËVËRÏN7-van m SSKLDORP. 9 Photngra f van verschillende Hoven 's HAGE. Noordeinde IO». Portretten ii ille afmetingen tot zeven voeten hoog (Natuurlijko grootte). (11177) VlMltekaarteii Medaillon- Kcpredoctlen van Schilderijen Dnguerreo'yp'n enz. POBTLAMtSCHE CEMENT. VUURKLEI. VÖOEVASTE STEENEN l:i alle ¦«••te'lea voorhanden. (.ebreretoerdo BASCULES ras* ItHAUHE. niet «es iiinaii«««»•• guarantie. GAZ-PIJPEN. HOLLAND COMPOÜND. 3 9') Bl*» 4'HOP & WBr»CH Brieven fra- co Rotterdam Zuidblnnk 2 — 28. (Sl«8) Men VRAAGT voor een Fatsoenlijk HEER von ruiui 60 j '.ren oud by Fatsoenlijke Prot Lieden : Inwoning met Kost HKHMMCHIVIi en HUIS9ELI »K VERKEER. Adres roet Opgaaf van Standen Prjjs por mnand met franco Brievn onder het Nominor dezer Advertentie aan het Bureau dozer Courant. Itl-rnlic ». \. p. Eene BETREKKING WOKDT GEVRAAGD als AUim-MST-KATEI-R OPZII-TER of tot het doen van REIZEN v.ior < >ne of andero Handelsfabriek  voir iomsnd 50 jaren oud van do R K. Godsdienst en om trent wien de boste Informatiën kunnen gegeven wordon. Zijne vro eere Uandolszaken sedert eenige jiren overgedaan hebbende wenschte hij thans «(jn tjjd en ondervinding nuttig tegen een billijk Sa'aris to besteden Adres franco. Let. XX bij den Boekhai-d.-1-ar deERVENP. T. BRAAM alhier. (3195) '¦¦____SMm Wo^':¦• ÖEfRAAGD: Een in «lle By opzigten zoowel Practisch als Theo» '*'**' **iw retiseh ervaren WERKTUIGKUNDIGE. geschikt nm als t'HKF in eon Constructiewiokcl werkzaam te kunnen zjjn. Adre» met franco Brieven onder het Nommer dezer Advertentie aan het Bureau dezer Courant. (31(16) OP KKN tlommi--1'- en Expeditiekantoor ALHIKR. WORDT GKVRAAGD: Een EXPEDITEUR van circa 20 jaren ; eeno vlugge hand Schrijvende en grondig met het Xeckantoornrerk bekend Adres net franco Brieven onder bet Nommer dazer Advertentie aan hot Bureau dezer Courant t.3171) HULPONDERWIJZERS worden VERLANGD in d*- Gemeenten Zuidla d en Oudenhoorn. Adres s*>n den Burgemeester van die Gemeenten te Zuidland wonende die op aanvraag nadere Inlichtingen zal geven. (2838) AAN Ë^N^^i«>ij^dooiMn<ianitoor WORDT VERLANGD: Een JOM; MENSCH niet beneden de 20 jaren oud  voor Loopend Kantoorwerk  als ook desgovorderd om het I»aden en Lossen van Stoomschepen te surveilleren; de vereischten zij"": goed Schrijven en een goed zedelijk Gedrag en hij dio een of mo-r Talen spreekt zal het meest in aanmerking komen. franco te adresseren m-*t eigenhandig geschreven Brieven  onder de letter» A. Z  ter Handelsdrukkerij (3033) J. W. VAN LEKNHOFF * ZOON. KÜORN.NO LEK AAKSKIN ECHT  bij voorkeur Gehuwd . geschiktheid voor het Straat- en flole. w»'»k bezittende en van goede Getuigschriften vo«.rzion kan rnmiddelijk geplaatst worden. Adres net franco Brievenonder het Nommer dezer Advertentie aan het Bureau deier Courant. (3099) WORDT GEVRA > GD~~OM DADELIJK ÏN DIKNST TH TREDEN: Fen BROODBA&KERSKMCHT zljn Werk goed verstaande P. O. Adres liefst in Persoon bij W. I 4 N DER HEUL HZn te Vlaardi-gen. (3192) WOR DT GÉ VRAAGD: E-u bekwaam GRirrmiskNECUT Ongehuwd . tegen Primo Mei aanstaande. Adres liefst in Pers ion bij P. DE JONG te Vlaardingen. ' (3198) OP EEN Handelskantoor WORDT EEN JONGSTE S&EDH-NDE GEVRi*.GD. eeno Nette Hsnd «chrijvende en niet onbekend met het Eranxch Engelsch on Duitse. Adre» franco onder Lotter A.. bjj de Boekhsndelaren en Drukker» MENGING & DE EO VING. to Rotterdam. (3205) lMFjomem. Adres aan het Bureau dezer Courant. (3232) —.-afflßßp-***--. Een P»t»oenl""jke JUFVROUW. •;_s*«B^^ van middelbaren l'?fijd . P. G. zag *""* """"*""** zich gaime tegen Mei of eerder GBPLAATsT» AI-» IIDISUOUDSTER .lufvroisw van 4.er.rl*eh*ip of tot A«-«si-itcotle in d.-> llnl-dioudli»*; . kunnende van goed Gedrait en Bekwaamheden de beste Getuigen geven zullende meer op Goe 'o Behandeling d«n op groot Salaris (telet worden. Adres onder Lotto- Z . bü H. T. HENDRIESEN Boekhandel Hoogstraat. (3202) k )Ek- EN BANKETBAKKERS-BEDIENDE. Door Ziekelijke omstandigheden wordt GEVR» AGD een Eerste KOEK- en Bl\- KKTHAHhi K«4-H*K«»IK*\IIK die het Pan» en (Barneerirerk verstr.at tegen vast W<rk zoo spoedig mogelijk Gehuwd of Ongehuwd en van goede Getuigen voorzien. onder Lett. Z  met franco Brieven bij B. M. SP 4NJERSRERG Papierhandelaar Oppert te Botterdam. .3200) •""jnMn^ Voor eeno Ouderlooze JOlïflK |B»^DÜCHIKB 22 j.ar oud. P. G. *-** ""**""¦ wenschte men tegen Mei of Junii eene BETREKKING Al. WIHKEiJÜFVROÜW Jufvrouw van «nrltchap of ter Assistentie in een Huishouden. Adres onder Letter G. bij H. T. HENDRIKSEN Boekhandel Hoogstraat. (3201) MËNIr*RATG'FTKGBN MEI AANSTAANDK: Eene Fatsoenlijke DIENSTBODE P. G  v>rr ""field ulleen  cc.* Burger pot kunnende Koken en met de Wa-tch omgaan. Adres bij de WED. f. P. VAN RIJE-TIJPBi\ Boek. Moot-straat (3190)",http://resolver.kb.nl/resolve?urn=ddd:000010073:mpeg21:a0049:ocr,4,ddd:000010073:mpeg21:p004,"Nieuwe Rotterdamsche courant : staats-, handels-, nieuws- en advertentieblad",1574
765444,1861/10/29 00:00:00,454,ddd:010981179:mpeg21:a0041,http://imageviewer.kb.nl/ImagingService/imagingService?id=ddd:010981179:mpeg21:p004:image&x=946&y=906&w=1686&h=454,ddd:010981179:mpeg21,2632,1360,946,906,6,Mejufvr. OUWENDIJK-AANSTOOTS STADHULSSTEEG wijk 9 n° 48*4 heeft de eer liare Begaii*jtl--cr§ te berigten  dat zij van hare rk*»s Is geretourneei d met een SCHOON ASSORTIH KIVT DOIMV LINTEN BLOEMEN enz.,http://resolver.kb.nl/resolve?urn=ddd:010981179:mpeg21:a0041:ocr,4,ddd:010981179:mpeg21:p004,Rotterdamsche courant,1686
171704,1861/11/16 00:00:00,254,ddd:010902292:mpeg21:a0018,http://imageviewer.kb.nl/ImagingService/imagingService?id=ddd:010902292:mpeg21:p003:image&x=1460&y=2717&w=676&h=254,ddd:010902292:mpeg21,2136,2971,1460,2717,4,a&pcrtenttcn. & 25JAUIGB ECHTVEREENÏGING VAN C. ESTËRMAN en M. J. BUHLER. Vlissingen 16 November 1861.,http://resolver.kb.nl/resolve?urn=ddd:010902292:mpeg21:a0018:ocr,3,ddd:010902292:mpeg21:p003,Middelburgsche courant,676
1627104,1861/11/03 00:00:00,1994,ddd:011190946:mpeg21:a0038,http://imageviewer.kb.nl/ImagingService/imagingService?id=ddd:011190946:mpeg21:p008:image&x=918&y=2362&w=816&h=1994,ddd:011190946:mpeg21,1734,4356,918,2362,8,"Advertentiën. Sociélcil • JHi riIEUK .Algvmvenv Verguderiny op ZAT U II I) A G den 2den November des avonds ten hal f »cli l Ure. ; Huixh vdclijko Werkzaamheden. Paramaribo ' diü 2fi Ocfober* 1861:. ' ; ' De Sociétci(houder ' [ 1 IVA. UUUGGKMAN./ A SALOMONS Vendumeester . z.il óp IUKDKtN des ii^detniddagH. oml 4 uur  in hel Huis aan de'K èize r s i raa I naast den Heer 1). BAèZV» verknepen. ; ""Wollen en Kalöeiieit DLKKNS Wit' Olaauw en Gestreept Osnabnigs Linnen| eléu»iilè| Zwarlft Zijtlcu Ma u lil les en Cloaks  fijn ZWAIKT l.iliKV Wh en Ünjv L i n i. e » l> r i I Komisch 1.-ér Wil en Gekleurd MvTKLUOIvIi  Gemaakl|] HKMDEN B orslrokkrn Z.j.leu F-iuiards . Shl > t i ii g ■ Linnen Katoen . fijn Bch>«tsch Baltst en K -m«r. do-k  Damasten Vervellen -en Tafrlgued. 3 dr. KItUSKM  fijne ivoren en bitlei«en ÏAFKLMKSSIiN  enz.■— Alsmede : *oor rekening dien het tuogt aaugaan: tien kistje iuli. 10 liQele en 15 halve |>s. li IE Li- 11: los L/.ryr/siV.ï De GOKUÉIiËN zijn lieden te bezig* tigeu. • I v'1vj",http://resolver.kb.nl/resolve?urn=ddd:011190946:mpeg21:a0038:ocr,8,ddd:011190946:mpeg21:p008,Surinaamsch weekblad,816
3794395,1861/01/11 00:00:00,3631,ddd:011089263:mpeg21:a0005,http://imageviewer.kb.nl/ImagingService/imagingService?id=ddd:011089263:mpeg21:p002:image&x=48&y=66&w=1045&h=3631,ddd:011089263:mpeg21,1093,3697,48,66,8,"; ' Advértentiëii ;; ; • ; Toko-Vendutie • - '7*~v ■ BIJ ■■ ■' . SOESMAN & CO. • op den. 15den Januarij 1861 waarop zullen worden verkocht:  100 pik._ Koflij. • v ; ( v 20 rollen/Imitatje Leder. ' *'; 1 factuur Yeeren en Assen van 3 4 cii 5 bladen.' 2 kisten gelinieerd wjt Papier. . 1 groote partij Boekwerken meest allen We'tónschappelijke werken! ' (24). Verder nog Koópmanschappen Dranken enz. . Op de Tokó-Vend ulie • w"" van Dingsdagden 15den Januarij e.k zullen de ondergeteekenden verkoopen voor • rekening van men zulks zouden mor/en aanr/aan: J. F. S. lv°. 2235 11 stuks \ 1d... ii 2236 7 ii I _ ld. ii 2237 -31 ii .' 6/4 ruwe Calicots. Id. ' » : 2238 32 » l ' ld. »_ 2239 17 ff ' Allen min of meer door zcewatér beschadigd en' gelost uit het Ned. Schip Anna en Elise kapt. C. J. JAS KI. 1 (25) - SOESMAN & C°/ "" op Dingsdag ien 15deu e k. . ZULLEN Soesman i Co. ALSMEDE VERKOOPEN: Jflk -^en Tent-Wagen met echt onderstel. Groote Hout-Vendutie vOp Woensdag 16 Januarij 1861 van eene aanzienlijke partij Ribben Dolken <e/i Doodkistplanken liggende op de gewone Stapelplaats en aldaar'voor een ieder te zien. (27) Tl lOOFT & O. VENDUTIE Op Donderdag den 17den dezer in het Vendu-lokaal van Pringiers & Co. van diverse Koopmanschappen enz. (26) öpÜI: \ I:M)I;TU<; van den l?den dezer . zullen de ondergeteekenden alsnog verkoopen voor rekening van belanghebbenden: 100 pikols Kol'lij cn 46 krandjangs Suiker C • wegende p. mi. 200 pikols. [28] PRINGIERS .& CO. Op de Vendutie van Donderdag zullen alsnog worden verkocht: 5# HAMMEN min of meer beschadigd aangebragt per het Ned schip Anna & Eliza Kapt. C. J. Jaski. '- ' (20) PRINGIERS & C<>.",http://resolver.kb.nl/resolve?urn=ddd:011089263:mpeg21:a0005:ocr,2,ddd:011089263:mpeg21:p002,Samarangsch advertentie-blad,1045
906456,1861/11/11 00:00:00,537,ddd:010981190:mpeg21:a0041,http://imageviewer.kb.nl/ImagingService/imagingService?id=ddd:010981190:mpeg21:p006:image&x=961&y=1168&w=1688&h=537,ddd:010981190:mpeg21,2649,1705,961,1168,6,""" :$ T 0 0 M M 0 T V A AR ï ROTTERDAM HULL en GOOLE lederen WOENSDAG en ZATURDAG. Voor PASSAGIERS GOEDEREN en VEE. De Stoomboot KORFOLH Kapit. Ths. Jewitt vertrekt van ROTTERDAM naar HULL en GOOLE iederen Woensdag. Ligplaats: wieuwehooid. Adres HUDIG & PIETERS.",http://resolver.kb.nl/resolve?urn=ddd:010981190:mpeg21:a0041:ocr,6,ddd:010981190:mpeg21:p006,Rotterdamsche courant,1688
3336800,1861/07/18 00:00:00,3104,ddd:011060886:mpeg21:a0007,http://imageviewer.kb.nl/ImagingService/imagingService?id=ddd:011060886:mpeg21:p002:image&x=1111&y=141&w=1075&h=3104,ddd:011060886:mpeg21,2186,3245,1111,141,4,"Gedurende de maand Julij is het vertrek der stoomsebepen langs de Noordkust van JAVA bepaald: Van Soerabata uw SamaraSq den 7M5'. 22'*. &. 29**. „ Samabaxg  Batavia  9'. 17*. 24"".  31"". „ Batavia „ Sauaka.no „ T. 15«. 22"". „ 29"". „ Samarasq  Soerabata „ 10"". lSe. 25"". „1"" August. Nadere informatien lij j (1011) ' W. COKES DE VISIES. VERTREK VAN SCHEPEN. liet het snelzeilend en voor den overvoer van passagiert ; ! uitermate doeltreffend ingerigt Nederlaudsch Campague j 1 I schip kapitein «I. tl. TAS OPPEN i wordt passage naar Rotterdam aangeboden. Het tchip ia voorzien van eene badkamer vaart een ; geëxamineerd geneesheer en heeft eene melkgevende koe aan boord. I Het vertrek zal plaats hebben uiterlijk ultimo Julij I van Patoeroean. Nadere inlichtingen te bekomen bij den gezagvoerder 'ia het Marine Hotel of bij j • Be Agenten (1043) FRASER EATOM & CO. VERTREKKENDE PERSONEN j G. VAN DAVELAAU CNttPIUS gemag] tigden de firma Mac Lennan & Co. (1101) ! De Heer J. A. VAN VEENENDAAL ;is van af 16 Mei jl. ata Deelgenoot in onze • Firma' 3 opgenomen. - . 11. \AN LEEVWEf & CO. Batavia (10S4) Soerabata. ! Personen bekend met onze koloniale aangelegenheden en I bereid om tegen billijk honorarium I daarover leadingariiMen aan een dag| blad te leveren  of wel genegen om I zich met de geheele redactie van dat blad te belasten en zich bij de zaak te interesseren gelieven zich persoonlijk dan wel schriftelijk te wenden aan De uitgevers van den Oostpost (991) fE HOY & CO.",http://resolver.kb.nl/resolve?urn=ddd:011060886:mpeg21:a0007:ocr,2,ddd:011060886:mpeg21:p002,"De Oostpost : letterkundig, wetenschappelĳk en commercieel nieuws- en advertentieblad",1075
45045,1861/10/19 00:00:00,65,ddd:010131555:mpeg21:a0004,http://imageviewer.kb.nl/ImagingService/imagingService?id=ddd:010131555:mpeg21:p004:image&x=206&y=1837&w=693&h=65,ddd:010131555:mpeg21,899,1902,206,1837,4,ADVERTENTIËN.,http://resolver.kb.nl/resolve?urn=ddd:010131555:mpeg21:a0004:ocr,4,ddd:010131555:mpeg21:p004,Nieuw Amsterdamsch handels- en effectenblad,693
2571984,1861/06/20 00:00:00,2696,ddd:010131435:mpeg21:a0059,http://imageviewer.kb.nl/ImagingService/imagingService?id=ddd:010131435:mpeg21:p004:image&x=3100&y=76&w=954&h=2696,ddd:010131435:mpeg21,4054,2772,3100,76,4,"[Bij den Boekhandelaar F. GUNST zijn Exemplaren voorhanden van: ÜC IIiÜV of ltegtbank f II Ei JU Hf 5 Gezworenen. door Mr. JONAS DANIEL MEIJER uit het Fransch ?* taald door Mr. A. J. NIEUWENHUIS. Prijs f O.SO- (¦*¦""*' PUBLIEKE VERMAKELiJKHEDB*^ «TAMS SCHOUWBURG. Eerate voorstelling van het Fransch Dramatisch GezeUcS*'^ en onder medewerking van Mevr. Adelaïdc Ristori* gj derdag2o Juny. BEATKIX op LE MALOJNÜA JDt-E *¦ L' tooueeispel in 5 bearijven van Légouvé"". Beatrix J_.w. B**l Pause na het 3de Bedryf. Prijzen der Plaatsen: 60 Balcon f 5.— Tweede Amphithé&ter fl' Loge 0 4.— Eerste Gaanderij . • ' Eerste Amphithéüter. » 3.— JJerae Amphithéater. I  0.5"" Bak 0 2.— Tweede Caanderg. • ' *.£ Tot het bespreken der Plaatsen ia het Bureau geopend elk 6 dag van des morgens 10 tot des namiddags 3 ure. t( (.2634) Aanvang des avonda ten aC*™7 iitfï' Le Brochure ia verkrijgbaar bij DE EBYEif H. VAÜ * „TEit &ZOO-T Warmoesgracht LL 48. PARK. DO-.D_-KJ.tA-_. 20 JUJVIJr 186** LANDELIJKE FEESTVIER-P' HABMUiNJJ- CUiVCEEÏ BUITENGE W_>A[E «AZ-ILLUiWIIMATI^ BBHEVMS PBACHTI&I. BENGAALSCHE EN GfIUSÜBSdU VERLICHT* Ver.aaruigd door den Heer il. VAA7 LEECvVEA' f*? Kunstvuurwerkmaker te Amsterdam. PROGRAMMA „eg-* 1. Eene groote Gloria waarin zien ( rachtige kleuren "" Jf eindigende in een zilveren regen. — 2. Twee tegelijk b 6* •**' Cascades welke zich tdi een br.llaat Sterrenlicht veret-'H-e yf 3. Jiene prachtige unineöaohe fontein met gouden en i-iive-*1* / en bloemen veranderende in een driesprong vau brillant 1- y 4. Een dubbel Kruislicht waarin zien pracutige kleuren b<>™ jr 5. Een frappante Liohispiegel met fraaije kleuren. —6*  Jt-* lend Eonteinwerk eind geude in een gr.oten waterval. ' 'p**l' draaijend Bad versierd met de ilatiouale kleuren. —8. **eB ? ' draaijende Zonnencirkel gedekt met eene purpere verde'- .jt-9. Twee tegen elkander in werkende staven siangßgewij-'''' neerd met differente kleuren. — 10. Eene groote Lécorati""' |-Ji stellend» eeue in volle werking zynde Watermolen >an f' Licht geformeerd waarin men het scheprad alsmede het pen van het water zal zien. Entree voor het Publiek f 1..Ö0 per persoon. „ „_» De Tuin zal ten 6 ure geopend zgn en het Concert te aanvangen. nttf* (2622; 3. EDUARD WKVnr*AS> Bij ongunstig weder STBIJE-üOJNCEttT in de GiiOO'X^ *„** alsdan de Bengaalsche en Chineesche Verlichting niet oD ptfkunnende worden de Entree voor het Publiek op J •*• t soon bepaald.",http://resolver.kb.nl/resolve?urn=ddd:010131435:mpeg21:a0059:ocr,4,ddd:010131435:mpeg21:p004,Nieuw Amsterdamsch handels- en effectenblad,954
4812294,1861/05/04 00:00:00,1227,ddd:010131390:mpeg21:a0058,http://imageviewer.kb.nl/ImagingService/imagingService?id=ddd:010131390:mpeg21:p004:image&x=81&y=1387&w=3922&h=1227,ddd:010131390:mpeg21,4003,2614,81,1387,6,"¦^MANUFACTUREN EN MODES ÊSBm ¦**¦ A J WREESMAN. mWyf* Nienwendijk heek Eolksteeg H N°. 189 ""* heeft de eer aan zijne Geachte Vrienden en Stadgenooten kennis te geven dat hij heden Zaturdag zijnen WINKEL en MAGAZIJN' MANUFACTUREN en MODES heeft geopend.—MANTELS MANTILLES SCHAWLS LINGERIES BRODERIES ZOMERSTOP^ ÏÏEEREN-ARTIKELEN; alsmede LINNENS BEDDEN DEKENS en verder al wat tot het vak behoort zijn aldaar in ruime keuze ontval Hij neemt de vrijheid deze zijne Nieuwe Onderneming ten vriendelijkste aan te bevelen hopende met een druk bezoek vereerd te mogen J^",http://resolver.kb.nl/resolve?urn=ddd:010131390:mpeg21:a0058:ocr,4,ddd:010131390:mpeg21:p004,Nieuw Amsterdamsch handels- en effectenblad,3922
2151842,1861/08/07 00:00:00,2198,ddd:010485228:mpeg21:a0020,http://imageviewer.kb.nl/ImagingService/imagingService?id=ddd:010485228:mpeg21:p004:image&x=1119&y=2776&w=979&h=2198,ddd:010485228:mpeg21,2098,4974,1119,2776,10,gotSß® oi' Hef Hsfis toebehoorende aan den Heer GUMPRICH. Te bevragen bij (2566) GUMPRICH & STRAUSS. Te Momps bjöé&êï. Een WOONHUIZEN ■ 'Slfd' f v^n den ondergeteekende met de •'• -: ' r- daarbij behooreude Vanille tuin groot drie bouw's beplant met vierjarige vruchtdragende ranken. Te bevragen bij den Heer BINNENDIJK alhier. B. B.'CRONE. Buitenzorg  1 Augustus 1861. (2553) XHDERLAftDSC H ÏNIHMC'III- Escompto-Maatsehappij De Directie maakt bekend dat tot nadere kennisgave 4.1 1.11 l \ IM DEPOSITO zullen worden aangenomen op de volgende Rente Basis: bij 14 dagen opzegging tot 4y3 pCt. 's jaars. Op 3 maanden vast - 5 ;/ „ ti o „ f ii 5/3 „ i ii 12 // v // 6  „ Namems het Algemeen Bestuur TIEDEMAN & VAN KERCHEM. (2543) Birecteuren. JVOTICE. An Extraordinairy General meeting of the British Residents in Batavia will be held at the office of this Gonsulate on Friday the 9th instant at % o'clock P. m. JAMES M. LACHLAN H. H- M. deling Consul. British Cossllate. V Batavia 2 August 1861./ (2658),http://resolver.kb.nl/resolve?urn=ddd:010485228:mpeg21:a0020:ocr,4,ddd:010485228:mpeg21:p004,"Java-bode : nieuws, handels- en advertentieblad voor Nederlandsch-Indie",979
2696464,1861/11/04 00:00:00,2654,ddd:010131570:mpeg21:a0006,http://imageviewer.kb.nl/ImagingService/imagingService?id=ddd:010131570:mpeg21:p003:image&x=3044&y=77&w=1016&h=2654,ddd:010131570:mpeg21,4060,2731,3044,77,4,"TIENDEN. De ondervinding der laatste jaren op het gebied der Wetgeving heeft genoegzaam aangetoond dat de VADERLANDSCHE LANDBOUW door geen ander middel van de Tienden te verlossen is dan door eenen KRACHTIG EST VOLK.§WIL die zich bewegend binnen den kring der wet maar nimmer Bluimerend tot dat doel onverdroten en onverpoosd werkzaam blijft. De ondergeteekenden houden zich gaarne overtuigd dat de tegenwoord.ge Begering ernstig bedacht is op eeno wetsvoordragt tot afscharhng van den Tiende-last maar zijn niet even zeker of bare weldadige bedoelingen wel met eenen gewenBchten uitslag bekroond zullen worden en of zij niet op een magtig eigenbelang dat voor geene redelijke overtuiging vatbaar is ofwel op staatkundigen partijgeest d.e de verwezenlijking van nuttige zaken zou willen vergde 12ltViatUïeD-' ten2Ü d 6 Re«eriDg «aöersteund ™rde door kLhf? i d?k.wlJze' waa""»n «»""» constitutionele regering hare SÏÏrTte^ÏÏ "" Waa""an ""^a^igingde uitdrukking  *£' ¦¦udTn !? voldoening aan den wenseh van het Nederlandsch landhuishoudkundig congres dat de ondergeteekenden willen beproeven om een verbond op te rigten niet tegen de tiendheffersmaar tegen de Tienden tot welk eindeizg den landbou wenden stand ook in die gewesten die van tienden bevrijd zgn nitnoodigen om zich tot dat doel ui afdeelingen te vereenigen en van de formatie dier afdeelingen aan den laatst ondergeteekende kennis te geven. Het is hun voorgekomen dat bij eenegroote deelneming die zij bil onzen verlichten boerenstand mogen verwachten eene jaarlijksche bijdrage van vijftig cents voor het lidmaatschap van het Tiende- Verbond toereikend zgn zsl om daarmede de voorloopige kosten te bestrijden (terwijl zij zioh voorstellen om zoodra een genoegzaam getal afdeelingen in het leven zal zgn getreden eene Algemeene Vergadering op eene nader le bepalen plaats te beleggen ten einde het Tiende-Verbond te constitueren een definitief Bestuur te doen kiezen ' en do verdere maatregelen tot het voorgestelde doel met gemeenschappelijk overleg te beramen. Zwolle November 1861. {Get.) Mr. B. W. A. E. Babon SLOET TOT OLDHUIS. Amersfoort den November 1861. (Get.) Mr. J. VAN DER LEEUW (4635) Advocaat. G. DE VRIES C. VOUTE D. FREES CORN B. BRUGMAN G. C. DE VRIES G. C. CALKOEN J. E. DE 'VRIES R. ADRIANI Jr. en D. H. ROOü' HUYZEN Jr. Makelaars zullen op Woensdag den 6den November 1861 des Namiddags ten Een Ure precies in de Witte Zwaan op den Nieuwendijk te Amsterdam presenteren te Verkoopen: »8 Kisten TAPIOCCA 1» Pakken GÜTTA PERCHA »73 Kisten PIERL SI «.O 200 Balen S/l GO ME Kt 1105 Pakken f« t TJÏÏIiMt. Alles direct van Singapore hier aangevoerd per Burgemeester van Reenen Kapt. A. W. F. VAN DER MEER VAN KUFFELER en liggende als bij Notitie zal worden aangewezen. (4388) Nadere inlichtingen bij bovengenoemde Makelaars. WEIXTHAIi & Cie^ SIGAREN LA RENOMMÉE. Zijn bijzonder aan te bevelen. Prijs per V* kist van 250 stuks f 4. WEIKTOAL & Cie. (4326 b) hoek Coolsingel en Binnenweg Rotterdam.",http://resolver.kb.nl/resolve?urn=ddd:010131570:mpeg21:a0006:ocr,3,ddd:010131570:mpeg21:p003,Nieuw Amsterdamsch handels- en effectenblad,1016
5298356,1861/06/20 00:00:00,2906,ddd:011060862:mpeg21:a0003,http://imageviewer.kb.nl/ImagingService/imagingService?id=ddd:011060862:mpeg21:p001:image&x=1141&y=1097&w=2110&h=2906,ddd:011060862:mpeg21,3251,4003,1141,1097,4,"Door den Heer Oimbtrg. \ Nieuw II i'iliud Pesapen Ruteuburgerpid Rjsendoornlaan en (rrissec i srhe weg. j Op.Zaturdag de» Sitten Junij 1861."" ' - • Door de» Heer eaé'Tijfn .. ij "" »*■»!■«■ - . De Kaüemsaswesferkade de Kinderstcejj Kabalen Wcrfslriat tul aan de Boomstraten 1 2 en 3 KalLsosok. Dour den Heer Saart. j Chineesche Kamp benoorden de groote handelatruat Officiers Kampc- i ment Kaliemaasoosterkade Pagirian en het Marine-Etablissement. Door den Heer Jlooghndt. De weg van Kapoetran de dijk lot aan Dinoijo Sa-  waan Fïnibongmalang en Bocboetan. Door den Heer van Ltilcrtscld. | Kran;bangankade mot dwarsstraten kapaudjeti. Komedieplein Officier» | pav l.'ocn Ileeren straat en lioemstraat. • ■ Door den Heer Zevergo. Chiccesche kamp bezuiden de groote hanJclslraat Kavalerie kampement ' Semiet Pedjagalan Kalie-anjar Oeudaün en Peneelc. Namens den Kerkenraad Sofeabat» der FrolesUnUche gemeente te Soerutiayj dm \2den Junij 1861 : &tt3OEHIH*JE3. VENDMJEMRTËMENT. I . .. i VEItUUOPIKG. ! Cp Vrijdaq den 2\slen Junij 1861. Bij den heer C. van Lig/en te kampong Baroe van : eene partij houtwerken. (913 Cp Maanrtay den 2lilen Junij 1861. Bij den kapitein Terg au te S»unet van mcubelaire j goederen en Bij de heeren Haije & Co. aan de Kaliemaas van ' scheepsbehoeften. Op Dingtdag den lasten Junij 1861. Bij de heeren Jleijman & Co- in de cliineesche kamp ' van diverse goederen. Op Woensiag den 26slen Junij IS6I. Bij den heer J. F. van Leeuwen te Genteng van meubelaire goederen. Op Donderdag den Zls'en Junij 1861. Bij de heeren Gebroeders Verre! aan de Werfstraat van diverse goederen fn gelijkfijdig Te kempong Baroe van 39 £idney paaiden  kopijen en kalveren. Op Vrijdag den %%sten Junij 1861. Bij de heeren Schimmelpe-tninek & Co- in de chineesche kamp van het rijst pelmolen etablissement Kcdong Sor'o en I'ij den heer Rok te Kembang Jepoon van diverse goederen. Go Zalurdag den 29s(e* Junij 1861. Te Ketabang va:i 20(10 stuks Balken eu Dolken van de heeicn van Eek & Co. (951) I HQÜI-VEMÜTIE Op de Vcmliitic van Vrijdagden 21"". Jnnij a s zal de ondergeteekcnde in de Ivampong Buroc nelder de Ge Jong Lima verkoopen: GO9 stuks {yoede djatie balkeu * afKomstig van de Stapelplaats te Koneganx van verschil lende dimciisiën. ; (915) C E. \\X MËTEIft I iDI LÊLANG lIAIII DJEIIUIAT langgal 21 botlan Djoenie njang daUng ini di Katapoong baroe di blakangnja Gulonj Um'a nanti kita djoewal ada 600 bidji balok kaijoe djati ' njang baik dan pandjangnja roepa roepa kloewa-. ; ïan darie Korrer/an. I (910) «:. BL. VAX !~ VENDUTIEBIJ HAYE & VAÏVf IVIARLE Maandag den 24sten Junij IB6L (.954) Op Dingsdag 2a Junij ! zulten rendtttie In-uden run diverse goederen  i j Waaronder cen paar WAGEN- ggfü ' fp% *W PAARDEN en RIJTUIGEN ffi£& | (946) HEIJHAN & CO. "" ■| PAARDEN VENDUTIE. '; Op Donderdag dea 27slea Juaij «1861. I zullen door D. D. VAN BOECKHQLTZ",http://resolver.kb.nl/resolve?urn=ddd:011060862:mpeg21:a0003:ocr,1,ddd:011060862:mpeg21:p001,"De Oostpost : letterkundig, wetenschappelĳk en commercieel nieuws- en advertentieblad",2110
1994916,1861/09/18 00:00:00,924,ddd:110532146:mpeg21:a0020,http://imageviewer.kb.nl/ImagingService/imagingService?id=ddd:110532146:mpeg21:p003:image&x=1142&y=5&w=2159&h=924,ddd:110532146:mpeg21,3301,929,1142,5,6,GROIIDEGF C -IZIRG van Likdoorns Eelt in I ■ • i Ie No - ' ':' ' eid <lrr iwlen vol yens eene bijzondere en nieuwe methode •' te i' maar >'. hij  tt-n • ■ ' :0r d zal ophouden. D begeven. r LEVI | / Voi tarts van Zijne Mi jesteit Napoleon 1 var iiaud is dagelijks (uit eken van d 9 tol ure iv het MARINE HOTEL No. :4  te Batavia. Copieën van Getulgschriftcn.,http://resolver.kb.nl/resolve?urn=ddd:110532146:mpeg21:a0020:ocr,3,ddd:110532146:mpeg21:p003,Bataviaasch handelsblad,2159
799268,1861/01/01 00:00:00,422,ddd:000022616:mpeg21:a0018,http://imageviewer.kb.nl/ImagingService/imagingService?id=ddd:000022616:mpeg21:p004:image&x=1012&y=4241&w=1894&h=422,ddd:000022616:mpeg21,2906,4663,1012,4241,4,w. mmwiGM hoogtaaï' W| vn assortiment gants chevreaux pour dames tl fiftI GANTS DUCHESSE POUR BAL AlUUll avec e AC ET et FLOCIIKS en OR. .,http://resolver.kb.nl/resolve?urn=ddd:000022616:mpeg21:a0018:ocr,4,ddd:000022616:mpeg21:p004,Dagblad van Zuidholland en 's Gravenhage,1894
3503516,1861/03/07 00:00:00,3238,ddd:011192719:mpeg21:a0004,http://imageviewer.kb.nl/ImagingService/imagingService?id=ddd:011192719:mpeg21:p001:image&x=2202&y=1329&w=1082&h=3238,ddd:011192719:mpeg21,3284,4567,2202,1329,4,"s V Vendumeester; /aan W il» man s van de plant. Potnona ;'c.; i - Idem J. 11. C.v Wolff aan L. 11-ƒ. Ma e s voor zijne reeds hebbende err te: tvërkriigene hinderen""'; van ' het lluis Erf op deuf Keizerstraten' N. W/ 'La. A ' Nol '2100. tW^La;;B;NaN'l3.'-.JÏ'H'ï;>'//;i'::ii'': den Q^Maart' ?t^del^f^%elaU:met -cle'/uiictieji'van den.Grifliwbii Wikt '-'Gerekts/tof ; A F D DAIJ •• • ' V;: . Het C.öllcgie. van Cömmi«sanssën' voorr Keti' -jl dels ' iii de kólöuie' óiiriiittmèbréart• rtér %nhi& van belangHébbêuden dat v gedarêndo v ■-^Ül:opgemeld Departëmëh t -zÜrj gejifïuideerd de navolgeridë: boedels: als : . êeiniI'batig saldo van 7' 70 »Adrraan Niebert » » 21057 A » R o'ra Ij e r t u s L'o. n- ' . .. gerhou Ruar d i .» » &1i77?» en» J aÜ: Fre d e ri k Vr ; H a r f s ë n » 23476». Wijders 'datgedurende ' dat jaar ; 'in i ""*i • i .i 4V--: "" 1 'ï* v»* ' • .• |. -• ■ - -Ï V . een staat' van insolventie zijn algeloopen dé boedels van : P ie r re'A im e J osep ii D u B.u s S ar.a S a lom'on 'S a m soÜ ar tin Mon teca 111 n i ; Jr.; Jo* hann e s loep et; Jo nan n a Car o« lina F ij t J Jo'li nJ Elcl e r eri daaraan toebehoord hebbend aandeel in de plan» taadjèn Coneor'dia .en' fóiïmrtlöt LL.  -D orotbe a e c ca' Sa ff i n: J a'n Gas* p a Wie e? bra K a m Sol i s T h ö m a s* Fin la ij;'J""an R a d en Pieter Nemel.c. llèt Cóllegie vxm; Commissarissen vooiv - ; ' : 'l?; President- • .>' EGBERT £ vAiri EMDIJN. ■}> Ter ordonnantie van ' het: Collegie "" l De waarneinende Secretaris \:i\ > - .'.""O A.v H. DkojGRANADA.: ' ■ [1829]'»i'Dcü Eiploieteurï bij thet nGeregt«*v hof iinf de ""Kolonie Suriname;) tal op.«Vrijdag den ■ 81 Maart ï 1861 des . rvoonniddags orai half- negen ure; 'publiekelijk bij eieeutio verkoópen: -t- •• • • u .-i 't ■:: • s i cnr. aan- d« Keizerstraat 'N. W. La. ;B No.- 211. O. *W» La: G No: öl (aarkkomende-:Dwi J:. i o th. f A'Paramaribo [den 6 'Maart 1861. :; OIMON ::A3ÉNDANÖN Sii r • •.",http://resolver.kb.nl/resolve?urn=ddd:011192719:mpeg21:a0004:ocr,1,ddd:011192719:mpeg21:p001,Surinaamsche courant en Gouvernements advertentie blad,1082
1257796,1861/01/12 00:00:00,1396,ddd:010079243:mpeg21:a0014,http://imageviewer.kb.nl/ImagingService/imagingService?id=ddd:010079243:mpeg21:p004:image&x=1963&y=1240&w=901&h=1396,ddd:010079243:mpeg21,2864,2636,1963,1240,4,DE ZALF EN PILLEN VAN zijn merkwaardig voor hunne doelmatigheid ter genezing van huidziekten. Zeere hoofden dauwworm enz. worden veroorzaakt door dc onzuiverheid des bloeds en hel eenige zekere middel om zulke kwalen te ontwortelen is het geregelde gebruik der Pillen van Holloway en ter zelfder tijd de toepassing van de onschatbare zalf. Dagelijks worden gevallen van genezing door dit middel bevestigd  waardoor de bewonderenswaardige doelmatigheid als bloed zuiverend en verster kend middel er van bewezen wordt. Dezelve zijn vooral aan te bevelen om wonden zweeren en klier gezwellen le genezen. Personen die hiermede aangehaald zijn moeten niet uitstellen er van gebruik te maken. Door het vermeerderd debiet zijn de prijzen als volgt Doosjes Pillen f 080 f 185 1' 300. f 675 f 1350. f 20X0. Pot j es Zalf f 080 f 185  f 300 f 705  f 1385  r 2025 Zijn op franco aanvragen a kontant te bekomen bij 11. van Goorbergh te Breda ; bij J. P. Verlinden ic Bergenopzoom; bij G. Does le Tilburg; en bij J. Straalman. Hoolddcpóthouder te 's Hertogenbosch ; alsmede in Holloway's etablissementen le Londen 244 Strand en le New-York 80 Maidcn-Laine.,http://resolver.kb.nl/resolve?urn=ddd:010079243:mpeg21:a0014:ocr,4,ddd:010079243:mpeg21:p004,De Noord-Brabanter : staat- en letterkundig dagblad,901
2241866,1861/12/05 00:00:00,1126,ddd:010131602:mpeg21:a0005,http://imageviewer.kb.nl/ImagingService/imagingService?id=ddd:010131602:mpeg21:p003:image&x=2063&y=3969&w=1991&h=1126,ddd:010131602:mpeg21,4054,5095,2063,3969,6,Heden is verzonden de November-Aflevering van het NEDERLANDSCH MAGAZIJN. UITGEGEVEN onder bescherming van H. JM. de Koningin der Nederlanden. INHOUD. TEKST. Genova la Superha (1860) door G. E. C. Oroiset. De Paardenataact noa. — Schetsen uit België V door Yours. — Een vergeten plekjen in het veldteeken der Turksche legers. — Wandeling door een gedeelte Noord Holland. — Renswoude door W. en H. — Oude liefde roest van Eriesland door P. H. Witkamp. VIII. — Een Europcër onder de niet doir J;han Gram. — Een nieuw vervoermiddel djor lucbtpersing Kabylen. V. — Eerlijkheid en gastvrijheid der bewoners van Tene- door W. — Het tooneel in de hoofdstai Mormonen.— Een nieuw Elrrffa. —De R.imeinsohe Zuil te lael door P. H. Witkamp. — HetLoo dorado. — De jongste Laudnnt iekkingen op Nieuw-Holland. — door W. J- Hofd.k. — Twee Midrieneeu*aohe Dichters door A. I. — Kunst- en T. oneelnieuws. —Sa Is Schouwburg. — Fransche Opera. Oe Starren duur A. E. Berg.— Het kasteel Nyeubu/ent. — Dage- Een Cjuceit vaneen jorg Nederlandsch Toonkunstenaar Grand denkpenning van het Antwerpsche Kunstles.. door A. I. — De Moe- Theatre. GRAVURES. De vilJa Palavicini; teekening van W- Hekking Jr. gra-u;e «an t gravure van E. Vermorcken. —De Gedenkpenning van't Kunstoon- E. W-'isseabrucb. — 't Praalgraf van Biron van Cochootn.—De ' gres; ick-niig van J. W. E. Each*lgravure van JE. Vermorcken.— Kerk te Slooten; teekeningen van W Hekki: g Jr. gravuren van E. DeMoifi'on; teekening van J. Sclißutn burg gravure van J.van Hjof.— vVtisseobruch. —De Lemmer; teekening van W UekkngJr. gravure De Hervormde Kerk te Rensw.iude; teekening van W. Eekking Jr. van Is. Weissenhruch. — De waterval aan deu kleinen vijver m bet gravure van J. van Hjof. — Ged-elte van het Luchtpompwerktuig Park op 't Loo. —De Slotpoort en het Terra*. —De Ceder voor bet vonr het vei voer van brieven enz. —De Buizen. — Het inwendige der oude Loo; teekeningen van J. Q. Smits gravuren van J. van Hoof. — Buizen; teekeningen en gravuren van P. van Groningen. Jacob van Maerlandt en Melis St.ke; teekening van Ch. R chu'sen Prijs f 5 per Deel van 50 k 60 bladen met meer dan 150 Houtgravuren. Alle Boekhandelaren namen Bestellingen aan voor dan Jaargang 1562. (5180),http://resolver.kb.nl/resolve?urn=ddd:010131602:mpeg21:a0005:ocr,3,ddd:010131602:mpeg21:p003,Nieuw Amsterdamsch handels- en effectenblad,1991
1148882,1861/01/16 00:00:00,1198,ddd:010545950:mpeg21:a0015,http://imageviewer.kb.nl/ImagingService/imagingService?id=ddd:010545950:mpeg21:p003:image&x=67&y=81&w=959&h=1198,ddd:010545950:mpeg21,1026,1279,67,81,6,"*** LANDGENOOTEN. De ramp welke onze gemeente en anderen in den Bommelerwaard getroffen heeft is welligt u allen bekend — minder echter onze hartverscheurende toestand! In een oogenblik des tijds werden onze huizen ten gevolge de twee doorbraken te Zuilichem en Nieuwaal door het water verzwolgen eene latere daarop gekomene ijskorst maken vele woningen welke Slaande hebben kunnen blijven onzigtbaar. Onze eenige gewaande toevlugtsoord was*dijk waarop menschen en vee hun leven hoopten te beveiligen; maar ook deze is door het wassende Waalwater ongenaakbaar; - eene laatste P tW6lk zich ter Plaatse va"" het on-<=val bevond ; d__r hebben menschen en vee hun leven beveiligd. cndnnrS0 rl hetJ._G<>d de Heere welke ons deze ramp in Zijne dezZf r^ J u W'lsheid heeft gedacht - maar het is ook nH™ w- . W W6lke UWe hlrten ten onzen gunste kan doen wh!fd«; N.V' fme/ken Vïn u hulD en bÜrtandi nog onlangs zagen Tniro nt lai""d V°°r de onSel^kigen in Syrië meer dan eenige andere natie hare zucht tot geven heeft doen zien. Och! doet ISfnlrW? her1bl13k«-„ GiJ geeft het aan ongelukkigen  diep ongelukkigen welken alléén hun leven hebben |ered. lle heeren A.Bax Plaatsvervangend Kantonregter te Heusden V«„ Elout*an_ s°eterwoude te 's Hage en de Notaris Jiskoot te \_.\£ ' •Ze te bestendige aanschouwer is van ons ongeluk. hebben z.ch met het ontvangen van giften belast; van welke ontvangst in de Couranten zal worden melding gemaakt. 11 xo ooner Ja°9 H' C- mn der Kvn' Korte Hoogstraat Wijk ' "" • i 9° • te «otterdam bereid in liefdegaveu te ontvangen alvorens een bus tot ontvangst der giften zal geplaatst worden. G. van OS. f""lst T. van OPSTELTEN. 11 January 1861. G. KLOP. A. KOOLHAAS. Rn . H. van OS Jz. iue uitgevers van de Haarlemsche Courant willen zich gaarne Heiasten met het ontvangen en overmaken der gelden-.]",http://resolver.kb.nl/resolve?urn=ddd:010545950:mpeg21:a0015:ocr,3,ddd:010545950:mpeg21:p003,Opregte Haarlemsche Courant,959
1759560,1861/09/20 00:00:00,1892,ddd:010252764:mpeg21:a0019,http://imageviewer.kb.nl/ImagingService/imagingService?id=ddd:010252764:mpeg21:p004:image&x=1971&y=2039&w=930&h=1892,ddd:010252764:mpeg21,2901,3931,1971,2039,4,"Zoo lang de voorraad strekt is bij boyengenoemden verktijgbaar: Chemin de la Croix avec les pratiques de cette devotion déliée a la très-sainte vierge etc. etc. ƒ0.20 Conformité de la foi Catholique  avec 1 É^lise primitive etc par Mgr Dosey évèqub de montauba* ƒ0.20 i*icu est Tamour lc pms pnr choix de prières approuvés ƒ0.20 Légende de Saint Jtean-Baptiste __ par M. I'abbé Gaütuier ƒ0.20 Notice sur la vie et sur lesvertns de rhuinblc servante de Bleu Anna-Maria Taigi par Mgr J. E. O. Luquet ƒ0.25 Histoire de Sainte Godelive de Ghistclles legende du X[e Siècle par M. Louis De Baecker ƒ0.25 Essai historique sur rimmaculéc Conception par M. I'abbé E- Darras ƒ0.25 La chasse aux pretres proflis de ceux qui la font et ce qu'ils en retirent par le Baron DE Nl_tl.SE ƒ0.25 Cinquante proverbes causerles famllières et chrétlennes dédiées aux sociétés d'ouvriers par Eugène de Margerie ƒ0.25 La Cascrnc et lc Presbytère par M. le conté Anatole de Ségur 9e édition ƒ0.25 Fatales et Poésies  par M. le comte Anatole de Ségur .'""¦'.•• ƒ0.25 Uistoire chrétienne de la Cniiforute par Mme Matuilde Tarweld ƒ0.25 Lc Pélérinage de christiau traduitde I'Anglais de John Bunyan et le Pasteur de la nuit de Noël traduitde I'Espagnol de Palafoxavec 16 gravures ƒ 0.25 Lc Roman dn Renard version épurée avec notice par M. Oollin de Plancy avec 6 gravures ƒ 0.25 Testament dun vieux laboureur recueilli par M. G. Symphor Vaudoré ancien représentant de I'Orne 2° édition ƒ0.20 Théologie populaire exposée dans le bon sens du Gure Meslier le véritable ƒ0.20 LesTribulations de Robillard histoire du temps de Louis-Philippe par S. de l'Enclos . . ƒ0.20 Deze 17 werkjes te zamen ter waarde van ƒ3.90 worden bij eikaar voor./ 2.90 afgeleverd.",http://resolver.kb.nl/resolve?urn=ddd:010252764:mpeg21:a0019:ocr,4,ddd:010252764:mpeg21:p004,De Tĳd : godsdienstig-staatkundig dagblad,930
4431330,1861/06/02 00:00:00,4645,ddd:000022779:mpeg21:a0014,http://imageviewer.kb.nl/ImagingService/imagingService?id=ddd:000022779:mpeg21:p002:image&x=1958&y=65&w=954&h=4645,ddd:000022779:mpeg21,2912,4710,1958,65,4,DIENST tusschen 's (iravenhafe en Sclieuniiigen ¦net de Snelvarende («ondel. B URGEMEESTER COPES van CA TTE NB URGH UREN VAN VERTREK: Van den lsten tot en met don ±6den Junij. DA G E L IJ KSCHK DIE NS T. Van 's Gravenhage  voormid. 91; u. namid. 1$ „ „ Scheveningen voormid. 11 j „ „ „ namid. 3£ „ ZONDAG- D I E N S T. Van 's Gravenhage voormid. 91 ure. „ „ namidd. I| 5 s| 6 en 6J uiv. „ Scheveningen voormid. lit ure. „ „ namid. 3^ SJ f> 7en B.J ure. «*k .\ EDERLANDSCIIK iÉÉ STOOMBOOTREEDERIJ. ZOMEBDIEATST van af HA Mei IS6I. DAGELIJKSCUI''. DIENST tusschen Rotterdam -Mannheim. ItO Tl XX» l tt afvaart Boompjes. Van Rotterdam naar Emmerik 's morgens ten 10 ure. „ Emmerik „ Keulen „ „ 7 n „ Keulen „ Mainz 's nachts „12 „ „ Mainz „ Maniilieim 's morgens „ 4 „ „ Mannheim „ Mainz 's middags „ 3 „ „ Mainz „ Keulen 's morgens „ 7 „ „ Keulen „ Nijmegen 's avonds „ 8 „ „ Nijmegen „ Rotterdam 's morgens „ 9 „ Vracht van Enkelereis. Heen en terug li. K. V. K. S. K V. K. Rotterdam naar Nijmegen /'l.BO f 1.20 /' 2.70 fI.SO „ „ Keulen - 4.70 - 2.95 - 7.— '- 4.70 „ „ Mannheim - 9.15 - 5.85 - 14.60 - 9.95 de STOOMBOOTEN dezer Reederij hebben op het dek Glas-Paveljoen en ieder 2 slaapkamertjes welke laatste voor ééne reis AK TE HUREN zijn. ~7~ Te ROTTERDAM ligt ln lading voor PASSAGIERS WÊ(\ BATAVIA rï*-nP<fW^\\ i 1 extra snelzeilend 'ifillM C' AMPAGNK BARKSCH I P dÜSÉr SCHEVENINGEN Kapt. S. ran dcv Velde  hebbende daarvoor uitmuntende inrigtingen en » ertrek ÜO .lunij. Adres bij de Cargadoors P. VAEKEVISSER & ZONEN teßoTT!;iiii.v.M en DE ('ONINGII& C°. te Amsteudam. HKT St'HKl- K\*iI';\KKSKI\I»MJPKAEPARAAT is oen nieuw uitmuntend middel ter versterking van het Haar. Hetzelve bevat in eene juistii verhouding alle bestanddeelen welke het Haar tot voedsel dienen en de Huid versterken llet reinigt het Hoofd van de schilfers belet hel uitvallen en bevordert den groei der Haren is uitermate verfrisschend en van het fijnste parfum. Prijs per Flacon ƒ 1.20. HKT KAU lIKS CARHKS van Mavyavetha üvass werkt gunstig bij krampachtige verzwakkingen van zenuwgestel en spijsverterings-organen bij flaauwten aanvallen van beroerte ongeregelden bloedsomloop en vervangt de Hoffman's druppels  met veel zekerder en aangenamer werking in alle voorkomende gevallen. Bij ieder Fleschje wordt eene aanwijzing tot gebruik afgegeven. Het kleins Fleschje 50 ets. het groote/1 De OOSTERSCIIK %VI I RUI n ITIS4 UK liltl IDKX-OI.IK is uit vlugtige Planten-Olién vereend met de Cajapoet-Olie te zamen gesteld en geneest alle Rhttmatische ziekten en verlammingen piju in de gewrichten verstijvingen in de pezen en andere aandoeningen. De inw rij vingen geschieden tweemaal daags met de vlakke hand; het lijdende deel wordt daarua met flanel of baai gedekt dat voor het vuur warm gemaakt is STOL.L.-S l»Kt I'I'KL.K* bevrijden oogenblikkelijk van de hevigste kiespijn ; men behoeft slechts een daarmede bevochtigd puntig watje in het oor te stoppen aan de zijde waar de kiespijn is. Het Fleschje kost ƒ 1. Amstekuam  I I II HOOl'lil IS. 'sGiiAvusnAi-E SACK & COMP. En in de bekende Depots in de andere Steden. lIOKkIIWIIH. van \\. M. COIYÉE Lange Poten. REISBOEKEN VOOR ALLE LANDEN VAN EVHO P A „ waaronder een uil muntende RUNGIDS. IN HET HOLLANDSOII. Voorhanden de complete Collectie T/tIiCHMTZ (MLECTION of lIKITISII U THORS. Albums l'lioi ot:raphiqncs  KINDERBOEKEN ARTICLES DX LUX F Depot van besle Nclirijftiikf. Lange Polen 23. M. M. COLYËK. ï,http://resolver.kb.nl/resolve?urn=ddd:000022779:mpeg21:a0014:ocr,2,ddd:000022779:mpeg21:p002,Dagblad van Zuidholland en 's Gravenhage,954
2202869,1861/03/12 00:00:00,2053,ddd:010584967:mpeg21:a0013,http://imageviewer.kb.nl/ImagingService/imagingService?id=ddd:010584967:mpeg21:p004:image&x=80&y=158&w=1073&h=2053,ddd:010584967:mpeg21,1153,2211,80,158,4,"YERHÜfUNG. u ;:_Si.^___S¥f_^Ï^Sl^ Sht-W Teihtiis onder Ge■:_*>_■ voor 8 jaren tegen borgstel""T^S.^eVceelen WEID-Verf BCOILAND gelegen onder ••nibrandabnren; alle in eigendom behoorende aan den Heer ?*3 Geertsma te Ircsam; bjj vorige advertentie aangeduid. _r__llinS \T_P De Notars A. HAAGSMA te VLtiïiLliïMïe Bneek zal op Donderdag den tt dezer 's namiddags 2 unr by N. de Kuiter op t Nieuw ' Tolhuis onder Grcaga  mede voor 8 jaren tegen borgstel- Bne verharen: •!___•«. In s'.nk GREIDLAND ondar Sijbrandaburen _. Ft;/.»*» ïeoaamd laatst gebruikt door Pier J. Wijtsma; nagelaten Aeor wijlen Hinne Jeltes Bakker. BoelgoedTe Oppenhuizen Do Notaris A. HAAGSMA te Sneek zal op Zaturdag den ■ Kaart 1861 des voorniddags 10 uur ten sterfhuize van vjlen Tbys D. Haga te Oppenhuizen by boelgoed tegen W7w^S cT^HOKLINGEN  BOERENREEUW ""ooals- Hooiwagen Kam mot toebehooren  Harken Vorken [«eiken Lodden  Grijpen 2 koperen Emmers 2 Gootlingen Saqdketel Gierbak  Meikanon Molkenvaten en Boteraden _n oer.9 Boot met 2 stel Zeilen; voorts circa 6 koeseten ïïcos een partytje llimi. en eenige MEUBELEN en HUISGERADEN enz. Geene Disschen of Tapperijen ep het Hiem. VERKOOPIXGe tarh™ Kon.mm zal'op den '._ Maart ISG L veilen en don 30 Maart daaraanvolgende toe■wij_en telkens des na-femiddags te 3 unr ten huize van C. 3e Roos te Stavoren ten verzoeke van den Heer K. M. ALTHUï.IUS als Curator in het faillissement van D. DEMMER iMaar: Eene HUIZING en Krr te Stavoren en ten kadaster dier i-emeente bekend sectie A no. 610 1 roede 14 el. Breeder bij billetten on_ cbreven. <3ï___r*¥ _TAl7_& Mr. deCARPENTIEB No'aris lï .ji_-l_\j'""s__i-re te Koudum zal aIsDU op den '5 Maart 1861. 's morgens te 9 nur verkoopen: De ROE- IiENDE GOEDEREN behoorende tot de onder bet voorregt van boedelbeschrijving aanvaarde Nalatenschap van Anke van den Akker te Koudum bereids vroeger in vorige advertentien aangekondigd en in het broede omschreven. Gegadigden komen ten sterfhuize van gemelden van den Akker te Koudum.",http://resolver.kb.nl/resolve?urn=ddd:010584967:mpeg21:a0013:ocr,4,ddd:010584967:mpeg21:p004,Leeuwarder courant,1073
3058141,1861/08/07 00:00:00,1303,ddd:010111933:mpeg21:a0053,http://imageviewer.kb.nl/ImagingService/imagingService?id=ddd:010111933:mpeg21:p004:image&x=136&y=73&w=2347&h=1303,ddd:010111933:mpeg21,2483,1376,136,73,4,"xij ligtin lading i NOTARISHUIS TE ROTTERDAM. |n#A- *.«.*** .. Op heden Woensdag den 9dea Augustus !§©:_.. ;'lK#\/E\ KÜT&¥iA €Ïes Namiddags ten 5 ure. (9724) fW^S^-'A SÖEBABAUA ! Een Pj*W_9 en BStVB  san de W. Z. vim den Oppert 6-201. In irekgeld ƒ 8000. ']'WflV -'-'• 'voor GOEDEBEN en: Een SïïiSS met LAAK en ËRVS 3  in de Kerklaan 15— 263. In trekgeid ƒ 3200. -ÖiyilyËL PASSAGIEES Een MUIS met LAAN gelegen als voren 15—5.62. In irekgeld ƒ 3300. ' iiMÏÉI Khet Extra Snelzeilend Ge- Een MUIS en ESBVM  aan de Z. Z. van de Halvamaenetrast 5- 497. In trekgeid ƒ 2250. -flTa™lHr koperd Nederlandsen VEILIIfGYA-Nl _ - _-s _Tk ™BC 'P Een WIKKEiJLHVIS en üRViS Ran de N. Z. van da Nieuwe Haven 12—307. J A t U Bi Ean PANI»  alsmede een PAKHUIS met ERVES  aan de N. Z. van de Hoogstraat 10 109 Adres l^dtlJgedo^l^vlTès^ Co. „ f». ¦J""*™* °PEN PLAATS' ACHTEEHUIS en EHVJEM aan de Z. Z. van de «rsra-JOO--*.CT-MO;y->.T. (9442) K^V*Ï_WDM met ACHTEBHÜISJES en EBWEN aan da Z.Z. van de Kipstraat 10-121. .„„* Een HUI» en SSK-VE  aan da N. Z. van Wijnstraat 2—74. SlOOmDOOiai^llSt Do K'LISKDI;»^I.I__SI_K;BI.I. de Zwaan met de daarop staande OPSTALLEN sap r. ~_i <% ff van Hl'l3 KOETSHUIZEN. STALLING en SPOELHUIS in da Ljjnbaanlaan 15—354. ™«5~ - .iiölii aittiliïilffl 8 Donderd. « 9.30 8 Donderd » 1.30 __ _T .mT nwurTS-Tvir *_ ia-r -i _-¦ r* 2Sï. : m&f'ri* F. VAN HEUKELOM & C .. 12 Maanrl'sn. 11/12 12.- 12 Maand. » 4.— • A sauvi-unu vm «w XjS o« hwSb^243 L- {.SS. : fc KOO[lf)-BLAAILs Wijk 4 No. 181. 15 Donderd. » 3.— 15 Donderd. - 7.~ -Wij hebben do eer het geëerde Publiek dezer stad bekend ta maken voorzien te zyn en ontvaDgen 16 Vrijdag ¦ - 4.30 16 Vrijdag » 8.30 le hebban een rtfeisM ttëSOTiimvnt GAMTS HUC32-.S9S en €««HÜC_ir *<; Bïanc. 17Za-urd. . 530 1/Zaturd. •- 9.30 DAMES CaAVATES. MOSCOVITES VICTOBIA. BBOCHES FICHUS MIGSOKETTES 19 Maandag . 7.30 19 Maand.  11.30 HEEREN en DAMES Witte en Bruine CASTOBEN HANDSCHOENEN HEEBEN Wit en Gekleurd 20 Dingsd. « 5.30 20 Dingsd.'snamidd.l23o PIQUÉ OVEBHEMDEN LINNEN IDEM. Rotterlam Boompjes Wyk Lt£°j|l. SATIN en ZIJDEN HEEBEN- en DAMESHANDSCHOENEN €JAKTS PA«E -fiOIB. (2881) VBÏKW-'B'a «fe «o. Allea 10. aoalltelt. (9720)",http://resolver.kb.nl/resolve?urn=ddd:010111933:mpeg21:a0053:ocr,4,ddd:010111933:mpeg21:p004,"Nieuwe Rotterdamsche courant : staats-, handels-, nieuws- en advertentieblad",2347
2028570,1861/09/15 00:00:00,846,ddd:010154615:mpeg21:a0010,http://imageviewer.kb.nl/ImagingService/imagingService?id=ddd:010154615:mpeg21:p004:image&x=98&y=90&w=2413&h=846,ddd:010154615:mpeg21,2511,936,98,90,4,"Leeuwarden 20 April 1861. «Gisteren haddun wij een Heer bij ons die eeno Bus Rarey's Voeder voor zijne Paarden had gebruikt  en wien het zoo goed beviel  dat hij ons op nieuw 2 Bussen van 90 Rantsoenen bestelde. Adverteert  dat het hij ons te bekomen is eu dat bij ons getuigschriften over de goede uitwerkselen van Rarey's Voeder ter inzage lisgen.'' GEBRs DE GRAAFF. RAREY'S Paarden- en Vee-Vcrbeterings voeder. Dit Voeder heeft de bijzondere eigenschap de Paarden Koeijen Ossen Kalveren Schapen en Varkens in slechten staat zijnde hun voorkomen te verfraaijen  hunne waarde to verhoogen. Bij Paarden voornamelijk verbetert het de Verteringsorganen  zoodat zij aan krachten winnende veel meer werk verrigten kunnen. Zelfs ouden  versleten en zwakke Paarden geelt het nieuwe kracht en aanzien bij bel Vee in het algemeen verbetert het de hoedanigheid van het vieesch en van de melk der Koeijen en maakt de beesten vatbaar  de geheele Voedingstof uit bun Voeder te trekken. Binnen ééne maand verhoogt dit Voeder het uiterlijke en de -waarde vau Paarden en Vee met 20 a 30 pCt. De Engelsche Veefokkerij is aan dit Voeder tegenwoordig hare groole vorderingen verschuldigd. Voor zieke Beesten is dit middel onbetaalbaar omdat het eene menigte ziekten geneest. De prijs is: Bussen van 45 Rantsoenen ƒ 4.50; van 90 R. ƒ9; Vaten van 450 R. ƒ4O en van 1000 R. ƒ75 zijnde Tf_ Cent ieder Rantsoen. RAREY en CO. St. .Tame's Chambers  Regen t's Quadranl London  EN IN HOLLAND BIJ Amsterdam Verkoophuis. Leur L. van den Berg. Breda Ilenri Sprengers. Oosterhout Gebr. Onessen. » M. Janssen voorheen Wed"". Rozen-laai M. D. v. Leeuwen. J. Sooiners. Steenbergen  W. v. r). Kar. Bergen-op-Zoom  I). Pon-welft. Tilburg C. 11. Donihoff. » P. F. Appelboom Apoth. Waalwijk P. Reijnen voorheen Eindhoven A. Beguin. F. v. ij. Klokken. Helmond  A. 11. Martin. » P. J. van Gils. 's Hertogenbosch F. L Wlsch. En in de andeie Steden in ile bekends Depots.",http://resolver.kb.nl/resolve?urn=ddd:010154615:mpeg21:a0010:ocr,4,ddd:010154615:mpeg21:p004,Bredasche courant,2413
2116443,1861/08/10 00:00:00,1039,ddd:010131486:mpeg21:a0003,http://imageviewer.kb.nl/ImagingService/imagingService?id=ddd:010131486:mpeg21:p004:image&x=1126&y=115&w=2037&h=1039,ddd:010131486:mpeg21,3163,1154,1126,115,4,"< IDERIAISCH-FRAICH 1 BELGISCHE SPilwlli. Pleizier-reis van Nederland naar Parijs FEESTEN VAN DEN 15 AUGUSTUS 1861. Halve J_*r#?_? voor Heen en Terua Van AMSTERDAM 2e kl. fl. 24.- So kl. fl. 16.50 Van HAARLEM 2e kif I. 24.- 3e kl. fl. 16.50 - „ ARNHEM „„ _ 25.— „„ . 17.50 ""'s HAGE ° » »''» » „ Ï5.50 - UTRECHT ._ „ 22.50 - _ „ 16^» ""en DORDRECHT I»» .» 20-50» ». v 14.50 Dingsdag 13 Augustus vertr elTlzatur ilag^ I'S August ns teru£rkom§. Kaar Parifs. vsm Parijs. i „ Tll i ?e- ?tatlons en Factorijen van de Nederlandsclie Ehijn Hollandsche en Nederlandsen-Belgische Spoorwegen zullen Biljetten afgegeven worden tot en met 11 Augustus.",http://resolver.kb.nl/resolve?urn=ddd:010131486:mpeg21:a0003:ocr,4,ddd:010131486:mpeg21:p004,Nieuw Amsterdamsch handels- en effectenblad,2037
2546888,1861/09/28 00:00:00,2642,ddd:010774721:mpeg21:a0007,http://imageviewer.kb.nl/ImagingService/imagingService?id=ddd:010774721:mpeg21:p004:image&x=1030&y=63&w=964&h=2642,ddd:010774721:mpeg21,1994,2705,1030,63,4,luèt/ J. HOUTMAN is voornemens in zijn KOORX\__ en PEIjMOEV.X ie Assen in hei volgende <3g3s> jaar een STOOMGEMAAL ie plaatsen. BV BARRYS ~~ Revalenta Arabica overtreft door hare heilzame eigenschappen alle andere middelen; duizende en duizende herstelde Lijders getuigen hare verwonderlijke geneeskracht. Het vooroordeel legen de Revalenta wijkt meer en I meer en derzelver gebruik onder de meer beschaafden en gegoeden neemt dagelijks toe. Vele beroemde doctoren spreken er met zeer veel lof  van en hebben ze met het beste gevolg aangewend als Professor URE bij verstoppingen en zenuwachiigheid. Dr. SHORLANU bj| waterzucht en verstoppingen. Dr. HAR VEV bij diarrh ca en zenuwaandoeningen Dr. GATTIKER bij maagkanker Dr. WUBZER bij tering hoest en asihma Landschapsread VON POLNITZ genas daardoor van eene hardnekkige onderbuikskwaal Generaal-Majoor KING van verzwakking en zenuwoogesteldbeid de heer HOISGONTIER van eene maagontsteking de heer C. 11ERMANN van kramphoest. Ook bier te lande deelen ons de heeren HUYSKES te Zali-Bommel C RIKKERS le Gronineen KLINGER en Co. le Rotterdam. WAGNER ie Delfi UHLENBROEK Ie Utrecht LEBBING le Doesborgh ZWART ie Gorredijk en anderen vele gevallen mede waar de Revalenta leven en gezondheid schonk. De Revalenta hermaaglijden van welken aard ook benevens versljjming en onderlijfskwalen  terwijl zij het gebruik van pillen poeders of mixturen geheel noodeloos maakt. Zwakke personen die de Revalenta als ontbijt en avondeten geregeld gebruiken zullen zich er uitermate wel bij bevinden Kinderen die de moedermelk moesten missen en alleen met de Revalenta werden opgevoed werden sterk en tierig. De Revalenta is ook een goedkoop genees- envoedings middel omdat zij de medicyuen overbodig maakt en zoo ajeconceutrerrd is. dat een lepel vol (naauwelflks eene waarde van ten hoogste 10 cenis representerende) een geheel bord soep oplevert voldoende voor een maaltiid Men letie er vooral op dat iedere Bus tot waarborg der echtheid door //F. VOK WINDHEIM en Co.» Verkoop huis// geleekend is. De prijs der Revalenta is.- Kleine bussen 87° Ct. Ipd f 2 2 pd. f 350 5 pd. f & 12 pd f 16 Amsterdam VERKOOPHUIS. Assen H. P. A. VAN GORCUM. Coevorden CJ. vai de- SCHEER. Dedemsvaa-. K L. v. d. VECHT. Gorcedijk S G. ZWART. ' Hoogeveen. JAN van der WOLDE Jr. Meppel. A. JEULEN. Noordwolde. JACOB VEENSTRA. Oldemarkt C VAN DER WEDDEN Steenwijk K. TIMMERMAN en in de bekende Depots in de andere steden.,http://resolver.kb.nl/resolve?urn=ddd:010774721:mpeg21:a0007:ocr,4,ddd:010774721:mpeg21:p004,Provinciale Drentsche en Asser courant,964
2233788,1861/05/30 00:00:00,4786,ddd:010546061:mpeg21:a0025,http://imageviewer.kb.nl/ImagingService/imagingService?id=ddd:010546061:mpeg21:p003:image&x=1069&y=118&w=1939&h=4786,ddd:010546061:mpeg21,3008,4904,1069,118,6,*** Eene ongeveer achtienjarige BURGER DOCHTER  wenschte zich ter opleiding geplaatst te zien in eene Mode-Affaire. Adres franco met'opgave van conditien onder Lett. P. aan den Boekhandelaar J. P. REVERS teDordrecht. *** Er bestaat gelegmheldTïiJTaTsoenlijke Lieden zoïTder Kinderen  om een MEISJE van boven de zes tot beneden de twaalf jaren opteleiden in de Huishouding en Vrouwelijke Handwerken tegen eene geringe tegemoetkoming. lemand daartoe genegen adressere zich per gefrankeerde Brieven bij den Heer A. KNOOP Klein Heiligland te Haarlem onder Letter A. *** Men vraagt tegen primo .Augustus op een Dorp nabij Arnhem eene tweede MEID goed kunnende Naaijen Stijven Strijken en bekwaam tot het verrigten van het gewone Huiswerk van goede getuigenissen van geschiktheid en eerlijkheid voorzien. .Adres La. R Hulp- Postkantoor te Ede Prov. Gelderland Brieven franco. %* Une REMOISEIaIaE  ayant passé ses examens sous la nouvelle loi et autorisée par lii a enseigner le F}-. VA. et le Holl. avec les autres branches d'instruction désire trouver l'occusion de donner quelques lecoits particulières soit h Harlem soit attx etivirons. — ()n est prié de s'adresser sous l'initiale 8. aux libraires LOOSJES a Harlem. Lettres affranchies. Bazaar iS^oordêefëvan het Gereformeerde Weeshuis te Haarlem. De ondergeteekende hebben een ruim assortiment VOORWERPEN en DAMES-HANDWERKEN geschikt voor de in Julij te houden Bazaar ten voordeele van het Gereformeerde Weeshuis alhier. &M. &_JLWEEVERINGH. V HaTirlemT^^^^C' De ondergeteekende maakt bekend dat hij van heden af werkzaam is als AGENT  voor de Brand-Assurantie- Compagnie Minerva te Antwerpen. J. de ROOY *„.* Burgemeester en Wethouders van HAARLEM brengen ter kennis van degenen welke op de aanstaande KERMIS binnen deze Stad dit jaar invallende op den 3den Julij en eindigende op den Bsten8sten Julij e. k. met hunne Tenten Kramen Stallingen enz. eene plaats wenschen te erlangen dat zij zich daartoe aan Marktmeesteren zullen moeten adresseren voor den 15den Junij a. s. met vrachtvrije Brieven waarbij de juiste lengte en breedte of diepte in Ned. Ellenmaat moeten worden opgegeven. Alsmede dat de Loting zal plaats hebben op Vrijdag den 286ten Junij a. s. des namiddags ten vijf ure op het Raadhuis alhier waarna de Tenten Kramen enz. kunnen worden opgeslagen. Eindelijk dat het aan niemand vergund is Tenten Kramen Uitstallingen enz. op te slaan dan nadat de staangelden in handen van Marktmeesteren voornoemd zullen zijn uitbetaald.,http://resolver.kb.nl/resolve?urn=ddd:010546061:mpeg21:a0025:ocr,3,ddd:010546061:mpeg21:p003,Opregte Haarlemsche Courant,1939
517440,1861/06/25 00:00:00,539,ddd:010546083:mpeg21:a0016,http://imageviewer.kb.nl/ImagingService/imagingService?id=ddd:010546083:mpeg21:p002:image&x=2013&y=1485&w=960&h=539,ddd:010546083:mpeg21,2973,2024,2013,1485,4,SCHEEPVAART OP lIET SPAAME. De COMMISSARIS des KONINGS in de PROVINCIE NOORD-HOLLAND brengt ten verzoeke van den Burgemeester van Haarlem ter kennis van de belanghebbenden dat op Dingsdag den 25sten dezer maand het gedeelte van het Spaarne begrepen tusschen de brug aan de kazerne en de belastingpaal op de grensscheiding der gemeenten Haarlem en Zuid-Schalkwijk voor de scheepvaart zal gesloten ziju van des namiddags vier ure tot den volgenden morgen bij het openen van den boom. Haarlem 10 Junij 1861. De Commissaris des Konings voornoemd R 0 E L L.,http://resolver.kb.nl/resolve?urn=ddd:010546083:mpeg21:a0016:ocr,2,ddd:010546083:mpeg21:p002,Opregte Haarlemsche Courant,960
1488177,1861/07/06 00:00:00,1517,ddd:010485219:mpeg21:a0004,http://imageviewer.kb.nl/ImagingService/imagingService?id=ddd:010485219:mpeg21:p001:image&x=1131&y=3435&w=981&h=1517,ddd:010485219:mpeg21,2112,4952,1131,3435,14,VENDUTIE Op Dingsdag <\en 9 Julij 1861  voor het Kommissiehuis van ABEEIiISX. »ËV\l§Oi & Co. van Puike BOTER Engelsch BIEU Wagen- en Bendij tuigen  Imitatie Leer _tlart»o houten Halkon. Voor rekening van belanghebbenden : 14 kisten CHITS. 12 do. RUWE CALICOTS. 1 do. BATIK SARONGS. 10 do. Everlastings. 6 balen BLAAUWÈ DRILL. 40 vaatjes IJzeren NAGELS voor Praauwen min of meer beschadigd. Ven 11 ure: Een Zaailand gelegen Buurt Tomdng Blok O Deel 8 No. 7 Verponding no. 8204. Een idem Buurt Kerkhof Blok L Deel 20 No. 73 Verponding no. 569. Drie perceelen Tiiingrond gelegen Manga Bezaar Blok IV Deel 1 No. 60 A en No. GO B en No. 61 F Verponding no. 0814 no. 6813 en no. 4098. Voor rekening van Tja TeilffSOeij: Een Huis en Erf gelegen Passer Baroe Blok M Deel 3 Verponding no. 9299. Koorts wegens vertrek: Eene zoo goed als nieuwe Bendij met Paard en Tuig. (2178),http://resolver.kb.nl/resolve?urn=ddd:010485219:mpeg21:a0004:ocr,1,ddd:010485219:mpeg21:p001,"Java-bode : nieuws, handels- en advertentieblad voor Nederlandsch-Indie",981
3917667,1861/04/12 00:00:00,4333,ddd:010546022:mpeg21:a0033,http://imageviewer.kb.nl/ImagingService/imagingService?id=ddd:010546022:mpeg21:p005:image&x=1055&y=554&w=1959&h=4333,ddd:010546022:mpeg21,3014,4887,1055,554,6,LIKWIDATIE. De ondergeteekende belast met de Likwidatle der Zaak van den Heer J. HOOGZAAD Koopman iv IJzerwaren aan het Groote Noord te Hoorn roept bij dezen op alle de bekende en onbekenden Schuldeischers van voornoemden Heer J.HOOGZAAD om vóór 1 Mei 1861 ten zijnen Kantore opgave hunner vorderingen te doen met overlegging der noodige bewijsstukken. Hoorn Mr. J. A. HAAKMAN 9 April 1861. Advocaat bij de Arr. Regtb. te Hoorn. %* De betrekking van MULr-OtfRERWIJIKER aan de derde openbare School voor gewoon Lager Onderwijs onder den Hoofd-Onderwijzer Van SCHAAIK vacant zijnde geworden door het eervol verleend ontslag aan M. H. P. Smits worden sollicitanten ter vervulling opgeroepen om met overlegging de*' bescheiden van bevoegdheid eu goed zedelijk gedrag zich met franco Brieven aantemelden bij den Heer Burgemeester der Gemeente voor of op den 25ten dezer maand. Aau de betrekking is verbonden eene Jaarwedde van / 200. Nijmegen den 9den April 1861. De Burgemeester F. P.jnjLEVELD. verlangt behalve de twee gevraagde LEERMEESTERS voor Strijk- en Kopennstrunientt-n noch een LEERMEESTER voor Hout-Blaasinstrumenten bij voorkeur een goed Oboïst op een jaarlijksch inkomen van Drie Honderd Gulden en met het vooruitzigt om dadelijk in de bestaande Orkesten geplaatst te worden. Een der Leermeesters wien door de Directie der School de leiding der ensemble klasse zal worden opgedragen geniet daarvoor ƒ 100 Gulden meer jaarlijksch Salaris. Brieven franco vóór 20 April aan de HH. M. HAGEMAN of G. WOUTERS Jr. TARAKS- Wi SIGAREN-FABRIEK. In eeue Tabaks- en Sigaren-Fabriek bestaat gelegenheid tot plaatsing van lEMAND reeds bij het vak werkzaam geweest zijnde en tevens voor een LEERLING beide P. G. on desverkiezende met Kost en Inwoning. Adres franco Brieven Letters A. 8. bij den Boekh. J. H. SIDDRÉ Utrecht. *#*~ Aan een Instituut waar alles wat aan de eischen des tij ds voldoet voornamelijk ook de oude Talen onderwezen worden kunnen nog een paar PENSIONNAIRES geplaatst worden. Aanvrage om Prospectussen onder Letter N by de Boekhandelaars Van PADDENBURG & C°. te Utrecht. *** lemand 32 jaren oud gezond en buitengewoon sterk van ligchaamsgestel gehuwd en van de P. G. beëedigd Landmeter eu bijzonder ervaren in de Wiskunde in welk vak hij ruim drie jaren Onderwijs heeft gegeven aan een der voornaamste Instituten van ons Rijk aan de Elèves voor de Academiën van Breda en Delft verder de Practische en Theoretische Bouwkunde zoowel hier te Lande als in België beoefend hebbende bekend met Landbouw Houtcultuur en Veeteelt de Holl. Fransehe Engelsche en Duitsche Talen met gemak en vlugheid sprekende en door de verschillende betrekkingen zoowel hier als elders waarin hij geplaatst was bijzonder geschikt voor het toezigt houden over werklieden eu werkzaamheden zoekt eene BETREKKING die een burgerlijk bestaan oplevert. De beste getuigschriften kunnen geproduceerd worden. Adres met franco Brieven onder Letters D. 8. bij de Boekveikoopers M. WIJT & ZONEN te Rotterdam. BOUWKUNDE. Men verlangt voor zes maanden ad ƒ5O 'smaands een OPZIGTER bij de stichting van een nieuw Gebouw in de omstreken van Alkmaar. Adres in persoon of met franco Brieven onder Letter L bij de Boekhandelaars HERMs. COSTER en ZOON te Alkmaar. V Een bekwaam MOLENAARSKNECHT gehuwd P. G. van goede getuigschriften voorzien zoekt tegen 1° Mei eene Betrekking. Adres franco onder Letters J. P aan de Erveu THIERRY en MENSING Boekhandelaren te 's Gravenhage. ** * EerT LEERLOOIJERS- en TOUWERSMNECHT  ook volledig bekend met het maken van Gewast en Tuigleder wenschte spoedig geplaatst te worden; vau bekwaamheid en goed gedrag kunnen de voldoenste bewijzen overgelegd worden. Brieven franco Letter Z bij den Boekdrukker G. J. van LEEUWEN Haarlemmerstraat te Leyden. V W P. G. vooJrzien van eene acte voor de Holl. Frausche en Engelsche Talen  mede in staat de Hoogduitsche Taal te onderwijzen wenscht zoo spoedig mogelijk eene betrekking als Gouvernante of Jufvr. van Gezelschap. Zij is reeds eenen.geruimen tijd in het vak van onderwijs werkzaam geweest. Men adressere zich Brieven franco Letter S. bij den Boekhandelaar J. G. BROESE te Utrecht.,http://resolver.kb.nl/resolve?urn=ddd:010546022:mpeg21:a0033:ocr,5,ddd:010546022:mpeg21:p005,Opregte Haarlemsche Courant,1959
1750175,1861/08/10 00:00:00,1825,ddd:010546123:mpeg21:a0015,http://imageviewer.kb.nl/ImagingService/imagingService?id=ddd:010546123:mpeg21:p003:image&x=1038&y=1861&w=959&h=1825,ddd:010546123:mpeg21,1997,3686,1038,1861,4,OPVOEDING EN ONDERWIJS. Aan een Instituut in Gelderland waar men zich tot 12 Internes bepaalt is gelegenheid tot plaatsing van een' .1 OS.GEST HEER welke voor Breda de Marine of Delft wordt opgeleid. Men ontvangt ook Privaat Lessen van een groot Wis- Natuur- en Taalkundige. Men betaalt ƒ 100 per trimestre met inbegrip van Boeken enz. en f 25 entree. Brieven franco aan den Heer A. KNOOP Klein Heiligland te Haarlem Letter' C. *** Een HUI_.P-OS.DERWIJZER P. G. geëxamineerd in de Moderne Talen en in staat de Wiskunde te helpen onderwijzen verlangt eene betrekking (geen Kostschool). Met opgave der conditien adresseren men zich met franco Brieven Letter Z. bij den Boekhandelaar I. J. J. BOERS te Middelharnis. *** Op eene Kostschool met een klein getal Leerlingen wordt tegen 15 Sept. a. s. of eerder gevraagd: Een SKCOS.OAS.T P. G. bezittende eene Acte voor het Engelsch en de Wiskunde. Behalve eene vriendelijke behandeling wordt een behoorlijk Salaris aangeboden. Brieven franco Letter N bij A. CRANENDONCQ & ZONEN Boekhandelaars te Nijmegen. *** O van DRIEL Instituteur te Gorinchem verlangt met September of later: Een SECOSJDASiT van de P. G. bedreven in het Fransch en geschikt voor den omgang met Jonge Lieden. Boven de gewone Verpleging en een vriendschappelijken omgang geniet men een goed Salaris. » APOTHEEK. Er wordt tegen 1 Oct. e. k. gevraagd in eene soliede Apotheek in Gelderland op aannemelijke voorwaarden een BEDIESIDE  van de P. G. en van goede getuigschriften voorzien. Adres met franco Brieven onder Lett. P. aan den Boekhandelaar H. OA. CAMPAGNE te Tiel. NOTARIAAT. Wordt gevraagd tegen I°. Sept. e. k. op een Notarieel Kantoor ten Platten Lande in Z.-Holland een knappe en vlugge KLERK het Minuteren etc. verstaande van de Prot. Godsdienst. Adres Brieven franco met opgave van het verlangde Salaris onder Lett». V. H. G. aan den Heer A. KNOOP Klein Heiligland te Haarlem.,http://resolver.kb.nl/resolve?urn=ddd:010546123:mpeg21:a0015:ocr,3,ddd:010546123:mpeg21:p003,Opregte Haarlemsche Courant,959
2218590,1861/03/27 00:00:00,2241,ddd:010485196:mpeg21:a0018,http://imageviewer.kb.nl/ImagingService/imagingService?id=ddd:010485196:mpeg21:p003:image&x=2121&y=94&w=990&h=2241,ddd:010485196:mpeg21,3111,2335,2121,94,12,"Ver'tovën't Een witte POEDEL halfgeschoren luisterende naSï den naam Cadeau. De vinder wordt vriendelijk verzpcht denzelven terug te bezorgentegen goede belooning bij den Heer HARTING op Noordwijk. ■ (912) Vertoren: Een Schotschc Terriër teef geelachtig wit ruig van haar. De vinder die op eene goede belooning kan rekenen wordt verzocht dezelve terug te bezorgen op Kramai bij (979) W. SÜERMONDT W.Zn. fwf tei^iu*» Voor de SuikerfabrieklPETjrAlW'3? VfiAaW in de Residentie .Mapara ■■-■ -—t.v js benoodigd een BEKWAAM MACHINIST voorzien van goede getuigschriften van hekivaamhèid en ijver. Hierop reflectccrcnclcn gelieven zich met frUïlCO brieven te adresseren aan den eigenaar aldaar (950) H. F. MOREOTTER. Wordt Gevraagd: Een bekwaam BOEKHOUDE W tevens vertrouwd met de Hollandsche en Fransche Correspondentie. Nadere inlichtingen bij den uitgever van dit blad. (960) WBÊ 12^* eene familie op eene der hoofd* ;:V""me"" plaatsen var. Java wordt verlangd eene GOUVERNANTE de vereischten bezittende tot het geven van onderwijs en dat wat tot eene beschaafde opvoeding van Meisjes behoort zoomede van les op de Piano; verder EESE IBOXKE voor het toezigt van jongere kinderen. Hierop reflecterende adressere men üicli aan de uitgevers van dit Blad onder Lt. R. f 965)",http://resolver.kb.nl/resolve?urn=ddd:010485196:mpeg21:a0018:ocr,3,ddd:010485196:mpeg21:p003,"Java-bode : nieuws, handels- en advertentieblad voor Nederlandsch-Indie",990
4415376,1861/05/22 00:00:00,4638,ddd:000022766:mpeg21:a0015,http://imageviewer.kb.nl/ImagingService/imagingService?id=ddd:000022766:mpeg21:p003:image&x=1026&y=64&w=952&h=4638,ddd:000022766:mpeg21,1978,4702,1026,64,4,De ondergeteekenden Directeuren van de Salon ' des Variétés van Amsterdam betuigen langs dezen weg den hartelijkst-n dank voor de gunst on bijval die hunne onderneming bij het geachte 's Gravenhaagsclie Publiek gedurende de afgeloopen Kermis wederom zoo ruimschoots heeft mogen te beurt vallen. Hierop ten hoogste prijs stellende zullen zij niets onbeproefd laten om te trachten zich de protectie des geëerden publiek-* bij voortduring waardig te maken. J». BOAS en X. JUDEES. De BURGEMEESTER van Eetjderdorp verwittigt de belanghebbenden bij den aanleg van eenen Spoorweg van Leiden op Woerden dat de kadastrale stukken bedoeld in de bekendmaking van den 16 Mei 11. de eigenaren der percelen aanwijzen  zoo als die bekend waren op het tijdstip waarop de Uittreksels uit de Kadastrale Registers  blijkens de daarop gestelde dagteekening zijn afgegeven. Leiderdorp 21 Mei 1861. De Burgemeester voornoemd P. G. HUBRECHT. Bekendmaking. De BURGEMEESTER der Gemeente Basersteoude door tusschenkomst van Zijne Excellentie den Heer Staatsraad Commissaris des Konings in de provincie Zuidhollund van het Ministerie van Binnenlandsche Zaken ontvangen hebbende de stukken tot voorbereiding eener onteigening volgens de wet van eenige percelen  in gemelde Gemeente gelegen  en die tot de uitvoering aanvankelijk voor zooveel de lyn Leiden—Woerden betreft benoodigd zijn . Brengt ingevolge de bepalingen der wet van den 28 Augustus 1851 (Staatsblad n°. 125) bij deze ter kennis van de belanghebbenden dat: I°. een uitgewerkt IMau van den aan te leggen Spoorweg van Leiden naar Woerden vervat in eene zakelyke beschrijving van dit werk; 2°. een Staat der in te iieinen percelen opgemaakt in overeenstemming met de Uittreksels uit de registers van het kadaster  en 3°. eene Grondkaart van het werk van af Dingsdag den 21 Mei aanstaande gedurende '!() dagen op de Secretarie der Gemeente ter inzage van een ieder zijn nedergelegd; wordende de belanghebbenden herinnerd dat zij iugevolgo art. 8 der genoemde wet hunne bezwaren mondeling of schriftelijk binnen de bedoelde 30 dagen aan het Collegie van Burgemeester en Wethouders moeten opgeven. Hazerswoude den 18 Mei 1861. De Burgemeester voornoemd  C. VAN DER VLIES. Bekendmaking. De BURGEMEESTER der Gemeente Koudeherh  door tusschenkomst van Zijne Excellentie den Heer Staatsraad Commissaris des Konings in de Provincie Zuidholland van het Ministerie van Binnenlandsche Zaken ontvangen hebbende de slokken betrekkelijk de onteigening van gronden in deze Gemeente ter uitvoering van do Concessie aan de Hollandsche IJzeren Spoorweg-Maatschappij verleend  voor den aanleg vau een Spoorweg ter verbinding van Scheveningen en 's Gravenhage langs Leiden met «len Nederlandsehen Rijnspoorweg bij Woerden Brengt ingevolge de bepalingen der Wet van den 28 Augustus 1851 (Staatsblail n°. 125) bij deze ter kennis van de belanghebbenden dat: I°. een uitgewerkt IMau vau den aan te leggen Spoorweg van Leiden naar Woerden  vervat in eone zakelijke beschrijving van dit Werk; 2°. een Perceelstaat der te onteigenene eigendommen opgemaakt in overeenstemming met de uittreksels uit de registers van het kadaster ;en 3G. eene Grondkaart vau het Werk van Dingsdag den 21 Mei 1861 af gedurende dertig dagen op de Secretarie dezer Gemeente ter inzage van een ieder zullen liggen; wordende de belanghebbenden herinnerd dat zij ingevolge art. 8 der genoemde wet hunne bezwaren mondeling of schriftelijk  binnen de bedoelde dertig dagen aan het Collegie van Burgemeester en Wethouders moeten opgeven. Koudekerk deu 18 Mei 1861. De Burgemeester voornoemd BRUI.INIS. Bekendmaking. De BURGEMEESTER van Zufumtnerdutn door tusschenkomst vau Zijne Excellentie den Heer Staatsraad  Commissaris des Konings in de provincie Zuidholland  van het Ministerie van Binnenlandsche Zaken ontvangen hebbende de stukken betrekkelijk de onteigening van gronden iv deze Gemeente voor den aan te leggen Spoorweg van Leiden naar Woerden  Brengt ingevolge do bepalingen der wet van don 28 Augustus 1851 (Staatsblad n°. 125) bij dezo ter kennis van de belanghebbenden dat: I°. een uitgewerkt Plan vau den aan te leggen Spoorweg; 2°. een Perceelstaat opgemaakt in overeenstemming met de uittreksels uit de registors van het kadaster eu 3°. eene Grondkaart van het werk van Dingsdag den 21 Mei 1861 af gedurende dertig dagen ter Secretarie der Gemeente tor inzago voor een ieder zijn nedergelegd; wordende de belanghebbenden herinnerd dat zij ingevolge art. 8 der genoemde wet hunne bezwaren mondeling of schrifte- ; lijk binnen de bedoelde 30 dagen aan het Collegie vau Burgemeester en Wethouders dezer Gemeente moeten opgeven. Zwammerdam den 19 Mei 1861. De Burgemeester voornoemd  H. SMEDA.,http://resolver.kb.nl/resolve?urn=ddd:000022766:mpeg21:a0015:ocr,3,ddd:000022766:mpeg21:p003,Dagblad van Zuidholland en 's Gravenhage,952
2001870,1861/03/29 00:00:00,1885,ddd:011060795:mpeg21:a0008,http://imageviewer.kb.nl/ImagingService/imagingService?id=ddd:011060795:mpeg21:p002:image&x=2173&y=170&w=1062&h=1885,ddd:011060795:mpeg21,3235,2055,2173,170,4,Een fatsoenlijk jongmensch oud 24 jaren zoekt een e plaatsing bij eene landelijke onderneming liefst in tabak. Adres onder Letters ABC bij de Redactie van de qOSTPOST. (484) Voor de SUIKER FABRIEK Peljangan in de Residentie Japara is benoodigd een bekwaam AI AC II ■- IVIST voorzien van goede gefvigsc&ri/ten van bekwaamheid en ijver. Hierop reflecterenden gelieven zich met franco brieven te adresseren aan den eigenaar aldaar. (505) H. F. MORBOTTER. Eene XI±G\X7S7KrG TD©XI<aJJ • Adres met opgave van prijs onder Lett. C Iffl burp.au van dit blad.  (514) 3L.E3 DEtOY cfc GO. HOUDERS VAN COGNOSSEMEhf OVEE 50 kisten ROODE WIJN @ 48 fl. 25 kisten BRANDEWIJN @ 12 fl. Aangebragt per Nederlandsen schip kapitein W» Tan Som eren Greve en afgeladen door de Koninklijke Nederlandsche stoomboot Maatscbappij te Amsterdam worden verzocht zich bekend te stellen bij De Agenten (497) SCIIIMMELPENNINCK & CO.,http://resolver.kb.nl/resolve?urn=ddd:011060795:mpeg21:a0008:ocr,2,ddd:011060795:mpeg21:p002,"De Oostpost : letterkundig, wetenschappelĳk en commercieel nieuws- en advertentieblad",1062
2163179,1861/02/08 00:00:00,2237,ddd:010545970:mpeg21:a0018,http://imageviewer.kb.nl/ImagingService/imagingService?id=ddd:010545970:mpeg21:p004:image&x=2047&y=97&w=967&h=2237,ddd:010545970:mpeg21,3014,2334,2047,97,6,"*** LOF en DANK wordt openlijk toegebragt door Ingezetenen en Ingelanden van den Polder Hardinxveld aan hunnen Burgemeester de Heer P. M. BROUWER in de onlangs voorgevallene zaak tusschen het Dijk-Bestuur van den Alblasserwaard en het Polder-Bestuur van Hardinxveld bewezen door zijne tegenwoordigheid en onpartijdige houding ter plaatse der ontgraving van den waterkeerenden dijk waardoor ZEd. niet alleen veler hartstogten tot bedaren wist te brengen en hierdoor dreigende wanorde en ongeregeldheid heeft voorkomen maar ook de nooit volprezen les heeft behartigd „ dat het beter is het kwaad voortekomen dan het kwaad te straffen."" KF-Rld. T. j- »• so„ Tanitmeester en Vervaardiger van Kun. .tanden  zal Dingsdag 12 dezer te spreken of te ontbieden zijn bij den Heer J GROENEWOUD te Bakhuizen 13 en 14 dezer bij den Heer K. de VRIES op het Breed te Hoorn. Verder aan zijne Woonplaats St. Antoniebreedstraat C. 78 over het Lokaal de Ooijevaar te Amsterdam. E^= Eiken Dingsdag bij den Heer A. KLOK te Purmerende uitgezonderd 12 dezer. *** In den omtrek van Apeldoorn wordt voor de Zomermaanden gevraagd voor eene Dame: Eene vrije KAMER  met KOST en BEDIENING. Opgaven van stand en prijs met franco Brieven onder Letters V. K. Poste Restante Rotterdam. *„.* Bij fatsoenlijke Burger - Lieden in de Prov. Noord- Brabant zonder kleine Kinderen wordt INWONING aangeboden met vrije Slaapkamer Ook zou men niet ongenegen zijn een paar KINDEREN of eene HULPBEHOEVENDE te verzorgen tegen primo Mei. Men adressere zich met franco Brieven onder Letters A. L. bij den Boekhandelaar L. VEERMAN te Heusden. *_* Tegen Mei eerstkomende wordt in HUUR gevraagd liefst in de Gemeeute Wageningen Renkum Oosterbeek of Loenen a. V. voor een klein Gezin : Een HUIS  waarin niet minder dan vijf Kamers met Keuken Kelder en wat verder tot een net geordend Huis behoort benevens een daaraan grenzende kleine TUIN de Huurprijs van ƒ2OO niet te boven gaande. Opgaven worden verzocht met franco Brieven onder de Letters T. L bij de Boekhandelaren C. L. SCIILEIJER en ZOON te Amsterdam. V Het Buiten verblijf VREBELtUSTmet TUIN"" gelegen aan de Middachtersteeg bevattende behalve Keuken Kelder Dienstbodenkamers Droogzolder en verdere gemakken 7 beneden en 8 Bovenkamers waarvan 8 geplafonneerd en meest allen behangen en van stookplaatsen zijn voorzien wordt met I°. Mei a.s. of vroeger TE HUUR aangeboden. Te bevragen bij de Rentmeester op Middachten.",http://resolver.kb.nl/resolve?urn=ddd:010545970:mpeg21:a0018:ocr,4,ddd:010545970:mpeg21:p004,Opregte Haarlemsche Courant,967
1018948,1861/05/30 00:00:00,1057,ddd:010546061:mpeg21:a0023,http://imageviewer.kb.nl/ImagingService/imagingService?id=ddd:010546061:mpeg21:p003:image&x=1069&y=120&w=964&h=1057,ddd:010546061:mpeg21,2033,1177,1069,120,6,V Een PERSOON van de H. G. voorzien van getuigschriften van zedelijk gedrag en eerlijkheid zag zich gaarne geplaatst als Oppasser of als Looper voor een Kantoor. Adres bij den Boekverkooper A. 11. B.AKHUYZEN te 's Gravenhage. *** Er wordt gevraagcTTeen bekwaam KLEERMÏi KERS-KNECHT. Adres met franco Brieven aanK. KRIJGER Mr. Kleermaker te Venhuizen doch liefst in persoon. VOORDEELTI¥TELDBSEGGi\Gr~ Een solide Persoon vraagt voor eene buiten twijfel winstgevende onderneming die uiterlijk binnen 2 jaren moet zijn afgeloopen 33 Mille tegen 5 percent eu een Aandeel in de winsten met guarantie tegen verlies. Men wordt verzocht zich met franco Brieven te adresseren  onder de Letters A. S. T. aan den Heer A. KNOOP Klein Heiligland te Haarlem. *** Eene MTïI.P-bND^RtVÏJ^ERËS~te7ens geëxamineerd voor de Fransche Taal (Art. 1.) en de Handwerken en daarbij de beginselen der Engelsche Taal kunnende onderwijzen zag zich gaarne tegen half »Augustus op eene niet te talrijke School geplaatst. Inclinerenden worden verzocht zich met franco Brieven onder de Letter H. te adresseren aan de Wed. P. v. WAESBERGE en ZOON Houttuin te Rotterdam.,http://resolver.kb.nl/resolve?urn=ddd:010546061:mpeg21:a0023:ocr,3,ddd:010546061:mpeg21:p003,Opregte Haarlemsche Courant,964
376320,1861/01/17 00:00:00,490,ddd:000010017:mpeg21:a0055,http://imageviewer.kb.nl/ImagingService/imagingService?id=ddd:000010017:mpeg21:p006:image&x=2443&y=2015&w=768&h=490,ddd:000010017:mpeg21,3211,2505,2443,2015,6,(833) Bö O. W. VAN HEIXE te Rotterdam  komt heden van de Pen : EEN KLEIN OFFER voor de ongelukkigen van den Watersnood ln den Bommel er meaard. Prijs 25 Oents De Uitgever heeft niet geaarzeld bovenstaande door den dnik algemeen verkrijgbaar te stellen en hoopt daardoor ieti bij te dragen tot leniging onier oncelukk ge Landgenooten. Het is een allerliefst Dichtstukje vervaardigd door eene jeugdige Siadgenoote die reeds vroeger in dergelijke gevallen haar talent heeft ten bite gegeven.,http://resolver.kb.nl/resolve?urn=ddd:000010017:mpeg21:a0055:ocr,6,ddd:000010017:mpeg21:p006,"Nieuwe Rotterdamsche courant : staats-, handels-, nieuws- en advertentieblad",768
1646204,1861/07/05 00:00:00,1589,ddd:011060875:mpeg21:a0006,http://imageviewer.kb.nl/ImagingService/imagingService?id=ddd:011060875:mpeg21:p001:image&x=2213&y=2445&w=1036&h=1589,ddd:011060875:mpeg21,3249,4034,2213,2445,4,VENbüTiFw^cisl/ËBTBÊIL Op Maandag den ldden Julij  soos m na ®§mMuMë 9 te 3E»Girjajl3a.§s ten huize van den Ifeer G. VAN DJWELMR'. CNOPiliS. Fan eencn nellen en wel onderhoudenen INBOEDEL bestaande in : » Kz.p£$j E.cdïlüusien kasten ban- 0OL «SSBsii»Ken stoeien tafels pen glas- en servieswerk voorts: Wagens  paarden tuigen. Alsmede een bij uitstek schoon rijpaard hoog •t voet. (1009) PAAR1)M:VENDUTIE TE BEZOEKÏE. Op nader te bepalen dagen voor rekening van de lieer en & CO. te Koopang,http://resolver.kb.nl/resolve?urn=ddd:011060875:mpeg21:a0006:ocr,1,ddd:011060875:mpeg21:p001,"De Oostpost : letterkundig, wetenschappelĳk en commercieel nieuws- en advertentieblad",1036
1507236,1861/07/20 00:00:00,1524,ddd:010485223:mpeg21:a0015,http://imageviewer.kb.nl/ImagingService/imagingService?id=ddd:010485223:mpeg21:p004:image&x=96&y=94&w=989&h=1524,ddd:010485223:mpeg21,1085,1618,96,94,12,8W Door Sterfgeval 17JU KOOP eenige in de Indische Levensverzekering Maatschappij. Het laatste dividend was 71/ pCt. terwijl bovendien 2 pCt. op reservefonds werd overgebragt. Te bevragen bij (2377) REYNST & VINJU. @m&> SUIKERPANNEN van verschillende afmetingen. (2381) REINST & VINJU. Een PAKHUIS met Zolder gelegen aan de Groote Rivier. (2350) REYNST & VINJU. (ê^ll_iSEP EEN HUlS||| in Gang Boentoe. Te bevragen bij (2374) GASPER & Co.,http://resolver.kb.nl/resolve?urn=ddd:010485223:mpeg21:a0015:ocr,4,ddd:010485223:mpeg21:p004,"Java-bode : nieuws, handels- en advertentieblad voor Nederlandsch-Indie",989
3979500,1861/09/21 00:00:00,3790,ddd:110532147:mpeg21:a0016,http://imageviewer.kb.nl/ImagingService/imagingService?id=ddd:110532147:mpeg21:p003:image&x=1179&y=2724&w=1050&h=3790,ddd:110532147:mpeg21,2229,6514,1179,2724,8,"Ten verkoop onlvanyen ; Eene (raatje VJtIL VIU luAiii Em ai. Ontvangen : Eeo party Goudvrerkeo Prachtige DAMES-WEI.KDOOZEN Fraai-2 Photographie xii>.i_ns. Verko muls. Met de laait traogen i ' ~w. I' - : Gedroogde >ruci*:_>;_ Tafelrozijnen trntiO d'Ente gerookte Zalm enz. *i "" • SCHAB Etuis. PORTEFUEILLESmeI Necessaires GOD DXi\T RINGEN I B'j JOHN PRYCE & Co_._.. U-___________il '__& £J«Lw 4 fclsfillg Viennent de recevoirj DHAPS CACHEMIRE extra fin noir et de couleur pour Habits et Redingotes. SATIN-LAINE et TRICOTS NOUVEAUTÉ pour rantalons. '1 Kit MTS MODE pour vCtcments coroplets et étoffes issorties pour Jaquettes. SOIERIES el PIQUE3 BROCHES et FANTAISIE ioiir (iil.ts. CRAVATES GANTS JOUFIN et SATINE- CHAUS3ETTES MOUCHOIRB etc. Assortiment de BOUTONS -HAPEAUX ii.itilcs ei Fantaisie et de Cocher. Broderies E pees Claques pour Messieurs les employés 371"") Meerschuime pikjes ""'t Barns tken. ; W. 8. VAN HOGEZAND Sr.",http://resolver.kb.nl/resolve?urn=ddd:110532147:mpeg21:a0016:ocr,3,ddd:110532147:mpeg21:p003,Bataviaasch handelsblad,1050
1175656,1861/02/07 00:00:00,1318,ddd:010079254:mpeg21:a0014,http://imageviewer.kb.nl/ImagingService/imagingService?id=ddd:010079254:mpeg21:p004:image&x=1941&y=2627&w=892&h=1318,ddd:010079254:mpeg21,2833,3945,1941,2627,4,DE PILLEN VAiV HOLLOWAY Personen die zittende bezigheden hebben zijn u-eest onderhevig aan ongesteldheid der ingewanden als verstopping der ingewanden kramp enz. Deze ongesteldheden die bet leven verkorten en onaangenaam maken zullen genezen worden door het geregeld gebruik dier onschatbare pillen en het lerugkeereii der kwalen kan ook door het gebruik derzelven voorgekomen worden. Een ieder die dergelijke bezigheden heeft moest van de pillen voorzien zijn. Door het vermeerderd debiet zijn de prijzen als volgt Doosjes Pillen f 080 f 185 f 300 f 675 f 1350 f 2Ö.SO. Potjes Zalf f 080 f 185  f 300 f 705  f 1385  ( 2025 Zijn op franco aanvragen a kontant te bekomen bij 11. van Goorbergh te Breda; bij J. P. Verlinden te Bergenopzoom; bij G. Boes te Tilburg; en bij J. Straatman . Hoolddepóthouder te 's Hertogenbosch; alsmede in Holloway's etablissementen te Londen 244 Strand en te New-York. 80 Maiden-Laine. JTaarmarkten in Noordbrabant. 11 Februarij. Bladel en Netersel. beestenmarkt. 11 Februarij. Heeze beestenmarkt. 18 Februarij. Budel jaarmarkt.,http://resolver.kb.nl/resolve?urn=ddd:010079254:mpeg21:a0014:ocr,4,ddd:010079254:mpeg21:p004,De Noord-Brabanter : staat- en letterkundig dagblad,892
2947670,1861/04/19 00:00:00,2794,ddd:010584978:mpeg21:a0054,http://imageviewer.kb.nl/ImagingService/imagingService?id=ddd:010584978:mpeg21:p007:image&x=1194&y=222&w=1055&h=2794,ddd:010584978:mpeg21,2249,3016,1194,222,10,Ml). ZKNIMiEL l)MIÜMI). BOZBI EN OMLIGGENDE PLAATSEN. i 00-..1 « ti-Nt _:n<- ai»* iti .<- te Rauwerd op Woensdag den eersten Mei 's namiddags te half twee ura. Zy zal in het Kerkgebouw met het houden eener openbare opwek kiogsrede worden geopond door den WelKerw. Zeer Gel. Hoer A. MOENS Predikant to Snoek en daarna door leien en begU-.stigers des Genootschaps worden voortgezet in het loge ment bij D. D. Valkuma. Namens het Bestuur J. KON IN -  Sec. EXTRACT-VONNIS. By vonnis gewezen door de Arrondissements-Regtbank te Leeuwarden den vyfden Maart 1.00 eon en zestig behoorlijk geregistreerd is de Rcheidlng v..n Tafel en lied tusschen JANTJE PIETERS WOUDA wonende in de Valom onder Dantumawoude als Eischerse en CORNELIS HALBES HALBKSMA Landbouwer wonende aldaar als Gedaagde uitgesprokon  met alle de gevolgen daaraan by en uit kracht der Wet verknocht. Voor Extract conform Mr. lE. M. de SWART Procureur der Eischerse. By' acte gepasseerd door den Edel Achtbaren Heer Kar tonregter *.e Heerenveen den 6 April 1861 is aan TJEBBE HESSELS de JONG minderjarigen Zoon van wylen HESSEL DOUWES de JONG handllgtinir verleend tot het uitoefenen van een Tabak-fabriek en het dryven vao nering en handel. Geschiedende deze bekendmaking ter voldoening aan art. 486 van bet Burgerlijk Wetboek. By acta van den 15 April 1861 verleden voor het Kantongeregt te Leeuwarden behoorlyk ger. heeft de Heer H. BOLMAN te Leeuwarden aan zijnen Zoon DIEUWKO HA:OMDES ANDRIES BOLMAN te Eindhoven liandllgtlng verleend hem toekennende de bevoegdheid tot de geheele ontvangst de uitgave van en de beschikking van zyne inkomsten het fabriceren en verkoopan van damast pellen en linnen het dry ven van nering cc handel in die artikelen en het sluiten van alle verbindtenissen tot dezo fabrikatie en handel betrekkelijk. Mr. J. L. HUBER Griffier bij het Kantongeregt. VERZOEK TOT RfcHABIL.TATIb. Ter voldoening san art. 895 van het Wetboek van Koophandel en nit kracht van een bevel door de Arrondissements-Regtbank te Leeuwarden op den tweeden April 1800 een en zestig verleend  zynde behoorlijk geregistreerd  worot bij deze aangekondigd dat door JAN GJALTS KUIPEBS Junior vroeger Koopman to Leeuwarden aan gemelde Regtbank verzoek is gedaan  om opheffii.g van den staat van faillissement  waarin hy by' vor nis van dezelve Regtbank van den zevenden September 1800 acht en vijftig is verklaard  en om alzoo te worden gerehabiliteerd. Mr. B. IJ. WA KM O LTS Procureur. HULPONDER W IJ S. Zij die genegen zyn de betrekking van HULPONDERWIJZER aan de Openbare Lagere School te Dockum waaraan eene vaste jaarwedde is verbonden vao f 850 te vervullen  worden verzocht onder overlegging der vereischte s'ukken zich met jranco brieven te wenden tot het Gemeentebestuur van Dockum  niterlyk vóór 1 Mei e. k. Er bestaat tevens geschikte gelegenheid tot verdere opleiding van Hulponderwijzers. Hel Gemeentebestvur van Dockum A. POVTHUMA. De Secretaris A. van SLOOTEN.,http://resolver.kb.nl/resolve?urn=ddd:010584978:mpeg21:a0054:ocr,7,ddd:010584978:mpeg21:p007,Leeuwarder courant,1055
4918167,1861/05/02 00:00:00,4467,ddd:010136712:mpeg21:a0014,http://imageviewer.kb.nl/ImagingService/imagingService?id=ddd:010136712:mpeg21:p004:image&x=2282&y=137&w=1101&h=4467,ddd:010136712:mpeg21,3383,4604,2282,137,6,"! Voor de NOODLIJDENDEN binnen deze STADt is alsnog bij den Ondergeteekende in dank ontvang-*: [ Van A. Z. 15 Linnen Lakens welke even als de voorgaand. Behoeftige Kraamvrouwen zullen worden bestemd; de onbekende öc""* j Van liet Bankhillet groot Honderd Gulden wordt berigt dat het -o°r  ZEd. bedoelde Gezin is woonachtig in buurt LL en hetzelve door tussen»""' komst van den Doctor daarvan wekelijks zal worden onder»!?***""'- • u- worlt berigt dat er van zijne Gift nog ƒ13.25 overig is en er>-**r f heden geene behoefte meer in dat gezin bestaat de man is als Tinu_ö' i """"""--knecht geplaatst. J. WM»OOC._IY Mz. (7774/ ? ~aTkEPPLER Cuisinier.""^  Bloemmarkt F 125 verlangt een JtOA-.-I'F. 1111)11 \DI • W i vervoege zich in Persoon aan bovengenoemd Adres. (7738) ; voroNï__R_r ' jgiswz *.*- _-_-__ r^_ „_rr_s_ Jaren. Kennis van de Fransche Engelsche en Duitsche Talen v""'""* ¦ vereischt maar vooral ook een zeer fraai Handschrift. Adres met ei.-""1' handig geschreven Brieven franco onder Letters V. S. Bureau U 1  dolsblad. "" (7777) . JU ÖIT DE HANDTEKÖOPr ' -T_^rps* Een uiterst Solicd naar deu laatsten Smaak be«--> goed onderhouden ZOM-n«TE„T%Y_GEI.TJ(E •_( Vier Personen en Knechtszitting zoowel voor een als voor twee ?¦»-_ i geschikt. Dagelijks van 12 tot 3 Ure te bezigtigen en te bevragen te*? i Stal Kerkstraat tusschen dc Vijzel- en Spiegelstraten 88 589.  lEïfl__.D 26 Jaar oud van da b_te Getuigen voorzien -eed k—me»-* Schrh'ven en Rekenen en met het Verkassen van oud Vaatwerk en ¦** ' verder in het Knipen te pas komt bekend zag zich gaarne hier of -lJcrt goplaatet op eene Pabriek waar men hem dienstig oordeelt. Hierop Bf' flecterende gelieve men zich te Adresseren onder het Nummer dezer -**J' 1 vertentie Bureau Handelsblad. (77 Door een zeer Onverwacht en Haastig Vertrek biedt men voor SP***' PI-IJS van cene Ferme TAPPERIJ) waarin altijd en nog *-*? i goede Kostwinning is geweest. Adres Franco Brieven onder Lett bij den Boekhandelaar D. C. VAN VOORST Wijde Gasthuisiuolen»-'*^ XX 613 te Amsterdam. (7739) _-£'ior_._i_-r_._er toaval TE HUUR cene in volle werking •*-!)""ƒ' GIUI I-I-IJI en toebehooreu op een der beste St_nd„ van UtreI**; Hierop reflecterende gelieve men zich met franco Brieven ouder Lr. t£ . adresseren aan den Boekhandelaar W. MAAICSCHALKERWAA-*^ ""]______ (665 Een JONG IWENSCH van goeden huize 6 jaren werkzaam i vak vail MANUFACTUREN  kunnende met Paard en Rijtuig om.*"" weiischtc Mch geplaatst te zien als REIZIGER  liefst in .-• Prov. Limburg Noord-Brabant of Gelderland. Reflecterendcn wen» met iTiinco Brieven onder Lett. J. v.L. aan de Wed. H H UYTTI*y BBOECK Boekhandclares te Venlo. (778-3 Ter uitbreiding t..nei- Handelszaak wenscht men een of twee CO?*. iH\-„«._'.l_ï- DEEI-GF-.00TE1. die in staat lijn »iicvcs.-l'^' oen Half Millioen Gulden aan te brengen en genegen om nadat b-B „ oen of twee Jaren  in welker verloop slechts 50 Mille is te storten i "" goede gang zal zijn gebleken als werkende Dcelgenooten op te t'ei« of zich als zoodanig te doen vertegemvoordigen. Adres Frauco Leit. B* Bureau Handelsblad. (7776) Een bekwaam BOEKHOUDER tevens «EROUTU-E--8? REIZIGER . gehuwd en 35 jaren oud wenschte giturne van B-0*' king te veranderen en aan een Solied Huis overgeplaatst to vof^! onverschillig waar of in welk Vak. Rellecterenden gelieven zich F'!_s. te adresseren onder Letter A. B. bij de Boekhandelaars M SCHOOF VELD en ZOON Bcaarsstceg E 188 te Amsterdam. (769») OM DADELIJK TE AANVAARDEN wordt op een KAN verlangd HMtVll van 20 _ 25 Jaren P. 0. de noodige km zittende en ter mcdo¦ bijwoning der Beurs tegen een Salaris vnn/-3*- -.00 naai* bekwaamheid accuraat in alles sierlijk Schrift en be-TFj van eerlijkheid goed gedrag en op welk Kantoor werkzaam is ge« » nog zijnde is vereischtc. Adres Franco onder Lett F B bii den B°^ H. W. HELMIG. Stilstcg te Amsterdam. J (778*») Door J. C. A. SULPKE te Amsterdam is Uit--*-'-' Du. S. I 1t.E1»«1..\1*  NEDERLANDSCH OOST-°cn W&1 INDIE voljcns de nieuwste inrigting. met betrekking tot Aardrül-*kuD j. SuttisÜék Voortbrengselen Luclitgesteldheid en vooral tot den Ge*-00 heidstoestand. Dit het Hoogdiutseh Prijs f' 50 PROF. F. RAISIK DE STERRENHEMEL 2 Deelen f&Zki lste Deel afzonderlijk onder den titel: DE .STERRENHEMEL *~ïl KL AARD. Berde op nienw vermeerderde Druk. Prijs ƒ5 2de D*0*.») zonderlijk onderden titel: DE STERRENHEMEL BESCHREVE*'t AFGEBEELD. Met een llcmelplcin in 2 bladen benevens 5 Sta-*-*--ten. Tweede vermeerderd» Druk. Prijs ƒB.BO. Wit. P. Jl. ÏlOLLIHAN HANDBOEI. VOOR BEOEFENA-__ DER PHOTOGRAPHIE. Met twee uitslaande Platen. Prijs fl. 50 X_t_____fl___M-_-.Si^ |B„ C. 11. RECLAM st-. in Leijw.ig j_t so eb*-19 j| erschienen und in der SEYFFARDT'sch-n >g Buehiiandlung in Amsterdam voriaihig: I Bic Populilre Predjgt!3 Nach ihren Erfoiilernissen dm-gestullt und durch Beispiele »vS ('^ !3 vorzüglichsten Kan„lr„nern von Luther bis am die neuest- -^ 2 eiliiutert.— Ein Beirrag zur Homiletik von K. KIRSCH Oliarpfarf*C §u.s. w. Preis/1.60. ' (7773)_ Bij GEBR. BELINFANTE Boekhandelaren * 's Gravenhage  ziet lieden liet licht: llM__¥m crOKl_&4_%r£f _ TJC DATJMALE ET L'HISTOIRE DE FRANGE par L. SCIIAUER Homilie de Lettres de Paris. PI-IJS S-.40. (_J^ CLEEF. Motel van Stirum. Gezonde Ligging. Heerlijke Wandelingen. Vroljke Apprtr^o(nl'' Stilte. Abonnementen voor Fomilien. (7724) W. ARMTZ ZOON. _«•",http://resolver.kb.nl/resolve?urn=ddd:010136712:mpeg21:a0014:ocr,4,ddd:010136712:mpeg21:p004,Algemeen Handelsblad,1101
1906344,1861/09/15 00:00:00,1494,ddd:010790001:mpeg21:a0017,http://imageviewer.kb.nl/ImagingService/imagingService?id=ddd:010790001:mpeg21:p005:image&x=1374&y=148&w=1276&h=1494,ddd:010790001:mpeg21,2650,1642,1374,148,8,De voorwaarden waarop deze Verpachting zal plaats hebben zoomede de omschrijving der perceelen liggen ter lezing ter Griffie van het Provinciaal Bestuur van Zuidholland ter Secretarie van de Gemeenten  waaronder de perceelen gelegen zijn aan de Directien dei- Registratie en Domeinen gevestigd te Breda Middelburg en sGravenhage; aan de kantoren van de Ontvangers der Registratie en Domeinen te Rotterdam Schiedam Brielle Oud-Beijerland IJsselmonde Gouda Papendrecht Gorinchem Dordrecht Middelharnis Oosterhout Zeveiir bergen  Zierikzee en Tholen ; ten kantore van den Notaris Mr. P. G. Dalen te Rotterdam en eindelijk ten kantore van den Ontvanger der Domeinen te 'sGravenhage alwaar tevens ter inzage ligt de kaait waarop de perceelen zijn afgedeeld. Do gedrukte voorwaarden en omschrijving der perceelen zijn  togen betaling van 25 cents voor ieder exemplaar verkrijgbaar ten kantoro van den Ontvanger der Domeinen te 's Gravenhage en ten kantoro van de opgenoemde Ontvangers der Registratie en Domeinen. De Ontvanger der Domeinen te 's Gravenhage 11. COLLOT d'EsCUKY. OPENBARE AANBESTEDING.. Do Kolonel Directeur der Artillerie- Stapel-en Constructie-magazijnen to Delft zal onder nadere goedkeuring op den Bsten October 1861 des middags ten 12 ure op het Bureau zijner directie in de Houttuinen  in het openbaar aan den minstinschrijvendo Aanbesteden de levering van: 26512.5 pond Geraffineerde Salpeter in Brooden; 10 Kiemen ongealuind kardoespapier; en 2000 Riemen Wit Infanterie-patroonpapier. Do Voorwaarden der Aanbesteding zullen van heden af ter lezing liggen op het Bureau des Aanbesteders op de Bureaus van de Heeren Commissarissen des Konings in de Provinciën alsmede van den Heer Kommanderenden Officier dor Artillerie te Maastricht en in het Cafd des Pays-Bas bij den Heer Molenbeek Botoimarkt te Amsterdam. Delft den loden September 1861. De Kolonel voornoemd J. W. Blanken.,http://resolver.kb.nl/resolve?urn=ddd:010790001:mpeg21:a0017:ocr,5,ddd:010790001:mpeg21:p005,Nederlandsche staatscourant,1276
1738732,1861/08/02 00:00:00,2379,ddd:010546116:mpeg21:a0014,http://imageviewer.kb.nl/ImagingService/imagingService?id=ddd:010546116:mpeg21:p002:image&x=67&y=1259&w=2929&h=2379,ddd:010546116:mpeg21,2996,3638,67,1259,4,*„* Bij een der leden van de commissie die zich gevormd heeft tot ondersteuning der meest behoeftige landlieden in Gooiland die geleden hebben bij den vloed van 30 Junij jl. is in dank ontvangen f 5880 in coupons uit Amsterdam van H. en M. F. ROTTERDAM — BORDEAUX. Het STOOMSCHIP BORDEAUX Kap. BIJL vertrekt naar Bordeaux Zaturdag den 1 Oden Augustus. Deze afvaart correspondeert met de Mailboot die 25 Augustus van Bordeaux naar Brazilië en Laplata vertrekt: — Goederen voor Pernambuco Bahia Rio Montevideo en Buenos-Ayres worden te Rotterdam met directe connossementen aangenomen. ROTTERDAM — ST. PETERSBIRG. VIA KOP EX RAGE. Het STOOMSCHIP GIRONBE Kapt Van EMMERIK  vertrekt naar Kopenhage en St. Petersburg Maandag den Uden Augustus. Nadere inlichtingen bij G.SMITH&Cie te Rotterdam. *+* Bij de opening der Stembriefjes ter benoeming van *es Visitatoren tot het onderzoeken der gesloten Rekening van de Maatschappij van Assurantie Discontering en Beleening der Stad Rotterdam is gebleken dat bij meerderheid van stemmen zijn benoemd de Heeren: Mr. J. A. M. BICHON van IJSSELMONDE. A. van der HOOP Janszoon. J. KOLFF. JOHs. van VOLLENHOVEN. P. H. TROMP. H. W. A. van OORDT. Rotterdam 30 Julij 1861. REHABILITATIE. Bij Vonnis van de Arrondissements-ltegtbank te Haarlem van den 30st<m Julij 1861 is het aceoord hetwelk door den Heer C. J. GEIJER Winkelier aldaar handelende onder de Firma C. J. GEIJER en COMP. in staat van Faillissement verkeerende met zijne Schuldeischers op den sdcn5dcn Julij jl. was aangegaan gehomologeerd en de gefailleerde bij dat vonnis gerehabiliteerd. De Curator Mr. H. GERLINGS Cz.,http://resolver.kb.nl/resolve?urn=ddd:010546116:mpeg21:a0014:ocr,2,ddd:010546116:mpeg21:p002,Opregte Haarlemsche Courant,2929
7662093,1861/06/10 00:00:00,6027,ddd:010131424:mpeg21:a0066,http://imageviewer.kb.nl/ImagingService/imagingService?id=ddd:010131424:mpeg21:p003:image&x=989&y=63&w=2999&h=6027,ddd:010131424:mpeg21,3988,6090,989,63,4,"Douanen op de Grenzen. -Wij (dat wil zeggen de Bed. van het Blad) ontvangen den volgenden brief en deuken er te kunnen bijvoegen dat de ondervinding ons van de waarheid daarin opgevat overiuigd heeft: Heer uitgever Tan het „Handelsblad"". Het voorstel van M. Joffn-y namelyk bet verscheuren «an de douanen-wetten het afbreken van palen en tariefplanken het naar de maan zenden der ambtenaars en het sluiten der tolkantoren.... maakt grooten voortgang. De ziekte der afschaffing wordt hierin al ruim zoo erg als die der jeneverproevers en we zien den dag welhaast aanbreken dat wij om de afgebrokene grenspalen zullen dansen gelijk wy gedanst hebben om de octrooihuizen terwyl er ambtenaars zullen zyn die met on» den rondedans zullen maken. Ge siaat verwonderd: niettemin zulke ambtenaars zyn er. Hoe kan men inderdaad beter voor de afschaffing der douanen werken dan door helder en kiaar te doen zien boe lastig kwellend plagend en onregtvaardig die douanen zijn en door de mensche-n ieder dag in hunne litanie te doen bidden: «van plagende ontvangers ambtenaars en grenspalen verlos oob Heer!"" Het Nederlandsche gouvernement heeft sedert eenige maanden aan het grenskantoor Bensel (boven Turnhout) een dier plaaggeesten geplaatst die ieder dag door de reizigers de douanen naar al.e duivels doet wenschen en zoodanig wy herhalen het het getal der afschaffers grooter doet worden. Nu ik ben geen afschaffer en daarom ben ik ook tegen eiken plaagduivel die onder vorm van een mensch de wetteu hatelijk komt maken en ze door het voik doet verweuschen: —wij waarschuwen al de Belgen die een reisje van Turnhout naar Eindhoven zouden wagen tegen dat kantoor —niet oneigenaardig als een soort ran wespennest aangezien — waai ut ontvanger en ambtenaar? op alles wat voorbij kumt neervallen al wa» het maar op een stuk peperkoek of eene deels leeg gedronken flesch wyn. Brood dat de boeren maken van roggemeel wordt door dien ontvanger aangezien a 15.... banket; houihakkers die aan het Belgisch kanaal eenigo boomen gaan fa.soeneren moeten bij het teiuskeeren bitalen voor het vervoeren van hunne oude bijltjes; een teug wijn om niet van dorst te versmachten betaalt de veekoopman de vuerman; kortom ieder paßSant moet . aar gevoelen wat douanen zijn en hy wordt er 'gepluimd en g. plukt zoo veel al» de letter der wet het maar eenigzins toelaat terwijl men in Essen en Boosendaul voor nietigheden de schouders ophaalt en verdraagzaam ib. Wij begrijpen heel goed dat zulke ontvangers zioh verdienstelyk willen maken by het gouvernement door boer en burger to plagen en zooteel mogelijk af te persen; maar het Nederlandsche gouvernement i» te liberaal te vrijzinnig om dergelijke maatregels als eene verdiennte aan te zien; zy"" kunnen bij een loyaal minister of opperhoofd niet anders aan afkeer doen oni staan. Wat my betreft mijnheer ik heb enkel mijne Belgisohe landgenooten die langs Arendonck over de grenzen gaan willen verwittigen dat zy niet op veel redelijkheid in dat kantoor rekenen zouden en zioh zoo weinig als mogelijk zouden belasten met kleinigheden die men denkt dat niets betalen en waarvoor men evenwel daar gekomen veel — heel veel moet neêrte.len terwijl men nog 1 kans heeft van een proces-verbaal op den koop toe op den hals te krijgen. 1 Wat de afschaffers aangaat het schijnt ons zeker dat die in den ' hoogsien hemel moeten zijn: niemand wij herhalen het maakt meer propaganda teg-n de douanen dan wel menschen die ons op ieder 1 oogenblik doen gevoelen dat de douanen jammer genoeg! verge' ten zyn geweest in de zeven plagen van Egypte. ' Met dezen brief op te nemen zal uw biad eene groote dienat bewijzen aan velen zijner lezers vooral aan diegenen welke in han-1 dels- of nijverheidabeirekking staan met Noord-Braband. 1 In verband met het bovenstaande geef ik: JEene prysvraag. Een Amerikaan een Yankee van echten stempel die zyn geheel leven lang geweldig door de muiren was geplaagd en getergd geweest wilde op zyu sterfbed eene weldaad aan het mensehdom bewijzen en ' schreef in zijn testament dat hy een prys van 500 dollars (f 12ï0) naliet vour dengene die het boste middel zou aanwijzen tot vermindering der muizen. De uitvoerders van het testament ontvingen veel geweldig veel brieven van mededingers naar de ƒ 1250; isder gaf een middel op om de muizen te vernielen. „.... M»ar welk wa» nu het beßte middel? wie moest den prijs hebben ? ' De uitvoerders van het testament waren in de grootste verlegenheid • want wie zou zich bezig gehuuden hebben met al de ingediende middet len op de proef te stellen? Dit was inderdaad eene zwarigheid. Maar ii ziet op het iaatst kwam er nog een mededinger naar den muizenpry- die al het bezwaar uit den weg ruimde. Meu Opende zyn briet en in s piaats van arsenic phosphorus gestampt glas en andere droogeryen Tot vernieling der muizen voor te schrijven bevatte zyn brie* dez» e woorden:  - Het beste middel om de muizen te vermindee ren is ... de katten vermeerderen. '• De testamentuitvoerder» aarzelden geen oogenblik meer zy «ehre "" ven probalum est op 't laatst ingezonden middel en kenden het ai "" Zou dit°geene grap wezen ? — Laat het zijn wat het wil dit belet nie n dat de Economiste Beige van het prapje gebruik maakt en zegt: —Un 'j gouvernement heeft ook een prys uitgeloofd niet om muizen en rattei n te vernielen neen want ons gouvernement houdt geweldig veel val ;e ratten vreemde ratten en inlandsche ratten die niets doen dan groot r"" gaten in onze kleederen (het budget) knagen; neen het is een prijs vai *' / 2500 te winnen door hem aie het beste middel weet aan te duider ? om onzen kwijnenden handel weer van het lijkstroo op te beuren e I gezond te maken. "" —De Economiste beweert dat hij vast den prij» moet winnen me dit middelij e op te geven: II «Het beste middel om den handel te doen her leven is om de ambtenaren af te schaffen. j. Het is wel mogelyk dat onze vriend Molinari gelijk heeft maar W a- gelooven nog niet dat zoo men morgen op eens al de commiesen mi n een behoorlijk pensioen liet naar huis gaan dan de handel in eens va ¦e zijn ziekbed zou opstaan en gezond worden. De ambtenaren zoo ze; N) men ja belemmeren den handel gewe dig en er is geen koopman c r. expediteur die den laatsten douanier niet zou naar de maan wensehei m de douanier» belemmeren den handel wel met hunne duizend kwe 5n lende formaliteiten maar zij beletten den handel daardoor me t. de handel put zijne levenskrachien niet uit de douanier» dus kui m nen de douaniers de levenskrachten van den handel niet doen ui >r. droogen. Maar zullen onze lezers mogelijk vragen al» de Mconi „t miste het vraagstuk niet heeft opgelost kunt gy h«t«""F"" at Kunt gy den prys verdienen ? Daar willen wy eens over nadenken. De RANGSCHIKKING in den insolvent verklaarden BOEDEL van WOLBERT -L-EISSEN Brood)akker in do Laurierstraat te Amsterdam is gedurende reertien da^en gedeponeerd ter Griffie der Arrondissenents-Regtbank ter inzage van belanghebbenden. Amsterdam 8 Junij 1661. De Curator Jl. P. FARRET Adv. 2539*\ Waimoesstraat J 40. ~Wm MET DE HOOFDEN te Amsterdam. C. F. ROOS G. DE VRIES Jz. en W. J. M. ENGELBERTS zullen op Dingsdag den 11 Junij 1861 ter plaatse voornoemd verkoopen: Eene zeer fraaije en uitgebreide verzameling (2474) SCHILDERIJEN door Oude en Hedendaagsche Meesters uit onderscheidene Scholen waarbij vele Antieke Stukken voorkomen; bijeenverzameld door twee voorname Kunstliefhebbers. De CATALOGUSSEN zijn aan de bekende adressen verzonden en te bekomen bij genoemde Directie. Particulier te zien van af Donderdag 6 tot Zaturdag 8 en voor het Publiek op Maandag 10 Junij 1861. THiiilllilßEß-PEPERMIT BEBEID DOOB EN VEB_BIJGB__B BIJ T.W. SIMOWS Ad Sint Jansstraat Nft 267 IN DBOOOEKUEN ENZ. AMSTEBDAM. Prijs 20 Cents de Doos welke verzegeld en van Etiquet met Handteekening voorzien is terwijl elk Schijfje met den Naam is gestempeld- In zich vereenigende datgene wat PEPEBMUNT- en GEMB EBTABLETTEN op zichzelf e beziiten munt dit NIEUWE ABTIKEL eenig tot dusverre bijzonder uit door zijne voortreffelijke eigenschappen als ook door smaak eu nasmaak. Door deskundigen als een uitmuntend middel reeds beschouwd wordt het ieder bijzonder aangeraden _fn Tegen goed Babat worden er door geheel ons land VerjpiiS. koopers gevraagd. HH. Verkoopers mijner dubbel Sterke Pepermunt wordt berigt dat de Conditien dezelfde als van voornoemd Artikel zijn. Brieven franco aan bovenstaand Adtes. <?ÜÜ j|&JL DOCTOR J. A. HES x§3l|j|è Chir. Dentiste -{g^* *_s||g> is dageliiks te consulteren wegens het inzetten van KU«BTTAWDEMenGEBITTEIIhet vervaardigen van GLISOIRE3 en OBTURATEURS; abonneert familiën en verrigt alle verdere operatiën de Tandheelkunde betreffende. (1661) ÊfSST* Kloveniersburgwal het 3de huis van het Rusland B 115 te Amsterdam. . BMBENIffOERBETERBE ALÏZMHir is volkomen vrij van zuren zoodat de Stalen Pennen er niet door worden aangedaan; ze vloeit gemakkelijk uit de Pen is bij den aanvang niet zoo bleek als andere Inktsoorten en verandert jteer spoedig in het schoonste zwart. Ze verdikt niet noch in de Pen noch in den Inktkoker en beschimmelt nooit. Ondanks hare vloeibaarheid is deze Alizarin-Inkt teveni voor Copiëer Inkt uitmuntend geschikt. Prijs 60 40 30 en 20 cents het glazen tonnetje. Roode en blaauwe Inkt brillant van kleur en goed vloeibaar; het fleschje 20 cents. J. ALEXAKDEES RESERVOIR-PEN is de gemakkelijkste en aangenaamste Pen voor allen die eene ligte en loopende hand schrijven. Het V 2 grosdoosje 75 cent.' Ook geven wij hiermede kennis dat de zoo gezochte GILLOTT'S CORRESPONDENTIE-PENNEN N°. 382 of driegaatjes Pen verder N°. 417 en N°. 0118 in V* grosdoosjes gepakt weder voorhanden zijn. Te verkrijgen in het Hoofd-Dépöt VERKOOP- MiZJMS en in zijne bekende Dépöts in de Provinciën. (2512) iTffl-BS"""" Door een practiserend Geneesheer te AmhW? sterdam wordt ten spoedigste gevraagd een bekwaam MAGNETISF.UH. Nadere informatiën onder Lett. M. A. aan het Bureau Handels- en Effectenblad. (2408)",http://resolver.kb.nl/resolve?urn=ddd:010131424:mpeg21:a0066:ocr,3,ddd:010131424:mpeg21:p003,Nieuw Amsterdamsch handels- en effectenblad,2999
1582600,1861/01/05 00:00:00,1544,ddd:011060724:mpeg21:a0003,http://imageviewer.kb.nl/ImagingService/imagingService?id=ddd:011060724:mpeg21:p002:image&x=1163&y=2309&w=1025&h=1544,ddd:011060724:mpeg21,2188,3853,1163,2309,4,"ADVERTEB3TIEN. ' BËRENDÏIAKmG."" "" Op Bingsdag den 8 Januarij 1861 zal ten bureele van den Resident van Soerabaija EENK UITBESTEDING worden gehouden voor den overvoer van steenkolen v»n Soeralaija naar Amhoina Temate Kema Ktoandany Bima (Poeloe kambing) eu Baettm. De voorwaarden liggeu liet uitzondering van zon- en feestdagen ter inzage voor belanghebbenden op gemeld bureau. SoKRABiYA  Namens den Resident 27 December 1860. De Sekretaris  (2122) CH. 'JTBIÖBH» bekëndmakingT"" «I» Zatnrdag den 12den «lezer zal ten overstaan van den Adsistent-Resident van Sidho- Ardjo voor afbraak publiek worden verkocht de oude kontroleurs woning eu bijgebouwen te Boengoor. Soerahaya Namens den Resident den Aden Januari! 1861. De Secretaris (25) Chr. TROMP. I)e Wijk meesters dezer plaats worden beleefd verzocht ten spoedigste aan mij de bevolkiugstaten te willen indienen zoomede de cohieren der paardenbelasting tegen ultimo dezer. §ocra!»aya De Assistent Besidenl 1 Januarij 1861. voor de politie (19) E. DIBBETS.",http://resolver.kb.nl/resolve?urn=ddd:011060724:mpeg21:a0003:ocr,2,ddd:011060724:mpeg21:p002,"De Oostpost : letterkundig, wetenschappelĳk en commercieel nieuws- en advertentieblad",1025
607595,1861/06/24 00:00:00,685,MMKB08:000088097:mpeg21:a0019,http://imageviewer.kb.nl/ImagingService/imagingService?id=MMKB08:000088097:mpeg21:p003:image&x=1885&y=52&w=887&h=685,MMKB08:000088097:mpeg21,2772,737,1885,52,8,Advertentie publieke forhoopittg van B0UWIATE1ÏI4LEN. Op Donderdag den 27 Junij 1861 des middags ten twaalf ure zul men in het Kamp bij Milligen gemeente Apeldoorn  publiek voor contant geld Verkoopen: Eene groote hoeveelheid PLANKEN NOORDSCHE JUFFERS en KOLTERS STEENEN en PANNEN; verder eene groote partij STEIGER-GEREEDSCHAPPEN in alle soorten alles zeer geschikt tot het bouwen van Cantines in genoemd Kamp.,http://resolver.kb.nl/resolve?urn=MMKB08:000088097:mpeg21:a0019:ocr,3,MMKB08:000088097:mpeg21:p003,Arnhemsche courant,887
1909700,1861/07/11 00:00:00,2260,ddd:010981083:mpeg21:a0044,http://imageviewer.kb.nl/ImagingService/imagingService?id=ddd:010981083:mpeg21:p004:image&x=76&y=2794&w=845&h=2260,ddd:010981083:mpeg21,921,5054,76,2794,6,"DIRECTEUREN ""van het Administratie-Kanm-ir opgerigt door A. L. VAN HARPEN en PLUYM k j BACKER te Amsterdam adverteren met goedvinden van Heeren Commissarissen dat de COIIPOMH der ïi°o Certificaten dezer Administratie. verschenen 1 Julij 1861. worden betaald en ingetrokken ten Kantore van de Ontvang- en Betnalkas alhier en elders bij Heeren Correspondenten. Bovenstaande Coupons worden dagelijks uitgenomen /les Zaturdag». betaald ten Kantore van A. AUBIÉ Leuvehaven wijk 3 n.° sb. Wed. B. POLAK & Co. adverteren dat ten hunnen ' Kantore Bierhaven hoek van de Wijnhavep  dagelijks j gevaceerd wordt tot Betaling der COlf PO TV S : verschenen 1 van Certlilcateii «V Werkelijke Schuld uitgegeven >lonr hel Administratie-Kantoor van de Heeren BRON DGEEST & Zn. c. s. te Amsterdam en Utrecht. A. GELDEREN; B K B 1 X fi E il. IS VERHUISD var hei Kwakernaat naarde GA PE'«.STEEG wijk » n.° ÏOO bi| de Vischsteeg. AANBESTEDING. Op den 17 Julij 1861 d-s voormiddag- ten elf ure zal ten Raadhuize van Zuiil-Waililinxvei-n  san de Hooge Briiij aldaar worden Aanbesteed: Het M;(;tK\ van ongeveer SOO vierkante Ellen HJlnkerstraat in die Gemeente volgens B---iek en Conditie» welke ter voor/. plant* ter lezing liggen. ROnERüM-GRANtiHHHiTH in directe verbinding met ttLA9t!OW door het Porth- in Clyde-Kanaal. Het Stoomschip EOUIS E Kapitein P. .1. van der Grient zal »van hier naar GRANGEMOUTH vertrekken iZ'ATURDAG 13 Julijles moivens vroeg. Adres bij D. BURGER Sr ZOON. iiöïïHPiiifLir Voor Passagiers en Goederen. De Stoomboot LOR1'» RAGLATV  Kapitein John Hart zal van hier naar NEWCASTLE vertrekken ZATURDAG 13 Julij des morgens vroeg. Adres bij D. BURGERS? ZOON. ROïïlDf Ilil lederen WOENSDAG en ZATURDAG. Met de ) Enchantress Kapit. Ths. Farr. : Stoomschepen | Ocean Queen „ Chs.Hardv.il Het Stoomschip EX t II A>TK ESS vertrekt!. van ROTTERDAM naar HULL Zaturdag;1 18 Julij des namiddags. De Agenten SEEUWEN 6/ Co. jl",http://resolver.kb.nl/resolve?urn=ddd:010981083:mpeg21:a0044:ocr,4,ddd:010981083:mpeg21:p004,Rotterdamsche courant,845
661990,1861/08/28 00:00:00,686,ddd:010546138:mpeg21:a0036,http://imageviewer.kb.nl/ImagingService/imagingService?id=ddd:010546138:mpeg21:p005:image&x=1020&y=3261&w=965&h=686,ddd:010546138:mpeg21,1985,3947,1020,3261,6,*** Aan een der openbare Lagere Scholen in de Gemeente Helder  wordt ten spoedigste een HULP-O._ - DERWIJZER gevraagd. De Jaarwedde is bepaald : voor een Hulp-Onderwijzer beneden de 22 jaren op ƒ350 boven de 22 jaren op ƒ 400 en voor hem die eene acte van bekwaamheid als Hoofd-Onderwijzer bezit op ƒ 500. Sollicitanten worden verzocht hunne Stukken intezenden aan den Burgemeester voor of op den 13*™ September 1861. *** Een HULP-ONDERWIJZER van deP.G. 20 jaren oud door bijzondere omstandigheden buiten betrekking wenschte aan eene Inrigting van Onderwijs geplaatst te zijn. Hij is gewoon de Fransche Hoogduitsche en Engelsche Taal te helpen onderwijzen en heeft de beste getuigschriften. Adres Letter P. aan het Postkantoor te Maassluis.,http://resolver.kb.nl/resolve?urn=ddd:010546138:mpeg21:a0036:ocr,5,ddd:010546138:mpeg21:p005,Opregte Haarlemsche Courant,965
1355388,1861/05/21 00:00:00,1262,ddd:010584987:mpeg21:a0012,http://imageviewer.kb.nl/ImagingService/imagingService?id=ddd:010584987:mpeg21:p004:image&x=1202&y=4208&w=1074&h=1262,ddd:010584987:mpeg21,2276,5470,1202,4208,4,ATTENTIE. De Ondergeteekende HARMEN HOTZES HOEKSTRA te Rauwerd brengt by deze ter kennisse van het Publiek dat hij aan te vangen met den 22 dezer het voornemen heeft op. gevat met een HaNDWAGEN te ryden  telken Raandag en Donderdag naar SNEEK bylaogs de dorpen Oohrwifrum Bozum Scharnegoutum en Giënga en telken Woensdag en Katnrdag raar LEEUWaRuEN  bylaogs de dorpen Oosterwierum Mantgum Weidurn  Wirdum en Goutnm ; zich bij deze aan een ieder vriendelyk voor het uitvoeren van CommiBBien en bezorging van Paketten aanbevelende belovende een. prompte en vlugge bediening. Op zyne reisdagen wenscht hy de Commissien en zoo voort ten zynon huize te Rauwerd gaarne te ontvangen 's morgens vóór 8 uur te Sneek by den Kastelein A O 'STERHOF en te Leeuwarden op de Koemarkt by H. FRaNZEN 's namiddags vóór 3 uur. Riowerd 90 Mei 1861. _ _ HOFK^TRA. ATTE\ T 1 E. Gezüstu» T. E en A. SIJTSEMA bM-igteo by deze dat zy alh'er eenen GAREN- eo LINTWINKEL hebben geopend en bevelen zich minzaam aan in de gunst van hunne geachte Stad- en Landgenooten. iiokbiiin  Korenmarkt. HiiTpershoiit. Te Harlingen binnengekomen het Schip Miolphifn  Kap. Z. HFILMERS beladen met KLAPHOUT voor de Heeren I. S. TROMP & ZONEN te Woudsend.,http://resolver.kb.nl/resolve?urn=ddd:010584987:mpeg21:a0012:ocr,4,ddd:010584987:mpeg21:p004,Leeuwarder courant,1074
3533145,1861/05/23 00:00:00,2854,ddd:010902216:mpeg21:a0023,http://imageviewer.kb.nl/ImagingService/imagingService?id=ddd:010902216:mpeg21:p005:image&x=808&y=163&w=1370&h=2854,ddd:010902216:mpeg21,2178,3017,808,163,6,"1 December ISGO. De onverbondene vrije Burgers van Vlissingen zullen stemmen voor Lid van den Raad den Burger W. H. GRAVESTEYW. MARI j\ E. OPENBARE AANBESTEDING bij inschrijving aan 'S RIJKS WERF te""VLISSINGEN op Woensdag den 29 Mei 1861 des voormiddags ten 11 ure van 1. Het doen van eenige vernieuwingen en reparatie» aan de Magazijnen no. 1 en 2 liet Takel magazijn Kantoren van Uitrusting de Victualicloods en het Hek enz. van het droogcDok niet leverantie der Materialen uitgezonderd het Eikenhout; 2. Ilct verwerken van ongeveer 50 kul». El Eikenhout tot reparatie en gedeeltelijke vernieuwing van de Wonnkist in de Marine-Dokhaven aldaar. Volgens de bestekken en voorwaarden welke ter visie van gegadigden ten Burele van den Hoofdingenieur op voorschrevene Werf zijn gedeponeerd  bij wien tevens alle verdere inlichtingen kunnen verkregen worden. De Inschrijvingsbiljetten zullen voor ieder werk afzonderlijk  op Zegel en overeenkomstig Art. 6 van de Bestekken ingevuld op voorschreven dag en uur ter Griffie van de Directie der Marine te Vlissingen moeten bezorgd zijn. Vlissingen. den 18 Mei 1861. De Vice-Admiraal Adjudant van Z.M. den » Koning in B. D Directeur en Kommandant der Marine de SMIT v. d. BROECKE. AAISBESTEDIING. De DIJKSDIRECTIE van den Polder Stavenisse c. a. zal op Maandag den 17 Junij 1861 des namiddags ten 4 ure ter Ilerberge van P. VAN OOST te Stavenisse in het openbaar aanbesteden: Het aanleggen van 2430 Ellen Griend weg in dicu Polder met bijlevering van Griend enz. Het Bestek ligt ter voornoemde Herberg ter lezing; de aanwijzing zal op den dag der Besteding geschieden. Stavenisse den 22 Mei 1861. De Dijksdirectie voornoemd D. RIJNENBURGH Dijkgraaf. MOOLENBURGH Ontv.-Griffier. ROTARISHUIS. VERKOOPING op Dingsdag den 4 Junij 1861 van MEUBELAIRE en andere GOEDEKEN. — Nader en breed er te adverteren. Zuivere en Zindelijke Goederen kan men van heden af bijbrengen. L. C. HONDIUS Ondernemer van Openbare Verkoopingen  ' Taxateur en BoedeTschikker. NEDERLAXDSCIIE HANDELMAATSCHAPPIJ. VEILING VAN BANCA TIN TE AMSTERDAM op Woensdag 26 Junij ISGI bestaande uit: 69157 Blokken liggende te Amsterdam; 55879 „ „ ; Rotterdam; 1910 „ ~ „ Dordrecht; 7382 „ „ „ Schiedam; 4125 „ „ „ Middelburg. Welke hoeveelheden bij tijdigen aanvoer nog zullen kun» nen vermeerderd worden met p. ra. 20000 Blokken. De Verkoop zal geschieden bij Kavelingen van 500 Blokken. De Directie geeft de verzekering dat zij vóór 1 Junij 1562 geen ander Tin aan de markt zal brengen; dat tot opgenoemd tijdstip geene Gouvernementsveilingen van Tin in Nederlandsch Indie zullen gehouden worden en dat almede tot voormeld tijdstip geene verzendingen van dat Metaal van Indie naar China voor Gouvernementsrekening zullen plaats hebben de hoeveelheid van 10000 Picols te boven gaande. De bovenstaande toezegging omvat niet het Tin hetwelk aan anderen toebehoort; zoo dat het Gouvernement zich voorbehoudt het regt om den Concessionarissen voor de ontginning van het Eiland Billiton behalve de 6000 Pikols op Java ook den verkoop in Nederland te vergunnen van eene geringe hoeveelheid die in geen geval meer dan 3000 Picols zal bedragen. Amsterdam 22 Mei 1861. i __ De MIDDELBURGSCHE MAATSCHAPPIJ VAN STOOMVAART voornemens zijnde na bekomene concessie eene Wagendienst op te rigten tusschen Goes en het Wolphaartsdijkschc Veer in verband tot de aankomst van de Stoombooten der Maatschappij aldaar noodigt bij deze uit een ieder die genegen is in het PAARDEN WERK met geschikten Voerman te voorzien zijne inschrijving per reis of per jaar daartoe gesloten en gekenmerkt voor of op den 31 dezer maand aan Bestuurders der Maatschappij in te zenden bij welke inmiddels nadere inlichtingen zijn te bekomen. BRANDMEESTERS van de Spuiten A B  C  D en D/B herinneren den belanghebbende dat de gewone jaarlijksche Exercitie en Inspectie zal plaats hebben op Dingsdag aanstaande den 28 Mei ISGI. Beste bloemige AARDAPPELEN te Koop aan het Pakhuis P 113 Kinderdijk van J. JERONIMUS. VERMIST een zwart-bonte KARNHOND bij J. MEIJERS te Grijpskerke. Belooft eene belooning voor het teregt brengen van denzelven. Een aankomend Meisje benoodigd K 159. . ATTENTIE S.V. P.ü! De ondergeteekende door aankoop Eigenaar geworden zijnde van het wijd en zijd bekend te BRESKENS staande HOTEL: Le Canon dOr heeft de eer aan Heeren Reizigers te berigten dat hij genoemd Hotel of LOGEMENT: HET GOUD KANOS uit den vervallen en onaanzienlijken toestand in welken het sedert eenige jaren onbewoond stond geheel heeft opgeheven het nu zelf heeft betrokken en zoodanig heeft laten inrigten dat zijn Logement alle gewenschte gemakken en aangenaamheden als zindelijke en wel ingerigte Slaapplaatsen wel voorziene Tafel met prompte bediening T vrije Kamers Tuin Rijtuigen voor eén en twee Paarden » bediend door flinke Voerlui enz. aanbiedt. De ondergeteekende beveelt zich bescheidenlijk in de gunst van Heeren Reizigers aan en belooft eene behoor| lijke en civiele bediening. 1 Heeren Landbouwers en alle verdere te Breskens per 1 Rijtuig komende Personen gelieven voortaan gedachtig te zijn — s. v. p. — dat het Goud Kanon te Breskens zulk eene geschikte overdekte Bergplaats aanbiedt voor Rijtuigen en Stalling van Paarden. Breskens den 15 Mei IS6I. J. F. VAN LEEUWEN. VITSPAXNIXG BJ3 XtV^AX. Op Zondag den 26 Mei 'savondsten 5} ure bij gunstigweder HARMONIE van het 2de Regement Infanterie y onder directie van den Heer KORN. STOOMBOOTDIENST TUSSCHEN MIDDELBURG EN ROTTERDAM. Uren van vertrek in Mei—Junij. VAN MIDDELBURG : VAN ROTTERDAM : Zaturdag 25 'smidd. 12ure. Zaturdag 25'smorg. 945- Zondag 26 „ 1230 Zondag 26 „ 1030 Maandag 27 'smorg. 6 Maandag 27 ' 1030 Dingsdag 28 „ 6 Dingsdag 2S „ 1030 Donderdag3o „ 6 Woensdag 29 „ 10.3 a Vrijdag 31 „ 6 Vrijdag 31 „ 1030 Zaturdag 1 „ C Zaturdag 1 „ 1130 Zondag 2 „ 7 Zondag 2'smidd.l2ure. Maandag 3 „ 8 Maandag 3'smorg. 6 Dingsdag 4 „ 9 Dingsdag 4 „ 6 Woensdag 5 : 930 Woensdag 5 „ 6 Donderdag 6 „ 10 Donderdag 6 „ 6",http://resolver.kb.nl/resolve?urn=ddd:010902216:mpeg21:a0023:ocr,5,ddd:010902216:mpeg21:p005,Middelburgsche courant,1370
4713606,1861/07/09 00:00:00,4258,ddd:010136813:mpeg21:a0016,http://imageviewer.kb.nl/ImagingService/imagingService?id=ddd:010136813:mpeg21:p006:image&x=69&y=1183&w=1107&h=4258,ddd:010136813:mpeg21,1176,5441,69,1183,6,"ADVERTENTIE K. Bij Vonnis der Arrondissements-Regtbank te Alkmaar van 3 Julij 1861» is het ACCOORD aangeboden in het Faillissement van JAN HERMANUS SCHAAP Winkelier en Tapper te Alkmaar GEHOMOLOGEERD en de Gefailleerde GEREHABILITEERD. Alkmaar  5 Julij 1861. J. P. KRAAKMAN (12016) Advocaat. FAILLISSEMENT. Bij Vonnis der Arrondissements-Regtbank te 's Gravenhage kamer van Vacantie van den sSen Julij 1861 is HENRIETTE ELISABETH PETRONELLA BAUDUIN Echtgenoote van JEAN STASSART Je. zich teekenende H. STASSART—BAUDUIN Winkelierster wonende te 's Gravenhage verklaard te zijn in staat van Faillissement aanvang genomen hebbende denj 28sten Junij 1861 met benoeming van den Edel- Achtbaren Heer Mr. J. C. VAN DE KASTEELE tot Regter-Commissaris en den ondergeteekende tot Curator. (12015) 's Gea venhage 6 Julij 1861. W. A. H. OUWENS. CONVERSIE GBENADA. Ds ONDERGETEEKENDEN belaston zich met de opzending van bovengemelde Fondsen naar Londen de Kosten zoo min mogelijk berekenende en de Zeerisico guaranderende. (11952) S. RAPHAEL & C. OBLIGATIEN NIEUW GRENADA. De Conversie en Rentebetaling van bovengemelde Obligatien te Londe11 aangekondigd zijnde zoo belast zich de ondergeteekende met het opzenden derzelve. De kostenworden zoo min mogelijk berekend en de zeerisico geguarandeerd. Nadere inlichtingen zijn ten zijnen Kantore verkrijgbaar. (12042) A. H. RE-SER. IIËfiTCTTEiFffiT TE CLEEF ZAL VAN 13 TOT 17 JULIJ op de gewone wijze gevierd worden met SCHIETEN naar den Vogel HARMONIE  BAX en CONCERT tot medewerking waarbij behalve de overige Toonkunstenaars de Kapel van het 3de Westfaalsche Regement Infanterie N°. 16 uit Dusseldorf onder leiding van don Kapelmeester LUTTICH geëngageerd is. Vrienden van gezellig genoegen worden ter bijwoning van dit Feest minzaam uitgenoodigd door (12032) _>E COMMISSIE. AAM_fllE^Tl!_ll»l_¥Ë. Het KERKBESTUUR der Hervormde Gemeente te Eindhoven is voornemens op Dingsdag 25 Julij 1861 des Morgens ten 12 Ure in het Koffijhuis van M. HEZEMANS te Eindhoven openbaar AAN TE BESTEDEN: liet BOUWEN van eene NIEUWE PASTORIE met bijlevering der benoodigde Materialen. Het Bestek zal tegen betaling adƒ 0.90 te bekomen zijn bij den Boekhandelaar Th. VAN DER HEYDEN aldaar. De noodige aanwijzing zal worden gedaan vier dagen vóór de Aanbesteding door het Lid van genoemd bestuur G. RIETBERG bij wien tevens inlichtingen zijn te bekomen en de teekening ter inzage ligt. Het Kerkbestuur voornoemd De Kerkvoogd: (12034) J. W. VAN LELIJIVELD. T A""B A __£• Op DONDERDAG 18 JULIJ aanstaande des Morgens tan 11 Ure zullen in het Notarishuis aan deGeldersche Kade te Rotierdam geveild worden: 1161 Pakken Fortorico TAHAK direct aangevoerd van Arecibo por het Spaansche Schip Bronze Kapitein GUINEA 600 Pakken Aracan TABAK. _ De Monsters zullen twee dagen voor en op den Verkoopdag te bezigtigen zijn achter het Kantoor van den Heer P. VAN DEN AREND alhier. Nadere onderrigting bij de Makelaars in Tabak alhier. (12020) WILLIGE VERKOOPINGdoor 11. G. GEERS Gz. Makelaar en Ondernemer van Verkoopingen op Vrijdag den 12denJulij 1861 des Voormiddags ten Elf Ure op do Noordermarkt van eene extra mooije en groote partij AF BJïAAIi. afkomstig van de Perceelen in de Kalvorstraat bij den Heiligen Weg  bestaande in beste Eiken en Greenen Balken  Vloer- en Sehot-eelen Ribben  Rigchels  Kapjpanten Kozijnen met Schuif- en Draairamen met Kamer- en Kasdeurcn fraaije Portes Brisées en Lambriseringen  Schotwerk Luiken  Trappen eu verders hetgeen daags voor den Verkoopdag ter plaatse bovengemeld ter bezigtiging zal zijn^ _ (12053) DÖÖRBIJZONDERE OMSTANDIGiEDEIT TE koop: Een HITTEN WAGEN  met overdekte Kap voor vier Personen . genoegzaam geheel nieuw  zijnde slechts eeno maand gebruikt. Te bevragen met Franco Brieven bij H. ROOS Logementhouder Loencn a/d. Vecht. (12073) Bij H. C. SUSAN C. HzoON te 's Hage ziet hët licht: BE KITI-STIISM VAN DEN NEDERLANDSCH INDISCHEN ARCHIPEL NOG EENS BESPROKEN DOOR L. VITALÏS. PRIJS 60 CENTS. Vroeger zijn verschenen: C. H. F. RIESZ. Het Cultuurstelsel en Art. 56vanhetRegerings- Reglement ƒ0.50. De Particuliere Indnstrie en de Publicatie van 25 December 183j-rrtn_fe-. •—— ' -?¦' ¦ HetNtelzijn van Java vooral van den Javaan ""te dat van tet Moederland Itesproken in Felis Meritis den 24sten Januarij 1891. ƒ0.60. \ (12048)",http://resolver.kb.nl/resolve?urn=ddd:010136813:mpeg21:a0016:ocr,6,ddd:010136813:mpeg21:p006,Algemeen Handelsblad,1107
1022580,1861/08/09 00:00:00,468,ddd:010136844:mpeg21:a0035,http://imageviewer.kb.nl/ImagingService/imagingService?id=ddd:010136844:mpeg21:p004:image&x=84&y=4941&w=2185&h=468,ddd:010136844:mpeg21,2269,5409,84,4941,4,lEDEBLIID Naamlooze Vennootschap van verzekering- op het Leven. Goedgekeurd bij Koninklijk Besluit van 17 Julij 1858. VERZEKERING BIJ OVERLIJDEN EN BIJ OVERLEVING. DADELIJK INGAANDE LIJFRENTEN. OVERLEVINGSKASSEN. — SPAARKASSEN ter bekoming van eene som Gelds tot uitzet en vestiging van Kinderen enz. Inlichtingen te bekonwn aan het Kantoor te Amsterdam op de Heerengracht bjj de Nieuwe Spiegelstraat X 456 es bij de HH. Agenten bttttta Attiferda» e * * (8805),http://resolver.kb.nl/resolve?urn=ddd:010136844:mpeg21:a0035:ocr,4,ddd:010136844:mpeg21:p004,Algemeen Handelsblad,2185
2643060,1861/05/23 00:00:00,899,ddd:010131407:mpeg21:a0004,http://imageviewer.kb.nl/ImagingService/imagingService?id=ddd:010131407:mpeg21:p004:image&x=1106&y=1114&w=2940&h=899,ddd:010131407:mpeg21,4046,2013,1106,1114,4,"». A. TIIIEIIIE te Arnhem heeft verzonden: GULDENS-EDITIE N°. 20. TWEE NOVELLEN van CELESTINE. In de Gruldens-MdiUe xvjn reeds verschenen: No. 1 A. H. VAN DER HOEVEN LEVENSBEELDEN SCHETSEN en VERHA- SCHE WEES en eenige andere Novellen 3e druk - No 9 HOI I»F WM> 3Ê LEN. - No. 2. -f. J. CREMER en GEHARD KELLEB VIER NOVELLEN. _ DEN EN SCHADUWEN. 3e druk - No 10 11 en 12 H I ÏJr.MMeÏ JÖ No. 3. DE OUDE HEER SMITS CLEMENTINE. - No. 4.GERARD HELLER HOLLIS. 3 deelen. - No. 13 14 en 15 Mevr A L « RO«R««-i ToW*^ HET HUISGEZIN VAN DEN PRAECEPTOR. - No. 5. LODEWIJIK MULDER JAN GRAAE PEPOLI. DE ROMAN vIN EEN RUK EDELMAN H^en - EAESSEN HISTORISCHE ROMAN UIT HET BEGIN DER 17de EEUW. 2 deelen HENRIETTE MARIA L«* COOUETTERIE 3e driï iJn T 7 nïoEPf*^ 3de druk. - No. 6. LOÜISE BLADEN UIT NICHT SUZE'S SCHETSENBOEK. - SMITS Tweede Vervolg op de BRIEVEN EN UITBOE^ImINGEN _ No. I 8 eU No. 7. DE OUDE HEER SMITS VERVOLG OP DE BRIEVEN EN UITBOEZE- Mevr. A. L O. BOSBOOM-TOUSSAIWT HET HTTTS T atKVwWE •»J MINGEN - No. 8. Mevr. A. L. «. BOSBOOM-TOUSSAINT. DE ALKMAAR- 2 deelen. *«L»SAIWT. HET HUIS LAUERNESSÜ. %0T Elk deel is afzonderlijk a ƒ 1 verkrijgbaar. (""U5>",http://resolver.kb.nl/resolve?urn=ddd:010131407:mpeg21:a0004:ocr,4,ddd:010131407:mpeg21:p004,Nieuw Amsterdamsch handels- en effectenblad,2940
3141574,1861/10/19 00:00:00,3518,ddd:010778589:mpeg21:a0010,http://imageviewer.kb.nl/ImagingService/imagingService?id=ddd:010778589:mpeg21:p004:image&x=45&y=790&w=893&h=3518,ddd:010778589:mpeg21,938,4308,45,790,4,"De Nieuwe Bak. SOIREE MUSICALE. «V ZATURDAG. ZONDAG en MAANDAG door ele Familie BKIJERBÖCH. lanvans 8 ure. *»* Degenen die iels verschuliligd zijn aan of te vorderen hebben van de Nalatenschap van JACOBUS PHILIPPUS VAN VEEN in leven Logementhouder aan de Meern onder Veldhuizen en aldaar onlangs overleden  worden verzocht daarvan ten spoedigste eu uiterlijk den 24. October e.k. in persoon of met franco brieven  betaling of opgave te doen aan den Heer W. C. HEIJMANS Logementhouder op bet Vreeburg le Utrecht of ten kantore van den Notaris VAN GEUTENBEEK te Harmeien. %• Allen die iels te vorderen hebben van  of verschuldigd zijn aan den Boeelel van wijlen Jonkvrouwe LAURENTIA CATHARINA SAHTiI elochter van wijlen den Edel Groot Achtbaren Heer ALBEBTUS GEBABDUS THEODOBUS SMITH in leven President van bel Provinciaal Geregsthof in Utrecht laatst gewoond hebbende te Amsterdam  en aldaar op den 21 September ab in teslalo overleden  worden verzocht daarvan vóór den 15. November aanslaande opgave- te eloen ten kantore van elen Notaris F. W. FABIUS op de keizersgracht bij bet Molenpad te Amsterdam. llrefjN-SPOORWEG. Verpachting van Kestauratien en Verhuring van Gebouwen. %* Op Donderdag den 31. October 1861. des voormiddags ten 11 ure zal door de Dirctie in haar lokaal boven het Goederengebouw le Amsterdam worden overgegaan: 1"". Tot de Verpachting van de Restauratien en ""Buffetten op de Slalions te Amsterdam  «otterdam Utrecht Arnhem en Kevenaar  en 2°. Tot de Verhuring van e-enige gebouwen geschikt voor Zomer-en Winterverhlijf waaronder bet gewezen stationskotrnjhuis in de onmideleüjke nabijheid van liet Station te Amsterdam. De voorwaarden waarop deze Verpachting en Verhuring plaats |hehben  liggen ter lezing en zijn te bekomen op bovengenoemde Stations. De noodige inlichtingen zijn te verkrijgen bij den Administrateur van bet verkeer den beer A. L. D'HAMEGOURT te Utrecht terwijl aanwijzing in loco zal worden gedaan door de Chefs van de betrokkene Stations. Amsterdam DE DIRECTIE den 14. October 1861. Liefhebbers van HreDtebrooil. %* Niettegenstaande de duurte der Krenten blijft de ondergeteekende leveren : 1 Ned. pond wit Krentebrood 27 Cents. 1 » » grof » 20 » 1 > » zuiver Rogge » 15 » i*/t * » » Tarwe zonder 24 • l/j » ■> » Rogge » 16 » Echte Haagsche Beschuit en Sint Wlcolaas 40 en 50 Cents de 5 ons. J. C. VAN BERGEN Lange Nieuwstraat. %* J. B. HUBEB te Groningen heeft uitgegeven : De regte verhouding van den Student in de Godgeleerdheid tot de Moderne Theologie. TOKSJPKAAK. bij de opening der Lessen in September 1861 door W. MUURLING Hoogleeraar te Groningen. Prijs f -ao.",http://resolver.kb.nl/resolve?urn=ddd:010778589:mpeg21:a0010:ocr,4,ddd:010778589:mpeg21:p004,Utrechtsche provinciale en stads-courant : algemeen advertentieblad,893
376320,1861/08/01 00:00:00,420,MMKB08:000088139:mpeg21:a0013,http://imageviewer.kb.nl/ImagingService/imagingService?id=MMKB08:000088139:mpeg21:p004:image&x=118&y=1151&w=896&h=420,MMKB08:000088139:mpeg21,1014,1571,118,1151,4,Advertentie BOVENHUIS Gevraagd. Om met 16 Augustus of 1 September te aanvaarden. wordt te Arnhem GEVRAAGD een BOVENHUIS gelegen op eenen vrolijken •tand. Adres met opgave van huurprijs grootte en waar gelegen bij den Heer G. H. van HENGEL Jr. iioekhandeiaar te Velp. Brieven franco onder No. 903.,http://resolver.kb.nl/resolve?urn=MMKB08:000088139:mpeg21:a0013:ocr,4,MMKB08:000088139:mpeg21:p004,Arnhemsche courant,896
1236368,1861/07/21 00:00:00,1577,ddd:010111916:mpeg21:a0040,http://imageviewer.kb.nl/ImagingService/imagingService?id=ddd:010111916:mpeg21:p004:image&x=2460&y=3618&w=784&h=1577,ddd:010111916:mpeg21,3244,5195,2460,3618,7,UITVOERING (SOIREE MUSICALE ET DÉGLAMATOIBE) ten voordeele der Nagelaten Betrekkingen der rerongelukte 'bemanning ran het te Rotterdam te huis behoord hebbende en onlangs op de Bot'andsche Kusten rergane Brikschip: Stad .Vlissingen DOOB de Zangvereenlglng Thalia. Directeur de Hr. A. J. SCHNITZLER en de Rederijkerskamer Helmers beiden gevestigd te Rotterdam op DINGSDAG den 23sten JULIJ ISfil in het Locaal der Maatschappij: Tot Nvt van 't Algemeen in den Oppert aldaar. (8970) Des Avonds ten 8_ vre. ZONDAG £1 JULIJ 1861 : MATINEE MUSICALE door de Rotterdamsche Mapei onder Directie van den Heer W. VAM IiBRUWSvII» met medewerking ran den Beer FISCHER. DES AVONDS: HARMONIE-CONCERT DOOB DI TAUIMUS-KAPEL onder Directie ran den Beer JOS. KEIFEKT. J. DOON. 818. Maandag avond de IHUHterdamsche Kapel onder Directie ran den Heer H. MEIJ BR en Dingtdag avond de Rotterdamsche Mapei  onder Directie ran den Heer M. VAN LEEUWEN. t 9067),http://resolver.kb.nl/resolve?urn=ddd:010111916:mpeg21:a0040:ocr,4,ddd:010111916:mpeg21:p004,"Nieuwe Rotterdamsche courant : staats-, handels-, nieuws- en advertentieblad",784
2716389,1861/02/08 00:00:00,2769,ddd:010545970:mpeg21:a0022,http://imageviewer.kb.nl/ImagingService/imagingService?id=ddd:010545970:mpeg21:p005:image&x=2027&y=566&w=981&h=2769,ddd:010545970:mpeg21,3008,3335,2027,566,6,"*** Het Gemeente-Bestuur van Stad Almelo vraagt een HULP-ONDERWIJZER in de openbare School voor het Lager Onderwijs tegen eene Jaarwedde van / 300. Adres met franco Brieven aan den Burgemeester dier Gemeente vóór den 15den Februarij 1861. % * Op de openbare Lagere School te Veenendaal wordt een derde HULP-ONDER WIJ/. ER verlangd Salaris ƒ 300. Brieven franco aan den Heer Burgemeester aldaar. %* G. J. A. v. TUSSENBROEK Instituteur te Driebergen verlangt zoo spoedig mogelijk eenen bekwamen SECONDANT van de P. G. die mede geregtigd is tot het onderwijzen der Wiskunde en der Engelsche Taal. Men wende zich met opgaven welk Salaris men verlangt en bij wien men informatien kan bekomen tot bovengenoemde Kostschoolhouder. *i* Li het Diakonie Oude Vrouwen- en Kinderhuis der Nederd. Herv. Gemeente te 'sGravenhage wordt ten spoedigste verlangd: Een EERSTE BEDIENDE of JONGENS-VADER Lidmaat van gezegde Gemeente en niet beneden de 30 jaren oud zijnde. Belanghebbenden adresseren zich met overlegging der bewijzen van goed gedrag en geschiktheid ter Vergadering van H. H. Regenten des Vrijdags-avonds ten 7 ure in voormeld Gesticht. *_„* Men verlangt met 1° Mei bij een Gezin dat des Winters te Amsterdam en des Zomers buiten is: Een PALFRENIER  van de 1. G. van goede getuigschriften voorzien van middelbare taille en niet onervaren in het Paard rijden en Tafeldienen. Brieven franco onder Letter X. bij den Boekhandelaar W. H. KIRBERGER te Amsterdam. *_* Men vraagt een gehuwd TIMMERMANSKNECHT P. G. zonder Kinderen tusschen de 30 eu 40 jaren voor vast werk. Brieven franco onder Lett"". A. C. S. of liefst in persoon bij de Boekhandelaars J. v. BENTUM & ZOON te Gouda. V* NB. ND. Men verlangtTtegen 12 Mei in de Provincie Friesland een TUINMAN  bij voorkeur ongehuwd van de Herv. Godsdienst en onbesproken gedrag die bekwaam is in alles wat den Moestuin betreft en vooral goed met de Broeijerij en het Snoeijcn van Vruchtboomen kan omgaan. Belanghebbenden gelieven franco Brieven onder Letters B. T. met opgave bij wien men omtrent hem informatien kan bekomen intezenden bij den Heer W. STEEN Bloemist te Amsterdam. *** De ondergeteekende Hoofd-Onderwijzeresse der bijzondere School tevens KOSTSCHOOLTOOR JONGE JUF VROUWEN  te Doetinchem beveelt haar Instituut beleefdelijk aan Ouders eu Voogden aan als zijnde de gezonde en aangename ligging der Stad en ruime Woning voor diergelijke Inrigting bijzonder geschikt. Prospectussen ziju op franco aanvragen te bekomen aan het Instituut. H. J. STRUBEN. ■ i Burgemeester en Wethouders van DOETINCHEM bevelen bovenvermeld INSTITUUT dringend _ en met de meeste gerustheid aan uit hoofde van de bekende bekwaamheid en geschiktheid voor het vak van Onderwijs en Opvoeding van Mejufvrouw H. J. STRUBEN. Doetinchem 26 Januarij 1861. Burgemeester en Weth. voornoemd  D. SIMONS De Secretaris (bij absentie.) H. C. WILLINK KETJEN Wethouder.",http://resolver.kb.nl/resolve?urn=ddd:010545970:mpeg21:a0022:ocr,5,ddd:010545970:mpeg21:p005,Opregte Haarlemsche Courant,981
3798531,1861/05/06 00:00:00,2061,MMKB08:000088046:mpeg21:a0013,http://imageviewer.kb.nl/ImagingService/imagingService?id=MMKB08:000088046:mpeg21:p003:image&x=1000&y=2232&w=1771&h=2061,MMKB08:000088046:mpeg21,2771,4293,1000,2232,18,Advertentie Goedkoope en nuttige Boeken voor Burgers en Boeren. I. Gids voor ieder die met geld omgaat of het leenen en koopen volgens de Nederlandsche Wet; door W. de GELDER Oud-Inspecteur der Registratie. Prijs 60 Cents. II. De Vraagbaak voor Burger en Koopman bevattende Voorschriften van bijna alle Acten en Overeenkomsten in Burgerlijke en Handelszaken met ophelderende Aanmerkingen opgaven van verschuldigde Zegel- en Registratieregten ent. Eene Practische Handleiding om in het burgerlijk leven alle voorkomende onderhandsche stukken zonder behulp van deskundigen zelf te kunnen opmaken; door denzelfden. Prijs ƒ1—. III. De Tafel-Ceremoniemeester of volledige verzameling van Toasten of Tafelcondities in Proza bij alle voorkomende gelegenheden door J. de BREET. Ecne onmisbare Handleiding voor genoodigden tot Feestpartijen en Maaltijden. Prijs 75 Cents. IV. Nieuw volledig Feestboek. Verzameling van Nieuwe en Oorspronkelijke Gelegenheidsgedichten voor alle mogelijke Feesten  Tafelzangen op de meest bekende Zangwijzen  Tafelconditics of Toasten voor Feestmaaltijden Albumversjes enz. Eene onmisbare Handleiding door denzelfden. Prijs fI—. V. G. C. Claudius' Volledig Brievenboek bevattende Voorschriften van Brieven Verzoekschriften Bekendmakingen toepasselijk op alle omstandigheden van het dagelijksch leven. Een Handboek tot eigen oefening voorzien van vele Opmerkingen omtrent Mijl cu Taal den uit- en inwendigen vorm van Brieven de Titulatuur enz. Prijs ƒ1—. VI. Briefstijl voor Minnende Harten. Volledige Verzameling van Brieven die bij Verliefden in alle gevallen en betrekkingen kunnen voorkomen. Prijs 50 Cents. VII. Het Briefschrijven gemaKkolijk gemaakt of Handleiding tot het leeren stellen van Brieven bij allerlei gelegenheid door W. J. OLIVIER. Prijs 55 Cents. VIII. De Huisarts of aanwijzing ter bewaring der gezondheid en ter aanwending van hulp in de meest voorkomende ziekten en ongevallen. Volgens de beste gencesk. schriften bewerkt door Dr. O. SEYLER te Vierlingsbeek. Prijs /125. IX. Nieuw Handboek der Wellevendheid of Handleiding om in Gezelschappen en verschillende betrekkingen des leven» zich wellevend en beschaafd te gedragen. Eeu nuttig Hand- en Hulpboek voor oud en jong van beiderlei kunne. Prijs 90 Cents. X. Do Nieuwe Hengelaar of de Kunst om op eene eenvoudige en min kostbare wijze veel Visch te vangen; opgehelderd üoor aanwijzing van Geheime Middelen om het Vischaas te bereiden en eene menigte andere Kunstgrepen. Prijs 60 Cents. XI. Het Boekhouden voor den Winkelier Kleinhandelaar en Ambachtsman door A. KREUITER Boekhouder te Haarlem. Prijs 90 Ceuts. XII. Bamberg in de Huiskamer of Handigheid is geene Hekserij  bevattende Goocbrlstukjes de kunst van Buikspreken  enz. enz. Prijs 40 Cents. XIII. Gods grootheid en goedheid in de Schepping Christelijke Natuurbeschouwing voor het Volk van H. ZSCHOKKE. Prijs f 120 geb. / 150. XIV. Jessus Christus ia zijn Persoon en Werk en het Christendom in de gemeente des Heeren op Aarde. Overdenkingen van H. ZSCHOKKE bijeenverzameld door Da. LUBLINK WEDDIK. Prijs ƒ170 geb. ƒ 195. Een ieder van wat rang of stand kan deze werkjes met vrucht gebruiken. Zg komen daqilijxs in vele opzigten te pas en zijn in alle Boekwinkels te bekomen altmede bij den Uitgever H. C. A. CAMPAGNE te Tiel. Van sommigen zijn reeds DUIZENDEN Ex. verkocht.,http://resolver.kb.nl/resolve?urn=MMKB08:000088046:mpeg21:a0013:ocr,3,MMKB08:000088046:mpeg21:p003,Arnhemsche courant,1771
295400,1861/10/16 00:00:00,280,ddd:011060963:mpeg21:a0015,http://imageviewer.kb.nl/ImagingService/imagingService?id=ddd:011060963:mpeg21:p004:image&x=2190&y=5091&w=1055&h=280,ddd:011060963:mpeg21,3245,5371,2190,5091,4,Voor ieder in dit bl<d voorkomend artikel lieUelk van ptene ondertcekem»g i> voorzien stelt de Redactie zich versntwooi delijk zoolang door huur geen «nder schrijver «ordt opgegeven. GEDRUKT BH I*l3 HOT * CO tl SOKRABAYA.,http://resolver.kb.nl/resolve?urn=ddd:011060963:mpeg21:a0015:ocr,4,ddd:011060963:mpeg21:p004,"De Oostpost : letterkundig, wetenschappelĳk en commercieel nieuws- en advertentieblad",1055
5717250,1861/09/13 00:00:00,5250,ddd:010136879:mpeg21:a0020,http://imageviewer.kb.nl/ImagingService/imagingService?id=ddd:010136879:mpeg21:p006:image&x=2291&y=115&w=1089&h=5250,ddd:010136879:mpeg21,3380,5365,2291,115,6,"SALON DES VARIÉTÉS in de Nes. Vrijdag 13 Sept. (Doorliet nieuwe Tooneelgezelschap van STERK VAN OLLEFEN en HASPELS). Eene sde voorstelling van : Eene Bruidspartij met Hindernissen kluchtige vaudeville in 5 tafercelen met Coupletten Duo's Chansonnettes enz. Entree ƒ0.75. Aanvang ten 8 Ure. JS. E. DUPORT. Plaatsen zijn dagelijks te bespreken van 9 tot 3 ure. Zondag 15 September. TWEEDE BIJEENKOMST van het College DE HEREENIGING. SALON DES VARIÉTÉS in de Amstelstraat. Zaturdag 14 Sept Tot heropening v*n het Lokaal: Wie van de Zeven is de Ledijkste? vtfH lijke vaudeville in 5 tafercelen  naar het Hoogduitsch met nieuwe couj pletten; voorafgegaan door: Een vreemd artikel in het Testament voorspel in 1 bedrijf. Tot slot: Engelsche John en Duitsche Apolonia of uw Lew\ is in gevaar kluchtige vaudeville in 1 bedrijf. (Abdv. 8 uur.) I Entree 75 Cts. in Vertering. Diploma's niet gangbaar. I Plaatsen zijn aan het Bureau te bespreken van 9 tot 4 uur. I De Directie hoogen prijs stellende op de gunst en bijval die hare ooi derneming gedurende eene reeks van jaren is te- beurt gevallen heeft dl eer te berigten dat zij wederom geene moeite noch kosten gespaard heeft oil haar Lokaal door verbouwing to verfraaijen en aanmerkelijke verbeterisl gen ten gerieve van hare geachte bezoekers daar te stellen ; terwijl zij nietl heeft onbeproefd'gelaten om zoo door de goede zamenstclling van het tooneel personeel als het aanschaffen van de nieuwste en schoonste stukken val het Fransche en Duitsche repertoire de protectie des geachten kunstmin! nenden Publieks bij voortduring waardig te blijven. I BOAS & JIUDELS. I Zondag 15 Sept. Eerste Bijeenkomst in het COLLEGIE : NUT El VERMAAK. I FRANSCHE SCHOUWBURG Singel bij het KoningspleiJ Hollandsche Voorstellingen. Vrijdag 13 September: Eene sde om voering van : Met Bedelende Meiye groot melodrama in 5 bedrijven w*l expresselijk vervaardigde Decoratien Machineriën Gevechten  Theatra-1 Toestel enz. (8 ure.) I 75 Cents in Vertering. ROSENVELDT & ROTTING' I Het Bureeu is des morgens geopend van 11 tot 3 ure voor het besprfl ken van Plaatsen. I HIEUW GBAHD THEATRE | Op bet Koningsplein tegenover de Leidschestraat I VRIJDAG 13 SEPTEMBER: ROBERT OF DE STRlllttl BOOVERS tooneelspel in 5 bedrijven. Gevolgd door: RE HOC 1] VESTER EN ZIJN PLEEGDOCHTER vrolijke vaudeville I 1 bedrijf. Aanvang 8 Urefl Alle Avonden ten 6 Ure THEATRE METAMORFHOSE van fl Engelsche en Fransche Marionetten. Gevolgd door: PANTALÖfI RENTENIER  vrolijke Arlequinade. I Prijzen als naar gewoonte. Kinderen beneden de 10 jaar betalen half geB Jl. HERMANS JS. GRADER en B. LORJIÉ Directeur-V Circus Wollsclilag>er9l AMSTELVELD. I HEDEN VRIJDAG 13 SEPTEMBER ten 8 Ure precies: De <M strafte Tyran geschiedkundig Mimodrama in 6tafereelen. Voorafgeg»« door het uitgebreid Programma der werkzaamheden in de Manége door fl eerste Artisten Dressuur der Paarden Adonis Mausouri enz. enz. fl FRAéCATT. gedurende de kermis alle avonden I GROOT I VOCAAL 1 INSTRUMENTAAL (MEN TE GEVEN IN DE I NIEUW GERESTAUREERDE EN RIJK MET BLOEMEN M EAU DE COLOGNE-FONTEIN VERSIERDE GROOTE ZAAM ONDER MEDEWERKING VAN B Ik GILLE NAZA ET lU. PAUMKE HI.AIHI Fraulein FfIANO.SK-A BÖSE SonWte aus Ache-B Mr. ISmile _Duiil£ler9 I Xm_ Herrn H Prof«Kratfey-BascMKl Deze Artist is dc eenigste op zijne Instrumenten en heeft zoowelH Engeland als Frankrijk en Duitschland de grootste sensatie verwekt-B Entree/1 gedeeltelijk in vertering. Aanvang 8 Ure. I Jf. EDITAR» STUMPFF. ¦ mmÉmw* I VRIJDAG 13 SEPTEMBER. I SOIREE VOCALE en INSTRUMENTALE te geven door* Hr. H. MOHRENSCHLAGER en bijhebbend Gezelschapgroot 23 PersdW] Alle Avonden CARNAVAL der Chinezen en Maleijers in CostuuiS'H Entree 49 Cents. Aanvang 8 Ure. I LOKAAL DE VEREENIGING. I WAEMOESSïEAAT. ¦ AUe Avonden ten 8 ure gedurendo de KERMIS SOIREES MAUS ET CüiANTANTI door de Familie LEOPOLD BOYER I bestaande uit 20 Personen ERANSCHE en DUITSCHE ARTIST'U i** -E'-*0"" Avond verscheidenheid van voordragt: Airs-^H '§&_%& mances Chansonnettes Duo's en Scènes Comiques in cost«*M Entree 49 Cents. Abonnement ƒ *->B SALOI LYRIQUE. I SOIREES VOCAAL EN INSTRUMENTAAL! door DUITSCHE en ERANSCHE ARTISTEN zijnde eet. G..el-H van 14 Personen. Alle Avonden ten 8 Ure Scène Comique in Costuum. H Entree vrij. F. VAN HAARLEM. Op de Botermarkt front Reguliersbreestraat: I KONINKLIJK HONDEN- EN APEN-TIIEATEII| van S. FtJLGONE  uit Milaan. Op Vrijdag 13 SeptembeDrie Voorstellingen ten 4 6 en 8% *r'B GROOT GERENOMMEERD I HEN-EN APEN-THEATER I Onder Directie van LEON A R DI VER O I uit MadJ I Staande de sierlijk met Gas verlichte Salon op het AMSTEL^^^k HEDEN avond en gedurende de Kermis 2 VOORSTELLINGEI""' I 5% ure en de Groote Avondvoorstelling ten _.'__ ure. \___U Let wel op Naam en Standplaats. EN HARE ¦ Dochter MOMMA I Vermenigvuldigen en aftrekken. Entree: Eerste Rang 49 Tweede Rang 25 Cents {___* Staande met zijne Tont op de Botermarkt stille zijde ____* :v __ JU P. VAN STRAATEJ^I -¦- "" ''- *— < ~ ;—— ¦ _i_______m",http://resolver.kb.nl/resolve?urn=ddd:010136879:mpeg21:a0020:ocr,6,ddd:010136879:mpeg21:p006,Algemeen Handelsblad,1089
2760660,1861/04/25 00:00:00,2940,ddd:000022738:mpeg21:a0013,http://imageviewer.kb.nl/ImagingService/imagingService?id=ddd:000022738:mpeg21:p003:image&x=1991&y=97&w=939&h=2940,ddd:000022738:mpeg21,2930,3037,1991,97,4,"SPOOBWEtt. J*. I. K. meent dat de beste rigting van den Spoorweg van de tegenwoordige Staiinn naar het Badhuis die is  langs de Lange Boefttenmarkl . Prinsegracht en Binnencingel: verder achter Zorgvliet en Scheveningen tot aan het einde van het Dorp en van daar langs den Rijweg en het Duin. De Station in den Haag te plaatsen op de Prinsegracht bij de Beestenmarkt en de Station te Scheveningen voorbij de Kerk aan den uitgang van het Dorp naar het Badhuis. PROVISOREN en BESTUURDERS der Stichting van vrouwe J. DEK Ij  weduwe van Mr. Cf. Jl. •FUKFiVBOLX  brengen ter kaanisse dat met 1 September aanstaande Kallen openvallen eter der zes Beurzen  jaarlijks bedragende meren honderd gulden. Met verwijzing naar hunne aankondiging van den 23 November 1854 roepen zij op de Ingezetenen of Inboorlingen van 's Gravenhage wier zonen hunne Akademische studiën in de Godgeleerdheid óf reeds hebben aangevangen öf met September aanstaande hopen te beginnen en dieoordeelen te zijn begrepen onder de in die aankondiging begrepen ouders: ten einde met overlegging der daarbij omschreven getuigschriften af te geven voor de eersten door hunne Hoogleeraren en voor de laatsten dooiden Rector van het Gymnasium en den Predikant door wien zij in de Godsdienst zijn onderwezen en met opgave van al de reeds genoten of toegezegde Beurzen of toelagen zich vóór den 12 Mei aanstaande met vrachtvrije brieven aan te melden aan den eerstondergeteekende. 'sGravenhage den 23 April 1861. F. de WILLIGEN. J. MOLL Jz. P. W. ROMENY. F. de GREVE. XEDERLANDSCHE Sm STOOMBOOTREEDERIJ. ROTTERDAM JaEAITITSaiM. Afvaart Hoontpjes. Van Rotterdam langs Nijmegen naar Mannlieim DAGE L IJ KS  behalve des Zondags en Woensdags des morgens ten ÏO ure. Van Nijmegen naar Rotterdam dagelijks behalve des Zondags en Woensdags  des morgens ten 8 ure. Ten spoedigste wordt verlangd: een bekwaam ITOFFKEKIIKK  niet onbekend met Behangeuij  ten einde ah Meesterknecht te kunnen fungeren. Alsmede twee bekwameKASTEl-M AKKKS en twee POL.ITOURIFERS""». Ervarenheid en soliditeit geeft hun do verzekering van vast werk. Reflecterenden adresseren zich bij M. VIERLING  Meubelfabrikant te 's Gravenhage. tegen I°. Junij aanstaande een 111 I* met zes groote  drie kleine kamers en TUIN gelegen in do Willemstraat digt bij het Park.",http://resolver.kb.nl/resolve?urn=ddd:000022738:mpeg21:a0013:ocr,3,ddd:000022738:mpeg21:p003,Dagblad van Zuidholland en 's Gravenhage,939
99264,1861/04/28 00:00:00,132,ddd:000010128:mpeg21:a0030,http://imageviewer.kb.nl/ImagingService/imagingService?id=ddd:000010128:mpeg21:p003:image&x=1633&y=3246&w=752&h=132,ddd:000010128:mpeg21,2385,3378,1633,3246,8,Grondbelasting over 1861 f 18.83. Verhuurd: het Pakhuis roor f 1.50 per wtek en de Boyenwoning voor ƒ 6.25 per maand makende to zamen / 153 'sjaars,http://resolver.kb.nl/resolve?urn=ddd:000010128:mpeg21:a0030:ocr,3,ddd:000010128:mpeg21:p003,"Nieuwe Rotterdamsche courant : staats-, handels-, nieuws- en advertentieblad",752
4577190,1861/01/09 00:00:00,4065,ddd:010136600:mpeg21:a0024,http://imageviewer.kb.nl/ImagingService/imagingService?id=ddd:010136600:mpeg21:p004:image&x=70&y=168&w=1126&h=4065,ddd:010136600:mpeg21,1196,4233,70,168,4,"a c c o o r d; De Curators in het Faillissement der Firmu de Erven B. J. FEENSTR\ te Sneek. bestaande uit de Heeren PIETER BAUKES FEENSTRA en JACOB BAUKES EEENSTRA. Kooplieden enz. beide te Sneek woonachtig berigten bij deze «lat door laatstgenoemden op heden ter Griffie der Arróndissements-Regibiink aldaar is ter neder gelegd een Ontwerp-Accoord  waarbij zij aanbieden de volle betaling van het hunne Sc.huldeischcrs vun hen aankomende mits ben uiterlijk tot den Isten Jan. 1800 Twee-en-Zestig met die be.talling uitstel worde verleend en dat daarover beslist kan worden op den dag tier eerste Verificatie den 18deu Jan. e. k. des Voormiddügs 11 Ure in bet Paleis van Justitie ie Sneek. indien voormelde Crediteuren alle alsdan hunne Schuldvorderingen indienen waartoe bij deze. beleefdelijk verzoek wordt gedaan. Skmk'3 Januarij 1861. T TEN CATE. (395) Mn. B. S. STIENSTRA. De Erven van Vijlen Dr. COLSON IWAN berigten het Publiek dat zij hunne MIDDELEN tegen JICHT en RHEIi- MATISMUS (zie het zoo algemeen gezochte Werkje get NIEUWE ONPEILBARE GENEESWIJZE van de JICHT en het RHEUMA'HSMUS door Prof. GORDON bij de Boekhandelaren G. PORTIELJE Eï- Zn. te Amsterdam uitgegeven) verkrijgbaar hebben gesteld bij den ' Apotheker W. C. LUSKEN . Hoogstraat K 83 to Amsterdam. Brieven Franco. (445) De Ondergeteekende berigt door dezen dat de Handel in KRUIDENIERS- en VERFWAREN  gedreven onder de Firma B. &G. ALBERTS van heden af voor zijne rekening onder dezelfde firma wordt voortgezet  zich minzaamst aanbevelende. Devestku  B. G. ALBERTS. 1 Jnmtarij 1861. _ • (21») ""MEN VRAAGT) tê Gorinchem te H arende dezen Winter of te Koop een completen KETTING MOLEN  voor 4 U 3 Paarden geschikt om voortdurend het-Water meer dan 2\ Ncd. El hoog <""'l' to Strengen. Omschrijving van den Moleu met opgave van EEUT RPBJJS per ""Week of dei Koopsom in te zenden «tin deu Burgemeester van Gorinchem. 12""°) ABen die eenige vordering hebben ten lasten den boedel van wijlen den Hoogeerwaarden Heer C.'BROERE  worden verzoekt daarvan opgave te doen aan den Hoogeerwaarden Heer 0. VAN KINTS President van het Seminarie te Warmond. (430) TABAK. Op Vrijdag den Uden Januarij 1861  des Namiddags ten 6 ure zullen te ROTTERDAM in bet Not&rishuis mm de Goldcrschukade publiek worden geveild: 830 Pakken Java TABAK. Hoofdmerk E B. Directe Aanvoer. (21872) T A B A K« Dadelijk na afloop dor bovenstaande Veiling van 830 Pakken JAVA TABAK1 op Vrijdag den Uden Januarij 1861 te Rotterdam zullen in hetzelfde Lokaal nog worden geveild: 379 takken Java TABAK Hoofdmerk R. Din-ere aanvoer. (21873) G A Z-VtffILUCBTIS C£._ Berigt aan Heeren GAZ-FABRIEEANTEN en VEKBUUIKERS Alt bij den OnnVrtreteekende ontvangen zijn Kristallen Vergulde en Bronzen GAZ-OKNESEENTEM cnKROONEN volgens de meawsta Modellen. F en. Belast zich met de levering van LILHATOESTELLEN voor alle Publieke Gebouwen. P. MUWENPAM (18999) Binnen Amstel bij de Halvemaansteeg Y32. SCHETSEN V.B VREESDE LWDES E 3 WEN. DJJEIJSVTSBZAStECD 0008 2de Serie R JJ# VINK. M* — I3de Jaargang. Per Jaar met & Platen ƒ 7.20. of 4 Doelen. =INHOIiD BER li: AJLEVEKÏKG 3801. Lora DUEEERIN'S Brieven uit het Hooge Noorden. — Ontdekking vun vun DÏemcnsland aan de Zuid-Oostkust van Australië gelegen door J B .1 VAN DOREN . met Plaat. — Reis door Mexico in de Lente van 1860. — MEDEDEEL! XGEN. -mi^_^H|^ta_ ruim 20 Jaren beeft de Redactie van „BE ! -'fl P^^GLOBE1""1 ziek beijverd om zoowel door oors|non- XjlS^H^ kelijke bijdragen  als door liet geven van vertalingen «SÈP en uittreksels"" uit Be voornaamste Htn het Buitenland verschenen Reislv-•¦•'¦ en geheel op de hoögl houden van al wat er 'belangrijks t-i- I van Land-en Volkenkunde voorgevallen of ontdekt is geworden. Omtrent de hflogC v. narrie van het Tijdschrift leze men de veroohiflende altijd gunstige beoordeelingen in do Vaderlandse!: i  / en l.et /  onwel in bet bijzonder de twee laatste beoordeelingen .-.«/;/--oen 1860 N°. II . ¦¦¦ent 1861  N°. 1. Voo "" bestcllinwn daarop aangenomen bij alle Boekhandelaren «ï bij den Uitgever Amltebda.u  2 _s_arij 186 L X.ff. SVBRANBL_n7I__ Leliegracht RR 78. CO KANTOOR- W ft* HINKEL- __ •** Ihagazijn- o «3j eitisboïjö-2! pakbots- *""""' _""D ZAR- _5g § NOTITIE- I GEBROEDERS KOSTER.",http://resolver.kb.nl/resolve?urn=ddd:010136600:mpeg21:a0024:ocr,4,ddd:010136600:mpeg21:p004,Algemeen Handelsblad,1126
2121456,1861/01/11 00:00:00,2748,ddd:000010011:mpeg21:a0048,http://imageviewer.kb.nl/ImagingService/imagingService?id=ddd:000010011:mpeg21:p004:image&x=3262&y=97&w=772&h=2748,ddd:000010011:mpeg21,4034,2845,3262,97,4,"Uitgave è 1861. Uitgave k -O Cents EERSTE 20 Centa per maand. AFLEVEBING. per maand. 121 12 Afleveringen 108 Bladzijden. per jaar Bladzijden. Door den Boekhandelaar JJ. JS. VISgEB te 't Gravenhage wordt heden uitgegeven: De Eerate Aflevering voor het jaar 1861  VA» HST BIJBELSCH DAGSCHRIFT 0_ DE INVLOED DES CHBISTENDOMB OP HUISELUI »k MAATSCHAPPELIJK GXLUIVS GODSDIES9TIO3 OVEBDWKI-OEOP lEDÜBEN DAG DES JAABS. Onder mede werking van ruim a<_ Predikanten. De Inteekenaren op do Uitgave van 40 Centa per maand ontvangen eene waarlyk prachtige Premie-plaat: Huiselijk geluk. Over de Prrmio plast laat een onzer geaohttta Dagbladen ïie.li alrlu» uit: ? Niet weinig wordt de waarde vanditTijdiohrift verhoogd door de ty«oudere zorg welke de Uitgever besteedt om door keurig uitofovoerde Premieplaten  de Geabonneerden aangenaam te «Iln. De nieuwe Premie-plaat voorstellende: Buitelijk geluk tot welker inzage wij in de gelegenheid werden gesteld draagt van die «org op nieuw de blaken. Op steen gebragt door den Heer C C. A. LAST en gedrukt door don Heer J. D. STEUEBWALD munt de Plaat boven de meeste voortbrengselen onzer lithographwche-pers uit en «y is ook om hot onderwerp allezin» waardig de wand van een huUvertrek to versieren."" Bij deze Premieplaat heeft Dr. E. LAUBILLABD Predikant to Leyden een afzonderlijk «tuk geleverd van 16 bladtijden druks waarin de dichterlijke Schrijver in krachtige taal het heil afschildert dat huiselijk geluk genieten doet. Dete Eerste Afleiering bevat Overdenkingen van de Wel Eerwaardo Zeer-Gf leerde Heeren: S. J. ADBIANI. J. F. COBSTICS. H. G. J. VAN DOEBBUBGH J. H. DÜMANB Dr. P. JAS C. LJUNGIUB C E. VAN KOETSVELD U. L. OOBT Dr. L. PBOE9 B. TER HAAK ROMEN.  H. B. BOOKMAKER en Dr. J. C. ZAALBERG Pu. (597) (602) Bij Joh. SOUA\' en _«JOI- te Zalt-Bommel ziet het licht en ia alom verkrijgbaar: „ Dr. W. R. VAN HOEVELL DEBTIENJABIGB BEOOBDEELING VAN 't Kultuurstelsel op Java. (Overgedrukt nit het Tijdichr. v. N. Indie). Boyaal Formaat ƒO.BO. Deze Brochure wordt alléén voor rekening afgeleverd. nieuw hollandsch-laagmaleÏschT WOORBENBOEEJE bevattende eenigo duizende woorden benevens da verklaring van onder-cheidene spreekwijzen DOOS Br.J.AranlUssel enjf G JLucardie. 495 pag. — ln Linnen gebonden ƒ 1.80. Het is een Boekje geeohikt voor den Zeeman hoogst nuttig voor den Koopman die op Oost-Indie handel drijft en ksn niet ontbeerd worden door hem die zich daar vestigt. — leder Oadgast aal het met genoegen doorbladeren. (12993) A W SIJTHOEF.",http://resolver.kb.nl/resolve?urn=ddd:000010011:mpeg21:a0048:ocr,4,ddd:000010011:mpeg21:p004,"Nieuwe Rotterdamsche courant : staats-, handels-, nieuws- en advertentieblad",772
2632966,1861/03/12 00:00:00,2807,ddd:010252605:mpeg21:a0017,http://imageviewer.kb.nl/ImagingService/imagingService?id=ddd:010252605:mpeg21:p004:image&x=1969&y=1117&w=938&h=2807,ddd:010252605:mpeg21,2907,3924,1969,1117,4,Bij den Boekhandel. C. L. VAN LANGENHUYSEN is van de pers gekomen en verzonden: ZALIGE DOOD U PLEGTIGE BEGRAFENIS VAN Zijne Doorluchtige Hoogwaardigheid MONSEIGNEUR FRAXCISCBS JACOBUS VA^ VREE BISSCHOP VAN HAARLEM HUISPRELAAT VAN Z. H. PIUS IX ASSISTENT-BISSCHOP »U DEN. PAUSELIJKEN TROON RIDDER DER ORDE VAN DEU NEDERLANDSCUEN LEEUW beschreven ïolgens geloofwaardige getuigen DOOR J. A. TAK IJEIV AKKER R. K. Priester. Prijs 25 Cents. Uitgeno èn ten voordeele van Arme Kinderen. fjjggffi» «ordt niet dan op aau vraag tn aar™*» commissie gezonden. De DERDE DRUK van de LIJKREDE OP MONSEIGNEUR CORI_.EI.I_» broere; EERE-KAMERnEER VAR Z 11. PIUS IX KANUNNIK DER KATBBDRALE KERK VAN H_ARLEM UOOGLEERAAR AAN HET SEMINARIE TE WARMOND EN RIDDER DER ORDE VAN DEN NEDERLANDSCHEN LEEUW. Gehouden in de St. Katharinakerk te Amsterdam den 22ste. Januarij 1861 door J. A. VAN DEN AKKER. R. K. Priester. Prijs 25 Cis. Alsmede: DE NEDERDALING TER HELLE VOLGENDS OUD-CHEISTELTJKE OVERLEVERINGEN: VERTAALT) DOOR J. A. _X____-D__lGK TU-JM O. S. G. EQ. InJ2° • • • * •_ ' ' ¦ Prijs 25 c. Het bovenstaande is te beschouwen als een vervolgop het -boekjen .van den zelfden auteur- JiSOS VOOR PILATSS gevolgd van de Afdoening van 't Kr his waarvan ipede nog exemplaren voorhanden.zijn tot 12. et. De DERDE druk AAN '5 HEEREN H. WOEDEN door P. VAN DER PLOEG Pr. Vermeerderd met de Zangwijzeu op noten. Prijs ƒo.lü,http://resolver.kb.nl/resolve?urn=ddd:010252605:mpeg21:a0017:ocr,4,ddd:010252605:mpeg21:p004,De Tĳd : godsdienstig-staatkundig dagblad,938
6278013,1861/09/15 00:00:00,5067,ddd:010112007:mpeg21:a0052,http://imageviewer.kb.nl/ImagingService/imagingService?id=ddd:010112007:mpeg21:p006:image&x=235&y=96&w=1239&h=5067,ddd:010112007:mpeg21,1474,5163,235,96,6,"GROOTE GEWONE NAJAARS-OPRUiMII BIJ ALLAN & WfOTJtfttITWLAIW van af Morgen MAANDAG 16 dezi BI36UÜDI-3. VOORDËELIG ZIJIS : ZIJDEN WOLLEM KATOEHI ZOUa- EM WIITESSTOFFEI VOOR K MANTELS TAPIS EN WOLLEN DOEKEN EN SHA GEDRUKTE KATOENEN LINTEN BRODERIES KINDER* Eenige WITTE GOEDEREN en LINPi ER ETC. ETC De Ondergeteekenden hebben de eer te berigten dat zij met eene der vot sche Corchetiuaaksters (gebrevetteerd voor Gewone en Orthopedovereenkomst hebben gesloten krachtens welke zij zich van Maandag midi dag morgen in hun Magazijn zal bevinden tot het nemen van de I Soorten van CEIMTURES-RÉGEMT en CORCHET3TEM (Orthope. als van een geheel nieuw genre CRIMOJLIME». De Dames wor noodigd het MAGAZIJN der Ondergeteekenden bjj die gelegenheid met een bezof HEIJERMANS & SP Rotterdam 14 September 1961. XoordhlaaU A— REVALENTA ARABI Mejufvrouw de Weel. JK. URAGER berigtte ons twee gevallen van genezinge Banketbakker en de Huisvrouw van J. JÖHANNESMA aldaar zjjn beidei REVAUEMTA van hunne maagkwalen genezen. De REVAIiEMTA heeft eene wonderlijke geneeskracht. Er gaat gee niet h*t een of and<r merkwaardige feit van genezing bekend wordt; niet uit vf van onbekende lijders maar in ons eigtn land in onze steden en dorpen onde ze plaats hebben. Ze geneest spoedig en met weinig kosten door de spijsvertet sterkeri derzelver verrigtingen te versterken en het bloed te zuiveren: Koorts Zinkings Hoofdpijn Sljjm Zuur Maagpijn Maagkramp Galziel Hoest» Verstoppingen Diarrhaea Slechte Spijsvertering Oprispingen f-panning menigte andere Ziekten. JDe REVALEMTA is een heerlijk gemakkelijk goedkoop smakeljjk jte kwaad doen kan en altijd helpt als het maar GOED GEKOOKT WORD'; waarop wjj bijzonder mceten aandringen. Men zie daarover de kleine gebruikü-ar Bus los afgege?en wordt en zorge dat daarbjj met een weinig op ettendheid te w De echte REVAEEMTA van de Heeren BAEET DU BARRY BW Londen wordt alleen verkocht door het VERKOOPHUIS en deszelfs De> Mer lette er vooral op dat iedere Bus tot waarbo-g dr echthe E. VON WINDHEIM 4 C° VERH OOM UIS geteeken De pms der REVALEMTA is: Kleine Bussen 87% Ct. 1 ffi f 2 2 ffi ƒ 3.6 Amsterdam VEBKOOPHDIS. Leyden L. G. DIBK3 V Rotterdam 3. A. KLINGER 4 Co. Hellevoetsluis H. G. VA1 Bergen-op-Zoom D. POUWELS. ' ALEX. BI . P. E. APPELBOOM. Maassluis P. POORTMA Brouwershaven G. ALING. Middelburg 3. O. KBUI Delft Wed. J. T. WAGNER. Oostburg Wed. P. J. GJ? Dordrecht Wtd. J. VETB. Schiedam M. J. DE LA Soes Wed. C. VBEEKE. Sluis Gez. JANSEN. Gorinchem H. BODEBIJ. Steenbergen W. VAN D 1 Gouda A. GOEDRAAD. Viaardingen 3. LAGEH m Wed. A. O. SCHOUTEN. Viissingen A. M. KALI H. P. VAN FBANKENHUIZEN. Willemstad B. ERIDER _ 's Gravenhage  SACK A Co. Bn in de h_»r>dit l»éi»ft*« in de »nd«r» 9t*_n . . üran___n Hoogstraat over de Üoofdstec HEDEN ©NTVANGEN EENE FRAAIJE FRANSCHE PASSEÜDO ALSMEDE: TEEKEWPORTEFEfIM.ES HOKER9 FABER TS. DEM. TEEHEJKPETWSEJN  COSTE Gekleurd TKEKEMKRIJj RANTOOR-SCÏÏMJFBöEtf UROOTKOEKEft  JOIIRMALE». WEiWORIALEM H RAMT- KAS*A- OKHOiT- ""MAGASBIJM- en alle andere! Eabrieken van de Onderge eekenden zijn de beste welke gefabriceerd kunnen - bijzonder aan door hunne gemakkelijke vlakke openliggin* keurige bewerking en. terwijl de Papieren hiervoor gebezigd van de beroemdste Fabrieken Bf fcometig c"" en de prijzen zoo goedkoop berekend worden dat zelfs van het Buitenlnnd de c° Magazijn: Mreuvehaven 3MA. (11270) J. W. VAM »>E*EJMI Bit het naderend JLees-saisocn vestigt de «ndergeteetten aandacht op zjjne •• HOLLANDSOHE FRANSCHE EN ENGE LEESINRIGÏI Prospectossen daarvoor zijn gratis verkrijgbaar alsmede een CATA ROW AM S» welke ter lezing zijn te bekomen. „___ Voorhanden: een OTGEBREID ASS©?n STEREOSCOOPPLAI Pa** t. J^_JNIEUWE COUHANTËHEESIN VAN H. W. DUSAULT; Lange Torenstraat YVjjk 7  J^lo. Door de meerdere uitbreiding die do Inrigting met October zal bekomen w op ruimere schaal opengesteld en worden belanghebbenden uitgenoodigd zich v te laten Inschrijven. _ Li alle wjjken der Stad wordt de Xiewwe Rotterdamsche f rtere Couranten ter lezing bezorgd en weder afgehaald op zoo ordeljj'» roo bepaalde uren tegen soliede Conditiën NAAR ALLE STEDEN EN D>: iwordt de A'tetiwe Rotterdamsche Courant verzonden franco per ""¦• \ de verzending een lsten dag Namiddag / 4 50 ) j  » » Sden » » » 3.— ƒ ™ Et/T Ongefrankeerde Brieven worden geweigerd.",http://resolver.kb.nl/resolve?urn=ddd:010112007:mpeg21:a0052:ocr,6,ddd:010112007:mpeg21:p006,"Nieuwe Rotterdamsche courant : staats-, handels-, nieuws- en advertentieblad",1239
2049746,1861/07/23 00:00:00,1954,ddd:011192778:mpeg21:a0010,http://imageviewer.kb.nl/ImagingService/imagingService?id=ddd:011192778:mpeg21:p004:image&x=1127&y=1565&w=1049&h=1954,ddd:011192778:mpeg21,2176,3519,1127,1565,4,"> . ■« -• -:• 4>.a •• •.•••• ■ -•• V-- •r -- v-* y ƒ  * - ;>AD yERTEjVTIEÜ. - ftó (104^5)j;jïDe v (i heeft tot t W.>»j 'Ah'.-'.it'j.L'-K:*«*—!■•>•■>.- »«.jifvwipi »= pi'i haren seneralenj Gevolmagiigae aajigesleltt ;l»n>lieei'Mr. B. E./COLa(;ü BELSOKTE Advocaat alhier. ; - Paramaribo den' 22' Jtt/y ■--1861:. j . iWed. J..BROSIETï|W® i '' t 4t-  i » 1 i ■.... «$• SAKCHB. :/ .  x • - ' ÈTp^m*tr* De. ondergeteekende waarschuwt; elk. en een iegelijk'; om ?den >hem\in* eigendom h toebehooienden #aafMetselaar lerT'^üdorVi .niet. ie* laten . Metselen of .. Schilderen i wat .voor. werkihet ookizij yte: laten doen aangezien genoemde slaahi door hem ;iverr huurd is ;—- tevens aan denzelven ook geen :Huisvesting noch"" nachtverblijf te •• geven ; zullende' hij de op deze waarschuwing niet ïëfftèh wi'VOlffèh; ' Paramaribo' de» 3 22.. Juïij \ 1801. ■ : . 7 ."" '*■ ■ 'v / • \' T !!'• TPnTT ■ '■■ ( ; ) 1. H. / IliUl 1. * • ' ' ; -1 1 ' • * - 'v' A. SALOMÓNS. *1 1 'i ......  .Tendumeester w-  1 1» ; m zal Ju eden Mlorgen verkoopen : .• A «• V... ■ l<. \ :- *' '■: * - • *_-v"" -B I li v Een groote .Yzeren . Uejreii^afel ■ 0 ■ -< /■% fift Q/ê \ .. ■ (10484)",http://resolver.kb.nl/resolve?urn=ddd:011192778:mpeg21:a0010:ocr,4,ddd:011192778:mpeg21:p004,Surinaamsche courant en Gouvernements advertentie blad,1049
1938356,1861/04/20 00:00:00,1871,ddd:011060812:mpeg21:a0011,http://imageviewer.kb.nl/ImagingService/imagingService?id=ddd:011060812:mpeg21:p004:image&x=1126&y=92&w=1036&h=1871,ddd:011060812:mpeg21,2162,1963,1126,92,6,Kinderwagentjes. Eerie grooie kwantiteit katoenen goederen. Eilnnen drllls voor Pantalons. Haloenen ld. id. Eïames zakdoeken. Fraalje venstergordijnen met kwasten. Wagcntulgen met pleet gemonteerd. Ilendlj i 0  > Zadels met toebehooren. Wagenvecren en assen. Itevoïvcr pistolen. ~ CSr oote spiegels met vergulde en verzilverde lijsten. Kamfer houten koffers. Scheermessen. ■'•nnenessen. Prachtige tafclkleeden. ETIJn servetgoed. Datlk sarong». fieaber wijn. Pale ale en porter. Ko. 3 4 en 5 niaulla clgaren. Japansche zijde enz. enz. en/.. Daags te voren te bezigtigen. NH. Goederen mogen op deze vendntle niet bljgebragt worden. (587) BEKENDMAKING. ■ u. De geannonceeide verkoop van bovenstaande JSPSf üngelsche  zal alsnu plaatshebben CP JBOfIDGCaDAG dca 95 APUIIi a. s. In het vendu-locaal. bij (628) D. D. VAN BOECKHOLTZ.,http://resolver.kb.nl/resolve?urn=ddd:011060812:mpeg21:a0011:ocr,4,ddd:011060812:mpeg21:p004,"De Oostpost : letterkundig, wetenschappelĳk en commercieel nieuws- en advertentieblad",1036
443178,1861/10/23 00:00:00,566,ddd:010112045:mpeg21:a0043,http://imageviewer.kb.nl/ImagingService/imagingService?id=ddd:010112045:mpeg21:p004:image&x=827&y=64&w=783&h=566,ddd:010112045:mpeg21,1610,630,827,64,6,TE HUUR: Eene BOTER WONING in de Gtroo'e Draaisteeg tegen 1 November k f 170. Adre* Schied-iaischen D'jk Wijk 3 N°. 498. (12310) HODES. De Ondergeteekende heeft de eer te berigten dat lij ven Parijs heeft Ontvan?en: een fraai Assortiment HOEDEN MUTSEN BLOEMEN enz. en neemt de vrijheid _<5b aan te bevelen. (12898) W. TtrjLJMBÏ¥B3JR_ 374 Hoogstraat. PETERS.,http://resolver.kb.nl/resolve?urn=ddd:010112045:mpeg21:a0043:ocr,4,ddd:010112045:mpeg21:p004,"Nieuwe Rotterdamsche courant : staats-, handels-, nieuws- en advertentieblad",783
3391692,1861/11/15 00:00:00,3158,ddd:010585038:mpeg21:a0044,http://imageviewer.kb.nl/ImagingService/imagingService?id=ddd:010585038:mpeg21:p008:image&x=1186&y=126&w=1074&h=3158,ddd:010585038:mpeg21,2260,3284,1186,126,8,"OPENRARE VERKOOPÏNG. ITHIIHI'KID I %. Mr db CARPtfNIIER Notaris te Koudum  zal in hot openbaar onder genot van stryk- en verhoogg-ld den 23 November veilen en dep 7 December 1861 toewijzen  telkens des namiddags te 2 uur by P. van Voen  Kastelein te Oudega (kanton Hindeloopen): Eene zeer vruchtbare ""BATHK en Ij*l»DKSmet florissante HUIZ^G en SCHUUR aan eenen kavel gelegon te Oudega vermeld ten kadaster van de gemeente Koudum bekend in sectio D nos. 1091 lot en 1097 geheel groot 11 b. 29 r. 20 el  met een kadastraal inkomen voor de gebouwde eigendommen van /' 45 en voor de ongebouwde van / 154.83  bezwaard te Oudega en Colderwoude met 4 fl. 6 stvs. 8 penn. floreen. In zes perceelen  met regt van zamenvoeging. Ter zelfder tijd en plaats zullen worden gaveild en verkocht : P. m. 22 koeseten best gewonnen hooglandsch HOOI staande te Colderwolde zeer geschikt tot vervoer. Alles breeder by varkoopbockjas omschreven. Conditien zyn te vernemen by den Heer B POOL te Oudega en ten Kantore van bovengemelden Notaris alwaar tevens boekjes verkrijgbaar njo. FINALËTIbÜIXG TE DRIESüMT Mr. J. WIITEVEEN Notaris te Metslawier  zal op Zaturdag den 23 November 1861  des namiddags 4 uur ten huize van den Kast»lein v->po»lstra ta Driesurn finaal veilen: Zes perceelen BOUWLAND gelegen onder Wouterswoude te zamen groot naar raam en faam 8 bunder en 26 roade (22J pont*.); by billetten omschreven en staando op: perc. 1 per 36j vk. roede f 390. „ 2 „ ~ „ » ""fl » 3 „ „ „ „ - 333. o 4„ „ „ „ "" _i"" e OOQ l> "" » t) )> 1) **u. I) 6 „ ~ „ „ - 316. VERKOOPÏNG VAN VASTIGHEDEN aar» Min AOfJtri—. Mr. J. WITTEVEEN Notaris te Metslawier  zal op Maardag dan 25 November 1861 drs namiddags 4 uur tco buize van T. P. v. d. Herberg Kastelein ta Atjum provisioneel veilen : 10 perceelen uitmuntend BOUW- en GREIDLAND gelegen onder Ar.jum te zamen groot Daar naam en faam 12 bunder en ruim 86 roede (35 pond.); in het fcreede bij billetten < mschreveo. Eiuen aan Doeda Jacobs van Eiz?nga Landbouwer onder Arjum. ZATHE TE SORREMORRE. De No aris W. A. EVERT>Z zal op Zaturdag dan 23 November 1861  des avonds ten zes ure by Raadsveld te Oldebooro  fioaal verkoopen : De in vorige ad cnentien breeder omschrevene byjonder vruchtbare groote RRIIDPI/UTI op Sorremorra onder Oldeboorn  groot 58-6^-36  m?t uiteondering vao 4-73-40 aao Ma ion geheel in Winter en Z imerpolder aanoonvolgeDde lis/geode: zijnde gebodeo op: perceel I f 2300 II /' 1000 111 f 2551 IV ƒ3350 V ƒ2850 VI ƒ2700 VII ƒ 1400 VIII ƒ 1600 IX ƒ 1400 X ƒ2lOO XI / 950 XII ƒ665 XIII ƒ fB5 XIV ƒ 1020 XV ƒ 1500 XVI ƒ 2250 XVII / 2900 XVIII f 3620 XIX f 2750. te zamen dus / 37791. IÜBIRGE MET ERF EN BLEEK TE lIEEG7 De Notaris TADEMA te Heeg zal op Zaturdagen den 23 November 186.  by J. v. d. Heide aldaar provisioneel en den 30 dierzelfde maand tij I. Bergsma fioaal telkens des avonds 7 uur tegen strijk- en verhooggeld presenteren te verkoopan : Eene hechte en ruime HUIZINGE gekwoteerd no. 49 met Krr et. Bleek c a. staande eo geb gen revers de Ger-formeerde Kertt te Heeg; door W. H. Neuta als mede-Bigenaar en R Fe-.isma als huurder bewoond; den 12 Mei 1862 vr'rj te aanvaarden.",http://resolver.kb.nl/resolve?urn=ddd:010585038:mpeg21:a0044:ocr,8,ddd:010585038:mpeg21:p008,Leeuwarder courant,1074
2681631,1861/06/08 00:00:00,2601,ddd:011060852:mpeg21:a0009,http://imageviewer.kb.nl/ImagingService/imagingService?id=ddd:011060852:mpeg21:p002:image&x=1136&y=104&w=1031&h=2601,ddd:011060852:mpeg21,2167,2705,1136,104,4,IN COMMISSIE ONTVANGEN. EEN ZOO GOED ALS NIEUW & MILORD met ecu s.tel Engelsch wagentuig. bij (334) HEIJMAN & CO. -^??ï?jsa Het HUIS thans bewoond door de Wïd. Geksoii  en Het HUIS van de Erven Lotii te Simpang te bevragen bij 24 Mei 1861. H. L. UADEMAKER. 1883) qq. Op billijke voorwaarden eene gerenomeerde TOOOZAAK op een der beste standen van Soerabaij i des jgsl|| verkiezende met dezelfs WOONHUIS te ütigitjfihuur of te koop. Nadere informatien te bekomen bij de uitgevers dezes. (840) -**-?Sm >Mw w VCZS >*s=e2 Sgsr-->i >&zi2*±* BIJ te Pasoeroean. voor DAMES en KINDEREN van 10 tot met 40 veeren. van geheel nieuw en verbeterd fatsoen direlit uit de beroemde Fabrijh VAN ysxr. SL cfc; O. THOMSON te Londen. [892],http://resolver.kb.nl/resolve?urn=ddd:011060852:mpeg21:a0009:ocr,2,ddd:011060852:mpeg21:p002,"De Oostpost : letterkundig, wetenschappelĳk en commercieel nieuws- en advertentieblad",1031
279240,1861/12/24 00:00:00,260,ddd:011061022:mpeg21:a0031,http://imageviewer.kb.nl/ImagingService/imagingService?id=ddd:011061022:mpeg21:p006:image&x=1225&y=5023&w=1074&h=260,ddd:011061022:mpeg21,2299,5283,1225,5023,6,PROTESTANTSOHB EERSDIENST. Eerste Keksdio. Woensdag den 25stcn December 1861. *s Morgens te half negan ure. Ds. VAN STEEDEN.,http://resolver.kb.nl/resolve?urn=ddd:011061022:mpeg21:a0031:ocr,6,ddd:011061022:mpeg21:p006,"De Oostpost : letterkundig, wetenschappelĳk en commercieel nieuws- en advertentieblad",1074
696000,1861/03/15 00:00:00,725,ddd:010546000:mpeg21:a0032,http://imageviewer.kb.nl/ImagingService/imagingService?id=ddd:010546000:mpeg21:p004:image&x=1042&y=1121&w=960&h=725,ddd:010546000:mpeg21,2002,1846,1042,1121,6,Uit de Hand te Koop: Zes Bunders uitmuntend WEI- en BOUWLAND geschikt tot kweeking van alle Vruchten annex HUIS SCHUUR BERG TUIN en VRUCHTBOOMEN tevens zeer geschikt tot aanlegging van een Buitenplaats daar het van alle kanten zeer aangenaam gelegen is aan den Zeister Straatweg tusschen tle Bilt en de Biltsche Tol één uur afstand van Utrecht. Te bevragen in persoon bij den Eigenaar daarop wonende H. van WELPEN *i* Door vergevorderden leeftijd UIT de HAND te KOOP een LOGEMENT en UITSPANNING met Stalling voor honderd Paarden en acht Koeijen staande op een der beste standen van een der drukst bezochtste Steden van Noord-Holland. De soliditeit dezer zaak kan men op franco aanvraag onder Lett. D. bekomen  bij den Heer A. KNOOP Klein Heiligland te Haarlem.,http://resolver.kb.nl/resolve?urn=ddd:010546000:mpeg21:a0032:ocr,4,ddd:010546000:mpeg21:p004,Opregte Haarlemsche Courant,960
860780,1861/12/05 00:00:00,892,ddd:010545915:mpeg21:a0023,http://imageviewer.kb.nl/ImagingService/imagingService?id=ddd:010545915:mpeg21:p003:image&x=2031&y=1897&w=965&h=892,ddd:010545915:mpeg21,2996,2789,2031,1897,6,"*** Men is van meening om op Donderdag den 19d""> December 1861 bij Opveiling en op Donderdag den 2d<""* Januarij 1862 bij Afslag op beide dagen des middags ten twaalf ure in het Logement van den Heer C. Keet te Schagen in het openbaar te Verkoopen: 1. Een HUIS zijnde het florissante Logement „BE ROOS"" met ruime Stallingen voor Paarden Koeijen en Rijtuigen alsmede het ERF staande en gelegen te Schagen aan de Laan en Hoogezijde Kadaster SectieC  Nos. len 308 ter grootte van 6 Roeden 82 Ellen. Bewoond door IJ. Hoogendijk; te aanvaarden 1° Mei 1862. 2. Een'HUIS zijnde de Herberg „BE OOIJEVAAR"" en ERF te Schagen aan de Kippen- en Botermarkt Sectie A N°. 324 groot 98 Ellen. Bewoond door Anthonij Boes- te aanvaarden 1° Mei 1862. Zijnde de Perceelen inmiddels Vit de Hand te Koop. Breeder bij Biljetten omschreven. Nadere informatien zijn te bekomen bij den Eigenaar den Heer C. KEET te Schagen alsmede ten Kantore van den Notaris Abr.P.BE LANGE te Schoorldam.",http://resolver.kb.nl/resolve?urn=ddd:010545915:mpeg21:a0023:ocr,3,ddd:010545915:mpeg21:p003,Opregte Haarlemsche Courant,965
2825802,1861/11/20 00:00:00,1641,ddd:010778616:mpeg21:a0007,http://imageviewer.kb.nl/ImagingService/imagingService?id=ddd:010778616:mpeg21:p004:image&x=973&y=1161&w=1722&h=1641,ddd:010778616:mpeg21,2695,2802,973,1161,4,"SM» WimMQ%M*%S V Voor het aanstaande St. NIKOLAASFEEST hebben wij zorgd ons Magazijn wederom ruim voorzien is van een massa NIEÜ ARTIKELEN welke alle zoodanig zijn ten toon gesteld waardooi onzer geachte begunstigers ieder op gemakkelijke wijze eene keuze vinden A- GRIJSEELS & CoMf %* Door P. C. HOOG te Rotterdam is heden verzonden: W PARTIJ VAN MEVROUW DE POES BEWEEGBAAR PRENTENBOEK Met Itüsehriften van ». J VAM DEI IHüKQH PrlJs /1M MERKWAARDIGE MANNEN. MERKWAARDIGE VROUW SCHETSEN VOOR JONGENS. SCHETSEN VOOR MEISJES. Gedeeltelijk naar hi t Engelsen  door S. J. van Gedeeltelijk naar het Engelsch door Me*3 den Rergrh. • Met 4 fraaije Platen; gebonden. Westrheene. Met 4 fraaije Platen; (P Prijs / i»o. Prijs f 100. DE KIM)\M\ W\ OOM IU IMIiFOKI  r\c QC UI OF SM OF EEN ZOMERTJE OP HET LAND. J™ VvVptJi ii\fil „ . .e. 11 „ „ „ ~ \i„ ST. NILO L A A S-V ERIEL L I N "". Naar het Engelsch van B. Wetherell. Met  R h van E Wetllere.|. 4 fraaije Plaatjes ; gebonden. Prijs / ».•»• g traaije P|aaljesn gebonden. Prijs / I.SOZOMER EN WINTERVREÜGD. cmn nncn Al MED SCHETSEN EN VERHALEN LliiU UULU ML UUU* door P. Deus D. Houtkamp 11. Ilpsema Vinekers DRIE OORSPRONKELIJKE VERTELLIN1' VV. C. Noack  P. Parson  C. v. Koetsveld O.Ez.  door J. v. Reu* en anderen. Agatha. 1 Mei 4 fraaije Platen; gebonden f 3. Met 4 fraaije Plaaljes; gebonden. Prijs /1 DE KUESIItfES CAKTONWERKËR. ZIJNDE EENE VERZAMELING VAN CARTONS WAARUIT KINDEREN EEN GEHEEL <H KUNNEN ZAMENSTELLEN. Prij* ƒ135. X",http://resolver.kb.nl/resolve?urn=ddd:010778616:mpeg21:a0007:ocr,4,ddd:010778616:mpeg21:p004,Utrechtsche provinciale en stads-courant : algemeen advertentieblad,1722
1639856,1861/06/11 00:00:00,1808,ddd:010079305:mpeg21:a0017,http://imageviewer.kb.nl/ImagingService/imagingService?id=ddd:010079305:mpeg21:p004:image&x=990&y=2223&w=907&h=1808,ddd:010079305:mpeg21,1897,4031,990,2223,4,"A 9 I . IIULML\ Junior te 's Hertogeobosch zal voor zijne principalen op Woensdag den 19 «ftunij des avonds ten 6 ure in het Eindhovensch Koffijhuis te 's Hertogenbosch finaal de volgende HUIZEN EN ERVEN gelegen te 's Hertogenbosch bij provisionele Veiling met de Hoogen gebragt als volgt: le KOOP. Huis Kerkstraat f 3300— 2e » » Putstraat „ HOO. 3c » ? Putstraat „ 740. Massa le 2e en 3c Loop » 5200 4e KOOP. Hnis op het Kanaal naast de Unie » 1(335 j £e "" Hnis daarncven » 905— 7 * » » » 900.— 0° "" » "" » 800— n„ "" » 780— 10e "" ' "" » 800— Jj; » >' » 680— Jol » "" » 625— ] * » "" » 700— 14e 8 » "" » 2550— Massa 4e tot en met 9e Koop » 6300 — Massa 10e tot en met 14c Koop „ 6800— 4e tot en niet 14e Koop » 14500 — 15e KOOP. Hnis Marktstraat „ 92g.__ Me » » Wcversplaats ? 550—",http://resolver.kb.nl/resolve?urn=ddd:010079305:mpeg21:a0017:ocr,4,ddd:010079305:mpeg21:p004,De Noord-Brabanter : staat- en letterkundig dagblad,907
809224,1861/06/15 00:00:00,806,ddd:010485213:mpeg21:a0028,http://imageviewer.kb.nl/ImagingService/imagingService?id=ddd:010485213:mpeg21:p003:image&x=1109&y=2199&w=1004&h=806,ddd:010485213:mpeg21,2113,3005,1109,2199,10,ouxr 3D^_B_^rxjrjs;. ff» Tle Ondergeteekende Particulier Onder•'-2r* J'wijzer verplaatst zijne Inrigting met primo Julij in het HUIS nu bewoond door den Wel- EdelGestr. Heer Dr. SMIT iv Gang Polones. Er bestaat nog gelegenheid om een 5 tal Jongens te plaatsen. Het hoofddoel zijner inrigting is jongens voor te bereiden voor bet G-yiiiiiasiiiiu Willem 111. Het getal zijner Leerlingen gaat een met de Ouders j overeengekomen cijfer niet te boven. Hierop reflecterenden kunnen omtrent het gegeven wordend Onderwijs informatiën bekomen bij Mr. T. H. DER KINDEREN. W. H. SNETHLAGE. Batavia den 12 Junij 1861. (1940),http://resolver.kb.nl/resolve?urn=ddd:010485213:mpeg21:a0028:ocr,3,ddd:010485213:mpeg21:p003,"Java-bode : nieuws, handels- en advertentieblad voor Nederlandsch-Indie",1004
1242837,1861/04/15 00:00:00,573,ddd:010136694:mpeg21:a0021,http://imageviewer.kb.nl/ImagingService/imagingService?id=ddd:010136694:mpeg21:p004:image&x=1222&y=461&w=2169&h=573,ddd:010136694:mpeg21,3391,1034,1222,461,8,ID. «f. WWJÏÏJDAVEM9 Groencnburf^wal C 433/4 CONTINUEERT MET HET VERVAARDIGEN VAN (GCO9) OVERHEIDEI & ÜITRUSTIH6EH MAAR DE lAAÏ\_ mm HOLLAIDSCHÉ PARAPmÈ:FMRÏÊK] W <T* En tous cas gevoerde Parasols Marquises Chinois. a IN DIVERSE KLEUREN IN ALLE PRIJZEN EN GROOTE SORTERING VOORHANDEN: LELIEGRACHT  KALVERSTRAAT  ROTTERDAM  hij de Heerengracht. bij do Osjossluis. Hoogstraat. A^.M.l2 April 18... 6ERRS. DAIE.,http://resolver.kb.nl/resolve?urn=ddd:010136694:mpeg21:a0021:ocr,4,ddd:010136694:mpeg21:p004,Algemeen Handelsblad,2169
3922517,1861/07/03 00:00:00,3697,ddd:110532124:mpeg21:a0014,http://imageviewer.kb.nl/ImagingService/imagingService?id=ddd:110532124:mpeg21:p002:image&x=2252&y=12&w=1061&h=3697,ddd:110532124:mpeg21,3313,3709,2252,12,7,"Per direct van Boston bij de oudergeteekeudeu Outvaugeii i AIEBIKiAHSCH HEEL in heele en halve vaten en iv blik van 8 25 en ""jl* il' ROGGE MEEL. Amerikaansche kAAS in Blik. RIEMEN van verschillen.le Grootte NEGRO HEAD TABAK STOUGHTON 'S ELIXER PINEAPPLE KAAS Gedroogde APPELEN in vaatjes SPLIT PEASE (groene Erwten) PEARLÏ BARLEÏ (gort) ROZIJNEN. 30 Diverse soorten Klokken enz. enz. HECKERS' FAEIMA: Prepared for Families Hotels auil Ealiug llimses. It is a most delicious article for Pnddings etc. superior to Rice Sago or Tapioca more eeonomieal nutritious and palatable ; unequalled t'ur gruel and for thiekeuiiig Soup than \ eruiieelli lxirley or Rice (8859) ABEELEN DENNISON k Co. Op nieuw Ontvangen: eene partij Friesche en andere É KLOKKE !¥ WINSSER DE LANGE & Co. i . Th ■ ■ / __ \-fP 22 Amerikaasisclie int iiiii \ meest nieuw mo lel en ooderdoordraaijeiidt Voorwielt MYLORDS VIS-a-VIS TE.VTW.A33NS HAND WAGENS KINDERWAGENTJES en a doux mams. Outpakt bij (M 97) CABSALETTE fc Co. caioufwüit SAUCISSOIDEIYOS. (2373) WINSSER DE LANGE \ Co.",http://resolver.kb.nl/resolve?urn=ddd:110532124:mpeg21:a0014:ocr,2,ddd:110532124:mpeg21:p002,Bataviaasch handelsblad,1061
2486835,1861/05/03 00:00:00,2535,ddd:011089283:mpeg21:a0029,http://imageviewer.kb.nl/ImagingService/imagingService?id=ddd:011089283:mpeg21:p005:image&x=59&y=464&w=981&h=2535,ddd:011089283:mpeg21,1040,2999,59,464,8,"JBATIB Geheel ten voordeele van de Slagtoffer» van. den Watersnood in den liotnme-— lernraard en het hand tusschen MAAS en WAAK js bij <le ondergeteekende Bockhandelaren en Boekdrukkers in Nederlandsch-Indie de 1 1 Inteekening geopend op eene GROOT K PLAAT voorstellende 24 Taf ereelen UIT DEN WATERDAMP IN «EN BOIMEIERWAARD TER PLAATSE ZELVE GETEEKEND door den Heer LAST Prijs ƒ 5.— Deze PLAAT circa 75 Ned. duim breed en circa >5 Ned. duim hoog bevat Tafereelen uit Bommel Zuiichem Gameren Nieuwwaal Bruchem enz. en wordt net Tint gedrukt op extra zwaar Papier groot 110 bij ?0 Ned. duimen. Bij ruime deelneming zullen wij van de Uitgevers (AYeijriNO & 15 have te Amsterdam) een tgroot getal exemplaren egen veel' verminderden prijs trachten te bekomen en de totale overwinst in handen stellen van de Iloofdkommissie lot ondersteuning der behoeftigen in Nederland. Vroeger is eene dusdanige poging door den Bockhandel in Indie met den gunstigsten uitslag bekroond geworden. Wij vertrouwen dat dit thans evenzeer liet geval zal zijn nu wij het tooneel eener ramp ter veraanschouwelijking ivenschen te geven die de schoonste en rijkste Provincie ran ons Vaderland zoo onbeschrijfelijk zwaar geteisterd heeft. Eene zelfde bezoeking trof ook een groot gedeelte van Java en van allerwege stroomden de aanzienlijkste giften lot leniging dier ramp. * Een overgebleven penningske vragen wij voor onze diep ongelukkige Landgenooten die men alleen door particuliere weldadigheid kan opheffen uit hunnen beklagenswaardigen toestand. O! men 'bedenke wel dat waar lder een geduchte watersnood vele heeft getroffen al de akeligheid en ellende daaraan verbpnden' ginds 'nog zijn verergerd door een killen ijsvloed! ledere extragift zal ons bovendien welkom zijn. Alle bijdragen (zoowel die voor Inteekening op de plaat als extragift) gelieve men bij de Inteekening te voegen ten einde ze al dadelijk en achtereenvolgens naar Nederland te kunnen overmaken. Van alle ontvangen gelden zal uitvoerig melding en verantwoording in dit dagblad worden gedaan. W. BRUINING \ H. M. VAN DOItP I G. KOLFF & C°. } te Batavia. LANGE & C°„ \ ""VV. OGILVIE / G. C. T. VAN DORP I  „ - DE GROOT KOLFF & CO. I Samarang Gebr. GIMBERG & CO. Chs. KOCKEN te Soeralalja. LE ROIJ & C°. W. EEKHOUT & CO. te Makasser. R. 11. VAN WIJK Rzn. te Padang.",http://resolver.kb.nl/resolve?urn=ddd:011089283:mpeg21:a0029:ocr,5,ddd:011089283:mpeg21:p005,Samarangsch advertentie-blad,981
5203528,1861/11/06 00:00:00,4078,ddd:010790046:mpeg21:a0012,http://imageviewer.kb.nl/ImagingService/imagingService?id=ddd:010790046:mpeg21:p003:image&x=1475&y=224&w=1276&h=4078,ddd:010790046:mpeg21,2751,4302,1475,224,6,ADVERTENTIEN. MINISTERIE VAN FINANTIEN. *** De Minister van Finantien maakt bekend dat de Statistiek van Handel en Scheepvaart van het Koningrijk over 1860 verkrijgbaar is gesteld bij de Gebroeders Giunta d'Albani Boekdrukkers te 's Gravenhage  tegen den prijs van zes gulden vijftig cents het exemplaar. 'sGravenhage den 31sten October 1861. De Minister voornoemd van Tets. MINISTERIE VAN MARINE. BERIGT AAN ZEEVARENDEN. NOORWEGEN. Stroom van Svelvig. — Eiland Tommeraas. De Minister van Marine brengt ter kennis van belanghebbenden dat blijkens bekendmaking der Haven-commissie te Drammen tot geleide der schepen die des nachts den stroom bij Svelvig passeren lantaarns aan de bakenstangen zijn aangebragt in dier voege dat de bakenstang op het eiland Tommeraas een rood de stang beneden den berg een wit en die in het Zuiden van het eiland Tommeraas een blaauw licht vertoont. Binnenkomende schepen nabij de benedenste ton gekomen zijnde zullen het roode licht kunnen zien hetwelk om in het regte vaarwater te blijven ineen gebragt moet worden met het witte licht. Uitgaande schepen moeten  wanneer zij het licht der lantaarn bij de Blinde klip (Bliudeskjoer) voorbij zijn het roode en het blaauwe licht inéén brengen ten einde den stroom bij Svelvig veilig te passeren. Deze lichten zullen telken jare branden in de maanden Maart April September October November en December van één ure na zons-ondergang tot één uur vóór zons-opgang. 'sGravenhage den 26sten October 1861. De Minister voornoemd W. J. C. Huyssen van Kattendijke. MINISTERIE VAN KOLONIËN. * * Van wege het Departement van Koloniën zijn bij de firma wed. G. Hulst van Keulen te Amsterdam verkrijgbaar gesteld de navolgende door de Commissie tot het verbeteren der Oost-Indische zeekaarten uitgegeven kaarten en gidsen. Kaart van de eilanden en vaarwaters beoosten Java door den luitenant ter zee 11. D. A. Smits verbeterd door P. baron Melvill van Carnbée in 2 bladen. Kaart van de zuidwestkust van Celebes trigonometrisch opgenomen door Zr. Ms. brik Postillon onder bevel van den luitenant ter zee lste klasse J. Schröder 3de uitgave. Kaart van straat Makassar te zamen gesteldop last van den schout bij nacht J. F. D. Bouricius door den luitenant ter zee A. C. J. Edeling 2de uitgave blad I en 11. Kaart van de Javazee en aangrenzende vaarwaters te zamen gesteld door de luitenants ter zee Smits en Melvill van Carnbée 3de uitgave blad I en 11. Kaart van het zeegat en de reede van Tjilatjap trigonometrisch opgenomen door den luitenant ter zee 2de klasse J. Groll nieuwe uitgave van 1857. Aanwijzingen om het zeegat van Tjilatjap uit- en in te zeilen door den luitenant ter zee 2de klasse J. Groll. Kaart van de oostkust van Celebes met aangrenzende vaarwaters te zamen gesteld volgens de opnemingen van de officieron van Zr. Ms*. zee-  door de luitenants ter zee lste klasse H. D. A. Smits en P. baron van Melvill van Carnbée in 2 bladen. Kaart van de westkust van Sumatra  lste gedeelte  van af Atsjin tot Padarm- te zamen gesteld op last van den schout bij nacht J. F. D. Bouricius door den luitenant ter zee A. C. J. Edeling. Kaart van de westkust van Sumatra 2de gedeelte van af Padang tot den Vlakken hoek te zamen gesteld op last van den vice-admiraal J. F. D. Bouricius door den luitenant ter zee A. C. J. Edeling. Kaart van de eilanden bij Padang te zamen gesteld op last van den vice-admiral J. F. D. Bouricius door den luitenant ter zee A. C. J. Edeling. Kaart van de Westkust van Sumatra van af Singkeltot Taboejang hoofdzakelijk te zamen gesteld uit de opnamen van den luitenant ter zee lste klasse J. van Maurik op last van den vice-admiraal J. FD. Bouricius door den luitenant ter zee A. C. J. Edeling. Kaart van de straat Bangka hoofdzakelijk uit de opnemingen van den luitenant ter zee C. W. E. Moeth te zamen gesteld op last van den viceadmiraal J. F. D. Bouricius door .den luitenant ter zee A.C. J. Edeling. Kaart van de reede van Padang opgenomen door den adelborst lste klasse jhr. A. O. Wichers en den 3den stuurman G. Verspick. Kaart van de reede van Tikoe door H. L. Osthoff. Kaart van de reede van Priaman trigonometrisch opgenomen door den adsistent-resident P. J. B. de Perez en den luitenant ter zee 2de klasse J. F. Jansen. Kaart van de reede van Baros  opgenomen door den luitenant -ter zee R. P. Struick den adelborst C. Kruys en den stuurman Huet. Kaart van de reede van Singkel opgenomen door de luitenants ter zee E. P. Struick en L. C. Holzapfel en den stuurman Huet. Kaart van de reede van Bengkoelen door MacDonald herzien door den luitenant ter zee H. A. Modderman  en der Poeloe-baai door de luitenants ter zee H. A. Modderman en D. Schuurman en den opperstuurman D. Sehwencke. Kaart van de reede van Ampanam door den luitenant ter zee 2de klasse D. G. E. Wolterbeek Muller adelborst lste klasse J. L. van Isselmuden en den lsten stuurman J. P. Valter. Kaart van do reede van Tapallang en Kait door het état-major van Zr. Ms. fregat Palembang. Kaart van de reede van Muntok opgenomen door Zr. Ms. opnemingsvaartuig Pylades. Kaart van de baai van Laboeang Pring door het état-major van Zr. Ms. stoomschip Samarang.,http://resolver.kb.nl/resolve?urn=ddd:010790046:mpeg21:a0012:ocr,3,ddd:010790046:mpeg21:p003,Nederlandsche staatscourant,1276
1004157,1861/11/23 00:00:00,1449,ddd:010902295:mpeg21:a0020,http://imageviewer.kb.nl/ImagingService/imagingService?id=ddd:010902295:mpeg21:p004:image&x=1475&y=107&w=693&h=1449,ddd:010902295:mpeg21,2168,1556,1475,107,6,"VERPACHTING VAKT TOLLEN op den Straatweg tusscheti VMSSIïSGESJ en UOVt»EH.EUKE. De Commissie van Beheer voor den Straatweg tusschen Vlissingen en lioiidekcrkc zi\\ op Vrijdag den 2D November 1861 des middags ten 11 ure op het Kaïulhuis te Vlissingen in het openbaar ter verpachting aanbieden het heffen van het TOL- ol"" WKfiKSSi» aan de bvtdc To-'palcn op den gcmeldcn Straatweg over de jaren li>62 ]S(i;i en 18M volgens eonilitren ter inzage bij den ondergeteekende te Koudekerke. Koudekerke den 15 November IS6I. Namens de Commissie voornoemd P. LOEFF Secretaris. BIEBEaf (Zaturdag) des voormiddags 11 ure zal op de WEÜF M VOLHARDING worden voortgegaan met den verderen verkoop - der AFISI&AAK van den gesloopte» MODDSR- «f BAGGEUMOLEK. ~ .. ' .___._____ PUBLIEKE YERKOOPI\G op Maandag den 2r.No. vember 1 St* 1 des morgens om 11 ure op het Stads Koffijhuis de Bkurs te Vlisslisgcn van circa vijf Lasten min of meer door Zeewater beschadigde WITTJS HAVER afkomstig van het bij Zoutelande gestrande Barkschip Émigrant Kapitein AUENTZ gekomen van Archaiigel bestemd naar Antwerpen. — Informatien bij den Heer J. SMIÏH. OPENBABE VERKOOPING . Dondeniag2SNo;2 bet' 1861 des middags (en half een ure (en overstaan van den Notaris P. VAN DE GRAFT op den Ü.eistlain te Middelburg van eene partij __? _F Si il M A Mi bestaande in Kolders Gordingen Muurplaten; Schutselen Mestputpnlen  Sparren  Latten Deelen Dein- en Licht kozijn en met Blinden; alsmede nieuwe Kolders van 10 El lengte en meer andere Goederen. Ten dage der Verkooping te zien. _L_ OPENBARE VEBKOOPN6 doorden Notaris WOUi TERSEN Vrijdag 20 December 1801. 's morgens 10 ure iop de Buitenplaats 19uinvliet bij Komburg van ruim G bunders sjarig _.vaar Essen Elzen en Wilgen RAI* il ©UT eene partij Olmen en Populieren STAMMEN enz.",http://resolver.kb.nl/resolve?urn=ddd:010902295:mpeg21:a0020:ocr,4,ddd:010902295:mpeg21:p004,Middelburgsche courant,693
2080176,1861/10/19 00:00:00,2114,ddd:010485249:mpeg21:a0007,http://imageviewer.kb.nl/ImagingService/imagingService?id=ddd:010485249:mpeg21:p002:image&x=61&y=109&w=984&h=2114,ddd:010485249:mpeg21,1045,2223,61,109,10,Vendutie Op Dingsdag den 22sten October voor liet Commissielmis van JT. SPEET van een GROOT FACTUUR pas van China aangebragte c o i: i» i: lt _è\. als .* Fraaije CHINEESCHE BLOEMPOTTEN met gewerkte voetslukken CfIINEESCH OEFEN-PAPIER PORCELEIN en AARDEWERK Paijougs Kipsou Trekpotten Josticks Offerpitten alsmede: 88 kisten JAPANSGHE WAS. (5578 Op Dingsdag 22 October e. k. des morgens ten ELF ure zullen de Ondergeteekenden voor hun Contmimiehui» zonder reserve aan deu meestbiedende verkoopen: wegens overlijden van een der associés de Arak- Likeur- en AZimMERU benevens de daaraan verbonden SUIKERRAFFINADERIJ met derzelver Gebouwen. Gereedschappen Distelleerketel Suikerpannen Azijnkuipen enz enz. volgens Inventaris; staande en gelegen aan den ouden weg van J i-at ra . in de oniniddelijkc nabijheid der Stad Batavia. Nadere informatien zijn inmiddels te bekomen bij de ondergeteekenden (5605) VAN SLOOTES MORGAN & Co.,http://resolver.kb.nl/resolve?urn=ddd:010485249:mpeg21:a0007:ocr,2,ddd:010485249:mpeg21:p002,"Java-bode : nieuws, handels- en advertentieblad voor Nederlandsch-Indie",984
2783388,1861/05/27 00:00:00,1289,ddd:010136734:mpeg21:a0023,http://imageviewer.kb.nl/ImagingService/imagingService?id=ddd:010136734:mpeg21:p004:image&x=1178&y=106&w=2172&h=1289,ddd:010136734:mpeg21,3350,1395,1178,106,8,"T A B A K« In een KOFFIJ- THEE- en TABAKS-WINKEL verlangt men een BEDIENDE die goed kan Sorteren en met den Winkel ora kan gaan of iemand die Kerven ook kan; ook verlangt men een LEERLING of een aankomenden JONGEN tegen Weekgeld. Brieven Franco Lr. A.8. Bureau Handelsblad. (9269) Jr U 1 MLJyL iiliö 1 finlmifi. Tegen Primo Julij of Augustus wordt in eene APOTHEEK gevraagd Een BEDIENDE  van de P. G. tegen genot van ruim Salaris Kost en Inwoning. In dezelfde Apotheek kan een LEERLING geplaatst worden. Adres Lett. A. bij den Boekhandelaar J. KRAAN O. Z. Voorburgwal bij de Halsteeg. (9282) §m FABRIEK EN MAGAZIJN „* «ff VAN |-.-'Kv-1 LAARZEN E ffllffl Z 'wm» van _#ai 6. H. EÏE6ELAAR DAM 522 AMSTERDAM. beste kalfsleeren Heeren Laarzen het paar ƒ 6. GEL AKTLEEREN HEEREN-BOTTINES met Elastiek af 4.50 het p. ii i' ROZETSCHOENEN... « 5.— // n ii 'i LAARSJES ii 6.— r « DAMES LAARSJES met Hakken // 2.75 # * » VICTORIA LAARSJES n 3.—  * // // i met Hakken // 3.50 // u En verders is het MAGAZIJN ruim voorzien van de smaakvolste KINDER-LAARSJES en SCHOENEN voor dit Saison etc. etc. Alles tegen LAGE en VASTGESTELDE PRIJZEN. (9332) lÉpf Riano-Onderwijs» giEwKïgsag Tot het geven van bovengenoemd Onderwijs biedt zich een» IW___S.-JUFVROUW aan. Prijs 30 Cents per Les-Uur. A&* Franco Lett. A. J. bij den Boekhandelaar G. THEOD. BOM Kalverstraat  E 10 alwaar tevens onder dezelfde letters te bevragen is een* goede 6 Oct PIANO in Mahonijhouten Kast Prijs/35. (9284)^ TAFEL-iERÏÏESEM. IN 12 VERSCHILLENDE SOORTEN EN MODELLEN. _v In FIJN PORSELEIN-WIT in NIEUWE zeer ELEGAN^ en SMAAKVOLLE Modellen geheel Compleet volgens Tarief ƒ 3640 W- Effen GOUDRANDS RIJK VERGULD en GEBLOEMDK£ü' RIG DESSEIN allerliefst met Goud afgezet Compleet ƒ 65 75 80»* ƒ 120 150 en hooger. Best Binnenlandsch AARDEWERK 1 Keuze Compleet ƒ 18. OIVTBIJT-SERVIESEN. Fijn PORSELEIN-WIT 18 a 20 Stuks ƒ 5.75 6.50 9.50. Effen GOUDRAND RIJK GEBLOEMD en VERGULD ƒ l»-5""' ƒ11.50 16.50 en hooger.  Fijnste FRANSCH PORSELEIN Keurig Geschilderd met Go** gedecoreerd f 25 30 35 40 en hooger. Bfß^Spg»» Wij zijn in staat en verpligten ons van alle Serviesen «"""" . <fS§§mSÏJF kele stuks na te leveren. (9313) JL. MüMsËer ës €*•",http://resolver.kb.nl/resolve?urn=ddd:010136734:mpeg21:a0023:ocr,4,ddd:010136734:mpeg21:p004,Algemeen Handelsblad,2172
3810716,1861/03/23 00:00:00,3458,ddd:110532095:mpeg21:a0016,http://imageviewer.kb.nl/ImagingService/imagingService?id=ddd:110532095:mpeg21:p003:image&x=9&y=21&w=1102&h=3458,ddd:110532095:mpeg21,1111,3479,9,21,7,"plpïer- en Barerahanio! r&nW.BRÏÏILfIüS. V.:s ontvangen en lege i zeer billijke ' ■ prijzen verkrijgbaar: O r . «rit en azuré g lini Jard - '■ - mei iii zo i ler bi i hoon n '..■ u.N \ N  iWATBU en YiLIXStHBÏJF PAMEB in seorlen KARDOES- en PAKPAPIER VLOEIPAPIER prima qualiteit MARMER- en (TTSPAPIER gewoon blaauw KASPAPIER ROEST- of SCHUURPAPIER. I (K'-'u?) 1 « een steenen HUIS met Bijgebouwen "" COD— tot en met/7000—; Niemy-Zeelandsche Greenen HOUTSOORTEN of te zagen op I jen a in de Machine-Fabriek en Hou! zaag mol en cii van J. B. DROSSANRS. !'••* .ken -•. a.'v Ie BdTendtSlaan. thans bewoond door Mevrouw de de .'■'. -. . ... len P. Mei. Adre» >l) A. THIEBAULT. MUIS Rijswijk  thans bewoond door den H er i e. k. te aam bij \V. F. G. Pt / — a f 60000--■ 3*l tB I. \dr-'Il \l).",http://resolver.kb.nl/resolve?urn=ddd:110532095:mpeg21:a0016:ocr,3,ddd:110532095:mpeg21:p003,Bataviaasch handelsblad,1102
3607296,1861/11/14 00:00:00,2816,ddd:010790052:mpeg21:a0015,http://imageviewer.kb.nl/ImagingService/imagingService?id=ddd:010790052:mpeg21:p010:image&x=1384&y=50&w=1281&h=2816,ddd:010790052:mpeg21,2665,2866,1384,50,10,"Al de aan de orde gestelde onderwerpen worden bij gewone meerderheid van stemmen der aanwezige aandeelhouders beslist behalve in he geval dat zou moeten worden geraadpleegd en besloten omtrent wijziging van de statuten als wanneer tot het nemen yan een besluit eene meerderheid van vier vijfden der stemmen wordt vereischt terwijl een voorstel daartoe niet in behandeling kan worden genomen dan na eene maand te voren ter kennisse der deelgenooten te zijn gebragt door bel ter lezing liggen van hetzelve gedurende dien tijd ten kantore der vennootschap  met voorafgaande oproeping tot het nemen van inzage daarvan- Bij staking van stemmen heeft de voorzitter eene beslissende stemleder vijftal aandeelen geeft regt op eene stem zonder dat echter dozelfde persoon meer dan zes stemmen zal kunnen uitbrengen. De aandeelhouders zullen om bij vergaderingen te worden toegelaten of om naar aanleiding en ten gevolge van daartoe gedane oproepingen mededeelingen en inzage van stukken te erlangen verpligt zijn de bewijzen van aandeel waarvoor zij opkomen  aan directeuren over te leggoll- Artikel achttien. Alle oproepingen kennisgevingen en aankondigingen worden ten aanzien van de deelhebbers gehouden voor geldig indien zij geplaatst zijn in de Nederlandsche Staats-courant en ten minste twee Nederlandsche dagbladen waarvan een te Amsterdam en een te R°. terdam uitgegeven. De oproepingen tot vergadering moeten tenzij lö buitengewonen spoed vereischende zaken veertien dagen te voren geschieden. Artikel negentien. Bij ontbinding der vennootschap uit welken hoofde ook vóór de expiratie van den termijn der concessie blijft deze ter beschikking van den heer Arend Nicolaas van den Berg of regtverkrijgenden terwijl even als in het geval van ontbinding ten gevolge van denafloop der exploitatie alle voorhanden activiteiten verblijven aan de aandeelhouders. De realisatie van hetgeen daarvoor vatbaar is geschiedt door directeuren en de opbrengst na afbetaling der schulden wordt over o. gezamenlijke aandeelen verdeeld. Artikel twintig. In geval van verschil hetzij ten opzigte van eenig punt waaromtrent niet mogt zijn voorzien of omtrent de uitlegging0 toepassing van eenige bepaling der statuten en wat op eenigerlei wijz daarmede in verband zou kunnen staan of van welk een aard het tusschen de contractanten van deze overeenkomst moge zijn of van deelnemers in het algemeen zal hetzelve verschil ter beslissing worde onderworpen aan de uitspraak als goede mannen van drie scheidsmannen  waarvan te benoemen ter weerszijden een en de derde door deze beiden en bij gebreke van benoeming van de eene af andere zijde of van onder ling overleg door de arrondissements-regtbank te Amsterdam ten ver"" zoeke van de meest gerecde partij. De alzoo benoemden zullen vrijgesteld zijn van de naleving der ""J de wet bepaalde vormen en uitspraak doen als goede mannen; in uitspraak zal even als in een vonnis in het hoogste ressort ge-wezö » moeten worden berust zonder dat daarvan eenigerlei beroep of reVis zal kunnen plaats hebben noch welk middel tot vernietiging er ZIJ mogt met eenig gevolg zal kunnen worden aangewend. Bij uitzondering op het bij dit artikel alzoo bepaalde zal in geval v verschil tusschen directeuren onderling ten aanzien hunner verngt'n_ voor de vennootschap de beslissing daaromtrent aan eene algei«ee vergadering van deelhebbers worden onderworpen. Alles is aldus overeengekomen tusschen partijen die voor de ui tv ring dezer domicilie kiezen ten huize van den jongsten notaris te Amsterd in der tijd en aldaar woonachtig alles onder afstand van alle excep"" en verband als naar regten. .0 Waarvan acte. Gedaan en verleden in Amsterdam ten dage als voren tegenwoordigheid van Hendrik Abcouwer kruijer en Johannes van Guv g boekbinder  beiden wonende binnen deze stad als getuigen  die me' heeren comparanten aan den notaris bekend en denzelve na voorlez ■ deze minute hebben geteekend. u) (Geteekend:) A. Mendel Herman L. J. Haakman M. H. 'sJft<ïj F. E. van Putten D. H. Roodhuyzen Jr. H. J. van Buren; H- -* couwer J. van Guylik  «T. B. van Houten  Notaris. . ef W. 1226. Geregistreerd te Amsterdam den zeventienden Octo 1800 een en zestig deel 116 folio 156 recto vak 7 vier bladengeto renvooi. Ontvangen voor regt f 2.40 voor 38 opcenten f 0.91  zamen drie gulden een en dertig en een halve cent. De ontvan» (get.) ten Sande.",http://resolver.kb.nl/resolve?urn=ddd:010790052:mpeg21:a0015:ocr,10,ddd:010790052:mpeg21:p010,Nederlandsche staatscourant,1281
5854879,1861/06/10 00:00:00,2381,ddd:010925406:mpeg21:a0013,http://imageviewer.kb.nl/ImagingService/imagingService?id=ddd:010925406:mpeg21:p003:image&x=47&y=1645&w=2459&h=2381,ddd:010925406:mpeg21,2506,4026,47,1645,4,"1 iEene Buitengewone groote sortering LINKEN I STOFJASSEN DRIL MARKIEZE' PRTNCEPTE CASSINETTE en KRIPL.4STING';' BpSSSPH HÜISJASSEN [van af f 1.90. .:'ll±t^. j - Tevens heeft de.Ondergeleekende de eer zjjne geëerde Begunstigers dat het Magazijn nog ruim gesorteerd is van elegante Zoincr- I tlccdingstukken als Fantasie Jakets Byron Dilès Lakensche Jassen* Piqué en Zijden Vesten Lakensche Busking en Linnen Drilbroeken en jr verder alles wat tot eene.Heereri-Garderobe behoort.- | .... .«j .... .„ ~-•;- „...f .._- tj fiïbu3*nbi**n i 1..-De Kleediiigstukken kunnen ook desverkiezende -naar het lijf aangemeten worden zonder verhooging van prij5.'.....;. / - „ e v\ ~„. E uitkustikgejV staar oost- es; ivest-isjdie worden bikwest weinige dagen hv gereedheid gebragt .' GOEDKÖOPE TERROOPHUIS ■'-*-I'-'* ' '""' „'_ ■>'. d ■■■:. .- ' : ■ .""V .""/. 1.-l- ■ ■•..'...■:: I .- — ......';..'• -; "" r'""""W al!''t_t:-c?'tvt ■ tr; ■■'''•'■'••--r • •■••.■>!!*. '•».! I.':<! 1 .-•- Ji \J A: JM rfj .  ...■- Molm viM-;' .nj-O-il «tTOOi Maarsmansteeg het tweede huis van de Vischbrug WijklV. N°. 72.  •-.■.. J':.Héden: uit: Londen ontvangen eene groote partij MANS MERINOS-HEMDEN. 1 in het HOT2.-L ÏDI2 BBJKG* te -Leiden in de Benedenzaal aan de Poort »J ' van Witte Linnen en Katoenen Goederen Meübelgordijnen en Nételdoekén. ; V tri — »—-. --r. i ' • • : Wiet langer dan tot den IS Junij. . Boor de tegenwoordige.onlusten in Amerika en door de vele faillissementen aldaar plaats hebbende zijn verscheidene Fabriekanlen huiverig om de n goederen daarvoor bestemd.'er naar loe-te zenden en daar zij met hunne goederen niet opgestapeld kunnen blijven zoo hebben wij van verschillende ré! Fabriekanten van deze goederen ontvangen om dezelve lot nimmer gekende lage prijzen te realiseren tegen contant geld te meer om hunne fabrieken tij gaande te houden en de arbeidende klasse van werk te voorzien. ■ . ■ t y n Zoo verzoeken wij beleefdelijk het geëerde.Publiek om de goederen te komen bezigtigen' en zich van de echtheid en de soliditeit zoowel als van ~. Je exquise bewerking en de billijke prijzen der_ goederen le overtuigen. ~- {¥ t *""' ""' "" * '*' '' .'Wij guaranderen voor deze/goederen die door onsverkocht worden 'enigeven daardoor eene waarborg dat wij gevestigde Kooplieden zijn. ' Onze Magazijnen zijn -.Amsterdam Kloveniersburgwal N°.' 98. 's Hage lste Wagenstraat N°. 6.""* i tin a « \% r$ U *\Ol fl».« I !* 'n*~ !'-'""• ••:■■'.""-: • **«""""•"" de GROOT & COMP."" I Onderstaande Prijs-Courant zal dan ook doen zien dat nimmer van deze echte grondstof vervaardigde goederen voor deze ongelooflijke spotprijzen -J *ijn aangeboden. .fctffiWf-.i'. Ul '-'■'■''• ; ) - h ni 3' .'.i.'*.: Russisch Linnen' \per stuk van 50 el • . . . . ƒ7.50 Geheel Linnen Zakdoeken per dozijn ~-..-. ƒ 3.— 'Sf-BM -*■'?■ lersch voorSloopen per stuk van 52 el. ... .. -10.— Fijne Fransche Linnen Batist Claire el Batist de Linon Dameszak- y~°vl fi/i """" !■ ï'l'anscb.voor.Dameshemdeiii 52 el . ... ... -.. -12.— j doeken per dozijn .'/.'!...'.. .!...''.'..;....- .""■ .' ' ■'. ■'■'- 3.50 i s/1 '•'»"""" "" Hernhutter voor Lakens""per el. ....:.-. - 0.27| 'Afgepaste piqué Damesrokken met gebloemde randen . . ... . - 1.50?' 1 lu'-'• "" ' Schots«n 'dubbel..draads: . . \...."".'. *. .' . - 0.30 6/4 Zwaar Bockholder Keper' per stuk van 20 cl ~..' ... . - 6.— «tl fi/j Ulyer ïerzeeHwscb en Vlaamsch-Linnen vanaf' '.'.'..'. - 0.35 .Damaste Vingerdoekjes in diverse patronen van af . . . ..•'■- 3.—' al 'Il ï aÖnslrecPen voor Damesrokken .'••'. '.' '. "".' . . '-. 0.30 .Theedoekjes met gekleurde randen per dozijn . .. . . . .-*.'- I.— I fi/i nse'lc' Dieraeieii in alle slreepen ."" ."". '.' '.' . '.' '.'.' ."":'- 0.30 ■Jieubelgordijnen..-het paar van af ... ."" V■; .«'.'««'.'Y- 2.50 !i'l ?u fl""pra f*Jn«'Percals en Madapolams voor Heeren Overhemden - 0.25 7/4 Neteldoeken met fesion per stuk van 32 el . . . ........ - 4.75 iMi m tijne Bieiel- Chirting voor Kinderhemden v . . -.- ■. ••'. ■•'. ■: \- 0.15 7/4 Gecordonneerde in fraaije patronen per stuk 16 el .• . .- * - 6.— -■ j.ateloarnitiiren'.voor 12 personen ; per stel .'. '. -.'.''. .-.'--7.50 'Alsook eene groole parlij fijne flanellen 11 eerenhemden 5/4 Fransche .. lel wmasten Tafelgarnituren i met Jagten en Bloemen -11.— '; krimpvrij Flanellen .... ... ~ ..... ~.;•...;.: ...!.i-.- 0.50 iv! 'gepaste Tafellaken voor 6 personen . -.. ~ . ~;...„.)- ~.-;;.1.40 Dameskousen per dozijn . . . . .•;.'. .'. . '.-... .-..-- 2.50 t' nmi' **"" idem '12 » "" **i;.''...''."".' . ..""..""-'. 1.80 iWitte gekleurde en ongebleekte Ilecrcnsokken per dozijn .;t'.!i .■il-'.3.50 . 5/4^e.rïe''enV het half dozijn"". :-.•'-.-■*'-.""'. '■*.';.-' 2.70 6/4 Zware dubbele W.ateriwisten per el- .'..;■• .„-. n'iA-.u-. ■.-..:- 0.25 •?•"" nin- • Ser Tel- Handdoek- en;Luijergoed van af .'.'""'.."" tT . -~0.25 En meer andere Artikelen. ... ■.-.:<) . j!|i„.«'i-I . f»';.:-.:i>ivlo) b'i_llol ™'nnen Zakdoeken; per dozijn. '.y''.\'i .V'1.'1. . -0.90 <w ""Joor de uitgebreidheid onzer zaken zal deze verkoop niet langer duren dan tot en met Dingsdag den l_dra Junij ek.",http://resolver.kb.nl/resolve?urn=ddd:010925406:mpeg21:a0013:ocr,3,ddd:010925406:mpeg21:p003,Leydse courant,2459
941868,1861/01/29 00:00:00,972,ddd:010545961:mpeg21:a0036,http://imageviewer.kb.nl/ImagingService/imagingService?id=ddd:010545961:mpeg21:p005:image&x=1994&y=2610&w=969&h=972,ddd:010545961:mpeg21,2963,3582,1994,2610,6,*„* Men vraagt tegen 1 Maart tot assistentie in het Huishouden op eene niet talrijke Kostschool eene Prot. JUFVROUW van beschaafde manier. Men adressere zich onder Lett. X. met franco Brieven aan G. G. BRUGMAN Boekh. te Weesp. %* De Heer ÉMANS te Gouda verlangt spoedig in zijne Huishouding en tot oppassing van eene aan de kanker lijdende Jufvrouw eene fatsoenlijke RURGER VROUW P. G. eerlijk zijnde en opgeruimd van humeur. Brieven franco. ** * Men verlangt in een klein Gezin eene Burger DOCHTER of WEDUWE  P. G middelbaren leeftijd  die een burger Pot kan bereiden Linnen en Wollen schoon Wasschen sierlijk nat en droog kaa Schuren en voor het overige zindelijk het Huiswerk verrigten. Adres met franco Brieven of ïnpersoon Letter W. Postkantoor Wormerveer. *„* Men verlangt te Voorburg tegen Mei of eerder eene zindelijke DIENSTRODE niet beneden de 30 jaren bekwaam om eene burger Pot te koken en Huiswerk te verrigten ; Loon ƒ 60. Adres met franco Brieven onder de Letter B aan de Wed. A. M. BROEDELET Boekh. te Voorburg.,http://resolver.kb.nl/resolve?urn=ddd:010545961:mpeg21:a0036:ocr,5,ddd:010545961:mpeg21:p005,Opregte Haarlemsche Courant,969
1200374,1861/06/12 00:00:00,1253,ddd:010546072:mpeg21:a0051,http://imageviewer.kb.nl/ImagingService/imagingService?id=ddd:010546072:mpeg21:p006:image&x=2010&y=3576&w=958&h=1253,ddd:010546072:mpeg21,2968,4829,2010,3576,6,V J* C. & W. ALTORFFER te Middelburg geven uit en hebben alom in.den Boekhandel verkrijgbaar gesteld : PREEKPROEVEN van C. G. SL.OTEMAKER  te Cats. Inhoud : I. Een woord van Gods welbehagen. 11. Davids sterfbed. 111. Levensverlies — Levensbehoud. IV. Denatuurlyke mensch en de geestelijke dingen. V. Oud en nieuw. VI. Nacht en morgen. VIL Waarheid en werkelijkheid — Gr 12°. in netten omslag a 90 Ct. %* Bij- S. E. van NOOTEN te Schoonhoven is heden van de pers gekomen : REISVERTELLIN6EN UUOR J. HERMAN de RIDDER. 211 bladz. met gekleurde Platen. Prijs ƒ 160 gebonden ƒ 190. 'jmmtiÊt&fl** Deze Reisvertellingen geven eene be||fB__sr langrijke en onderhoudende beschrijving WT^ van een groot gedeelte van NOORDELIJK DUITSCHLAND. De Schryver leidt den lezer door de bekoorlijke streken van Dortmund Hanover Oberhars Unterharz Kassei Eisenach Thüringer woud Erfurt Weimar Dresden Hernnhut Meissner Hoogland enz. op eene wijze dat dit werkje als een getrouwe gids kan beschouwd worden voor hen die insgelijks deze reis zullen ondernemen en als eene aangename herinnering voor diegenen welke deze streken bezochten.,http://resolver.kb.nl/resolve?urn=ddd:010546072:mpeg21:a0051:ocr,6,ddd:010546072:mpeg21:p006,Opregte Haarlemsche Courant,958
1407744,1861/12/02 00:00:00,1152,ddd:010925540:mpeg21:a0017,http://imageviewer.kb.nl/ImagingService/imagingService?id=ddd:010925540:mpeg21:p004:image&x=80&y=2804&w=1222&h=1152,ddd:010925540:mpeg21,1302,3956,80,2804,6,"Door P. C. HOOG te Rotterdam is heden verzonden: DE PARTIJ VAN MEVROUW DE POES Beweegbaar Prentenboek. 9lct Bijschriften van S. J. VAK DES BEKGH. Prijs ƒ1.50. MERKWAARDIGE MANNEN. MERKWAARDIGE VROUWEN. SCUETSEN VOOR JONGENS. SCHETSEN VOOR MEISJES. Gedeeltelijk naar hel Enselsch. donr Gedeeltelijk naar het Engelsch door S. J. van den BERGII. Met 4 fraaije Mevr. van WESTRHEENE. Met Platen; gebonden. Prijs ƒl9O. 4 fraaije Platen; gebonden. Prijs DE KINDEBEN VAN OOM RUTDERFORD. /L 9- ■ %^ OF EEN ZOMERTJE OP HET LAND. DE SCHOEN. RFaiPThet»ïi'lBeiSrhïan 'f."" EÏHE- St.NICOLAAS-VERTELLINGEN. RELL. Met 4 fraaie Plaaies; ge- L  „ <•-.  „ „„„.„ bonden.. Prijs ƒ 1.60. *%""he' En?e'??h va"" £■ WETBE/-. -\XT t BELL. Met 3 fraaije Plaatjes; ge- ZiOmer-en Wintervreugd bonden. Prijs ƒ1.50. SCHETSEN EN VERHALEN RIKI)'flOKI. Al. GORD door P.DUYS.D. HOUTKAMP H. Ll[W ""UE;U M' WPP' ILPSEMA VINCKERS W. C. NO- DRIE OOP.SPONKELUKE VERACK.P.PARSON.C.v.KOETSVELD TELLINGEN C.Ez. J. v. REYN en anderen. Met door AGATHA. Met 4 fraaije Plaat-4 fraaije Platen; gebonden. Prijs. ƒ2. jes ; gebonden. Prijs ƒ1.25. DE KLEINE CMTOMERKER. zijnde eene verzameling van Carlons waaruit Kinderen een geheel Dorp kuni.en zamenslellen. Prijs ƒ1.25.",http://resolver.kb.nl/resolve?urn=ddd:010925540:mpeg21:a0017:ocr,4,ddd:010925540:mpeg21:p004,Leydse courant,1222
577212,1861/06/01 00:00:00,618,ddd:010252671:mpeg21:a0022,http://imageviewer.kb.nl/ImagingService/imagingService?id=ddd:010252671:mpeg21:p004:image&x=1952&y=85&w=934&h=618,ddd:010252671:mpeg21,2886,703,1952,85,4,(4272) Tegen L Augustus e. k. wordt gevraagd lemand van ongeveer 30 jaren van de K. K. Godsdienst  om toezigt. te houden over Jonge Kinderen handig in het VVollennaaijen en Strijken  en goed kunjnende omgaan met de .Wasch. Adres franco brieven letter M. bij den Boekhandelaar A. M. van Dijk  te Delft. (4228) Tegen 1 Julij 1861 wordt er in--de gememeente Tubbergen provincie Overijssel een Hoofdof Hnlp-Onderwijzer gevraagd ; op eene jaarwedde van-ƒ3OO met vrije Woning en Tuintje om aan het hoofd der School te Vasse geplaatst te wordeu. Adres met franco brieven voor 15 Junij e. k. aan de Burgemeester der gemeente.,http://resolver.kb.nl/resolve?urn=ddd:010252671:mpeg21:a0022:ocr,4,ddd:010252671:mpeg21:p004,De Tĳd : godsdienstig-staatkundig dagblad,934
744095,1861/11/06 00:00:00,913,ddd:010981186:mpeg21:a0062,http://imageviewer.kb.nl/ImagingService/imagingService?id=ddd:010981186:mpeg21:p004:image&x=2624&y=1538&w=815&h=913,ddd:010981186:mpeg21,3439,2451,2624,1538,6,"Openbare Verkooping VAN RIET- ei BOUTGEWAS YPEBOOMEN E* _Hf VIKIII XIV(; van Wei- of Grazerslanden. .. DIJKGRAVEN en HOOGHEEMRADEN jj; Grondheerlijkheden Charlois en Katendref' zijn voornemms om op Vrijdag 15 November l*- J dts voormiddags ten 9 ure ten overstaan vat> « Notaris H. S. VAN RIJSO ORT residerend*! Charlois ten Huize van A. van Gent won'™ aldaar te Verkoopen: U 83 zware YPEBOOIffEIV staande »»"" * Charloische en Hooge en I.age Dijken en K»J'j drechtschen Dijk- voorts eenige Bunders te staand RIET Vierjarig .Vilden «ÏRIEM. HIJS Veertienjarig ELSGÉWAI enjj Koopen Vierjarig V. 11 gen HO OFHBTOV* RIJS. Verder te Verhuren: O Bunders W&'J] «RAZERSEAWDEIV DIJK en MA»8' Informatien te bekomen bij den Rentmeester.",http://resolver.kb.nl/resolve?urn=ddd:010981186:mpeg21:a0062:ocr,4,ddd:010981186:mpeg21:p004,Rotterdamsche courant,815
2643048,1861/03/06 00:00:00,4808,ddd:010545992:mpeg21:a0016,http://imageviewer.kb.nl/ImagingService/imagingService?id=ddd:010545992:mpeg21:p003:image&x=103&y=91&w=1922&h=4808,ddd:010545992:mpeg21,2025,4899,103,91,6,"*_* Wordt gevraagd ecu SCHILDERS-KNECHT of JONGELING  liefst P. G. met Kost en Inwoning. Salaris naar bekwaamheid vervoege zich bij A. J. SCHONEVELD te Warmond. *„* Men vraagt om dadelijk in dienst te treden een' allezints bekwamen KLEERMAKERS - KNECHT. Adres met franco Brieven onder Lettr. M. bij de Heeren JOHs. NOMAN&ZOON Boekhandelaars te Zalt- Bommel. MEN VRAAGT: EEN ASSOCIÉ. kunnende binnen 1 a 2 maanden f {-0000 beschikbaar stellen zijnde voor eene zeer Winstgevende Zaak waarin hij voor 1/3 DEELGENOOT wordt De Vennootschap aangaande wordt hij onmiddelijk Eigenaar van VASTE GOEDEREN  als : Landerijen  Branderij Brouwerij Molens heerlijke Huizing enz. minstens J5O pCt. meer aan waarde als zijn ingebragt Kapitaal zoodat de Zaak zeer soliede is. De ligging is in' een der gezondste eu aangenaamste Streken vm_ Duitschland. Adres met franco Brieven onder het Nommer 2853 aan het Advertentie Bureau van 11. NIJGH te Rotterdam. V Een KLEEBMAMERS-KNECHTTzïjnwerk goed verstaande en voor ecu jaar vast werk begeerende vervoege zich zoo spoedig mogelijk in persoon of met franco Brieven onder Lett5. V. 8. aan het Hulp-Kautoor te ""Winkel N.-H. *** Op een Salaris vau ƒ 2üU 'sjaars wordt voor twee Kinderen beneden de 10 jaren Jongen en Meisje gevraagd: Eene GOUVERNANTE. Vereischten zijn : grondige kennis der Fransche en Hollandsche Taal Rekenkunst Piano en Vrouwelijke Handwerken vooral vlug Fransch spreken. Adres met franco Brieven onder Letters M. H. bij den Boekhandelaar J. J. KOOREMAN te Leyden. V Eene JUFVROUW^ van Prot Godsdienst en van middelbaren leeftijd zag zich gaarne ten spoedigste geplaatst in eene betrekking van Huishoudster of Kamenier of wel de zorg voor Kinderen op zich te nemen. Adres met franco Brieven onder Letter D. bij de Boekh. J. W. van LEEUWEN Breedestraat te Leyden. *** Eene fatsoenlijke JUFVROUW P. G. omstreeks 30 jaren oud wenschte gaarne dadelijk of later geplaatst te worden als Jufvrouw van Gezelschap of Huishoudster. Zij is zeer goed bekend met de fijne als andere Kookkunst kan netjes de natte en drooge Wasch behandelen Naaijen Mazen en Dameshandwerken verrigten enz. Adres met franco Brieven gemerkt N°. 103 aan de Boekhandelaars A. van HOOGSTRATEN en ZOON te 's Gravenhage. %* Eene JUFVROUW van goeden huize Prot. Godsd. en middelbaren leeftijd zag zich gaarne weder geplaatst ter besturing of assistentie eeuer Huishouding of ook tot Gezelschap verlangende slechts eeue fatsoenlijke behandeling boven Salaris .\dres met franco Brieven onder N°. 102 bij de Boekhandelaars A. van HOOGSTRATEN en ZOON te 's Gravenhage. *#* Men zoekt gelegenheid bij Burger Lieden tot het plaatsen van een fatsoenlijk MEISJE  hetzij ter opleiding voor eene Bewaarschool of voor Huisselijk- en Naaldwerk  liefst tegen half Maart of April a. s. Opgave van Conditieu franco onder Lrs V. V. bij den Boekhandelaar A. H. KANTE te 's Bosch.",http://resolver.kb.nl/resolve?urn=ddd:010545992:mpeg21:a0016:ocr,3,ddd:010545992:mpeg21:p003,Opregte Haarlemsche Courant,1922
8366116,1861/12/06 00:00:00,5245,ddd:011061007:mpeg21:a0006,http://imageviewer.kb.nl/ImagingService/imagingService?id=ddd:011061007:mpeg21:p001:image&x=65&y=132&w=3180&h=5245,ddd:011061007:mpeg21,3245,5377,65,132,4,"r:~YENDÜTIÉ.~~ Op een nader te bepalen dag in den loop dezer maand in het vendulocaal I van D. D- VAM BÖECKHOLTZ Toor rekening van de heeren mmii&.&©« ..... ■ Van de volgende pas aangebragte goederen als : B»Bt»V«Slf5""« bestaande uit! ZALM ZUREN SAUZEN GEROOKTE HARING I MOSTERD JAMS & GELEYEN BESCHUIT en WIJN! AZIJN. ENGELSCHE PORTER in heele en halve fiesiclien  PALE ALB. Diverse seorten WMMEX als: MvDEIRA RDIJNWIJN van diverse merken. ! ROOD E WIJN van k'oede qualiteil. ; PUIKE CHAMPAGNE. j GEMBER WIJN. i COGNAC. RONDE en VIERKANTE KARPETTEN. ALCATIEVEN OMSLAGDOEKEN met nagemaakte tijger vellen WITT-1; en GEKLEURDE HEMDEN. MODEWAREN JAPONNEN etc. i NAGEMAAKTE BLOEMEN. I GEKLEURD 'FLANEL. j HANDDOEKEN GOED. ■ LINNEN en KATOEN DRILL. ; BROEKEN GOED. | BORSTROKKEN. ! KLAMBOE GOED. i SERVETTEN GOED lang 12 ellen. j WITTE ZAKDOEKEN. ! LAKEN. j WIT en GEKLEURD KAMERDOEK. ! NAGEMAAKTE BATTIKSARONGS en SLENDANGS» j CHITZEN. ! WITTE KOUSEN sn SOKKEN. I ! ENGELSCHE WAGENTUIGEN voor 2 en 4 PAARDBN waaronder geschikt voor Syilney paarden. I BENDYTUIGEN. i ZADELS. ! IMITATIE LEDER. i | GROOTE SPIEGELS met vergulde lijsten. REVOLVER PISTOLEN in kistjes met toebfhooren I MESSEN en VORKEN waaronder van pleet. GROOTE ZAGEN. ! PATJOLS. ! HOEPEL IJZER. KLOKKEN met en zonder wekker* 8 dagen loopende. HANGLAMPEN met KRISI ALLEN VERSIERSELEN KANDELAREN enz. enz. enz. Daags 4e voren te b?zig-fgen. NB. Op deze vendutie mogen geeue goederen bijge» . brsgt -order». (I93fi) Op ccn «ader te bepalen dag zal krachtens rogtcrlljkc magtlglng cu volgens plaatselijk gebruik worden» verkocht : «Ie lading MACHIAEI(IE.\ uit de gerenommeerde fabriek van H. O. ROBIÏÏSON & CO TE Xj.o:o.ctLQ:ra. vau daar aangebragt per het Nederlandjcke Brikschip Rlsijnvls E'eïtli kapitein A. F. LiMMERTS bestaande uit: 1 STOOMMACHINE van 12 PAARDENKRACHT met TUBULAIRE KETEL; 2 OLIEMOLENS. HYDRAULISCHE PERS met POMPEN fcompleet). 3 IJZEREN vlotten en diverse gereedschappen voor de opzetting. verder-j 33340 HOUTEN SIRAPPEN met de noodigc HOUTWERKEN. 48000 METSELSTEENEN KOOPMANSCHAPPEN  BALKEN PROVISIES nieuwe MEUBELEN enz. enz. enz. Inlichtingen te bekomen ten kantore van den procureur Mr. Kooiman in de chii eesche kamp te Soerabaija. (1824) VICmTBEUK VAM STOOMSCIIEPEMt. Vertrekdagen der Stoomboot | Ujdli JaÜaiJaLJÉt ur re*»» Kaïiitciii S. VAN nULSTIJX gedurende de maand December. fan Bataiia naar S.u:i. en Socrabnya sen 20 Dfc. ~ Satnavang „ Socrabaya 8„ 23 „ „ Socribaya „ Mam. en Batavia 12 „27 „ „ 8a ui ara ti j „ Batavia 11 „29 „ i Le Agenten (ini9) dö go. I _ _ __ _ „ j STMttIVAAKT | Langs de Ko'ordkust van Java. j HRr*"" Gedurende do maand December; tS&ïf'c 'vertrek der stoomschepen van Soerabvïa '' via Samarang naar Batavu bepaald op <lcu 7de» 15ilcn 33stca ea 39steu. Adres bij (1917) w. cossks e>e irutiKH. BET'STOOMSCHIP RÏACASBAR. i R""v 5 » j ■■'."" V' Jfifia&gJrV; ; kapitein lïicrinjjs. Vertrekt BSfttavi.l via £»:;iti:)rniag Op Zaturdag den rdfn Decetitber. Adres bij . j (191 C) COïCE? Ö3R VBSHJFS. | De Stoomboot Kraton^ Gezagvoerder MART^NS 1Rïo I v.-.-'V'V-' .v ver-trekt naar S*roJ>;»""hi.'|o en Eiczockic op Z ndt>Q den S.?v« December  en van SSczockic ovrr Sumanag» en EErnnta i naar §OCi*a3>:)3ja. Op IFoettS'lag den Wden Dceemltr. Adres bij (IP27) w. o>2:3<;s uit. vans-:.*». Fe bekomen aan het IJSIIUIS van A. 11. Dkelïmak j legen 10 cent het pond. I Het IJSIIUIS zal van des morgens f) tot 12 \ en des namiddags van S tot 0 ure geopend zijn. (1893)",http://resolver.kb.nl/resolve?urn=ddd:011061007:mpeg21:a0006:ocr,1,ddd:011061007:mpeg21:p001,"De Oostpost : letterkundig, wetenschappelĳk en commercieel nieuws- en advertentieblad",3180
1981694,1861/04/09 00:00:00,2197,ddd:010079279:mpeg21:a0013,http://imageviewer.kb.nl/ImagingService/imagingService?id=ddd:010079279:mpeg21:p004:image&x=1022&y=69&w=902&h=2197,ddd:010079279:mpeg21,1924,2266,1022,69,4,DE NOTARIS 8. A. »lfWilt te Js IIEnTOGENRoscn. gal over het Saizoen dezes jaars in het Openbaar VJKKPACHTJBÏIf: Op Dingsdag den 16 April 1861  des voormiddag» ten 10 ure ten Huize van G. SMITS te Lil/i: 70 Wei scharen op de Uiterwaarden den Marenschen Waard van Z. E. den Heer Luitenant-Generaal Ridder DE STUERS; bet Marcnscb Oord van Jonkheer Mr. E. J. P. VAN MEEUWEN en de Kesselscbe Bergen van Mevrouw de Wed. 11. F. VERMEULEN. Voorts nog: 35 Bunders Bouw-en Weilanden  gelegen in de Polders onder Alem Maren Kessel Alphen en Lith. Tenzelfden dage des namiddags ten 3 ure ten Huize van 11. R VAN LAMOEN aan de Blaauwe Sluis ie Gewande onder Maren: 26 Weischaren op het Landgoed den Middelwaard van Mevrouw de Wed. A. SMITS. firn®*. En daarna VERKOOPEN: Igtifi§| 20 Stuks opgaande Wllgen-Boo>_j|sfc _j| men eenigc Knootwilgen en eene partij één- en tweejarig BandllOllt alles in Koopen afgesmet en slaande op voormeld Landgoed de Middelwaard en eindelijk eene Roeiboot met Tocbehooren ; deze laatste daags te voren te bezien bij J. VAN MIL te Alem. Op Vrijdag den 19 April 1861 des voormiddags ten 9 ure . ten Huize van J. J. VAN LITH te Empel VERKOOPEN : 60 Ypcn-Boouien eenigc Wilgen- Booiueu en eene aanzienlijke hoeveelheid 2 en 3jarig Waarden- en Wilgcn-Schaarhout alles staande op bel Landgoed Castcrenshoef aar. de Maas onder DrieL Tenzelfden dage. des namiddags ten 2 ure terzelfder plaalse  VERPACHTEN : 42 Bunders Weiland en 50 Weischaren  allen gelegen op de Uiterwaarden van het Landgoed Caslerenshocf. Alles bij gedrukte Biljetten broeder omschreven. Nadere Inlichtingen zijn te bekomen bij de Waardsmannen in loco en ten Kantore van den Notaris BIJT VOET voornoemd.,http://resolver.kb.nl/resolve?urn=ddd:010079279:mpeg21:a0013:ocr,4,ddd:010079279:mpeg21:p004,De Noord-Brabanter : staat- en letterkundig dagblad,902
8603925,1861/04/26 00:00:00,4498,ddd:000014476:mpeg21:a0022,http://imageviewer.kb.nl/ImagingService/imagingService?id=ddd:000014476:mpeg21:p004:image&x=39&y=459&w=2074&h=4498,ddd:000014476:mpeg21,2113,4957,39,459,6,"UITLOTING. De BURGEMEESTER tau""\OMMEN doet te weten : dat heden zijn uitgeloot om op 1 Augustus aanstaande ten Kantore van den Gemeente-Ontvanger van Ambt Ommen te worden afgelost legen overgifte der Obligatiëu en Onverschenen Coupons  TWEE Aandeelen  ieder groot / 300  der geldleening ad ƒ 12000 ten behoeve van den Kunstweg van Ommen naar Goor (1"" Sectie) en wel de Nummers Vijf' en Acht en Dertig. Ommen den 23 April 1861. De Burgemerster voornoemd  A. C. BOUWMEESTER. De Notaris van der HIESEN zal op Dingsda; den 30 April 's morgens om 9 uur ten huize van KLAAS VERMEULEN op het Eiland te Zwolle publiek verkoopen : Allerhande MOÜILAIRE GOEDEREN Beddegoed  Zilver en wat verder zal worden voorgebragt. Te bezien Maandag te voren van 's morgens. 10—12 en 's middags vnn 2—5 uur. De Notaris van der BSMESEA' zal op Dingsdag den 7 Mei 's middags om 12 uur in ODEON te Zwolle publiek verkoopen : Een Huis eu Ert' slaande en gelegeu in den MBreedehoek te Zwolle bewoond door de Weduwe VOLKERS Kad. Sectie F. No. 3145 Huis Erf en • Gang groot 38 ellen. Staande op / 125. Nadere informatiën ten Kantore van den Notaris. W. SWAM Notaris te Gramsbergen zal op Woensdag den 8 Mei 1861 ten huize van den Logementhouder A. TEN •KATE aan de Dedemsvaart doen inzetlen en 14 dagen later aidüar publiek verkoopen : ¦ Een ¥EEIVSLAG J$SsS£S&. gelegen aau de Dedemsvaart Gemeente Ambt Uardenbergh naast en aan de west- I zijde van de Kerk en Pastorie der Her«S^^-^gl WtiSjfc vormde Gemeente van Luiten groot 2 Bunders 85 Roeden en 90 Ellen. Nadere informatiën zijn te bekomeu ten kantore van den Notaris terwijl de aanwijzing zal geschieden door ALBERT ODINK  Kastelein aldaar. Mr. C. W. van I>EDEM Notaris te Nieuwleusen en Avereest zal op Maandag den 29 April 1861 des morgens om 9 uren ten huize van HENDRIK BOERMAN te Nieuwleusen publiek verkoopen: y-j. Een Paard  6 Melkbeesten  3 Pinken #a %—'<ff~ 2 Kalveren eene Motte met 9 Biggen  fiXjrjiCT ir£*\^ 40 Schapen  Ploeg  Egge Kam eu -%..£*& 1 ' verder Bouw- en Melkgereedschappen  Graan Aardappelen en Huismeubelen en hetgeen meerder zal worden voorgebragt. Mr. «E W. vau DEDEM  Notaris te Nieuwleusen en Avereest zal op Woensdag den 1 Mei 1861 des namiddags te één ure ten huize van F. BOTERMAN aan de Dedemsvaart doen iuzetten en acht dagen later ler zelfder uur en plaats publiek verkoopen : jjj Een EEuiS en Erf met drie Woj/[i: —\ ningen  staande en gelegen in de nÊÊ Markte Arriën gemeente Avereesl aan de iHfIJI lange of Kruisinga's wijk in de nabijheid IBBRHS ter Kerk > waarin sedert jaren tPiS^L—L^.^' lëiV Winkel etl Bakkerij is uitgeoefend en mm 9n*ma**a**mm*MW laatst bewoond door de Wed. G. DORGELO. Kadastraal hekend Sectie D No. 953 groot 5.40 en No. 954 groot 27.50. Dadelijk na de toewijzing te aanvaarden. Nadere informatiën ten kantore van voornoemden Notaris. Mr. C. W. van BIEDEiTfi Notaris te Nieuw lt uut n en Avereest zal op Donderdag den 2 Mei des morgens om 11 uren ten huize van W. BRINKHOF te Dalfsen doen inzetten en 14 dagen later ten huize van D. J. van KUIK aldaar ter zelfder ure publiek verkoopen leu verzoeke der Erven SCHONEMEIJER: Jpt -6^ v 1. Drie akkers £.and —s»»i»__-.ijl /fA to op deKronenbirgskamp in Sectie K. No. 864 groot 11.70 en No. 863 groot 5.80. 2. Een Stuk Weidclaaid met den daarom geleden ISosrhhCg No. 854 groot 1.57.90 eu No. 848 groot 42.80. 3. Een Akker Zaailand in de voorste Mars No. 842 groot 14 Roeden. 4. Een Sluk JLand gelegen bij den Oostermolen No. 800 groot 20.60. 5. Een Akker Zaailand op den Pleijeudaal No. 1124 groot 17.20. 6. Een Akker ILand achter Pleijendaal No. 1116 groot 7.80. 7. Een derde aandeel in eene Grondrente te Garner. 8. Vier Zitplaatsen in de Hervormde Kerk. Alles gelegen in de gemeente Dalfsen. Nadere informatiën ten kantore van voornoemden Notaris  en bij de gemelde erfgenamen  die de aanwijzing doen. De Notaris -I. MLlJLï&'h te Kuinre zal op Vrijdag 3 Mei e. k. 's middags 4 uren ten huize van J. GOLS aldaar publiek verhuren : %<:\lËk 1M Wheer aclder de Kerk' groot I - 2.29.10; _/||lJ|L_ de Pels groot B. 7.70.10 iv 3 perecelen; j^laP^lj-SJlBi het Zuiderwheer groot B. 4 06.70; de Dijkstal groot B- 3.49.00; het Rietstuk groot B. 4.67.20; Landerijen gelegen in den polder achter Kuinre en de Lange Kamp in het Rondebroek groot B. 2.28.80; alles teu verzoeke van de Weduwe MEINE MEINEN. Voorts het Zielwheer van den Heer J. J. HARTMANN groot B. 2.27.50 het Halve Zielwheer van den Heer POSSE groot B. 2.01.05 de lleerenskamp yan de Weduwe L. KROES groot B. 4.33.30 en de 10 Mat van H. DONKER groot B. 6.90.80 ; alles mede in den polder achter Kuinre gelegen. De Notaris Jt. JIEUl.ft 614. te Kuinre zal ayAVoensdag 1 Mei e. k. 's morgens 11 uren ten huize van J. GOLS aldaar ten verzoeke van den Heer J. E. SLOT publiek verhuren : ij./.j De Meente groot B. 7.76.00; de 10 Mal —JwJ*-^. groot B. 6.69.30; de 9 Mat groot B. 5.79.90; P^:i 't ¦'• ' ¦.""-¦•'¦""s het Zu-anewheer groot B. 3.67.10; hel Wheer achter de Kerk groot B. 2.7-.50 ; alle Landerijen gelegen in den polder achter Kuinre. De Notaris H. JONKERS te den Ham jp7«55S?SP«Ste_ b""e;""t. bij dezen ter kennis van de belang- Bb hebbenden  dat hij van af Woensdag den ckiV~ >'° •dpH 1561 en vervolgens telken week op dieu dag Zitting zal houden ten huize van den logementhouder JAN WILLEM MEIJER op HET PONT VAN SEPARATIE aan het Almelosche Kanaal alwaar hij in zijne betrekking voor een ieder zal te spreken ziji. ERPHUIS. De Deurwaarders WKTELIIH en van OORSCHOT zullen op Maandag den 29 April e. k. des morgens om 10 uur ten huize van de wed. GERRIT van LEÜSEN op DEN BOTHOF voor de Diezerpoort alhier publiek Verkoopen: .„... . 6 guste- dnigtige- en nicuwmelkle K""""-'p»\ TpHRw Koeijen  eenig Hooi Ploeg  Eggen -pOEEJL 'jjij en verdere Bouw- en Melkgereedschap- JHl=gg peneene partij Mest eene Seliuur voor afbraak diverse fleubeleu  waaronder Kabinet Stoelen Tafels Klok Ladetafel Koper en Tin Bedden en wat verder zal worden voorgebragt. Te bezien Zaturdag te voren van 10—12 en van 2—5 uur. GRAS. Op aanstaanden Woensdag 1 Mei des middags te 13 uur zal door de Deurwaarders 'VOa.TELfl^-E-. en van OOEISCfifiOT ten huize van den Kastelein BOS buiten de Sassenpoort worden verkocht : Het GKASGE.WAS behoorende arm de Markte van Assendorp  in zoodanige perecelen als door den Landbouwer G. BELT zal worden aangewezen. Bij J. H. BROEKRÖTGER Groote fCerkflOlT ontvangen de nieuwste Modellen van Mantels» Hf antilies. alsmede Omslagdoeken Parasols en Fautaisie Stoften. LEES UIEU. f^^jSSSto Tegen hoog loon kunnen eenaantal Sj> AISIïEIDEKS werk bekomen aan de i*I*-----» Dedemsvaart waar gebrek aan Arbeï"" ders bestaat. ""PTïCll. COHEN Tandtneester aan liet Instituut voor Doofstommen te Groningen Kunstliuideti en Gebitten-vervaardiger eu van alle tot du» verre uitgevondene Mechanieke Mond-hulpmiddelen naar de beste Fransche uitvinding iq gelogeerd alhier in het MONSTEJtSCIJE POSTIIUIS'op dè~n Dijk aanstaanden Maandag Dingsdag en Woensdag tot 's namiddags 2 uur. UIT DJ-fHANB TE KOOP: -_ een voor korten tijd nieuw gebouwd zeer net M betimmerd Woonhuis met twee beneden en twee boven Vertrekken. Franco te bevragen bij M. ue GROOT Timmerman te Zwolle. UIT D£ HAND TE KOOP: /&*?> een Sluis staande op een der beste standen te 4i'Vfj Zwolle geschikt voor alle Affaires en vooral als Woning |]4^.b! voor Tapper Slager Winkelier of Bakker. Jaren lang is er veel nering in geweest en thans is het door omstandigheid onbepaald te aanvaarden. : om dadelijk te aanvaarden door vertrek naar Elders: <»-gS3a-j|& Een Wooni.uis  beslaande uit drie BElJjïïKff NEDEN- en drie BOVENKAMERS KEUKEN RpSfeylÉ ZOLDER KELDER met WEL- en KEGEN- BtfAW WATER en desverkiezeude een stuk Tciiilgroild  staande en gelegen in het Dorp Wijhe arm de Langestraat te bevragen bij den Notaris JACORSON aldaar. Brieven franco. TïTHUUR: Op den IBarssenbergïnSpoolde i Een BUITENTJE SrfwWnK met ttvee groote en twee kleine KAMERS benevens KEUKEN voorts KOEPEL en Tuiutje met eenige VRUCHTBOOMEN. Huurprijs f 15Q.",http://resolver.kb.nl/resolve?urn=ddd:000014476:mpeg21:a0022:ocr,4,ddd:000014476:mpeg21:p004,"Provinciale Overĳsselsche en Zwolsche courant : staats-, handels-, nieuws- en advertentieblad",2074
624338,1861/01/16 00:00:00,814,ddd:000010016:mpeg21:a0031,http://imageviewer.kb.nl/ImagingService/imagingService?id=ddd:000010016:mpeg21:p003:image&x=3241&y=4391&w=767&h=814,ddd:000010016:mpeg21,4008,5205,3241,4391,4,(794) De Ondergeteekenden betuigen hunnen welmeenendon dank aan die ingezetenen van HJlegertberg die op hunne uitnoodiging hebben willen bydragen tot le_i_.i_-g d*.r rampen ontstaan door doorbraken in dan fraai uil«rmmraT. Hot bedrag »d f 110 is heden venonden asn den Wel Edelen Heer H. W. A VAN OOBDT te Rotterdam. Wij nemen de vrijheid te berigten dat wy voort zullen gaan met het in Ontvang peme.n tan alles wat men ten behoevo der OngelnkiTfwn zsl willen afzonderen ten wier behoeve de Milddadigheid in dit barre janrpetyde met ni'lru--wordt ï geroepen. _T-le.iri.er. O A. VAN DEN BERG. 15 January 1861. J. H VAN MIEROP. (744) Bij den Bcok- en Kunsthandels-r 0-_M_._i-.JiEL  Steiger Wyk 7 N°. IM te Botterdam IS EEreE I-U-. geplantst ten behoeve van cieÜV-CXljJile-ttioil door den WATEF_SjYOOI-.,http://resolver.kb.nl/resolve?urn=ddd:000010016:mpeg21:a0031:ocr,3,ddd:000010016:mpeg21:p003,"Nieuwe Rotterdamsche courant : staats-, handels-, nieuws- en advertentieblad",767
1885500,1866/11/26 00:00:00,2250,ddd:010390023:mpeg21:a0042,http://imageviewer.kb.nl/ImagingService/imagingService?id=ddd:010390023:mpeg21:p005:image&x=902&y=2777&w=838&h=2250,ddd:010390023:mpeg21,1740,5027,902,2777,6,4J pCk HYPOTHEEK-OBLIGATIEN. AFLOSSING. Het -B EST U U R van de Nederlandsche Hypotheekbank berigt dat hare SCHULD-. BRIEVEN opeischbaar den laatsten No -moer 1866 met de tot op dien dag sedert den laatst vervallen Coupon verschuldigde Rente betaald worden op Zaturdag den 1 December 1866 en volgende werkdagen ten Kantore van de Ontvang- en Betaalkas te Amsterdam en verder bij de Hoofdagenten van voornoemde Bank. NB. Te Rotterdam bij H. C VOORHOEVE & Co. BAZAR van het Botterdamsch Engelsch Trouwen - U-ulpgenootschap voor In- en Uitwendige Zending op DINGSDAG en WOENSDAG 27 en 28 November van des middags 12 tot de:* namiddags 4 ure in de Zaal Verscheidenheid en Overeenstemming. Hoogst aangenaam zal het aan Bestuurderessen zijn met een talrijk bezoek vereerd te mogen worden. Bij Notariële Akte van 21 November 1866 is door «le Erfgename van wijlen den Heer JOHAN FREDERIK KIPS in leven Koopman in Thee te Rotterdam aan den Heer WILLEM VAN RAM Adrianug Zoon aldaar toestemming verleend om die Zaken voor zijne rekening en risico onder de Firma J. F. KIPS voort te zetten  zonder dat gezegde Erfgename of bare ï egt\erkrijgenden daarvoor immer aansprakelijk zullen zijn. De Vereeniging _UÏ_A.S zich ten doel stellende de bevordering van het Schüdersvak LOOFT UIT verschillende PRIJZEN voor het op een bepaalden tijd vervaardigen en inleveren van do beste Proeven van Hout en Marnier Nabootsing en van Penseelschrlft. Alleen die Werklieden welke hij of voor de Leden der Vereeniging werkzaam zijn hetzij als Knecht als Leerling of Zoon mits deze geen Vennoot is zullen tot de mededinging worden toegelaten. Inlichtingen Programma en Voorwaaiden zijn te bekomen bij de Leden der Vereeniging. Namens de Vereeniging Lukas B. VAN DE LAAR Voorzitter. J. JANSEN 2de » T. SMIT Penningmeester. W. GIEBEN. Commissaris. H. VAN AMEYDENVANÜUYM Secretaris. Messrs. KVFAL & DV&KLL Bambo-urg demandent de représentcr dans cette vil Ie et pour tont le Nord une Malson Hollandaise en tTlanelle et en Cuir de JLaine. S'adresser directement.,http://resolver.kb.nl/resolve?urn=ddd:010390023:mpeg21:a0042:ocr,5,ddd:010390023:mpeg21:p005,Rotterdamsche courant,838
2053683,1866/11/27 00:00:00,1319,ddd:010113566:mpeg21:a0064,http://imageviewer.kb.nl/ImagingService/imagingService?id=ddd:010113566:mpeg21:p005:image&x=21&y=1620&w=1557&h=1319,ddd:010113566:mpeg21,1578,2939,21,1620,6,"KIESVEREENIGING fe VOOR DE Uier van koophandel ei fabrieken. dier fc de heden gehouden Vergadering zijn tot C/ANDIDATEN voor het Lidmaatschap ""banier gesteld de Heeren: F. J. PLATE L. W. SCHöFFER G. TAN STOLK H. KERDIJK J. C. BURLAGE W. BUNGE Fz*. Mr. M. MEES G. H. MEES g C. W. HOYACK A. MILDERS als zoodanig worden aanbevolen. ? Rotterdam E. A. VINK l. Pres. --ü_£ovember 1866. (18553) J. L. DE BIE l. Secr. *>ebb5eui8e KIEZERS voor LEDEN der Hamer van Koophandel en Fabrieken """"«aki-1 ¦""aei bevreemding bemerkt dat onder de Candidaten voor het Lidmaatschap dier Kamer opge- v°ort m dc Vergadering der Kiesvereeniging op 17 November 1866  van de aftredende Leden niet ""eed» ude Heereu F. C. DEUTZ EKELLNG en D. 11. A. KOLFF welke beide Heeren dW met ijveren kunde de belangen van den Handei in die betrekking hebben behartigd. Zij nemen ""aJve de vrijheid de volgende Candidaten voor te stellen: W. BUNGE FZn. H. POLAK KERDIJK J. C. BURLAGE Mr. M. MEES P. C. DEUTZ EBELING F. J. PLATE C. yf HOYACK L. W. SCHöFFER D. H. A. KOLFF G. VAN STOLK hunne Mede-Kiezers dringend aan te beveien. (18897'",http://resolver.kb.nl/resolve?urn=ddd:010113566:mpeg21:a0064:ocr,5,ddd:010113566:mpeg21:p005,"Nieuwe Rotterdamsche courant : staats-, handels-, nieuws- en advertentieblad",1557
3896585,1866/09/28 00:00:00,3839,ddd:000018659:mpeg21:a0018,http://imageviewer.kb.nl/ImagingService/imagingService?id=ddd:000018659:mpeg21:p002:image&x=2140&y=1160&w=1015&h=3839,ddd:000018659:mpeg21,3155,4999,2140,1160,6,"SCHOUWBURG ODEON TE ZWOLLE Salon des Variétés DILIGENTE ONDEII DIRECTIE VAN IiOITIS «OUWIvIEESTEBt & Co. [ DINGSDAG 2 OCTOBER 1866. \ Croot beroemd drama in vijf bedrijven ; naar het Fransch (la Mendiante) hetwelk te Parijs met \ den eersten prijs is bekroon!. v Muziek van den heer d. lauondelle. (Nooit alhier vertoond) TOT SLOT: De zangzieke Behanger Vaudeville 'in één bedrijf waarin door den heer EDUARD BAMBEÉG nieuwe I Chansonnettcs en Politieke Coupletten1 zullen gezongen worden. Aanvang 7 uur. PRIJZEN DER PLAATSEN : Loge f 1.25. Balcon en Parterre ƒl. 2e Rang ƒ0.60. 3e Rang ƒ 0.30. HH. militairen beneden den rang van officier en kinderei beneden 10 jaar half geld. <0"" De plaatsen ziju te bespreken op den speeldag a il cents de verhuurde vau 9 tot 11 uur en de ove' rigen van 11 tot 2 uur. BEKIGX. Op de dagen van uitgifte dezer couraft gelieve men de advertentièn die men des avonds verlangt gt plaatst te zien vóór des middags 12 uur in te zenden. TTrOTTTTTirTTT^. HULFONDËRWIJZM. ':%___»_ Men verlangt in de gemeente Slcd AlmeU Ü^^ een BIULPOIIDEK WIJZER aal jÈkIT de Openbare School voor Lager Onderwijs. op eene jaarwedde van driehonderd en vijftig- gulden. Belanghebbenden worden uitgenoodigd zich met franct brieven onder overlegging der vereischte stukken vóór del 1 October e. k. aan te melden bij den Burgemeester diel gemeente. Stad Almelo 20 September 1866. C. FARRET. J Bij vonnis van de Arrondissemenst regtbank te Zwolle iQ 19 October 1865 in hooger beroep bevestigd en waarval de cassatie is verworpen is: JaooD Davïdson oud 29 jaren van beroep koopman geboren te Beverwykl wonentie te Zwolle ter zake van enkele bailKbreuW veroordeeld tot eene gevangenisstraf van twee maanden  ""1 eenzame opsluiting te ondergaan c. e. des noods exeeutab.l bij lijfsdwang met last dat van het vonnis aanplakkin schieden zal aan het gebouw der regtbank en aankondiging in de Provinciale Ocerijsselsche en Zwolsche Courant. Zwolle 27 September 1866. De Officier van Justitie te Zwolle EIJB3ONIU3 WIOHERB. ]a^©_D_p©l-___""V\7'C>lS*Ö__.o Stoomboot- I^^^^^* Voor Passagiers en Vrachtgoederen. SHenstveranderiug' niet 1 October. Van MEPPEL des morgens half zeven uur. „ ZWOLLE des namiddags drie uur des Vrijdags van Meppel een halfuur vroeger om tijdil op de markt Ie Zwolle te kunnen zijn. In directe weder keerige verbinding met de Diligences op Vollenhove Blok\ zijl Steenwijk en Hoogeveen en in correspondentie met de W ligences op Groningen Veendam Assen enz. met den spooH weg op Wijhe Deventer Zutphen Elburg Hardt Utrecht enz. enz. TEITVIERING TB WIJHËT OP AANSTAANDEN MAANDAG DEN 1 OCTOBER 1866 BIJ GELEGENHEID DER OPENING VAN DEN SPOORWEG devexteh-xivoale. Ringsteken te paard. Vollcsvermakelijkheden. Vuurwerk van den Heer v. D. BUHGII te Amsterdam. Concert en Bal. Muziek van het geheele korps Stafmuziekauteu van hc' Insiruetie-Bataillon te Kampen. Aanvang: 's namiddags % uur.",http://resolver.kb.nl/resolve?urn=ddd:000018659:mpeg21:a0018:ocr,2,ddd:000018659:mpeg21:p002,"Provinciale Overĳsselsche en Zwolsche courant : staats-, handels-, nieuws- en advertentieblad",1015
1688236,1866/09/25 00:00:00,1258,ddd:010791403:mpeg21:a0018,http://imageviewer.kb.nl/ImagingService/imagingService?id=ddd:010791403:mpeg21:p006:image&x=1343&y=31&w=1342&h=1258,ddd:010791403:mpeg21,2685,1289,1343,31,12,3°. dat de biljetten  op zegel geschreven en voorzien van de namen der borgen in de voormelde bureaux bezorgd en gestoken moeten worden in de daarvoor bestemde bus uiterlijk des middags ten 12 ure van don dag dor aanbesteding en dat voorts omtrent al hetgeen verder bij het inschrijven op de bedoelde leverantien moet worden in acht genomen  de noodige inlichtingen bij de directien der hospitalen kunnen worden verkregen. 's Gravenhage den 6den September 1866. J. A. van den Bosch. RAAD VAN STATE. Oproeping van Relanghebbenden. De Minister van Staat Vice-President van den Raad van State Voorzitter der afdeeling voor de geschillen van bestuur roept bij deze naar aanleiding van art. 38 der wet van den 21sten December 1861 (Staatsblad n°. 129) en van art. 50 van het Koninklijk besluit van den 4den September 1862 (Staatsblad n°. 174) op de onbekende belanghebbenden om — zoo zij dit noodig achten — te verschijnen in de openbare Vergadering der afdeeling welke zal worden gehouden op Vrijdag den sden September 1866 des voormiddags ten elf ure waarin verslag zal worden uitgebragt in zake van het beroep van een besluit van Burgemeester en Wethouders van Leiden van 14 Mei 1886 waarbij aeri N. Messchaert Snellen do vergunning is geweigerd tot oprigting van een magazijn van beenderen in het perceel aan den Apothekersdijk  wijk B  n°. 13  te Leiden. De Minister van Staat Vice-President voornoemd Mackay.,http://resolver.kb.nl/resolve?urn=ddd:010791403:mpeg21:a0018:ocr,6,ddd:010791403:mpeg21:p006,Nederlandsche staatscourant,1342
801144,1866/08/30 00:00:00,716,MMKB08:000087683:mpeg21:a0009,http://imageviewer.kb.nl/ImagingService/imagingService?id=MMKB08:000087683:mpeg21:p004:image&x=6&y=3665&w=954&h=716,MMKB08:000087683:mpeg21,960,4381,6,3665,6,Advertentie TE KOOP: Een goed gedresseerde Jagthond 7 jaren oud bruin van kleur  half Engelsch ras. ® Te bevragen met franco brieven onder Letter M. bij den Boekhandelaar G. H. FESSER te Zevenaar. RAAGT terstond in de omstreken van HUUR : emeubeleerde Kamer en INWONING voor eene Jufvrouw dje. Adres met franco Brieven onder ST'GiJlriiijvJ. J- KLUIT Cz.  Boekh. Rotterdam.,http://resolver.kb.nl/resolve?urn=MMKB08:000087683:mpeg21:a0009:ocr,4,MMKB08:000087683:mpeg21:p004,Arnhemsche courant,954
3057939,1866/10/03 00:00:00,3061,ddd:010484534:mpeg21:a0008,http://imageviewer.kb.nl/ImagingService/imagingService?id=ddd:010484534:mpeg21:p001:image&x=3120&y=2933&w=999&h=3061,ddd:010484534:mpeg21,4119,5994,3120,2933,8,"(5828) Vendutie op Maandag 15 October 1866 in de Pakhuizen vroeger geoccupeerd door de Heeren J. LITTLE & Co. voor reken.ni. van belanghebbenden zonder reserve door IF\ Cassalette «fc 00. van 100 kn. Amerikaansche STOELEN waaronder keurige en nieuwe modellen. 20 kn. Fraaije AMEUBLEMENTEN. 3 „ ETENSTAFELS. 100 „ OESTERS a 2 doz. 1 pond blikken. 50 „ LOB3TERS „2 „ 1 „ id 7 „ FEACHES „2 „ 2 „ id. 8 „ QUINCES „2 „ 2 „ id. 3 „ TOMATOES 2 „ 2 „ id. 3 „ GREEN PEAS a 2 „ 2 „ id. 5 „ CRANBERRY JAM a 2 doz.. 2 pond id. '5 „ BED CURRENT JELLY a 2 doz. 2 pd. id. 5 „ QUINCE JELLY „2 „ 2 „ id. 2 „ CONDENSED MELK „4 „ 1 „ id. 2  „ KOFFIJ „4 „ 1 „ id. 4 „ PICKLES a l doz. in flesschen. 13 vaten VLEESCH. 14 „ SPEK. 100 kisten TERPENTIJN a 10 Galls. 100 vaten HARST. 300 vaten LOODWIT. 23 „ MEEL. 7 „ PILOT BREAD. 4 kisten KLOKKEN. 20 „ a 2 doz. 1 g CLAMB. 25 vaten Amerik. HAMMEN. 10 „ „ TONGEN enz. enz. (5827) 7jw»|j|ttjjgg^^ Met referte aan de annonce van 10 ||ER_ September zal de VERKOOP van de mr Stoomsteenbakkerij op Mentengf  alsnu aldaar plaats hebben op Woensdag den 17 October 1866 des voormiddags ten 9 ure zullende : 1. De STOOMSTEENBAKKERIJ met het Erf-pachtsregt Stoommachine met Larninoirs Loodsen Ovens Smederij Woonhuis voor Machinist en Boedjano-swouino-en 2. De 8 stuks PRAAUWEN. 3. De STOOMSLEEPSI.OEP. 4. De GEVORMDE STEENEN'eerst afzonderlijk en daarna gecombineerd worden opgeveild. Zullende verder worden verkocht • Waarloos IJZER en KOPERWERKEN BUFFELS ir at. REN MEUBILAIR RIJTUIG en PAARDEN n  n  E- H- BLETTERMAN. Batavia 1 October 1866. (5825) Op Zaturdag 20 October 1866 des morgens ten tien ure zal door tusschenkomst van het Veududepartement in deszelfs Locaal alhier worden verkocht: J_"" ui Tledll B^%°Ud' %ehZ™ binnen deze stad blok J deel Oostzijde sub numero 15 buurt of wyk Groot Rivier bij de verponding geregistreerd onder iNo. 3747 en getaxeerd voor ƒ 135 . *£ Ee£ *frf' beb°™<! met 'een Steenen WOONHUIS Paardenstal en Bediendenvertrekken allen met Pannen gedekt gelegen binnen deze stad blok J Oost sub numero 1 2 en 3  buurt of wijk. Stadhuisplein bil de verponding geregistreerd onder No. 371 en «refiiwJ voor/ 7100- beide behoorende aa_U p TENTÉE (677°) F. ALTING MEES.'",http://resolver.kb.nl/resolve?urn=ddd:010484534:mpeg21:a0008:ocr,1,ddd:010484534:mpeg21:p001,"Java-bode : nieuws, handels- en advertentieblad voor Nederlandsch-Indie",999
907060,1866/10/17 00:00:00,1085,ddd:010389935:mpeg21:a0041,http://imageviewer.kb.nl/ImagingService/imagingService?id=ddd:010389935:mpeg21:p004:image&x=2626&y=1912&w=836&h=1085,ddd:010389935:mpeg21,3462,2997,2626,1912,4,"L. L. JACOBSON Azn. en J. A. RUEB Makelatf' te Rotterdam als last hebbende van hunne Meestert zullen op Vrijdag den 19 October 1866 des voormid' dags ten elf ure in het Huis der Notarissen a»"" de Gelderschekade in het openbaar Verkoopen voor rekening van wien het moge aangaan: 52 Vaten GERAFFINEERDE SUIKER door zoetwater beschadigd alhier aangebragt v»» Amsterdam per het Schip tde Vrouw Maf* Antoinette"" Schipper C. J. van der Pluym. De Suiker is liggende op de Marinewerf en «lda»r daags vóór en op den Verkoopdag voor een iedef te zien. Nadere informatien bij genoemde Makelaars. JAVA TABAK- Veilingen te Rotterdam op MORGEN den 18 OCTOBER 1866 van onderstaande Partijen: BUtar 558 Pakket BB 19»  Wates ioa » KOTTA (in een langwerpige Zeshoek) 67? » M * A Hedlrle 716 » KS 381 » E«A BUtar 553 > .  **",http://resolver.kb.nl/resolve?urn=ddd:010389935:mpeg21:a0041:ocr,4,ddd:010389935:mpeg21:p004,Rotterdamsche courant,836
1898407,1866/10/23 00:00:00,2597,ddd:000024753:mpeg21:a0014,http://imageviewer.kb.nl/ImagingService/imagingService?id=ddd:000024753:mpeg21:p004:image&x=771&y=2963&w=731&h=2597,ddd:000024753:mpeg21,1502,5560,771,2963,6,"BIJ de Gebroeders van Cleef verschijnt heden: PARLEMENTAIRE STUDIES EN SCHETSEN | DOOR ÏP. GROEN VAN PRINSTERER. 3e Doel No. 3. INHOUD: Allerlei. — De oppositie tegen dit Ministerie te fel? — Antirevolutionaire politiek. — Een brief over Keuchenius. — Varia. (6986) Geleerde Blinden. VERWERPELIJKE KANDIDATEN BIJ DE KEUS VAN VOLKSVERTEGENWOORDIGERS aangewezen (6983) door ZU*. O"". .EIAT iT ¦<__>¦ PRIJS f 0.25. Wordt uitgegeven bij van Weelden _fc Mtngclcn en is alom verkrijgbaar gesteld. Nieuwe Uitgave. ZELFBEWARING- Een Geneeskundig Volkshandboek  over de genezing der Zenuwverslapping van het Ligchaam als een gevolg van geheime gewoonten of buitensporigheden die de verrigtingen  waartoe de manbaarheid den mensch in staat stelt vdór den tijd uitputten alle hoop op nakomelingschap vernietigen en het huwelijksgeluk in gevaar brengen door de vervulling te beletten van de verbindtenissen die een der voornaamste grondslagen van het leven zijn; — door Dr. LA'MERT No. 37 Bedford Square te Londen Lid van het Heelkundig Genootschap in Engeland  enz. Hij is dagelijks ten zijnen huize te consulteren. Wie niet bij hem kunnen komen worden met goed gevolg door middel van briefwisseling behandeld en de Geneesmiddelen worden in het geheim en op veilige wijze naar alle deelen der wereld verzonden. De ZELFBEWARING (La Préservalion Personelle) versierd met zeer veel Afbeeldingen en Voorbeelden i» verkrijgbaar bij de Boekhandelaars H.T. HENDRIKSEN Hoogstraat Rotterdam; H. A. MEIJER N.-Z. Voorburgwal over de Molsteeg teAmsierdam. De Nederlandsche vertaling voor ÏO Cents en Franco per post 85 Cents; de Fransche uitgave voor 50 Cents en Franco per post OO Cents. Op FRANco-aanvrage wordt het Werkje door het geheele Rijk verzonden. NB. Men gelieve opmerkzaam te zijn dat de éénige uitgave van dit Werkje onder toezigt en met toestemming van den Schrijver Doctor SAMUEL LA'MERT gedrukt die is versohenen b\j H. A. MEIJER. (6724)",http://resolver.kb.nl/resolve?urn=ddd:000024753:mpeg21:a0014:ocr,4,ddd:000024753:mpeg21:p004,Dagblad van Zuidholland en 's Gravenhage,731
5480920,1866/06/20 00:00:00,4168,ddd:010782358:mpeg21:a0016,http://imageviewer.kb.nl/ImagingService/imagingService?id=ddd:010782358:mpeg21:p005:image&x=1351&y=100&w=1315&h=4168,ddd:010782358:mpeg21,2666,4268,1351,100,10,MINISTERIE VAN MARINE. ** De Audiëntie van den Minister van Marine zal op aanstaanden Vrijdag den 22sten dezer niet plaats hebben. MINISTERIE VAN BINNENLANDSCHE ZAKEN. Bijks-Waterstaat. PROVINCIE GELDERLAND. Aanbesteding. Op Vrijdag den 22sten Junij 1866 des middagsten 12 ure zal onder nadere goedkeuring door den Staatsraad Commissaris des Konings in de provincie Gelderland of bij zijne afwezigheid door een der leden van de Gedeputeerde Staten en in bijzijn van den Hoofdingenieur van den Waterstaat in het sde district aan het gebouw van het Provinciaal Bestuur te Arnhem worden aanbesteed: het verbeteren van eenige beschadigde vakken van het Lijnpad langs de rivier de IJssel tusschen den Hoofddam te Westervoort en de lijnbrug bij het veer te Dieren. Deze Aanbesteding zal geschieden bij enkele inschrijving. Het Bestek ligt ter lezing aan het gebouw van het Ministerie van Binnenlandsche Zaken aan dat van het Provinciaal Bestuur van Gelderland te Arnhem en is voorts op franco aanvrage tegen betaling der kosten te bekomen bij den boekhandelaar M. Nijhoff Raamstraat n°. 49 te 's Gravenhaga en door zijne tusschenkomst in de voornaamste gemeenten des Rijks. Den 6den en 4don dag vóór do Besteding wordt de noodige aanwijzing op de plaats gedaan ; voorts zijn nadere inlichtingen te bekomen bij den Hoofdingenieur en den Ingenieur te Arnhem. 'sGravenhage 29 Mei 1866. Van wege den Minister De Secretaris-Generaal 3. SCHRÖDER. Bijks- Waterstaat. PROVINCIE GELDERLAND. Aanbesteding. Op Vrijdag den 29sten Junij 1866 des middags ten 12 ure zal onder nadere goedkeuring door don Staatsraad Commissaris des Konings in de provincie Gelderland of bij zijne afwezigheid door een der leden van de Gedeputeerde Staten en in bijzijn van den Hoofdingenieur van den Waterstaat in het sde district aan het gebouw van het Provinciaal Bestuur te Arnhem worden aanbesteed: het met klei bekleeden van hot natte profil van het Apeldoornsche kanaal. Deze aanbesteding zal geschieden bij enkele inschrijving. Het bestek ligt ter lozing aan het gobouw van het Ministerie van Binnenlandsche Zaken aan dat van het Provinciaal Bestuur van Gelderland te Arnhem en is voorts op franco aanvrage tegen betaling der kosten te bekomen bij den boekhandelaar M. Nijhofï Raamstraat n°. 49 te'sGravenhage en door zijne tusschenkomst in de voornaamste gemeenten des Rijks. Den 6den en 4den dag vóór de besteding wordt de noodige aanwijzing op de plaats gedaan ; voorts zijn nadere inlichtingen te bekomen bij den Hoofdingenieur te Arnhom en den Ingenieur te Zutphen. 's Gravenhage  29 Mei 1866. Van wege den Minister De Secretaris-Generaal 3. Sciiröder. Bijks -Waterstaat. PROVINCIE ZEELAND. Aanbesteding. Op Vrijdag den 22sten Junij 1866 des voormiddags ten 11 ure zal onder nadere goedkeuring door den Commissaris des Konings in de provincie Zeeland of bij zijne afwezigheid door een der leden van de Gedeputeerde Staten en in bijzijn van den Hoofdingenieur van den Waterstaat in het 11de district aan het locaal van het Provinciaal Bestuur te Middelburg worden Aanbesteed: het bouwen en leveren van een Rijksvaartuig op het Kanaal van Neuzen. Deze Aanbesteding zal geschieden bij enkele inschrijving. Het Bestek ligt ter lezing aan het gebouw van het Ministerie van Binnenlandsche Zaken aan dat van het Provinciaal Bestuur van Zeeland te Middelburg en is voorts op franco aanvrage tegen betaling der kosten te bekomen bij den Boekhandelaar M. Nijhoff Raamstraat n°. 49 te 's Gravonhage en door zijne tusschenkomst in de voornaamste gemeenten des Rijks. Den 7den en 4den dag vóór de Besteding zal de noodige aanwijzing in loco worden gedaan; voorts zijn nadere inlichtingen te bekomen bij den Hoofdingenieur van den Waterstaat te Middelburg en bij den Ingenieur te Neuzen. 'sGravenhage 24 Mei 1866. Van wege den Minister De Secretaris-Generaal 3. Sciiröder. Aanbesteding. Op Woensdag den 27sten Junij 1866 des namiddags ten 1 ure zal onder nadere goedkeuring van het Ministerie van Binnenlandsche Zaken door Heeren Curatoren der Hoogeschool te Leiden in een der vertrekken van het Akademiegebouw op het Rapenburg worden Aanbesteed : het bouwen van een Physiologisch Laboratorium. Deze Aanbesteding zal geschieden bij enkele Inschrijving. Het Bestek ligt ter lezing aan het locaal van het Ministerie van Binnenlandsche Zaken te 's Gravenhage aan dat van het Akademiegebouw te Leiden aan dat van het Provinciaal Bestuur van Zuidholland te 's Gravenhage en op alle plaatsen waar gewoonlijk Bestekken in gemelde provincie ter lezing gelegd worden.,http://resolver.kb.nl/resolve?urn=ddd:010782358:mpeg21:a0016:ocr,5,ddd:010782358:mpeg21:p005,Nederlandsche staatscourant,1315
1749676,1866/06/20 00:00:00,2078,ddd:010783588:mpeg21:a0015,http://imageviewer.kb.nl/ImagingService/imagingService?id=ddd:010783588:mpeg21:p004:image&x=47&y=2564&w=842&h=2078,ddd:010783588:mpeg21,889,4642,47,2564,6,«NNISGEVÓG. Dijkgraaf en Hoogheemraden van ilen Lekkendijk Bovendams brengen ter kennisse van de Ingelanden dat de Begrooting van Inkomsten en Otgaven van hel Hoogheemraadschap voor het dienstjaar 1806—-ISC7 gedurende de eerste veertien dagen der maand Julij ter inzage zal voorliggen in liet Dijkhuis te Schalkwijk en afschriften dier begrooting in de Raadhuizen van de Hoofdplaatsen der Disl rieten. Utrecht den C Junij IB6f>. Dijkgraaf en Hoogheemraden voornoemd  J. lI.C VAN HENGST Dijkgraaf. H. A M. VAN ASCII VAN WlJCiv Secretaris. niPACHTINB van Grasgewas en Na weide. „% Donderdag '28 Junij 186f> des namiddags 6 ure ten huize van den Kastelein REAIKES te Utrecht aan den Ezelsdijk: Van 4 Bunders 78 Roeden 10Ellen L.AAD achter üuuwijk aan de Ridderschapsvaart onder Oostveen gemeente Maartensdijk. %• De ondergeteekende wenscht bij deze kennis te geven  'dat zij hare INRIGTIXt* van Onderwijs voor Jeugdige Meisjes uit den meer gegoeden stand met primo Sept. hoopt te openen. Prospectussen zijn te verkrijgen I'ieterstraat Wijk F No. 349.  H. G. DE WIT. %• tfaphta om alle soorten van handschoenen te wasschen in fleschies van 3.8 Ct. Brillantine pakjes poetspoeder a 10 Ct. Inkt om onuilwischbaar op zink te schrijven in lleschjes van 20 Ct. «utta-Percha-Smeer in doosjes van 5 Ct. Japansche Zoija a 60 Ct. p. kruikje. üavon des dames  p- dozijn GO Ct. Engel ch Peperment I. qualiteit en dubbel sterk a 30 Ct. p ons. I. J. L. VAN HAARLEM Droogist Vreeburg nabij de Barrière.,http://resolver.kb.nl/resolve?urn=ddd:010783588:mpeg21:a0015:ocr,4,ddd:010783588:mpeg21:p004,Utrechtsch provinciaal en stedelĳk dagblad : algemeen advertentie-blad,842
4804872,1866/11/13 00:00:00,4883,ddd:010529337:mpeg21:a0028,http://imageviewer.kb.nl/ImagingService/imagingService?id=ddd:010529337:mpeg21:p004:image&x=2039&y=1039&w=984&h=4883,ddd:010529337:mpeg21,3023,5922,2039,1039,4,"PUBLIEKE VERPACHTING RIJKS f OLIM. De Ontvanger der Registratie en Domeinen te ARNHEM zal op Vrijdag den 21stcu December 1866 des voormiddags ten 10 ure precies in het Stations koffij huis te Arnhem in het openbaar In pacht aanbieden voor den tijd van 3 achtereenvolgende jaren  in te gaan den lst«"" Mei 1867 HET REGT VAST TOLHEFFING aau de hierna te melden tolhoomen of tolpalen op 's Rijks groote wegen alsmede HET REGT TOT HEFFEN VAN TOL- OF BRUGGELD op de hierna te omschrijven brug bij Geldermalseu ; het een en ander met het genot der bestaande tolhuizen en bijbehoorende gronden  breeder in aanplakbilletten omsohreven; en zulks in 25 percelen  te weten : l.De tol Gabel n°. 11 te Nieuw Millingen (gemeente Apeldoorn). 2. De tol Gabel n°. 12 telloogsoeren (gemeente Apeldoorn). 3. De tol Gabel n°. 14 beoosteu Apeldoorn. 4. De tol Gabel n°. 15 op de Teuge (gemeente Twello). 5. De tol Gabel n°. 16 te Twello. 6. De tol Gabel n°. 4 aan den „Draaiboom"" bij Zalt- Bommel. 7. De tol Gabel n°. 5 te Hedel. 8. De tol Gabel n°. 13 te Elden. 9. De tol Gabel n°. 14 te Eist. 10. De tol Gabel n°. 1 aan de Nieuwbrug (gemeente Buurmalsen). 11. De tol Gabel n°. 2 aan de Nieuwsteeg (gemeente Buurmalsen). 12. De tol Gabel n°. 2op deu weg van Zutphen naar Goor bij de Boekhorst (gemeente Laren). 13. De tol Gabel n°. 3 op den weg van Zutphen naar Goor bij de Balksbeek te Laren. 14. De tol Gabel n°. 7 te Tersehuur (gemeente Voorthuizen). 15. De tol Gabel n°. 8 te Voorthuizeu. 16. De tol Gabel n°. 9 te Voorthuizerdijk. 17. De tol Gabel n°. 10 te Millingen. 18. De tol Gabel n°. 1 te St. Anna op den weg van Nijmegen naar Limburg. 19. De tol Gabel n°. 2 te Malden op den weg van Nijmegen Limburg. 20. De tol te Wijehen op den weg van Nijmegen naar Grave. 21. De tol of het bruggeld op de brug bij het dorp Geldermalsen; bij dezen tol bestaat geen tolhuis. 22. De tol Gabel n°. 3 op den weg van Utrecht naar Zalt-Bommel te Meteren. 23. De tol Gabel nL'. 1 te Duiven. Bij dezen tol bestaat geene woning maar daarbij wordt wel een erf en een stukje bouwland verpacht. 24. De tol Gabel n°. 2 te Oud-Zeveuaar. 25. De tol Gabel n"". 1 aau de Bruininkweerderbrug onder Warnsveld. De voorwaarden liggen ter lezing ten kantore van al de Ontvangers der Registratie in de provincie Gelderland  alsmede van die te Zwolle  Deventer  Utrecht Amersfoort Gorinchem eu 's Hertogenbosch; terwijl inlichtingen te bekomen zijn aan het kantoor van den Ontvanger der Registratie in wiens kring de tol ligt te weten : ten aanzien van de percelen 1 tot en met 5 te Apeldoorn ; de percelen 6 en 7 te Zalt-Bommel; de percelen 8 en 9 te Eist; de percelen 10 eu 11 te Kuilenburg; de percelen 12 en 13 te Lochem; de percelen 14 tot en met 17 te Nijkerk; de percelen 18 19 en 20 te Nijmegen de percelen 21 en 22 te Tiel; de percelen 23 en 24 te Zevenaar en het perceel 25 te Zutphen; alsmede ten aanzien van alle percelen bij den Ontvanger te Arnhem. Gegadigden worden opmerkzaam gemaakt op het laatste lid van art. 9 der algemeene voorwaarden houdende dat ingeval door maatregelen in het algemeen belang genomen  de passage verminderd en de opbrengst dientengevolge  naar het oordeel van den Minister van Financien belangrijk wordt benadeeld deze eene billijke vermindering van pacht zal toestaan. De Ontvanger der Registratie en Domeinen te Arnhem a. i. EVERWIJN. *#* De Luitenant-Kolonel Directeur der Artillerie-Stapel en Constructie-Magazijnen zal Volgens magtiging van Zijne Excellentie den Minister van Oorlog op den 3den December aanstaande in het Venduhuis te Delft in het openbaar doen verkoopen: de na vermelde voor de dienst van het Rijk ongeschikte wapenen als: 200 gladloops INFANTEBIE-fiEWEREN 50 gladloops SAPPEURS-GEWEREN 50 getrokken KERNRUSSEN 50 gladloops KARABIJNEN. De verkooping zal geschieden bij kavelingen of partijen van hoogstens 10 stuks van iedere soort afzonderlijk. Deze wapenen hoezeer ongeschikt voor de dienst van het Rijk nogtaus zeer bruikbaar zijude voor oefening zoo wordt de aandacht van gemeentebesturen directeuren van scholen en andere inrigtingen en ook die van bijzondere personen op deze verkooping gevestigd. Delft den 7den November 1866. De Luitenant-Kolonel voornoemd van der MEER de WALCHEREN. V Bij den Boekhandelaar M. J. VISSER te's Gravenhage ziet het licht: INDIEN GIJ DEZE DINGEN WEET ZALIG ZIJT GIJ ZOO GIJ DEZELVE DOET. Uit het Fransch vertaald naar ABBOTT met eene voorrede van J. A. SCHUURMAN Jolizn. Evangel. Luth. Predikant te 's Hage. Prijs ingenaaid ƒ 125  gebonden in geheel linnen band met vergulden rugtitel ƒ 150. In een populairen vorm Worden de allerbelangrijkste vragen behandeld: Wat moet ons tot weldoen dringen? Hoe zullen wij weldoen aan de ziel onzer naasten? In welke betrekking staat de Christen tot de maatschappij ? enz. Dit boek vergezelle den Christen in zijn huiselijk leven en op zijnen stillen wandel en sta hem bij in zijne edele taak om zoekende zielen tot Christus te brengen.",http://resolver.kb.nl/resolve?urn=ddd:010529337:mpeg21:a0028:ocr,4,ddd:010529337:mpeg21:p004,Opregte Haarlemsche Courant,984
462241,1866/04/23 00:00:00,481,ddd:010897183:mpeg21:a0032,http://imageviewer.kb.nl/ImagingService/imagingService?id=ddd:010897183:mpeg21:p006:image&x=3164&y=5426&w=961&h=481,ddd:010897183:mpeg21,4125,5907,3164,5426,6,"Korr-espondleiitie. ; Aan den Soerabaijaschen schrijver van het artikeltje: „Bluf bl"" ' | lcniaal bluf"" enz. moeten wij doen opmerken dat de kolommen ** t Locomotief niet disponibel zijn voor stukken al» het zijne. Of ' i Directeur S een drieste onverschrokken ruiter is en of al het ander -y tot bespotting wordt aangevoerd waarheid behelst zijn kwestiën ""lt^} ons niet de moeite waard is te onderzoeken en het publiek zeker i'lC moeite waard is te lezen Onze geachte inzender houde ons deze opmerking ten goede ! Van elk ongeteekend artikel in dit Blad voorkomende hetwelk S*J blootc nieuwstijding of aankondiging bevat is de schrijver voor de oolang de schrijver niet genoemd wordt DE REDAKTl^",http://resolver.kb.nl/resolve?urn=ddd:010897183:mpeg21:a0032:ocr,6,ddd:010897183:mpeg21:p006,De locomotief : Samarangsch handels- en advertentie-blad,961
4053480,1866/02/14 00:00:00,3974,ddd:000018519:mpeg21:a0017,http://imageviewer.kb.nl/ImagingService/imagingService?id=ddd:000018519:mpeg21:p004:image&x=71&y=1006&w=1020&h=3974,ddd:000018519:mpeg21,1091,4980,71,1006,4,"De Scheikundige ANTÏ-R II UMATI SCIIE WATTEN van Dr. PATTIIOI verzachten oogenblikkelijk en genezen in weinig dagen volkomen rhumatisme leudezwakheid en pijnen vau allerlei aard. Verkrijgbaar in rollen van 80 cent en 50 cent bij den heer A. C. van den BIJLLAARDT apotheker te Zwolle. bereid volgen liet aloude en eclite Recept waarop men in liet bijzonder attent maakt. zijn zeer nuttig in ongesteldheden der maag en werken heilzaam op de spijsvertering. Zij zijn uitmuntend tegen de gal scherpte in het bloed en uitslag van de huid zij ziju zacht luxerend en slijmafdrij vend Verzegelde Doozen van 37j cent en dubbele Doozen zijn verkrijgbaar gesteld bij de Heeren Apothekers Almelo B. Boom. Kampen J. S. Bijken. Dedemsvaart P. Eekma. Koevorden G. Marchant. Deventer A. S. van der Moer. Meppel J. G. Lambers. Enschede  \V. Baürichters. Steenwijk  E. Lampc. Hoogeveén H. Radijs. Zwolle Schaepman env.Haasbergen O- WAARSCHUWING. Het depot dezer echte Urbanus-1 _llen sints zoovele jaren met roe.m bekend en in algemeen gebrnik is door ons te Zwolle alleen en uilsluitend verkrijgbaar gesteld bij de Heeren SCHAEPMAN Xieuwstraat en van HAASBERGBN Bethlehernsehe Kerkplein Apothekers. Men wordt instantelijk verzocht wel attent te willen zijn dat door ons bij niemand anders de URBANUS-PILLEN bereid volgens het oude en ech'e recept in depot zijn verkrijgbaar gesteld in de hierboven opgegeven Steden en Plaatsen dan bij de hierboven genoemde Depfithoulers. In elk doosje is een billet voorzien met de eigenhandige naamteekening van dc vervaardigers Wed. KUENEN en ZOON Apothekers welke handteekening zich ook bevindt op het zegellak waarmede de Doosjes verzegeld zijn. Wij verzoeken de gebruikers instantelijk daar wel op te letten en raden hun aan wel toe te zien bij wien men de doosjes Pillen haalt. Alleen die doosjes waarin een billet met onze handteekening is zich aan te schaffen en zich te. wachten voor het gebruik van de vele namaaksels. REVALENTA AHABICA. De REVALENTA wordt alhier door velen met het beste gevolg gebruikt. Zoo hoorde ik dezer dagen uog van drie gevallen. Dc heer F. T. V. namelijk is door hut gebruik van twee bussen Revalenta elk van 2 pond genezen van zware maagpijn waarvoor vergeefs verscheidene andere middelen beproefd waren geworden. De dochter van den Wel-Edelen Heer 11. is door de Revalenta van eene verzwakking der ingewanden hersteld. Voor het kind van den landbouwer P. waren slechts 2 kleine busjes Revalenta voldoende om hetzelve van het zuur te genezen waaraan het sedert geruimen tijd lijdende was. Nudere inlichtingen ben ik gaarne bereid mondelings te geven. Leiden. (Get.) L. G. DIRKS. De REVALENTA is eene voedzame krachtige spijs en belooft leven en gezondheid aan alle lijders; niemand behoeft meer aan zijne genezing te wanhopen. Het is zonder tegenspraak de eenvoudigste en minst kostbare wijze van genezing. Gezond voedend eu krachtgevend kan zij alle andere spijzen vervangen. Zij is voor kinderen en volwassenen als ontbijt zeer aan te bevelen. Zuigelingen kunnen er mede gevoed eu groot gebragt worden. Zieken kunnen geen beter dieet houden dan zich bij de REVALENTA te bepalen. Zij kan op verschillende wijzen zeer smakelijk gereed gemaakt worden. Men zij op zijne hoede tegen nagemaakte soorten; de echte REVALENTA van de Heeren BARRY DU BARRY & 0. 77 Regentstreet Londen wordt alleen verkocht door het VERKOOPHUIS en deszelfs Depots. Men lette er vooral op dat iedere bus lot waarborg der echtheid met de handteekening van „F. von WINDHEIM & 0. VERKOOPHUIS"" voorzien is. De prijs der Revalenta is: kleine bussen 81\ Ct. Ifr ƒ2 2 _' /•3.50. 5 h- fB 12 ii: .10. VERKOOPHUIS te Amsterdam. Hasselt 11. J. van der Vecht. Zwolle A van der Kolk. Kampen Mej. M. Vooght.  G. Eleveld en Zoon „ Uej. GW de Ruitei en Co. Almelo C Rosmark. Noordwolde Jacob Veenstra. Coevorden C. J. van der Scheer. Nijkerk. Wed. F Koelman. Delden A B. Gerritsen Meppel P. Lagro. Dedemsvaart 11 L v. d Vecht. Oldemarkt _ v d. Wenden Deventer Mej. van Meurs en Co. Oldenzaal IV. B Banning. „ Wed. Louwerens. Olst A. van Enk.  J Boerboom. Steenwijk K. Timmerman. Enschede Wed A Stevens. Wijhe P Westhoff. Goor G. _ Krüseman. Zwartsluis Wed. A. Schurink. Harderwijk Mej C. Kerkhof. Eu in de bekende depots in de andere steden. Zalf en Pillen van _3oüoway. OVDERDOI. Het is van het grootste belang dc krachten der oude lieden in stand te houden terwijl men hunne kwalen verpleegt. Dc geneesmiddelen van Holloway bezitten die deugd in den hoogsten graad. Ook hebben zij het onmisbaar goed resultaat er van bewezen door deu geessel des ouderdoms kwade beenen te genezen. Weldra vertoont zich de oppervlakte van de ouzuiverste ctterwond reiner nadat de Zalf er op is aangebragt de verctteringen wordeu menigvuldiger en tezonder de brandende pijn vermindert de hevige smart wordt ligter de zwelling en de ziekte verminderen trapsgewijze en verdwijnen spoedig geheel en al. De Zalf en de Pillen van Holloway zijn insgelijks allernultig3t voor roos brandwonden open wonden verstuiking rhumatis3he eu jichtige ontstekingen en verscheiden andere ziekten die voortkomen uit toevallige ziektoaanvallen of vermindering der levenskrachten. Door het vermeerderd debiet zijn de prijzen als volgt: Doosjes Pillen f 0.80 f 1.85 f 3.00 f 6 75 f 13.60 f 20.50. Potjes Zalf . 0.80 „ 1.85 „ 3.00 „ 7.05 „ 13.85 „ 20.95. Zijn op franco aanvragen a contant te bekomen bij den Heer FREDk. ROMEUN Apoth. te Arnhem eu bij J. STRAATM\N Hoofd-Dépothouder te 's Bosch alsmede te Londen Strand 224 en te New-York op Macden Lane Holloway's Etablissementen",http://resolver.kb.nl/resolve?urn=ddd:000018519:mpeg21:a0017:ocr,4,ddd:000018519:mpeg21:p004,"Provinciale Overĳsselsche en Zwolsche courant : staats-, handels-, nieuws- en advertentieblad",1020
2050540,1866/11/10 00:00:00,2516,ddd:010783708:mpeg21:a0013,http://imageviewer.kb.nl/ImagingService/imagingService?id=ddd:010783708:mpeg21:p004:image&x=77&y=2063&w=815&h=2516,ddd:010783708:mpeg21,892,4579,77,2063,6,"~ ** De Notaris I. J. VAN I DEN HELM te Maarsse-! iH>» veen zal op Woensdag den \ %i 14 November 1866 des _J__ voormiddags ten 11 ure 4 ten huize van H. VAN OOSTROM  in het gemeentehuis te Westbroek verkoopen : N° 1-4. Eene Kapitale BOEBENHOFSTEBE bestaande in een Woonhuis  met Stalling voor Koeljen en Paarden Karnhuis Schuur en Hooibergen Boomgaard Erf en Grond Hooi- en Weilanden te zamen groot 25 B. 69 R. 56 E. gelegen te Westbroek aan den Kerkdijk. Eerst in 4 perceelen en daarna in Massa te veilen. Te zamen verhuurd aan GI.ISBt. VERKEBK tot Januarij 1870 a / 700 per jaar. Nn. 5. Een HUIS met Erf en Grond en daarachter liggend Weiland gelegen alsvoren groot 1 B. 6 R. 35 E. N° 6 en 7. Twee Perceelen Veenland Akkers en Water gelegen als voren groot 1. B. 65 R. Welke 3 perceelen zijn verhuurd tot Januarij en Mei 1867. Nadere informatiën te bekomen ten Kantore van genoemden Notaris VAN DEN HELM ten wiens Kantore de bewijzen van eigendom en voorwaarden van verkoop in tijds ter lezing zullen leggen. ~V* De Notaris VAN HEUST te Wijk bij Duurstede zal op Donderdag den 15. November 1866 des morgens ten 10 ure aan den Schoudermantel onder Bunnik verkoopen: Eene groote partij TIMMEB-en WEBtt- HOUT  als : Eiken Bergroeden  gewaterde Eiken Pompen dito lepen- en Esdoornen Stammen  lepen- Essehen- en Beuken Platen Eiken- Sparren- en Populieren Planken  Ribhout Gordingen  Palen  Balken en Stijlen ; voorts Deksparren Rneispanen  Hakspanen  gekloofde Ondereinden Toppen  Schalen en Takkenbossen;en eindelijk eene Hoveniersboot en 3 JTagtge-veren. Onderrigt bij A. VAN ZIJL en J. VAN DOORN te Bunnik. .- ** Publieke Verkooping van circa t '.jSEi 3© Bunders buitengewoon zware en ""__i extra flJne TEESf' voor het mes -_-_■»""' af slaande op de Hofstede Sterreschans-Hunthum in den Polder Mijnden nabij Nieuwersluis aan de rivier de Vecht alsmede 2 bunders extra best 3-jarig firiendhout op de Hofstede Ouderhoek nabij Meuwersluis. (Op dag tot 1° Augustus 1806) Op Dingsdag 20 November -isüii des"" voormiddags ten 11 uic ten huize van den Logementhouder VAN CASPEL te Nieuwersluis gemeente Loenen ien overstaan van den te Loenen residereuden notaris LRN-1 VAN BEUSEKOM Ezn.",http://resolver.kb.nl/resolve?urn=ddd:010783708:mpeg21:a0013:ocr,4,ddd:010783708:mpeg21:p004,Utrechtsch provinciaal en stedelĳk dagblad : algemeen advertentie-blad,815
4697713,1866/12/18 00:00:00,5225,ddd:010585569:mpeg21:a0049,http://imageviewer.kb.nl/ImagingService/imagingService?id=ddd:010585569:mpeg21:p005:image&x=1179&y=365&w=2177&h=5225,ddd:010585569:mpeg21,3356,5590,1179,365,6,"NEDERLANDSCH ZENDELING GENOOTSCHAP onderafdeeling Wonseradeel. OPWEKKINGSREDE te Makkum Donderdag den 20 December e. k. 's avonds ten 5 ure  door den WelEerw. Heer T. C. K. B. van ASSEN Pred. te Arum. Daarna -vergadering van Leden en Begunstigers. Namens het Bestuur T. C. K. B. van ASSEN  Secretaris. LATIJNSCHE SCHOLEN TE SNEEK. Het gewone winter examen zal gehouden worden in het schoolgebouw  op Woensdag 19 December van 9—12 uur des voormiddags en I—3 en 5—7 uur des namiddags. De Ondergeteekende noodigt alle belangstellenden tot bijwoning van dit examen uit. De lessen zullen worden hervat op Maandag 7 Januarij 1867. Voor de plaatsing van nieuwe leerlingen wordt men verzocht zich vóór dien tijd bij den Rector aan te melden. Sneek  14 December 1866. Dr. E. MEHLER. PROVINCIALE. STATKX. HOOFD-KIESDISTRIKT FRANEKER. De Ondergeteekenden hebben besloten bij de aanstaande verkiezing voor een Lid van de Provinciale Staten hunne stemmen uit te brengen op den Heer Mr. T. MULIER te Witmarsum. De groote belangstelling die ZEd. Gestr. meer dan zestien jaren toonde in alles wat den bloei en de ontwikkeling onzer Provincie kon bevorderen  maakt verdere aanbeveling overbodig 't Is daarom  dat zij hunne Mede- Kiezers dringend uitneodigen zich met hen te vereenigen opdat alzoo de Heer Mr. T. MULIER in staat worde gesteld al zijne krachten te wijden aan de belangen dier Provincie waarvan zijne veeijarige werkzaamheid hem eene algemeene kennis verschafte en ZEd. Gestr. zich alzoo gedrongen mogt gevoelen in ons midden werkzaam te blijven. U. RIJPMA 1 M. J. POSTMA  J. Witmarsum. S. RIJPMA l B. S. IJETSINGA.i A. J. ANEMA  } Arum. D. BANGMA P. J. SIEWERDA S. RIENSTRA  Pingjum. P. TACOMA  J K. J. WESTRA ) r- i H. ROORDA  . K. S. WIERSMA  ) Tr ~ 8. S. m WITTE | #«*««""»■ J. v. d. BAAN ) T. van GOSLIGA D S. ZONDERVAN ParTa9a- S. PIERSMA K. G. Db BOER I T- h^d C. D. de BOER I JJerlcwera- P. de JONG. { P. P. de JONG  f Exmorra. T. WESTENDORPJ G. S. RUSTICUS I «*__«_____■ W. DEEL  | Schettent. S. B. v. d. MEER  Longerhouw. De vereischten tot Lid der Prov. Staten zijn: kennisder Algemeene belangen maar die van den Waterstaat in het bijzonder; — breng daarom vrije Kiezers thans uwe vele stemmen uit tot Lid voor de Prov. Staten op den Heer IJ. v. d. MEULEN Lid der Kamer van Koophandel te Leeuwarden een man die onvermoeid voor die belangen zoomede voor de verbetering der Haven van Harlingen enz. heeft gestreden. EEN KIEZER. Tot KANDIDAAT voor het Lidmaatschap der Provinciale Staten wordt aanbevolen de Heer A. A. LAND  Notaris te Franeker. Eenige Kiezers in het hoofdkiesdistrict Franeker. YERKIEZIMi PROmCIALE MATEI. De Kiesvereeniging VRIJHEID EN ORDE te Harlingen heeft voor de benoeming van een Lid der Prov. Staten  op Woensdag 19 December e. k. als CANDIDAAT gesteld den Heer: H. J. van AISMA te St. Anna-Parochie. Namens de Vereeniging 3. van HULST. L. HANNEMA. P. J. GEIJKEMA. J. F. JANSEN. J. NOYON. DË KIEZERSVEREENIGJM „Eendra^t"" heeft in hare te Witmarsum gehoudene vergadering gesteld tot KANDIDATE.. : Als Lid voor de Provinciale Staten den Heer H. J. van AISMA te St. Anna-Parochie. Als Lid voor den Gemeenteraad van M onseradjeel den Heer KATRINUS van der WAL te Witmarsum. Namens de Vereeniging M. KINGMA Hzn. Dr. SCRINERIUS. I. J. VERWER.",http://resolver.kb.nl/resolve?urn=ddd:010585569:mpeg21:a0049:ocr,5,ddd:010585569:mpeg21:p005,Leeuwarder courant,2177
1936242,1866/01/10 00:00:00,2541,ddd:010113701:mpeg21:a0018,http://imageviewer.kb.nl/ImagingService/imagingService?id=ddd:010113701:mpeg21:p004:image&x=913&y=125&w=762&h=2541,ddd:010113701:mpeg21,1675,2666,913,125,6,HOUT le Koop UIT DE HAND Dnims V 4 X IA Duims DEELEN 2 BATTENS. Adres Leuvehaven wijk 3 n°. 359. Brieven ƒ«;(. o. (816) tegen 1 februarij a. 8. wordt te hu er Gevraagd in de buitenrtad Een KANTOOR  voor f IÜO a f 150 'sjaars. Opgaaf van stand en prijs franco onder het nommer dezer advertentie aan het Bureau dezer Courant. (803) TEGEN FEBRUARIJ BIEDT MEN TER OVERNEMING AAN EENE GAKE^-BAM)- E\ 3i\\[ FAtTI LR-ZAAK met geheel nieuwen en netten OPSTAL die een goed bestaan oplevert. Het MUIS er bij TE HUUR tegen 'ƒ 4 per weck. Adres met franco brieven onder lett. V bij H. W. DUSAULT 'Oppert. (798) DOOR GEVORDERDEN LEEFTIJD WORDT Eene WINKELZAAK TER OVERNEMING AANGEBODEN welke sedert 25 jaren door eene Vrouw is waargenomen en een fatsoenlijk burger bestaan heeft opgeleverd; dezelve is zeer voor uitbreiding vatbaar. Het HUIS er bij TE KOOP. Adres met franco brieven onder het nommer dezer advertentie aan liet bureau dezer Courant. (720) - 'PIANINÖ'S^ IN KOOP en IN HUUR tegen de billijkste conditiën  van BERNHARDT—AtsS L. BERNHARDT van f 33» prima kwaliteit LINNECKER ADAM CUIJPERS en diverse solide Instrumenten  tot ongekende lage prijzen. Voor derzelver soliditeit wordt deugdelijk geguarandeerd. Voorhanden eene Planino 6% Octaaf iv sierlijk Mihony Kast fiksclien en mooijen Toon voor ƒ l-l©. ' (799) H. W. DI'&tJLXT Oppert wijk 6 n°. 47. (778) De ondergeteekende heeft dc eer te berigten  dat hij zijne Zaak heeft overgelmi^t van de Oostmolenstraal naar den Houttuin  Zuidzijde wijlt Il  nJ. i.99. In de hoop ook daar met dc gunst vau betgeëerde Publiek fc-voorregt te worden  blijft hij met de meeste hoogachting «OREAI * €ie.  Fabrijkant in Parapln'ies Koffers en Reisartikelen. Ciroote Prijsmedaïiïe der lste klasse. ASTHMA drukking op de forst verstikking beklemdheid op dc borst  onmiddellijk gelenigd en genezen door het Papier van MICOV Cbcmist te Parijs Boulevard Sebastopol 99  Leverancier van verschillende Hospitalen te Parijs goedkeuringen der beroemdste Geneeskundigen. Ml'pot le Amsterdam bij H. H. ULOTH  Apotheker ; te 's Hage bij J. 'L. F. O. SNABTLIE; te Rotterdam bij M. CLOOS Vriéssché Apotheek in 't Hang te Groningen bij LEEK en in de voornaamste Apotheken vin ÈottaM. Prijs ƒ150. (7724),http://resolver.kb.nl/resolve?urn=ddd:010113701:mpeg21:a0018:ocr,4,ddd:010113701:mpeg21:p004,"Nieuwe Rotterdamsche courant : staats-, handels-, nieuws- en advertentieblad",762
2121336,1866/05/08 00:00:00,2562,ddd:010389914:mpeg21:a0041,http://imageviewer.kb.nl/ImagingService/imagingService?id=ddd:010389914:mpeg21:p004:image&x=57&y=85&w=828&h=2562,ddd:010389914:mpeg21,885,2647,57,85,6,"De AMBTENAAR van den Burgerlijken Stand der gemeente Botterdam brengt door deze ter kennis van de Belanghebbenden dat tot nader orde het Bureau van den Burgerlijken Stand zal geopend zijn des Maandags voormiddag te 8 uur en op de volgende werkdagen des voormiddags te 9 uur alleen voor zooveel betreft de aangifte van Overlijden. Rotterdam De Ambtenaar voornoemd 4 Mei 1866. HOFFMANN. De COMMISSIE der Loterij ten voordeele van het Hlnder-Zlekenhuls berigt dat de PRIJZEN aan de Groote Zaal van de Sociëteit Harmonie kunnen worden afgehaald tegen overgifte van de Loten op HEDEN Dingsdag 8 Mei van des middags ten 12 tot des namiddags ten 3 ure en Woensdag en Vrijdag aanstaande. De Lijsten der Trekking zullen Dingsdag ten 12 ure a 5 Cents verkrijgbaar zijn bij de Heeren M. WIJT en ZONEN alhier. Ter voldoening aan het bepaaide bij Art. 56 harer Statuten maakt de Directie der Binnenlandsche Hypotheekbank te Rotterdam bekend dat de XJITLOTIInTG van de door haar uitgegeven HYPOTBEEKBRIEVEN zal plaats hebben op Zaturdag 12 Mei 1866 des namiddags 1% ure ten Kantore der Maatschappij te Rotterdam. Bij Vonnis van de Arrondissements-Regtbank te Rotterdam van den 4 Mei 1866 is DAVI» PVLi wonende te Rotterdam thans zonder beroep vroeger Winkelier verklaard In staat van Faillissement ingegaan op den 4 Mci 1866 en zijn daarbij benoemd tot Regter-Commissaris de Edel Achtbare Heer Mr. PIETER VAN DER HOEVEN Regter in eemelde Regtbank en tot Curator Mr. PIETER GEORGE BIJSTRA Procureur bij gemelde Regtbank wonende te Rotterdam. Rotterdam den 7 Mei 1866. De Curator in genoemd Faillissement P. G. BIJSTRA. Al degenen welke iets te vorderen hebben van» verschuldigd zijn aan of Papieren en Bescheiden onder zich hebben behoorende tot de Nalatenschap van wijlen den Heer MACH-IRIUS JOSEPUUS VÏÏVI-STEKE in leven Particulier gewoond hebbende aan den Binnenweg te Rotterdam en aldaar overleden den 28 April 1866 worden verzocht daarvan ten spoedigste opgaaf betaling of afgifte te doen ten Kantore van de Notarissen DALEN en VAN WIJNGAARDEN aan de Zuidblaak te Rotterdam. Screw Steam Stopping Gompany. WEKELTJKSCHE DIERST ROTTERDAM e""n LÖII VOOK «OEBEREN en PASSAGIERS. Het Engelsch Schrcefstoomsehip _R ____ HST G- _EE_ IR Kapit. R. S. Rendell vertrekt Dingsdag avond 8 Mei ten 9 uur. Adres bij de Agenten G. LEVINGSTON 8c ZOON en J. A. HOUWENS te Rotterdam en W. H. CAREV Hr SONS. 84 Mark Lane Londen",http://resolver.kb.nl/resolve?urn=ddd:010389914:mpeg21:a0041:ocr,4,ddd:010389914:mpeg21:p004,Rotterdamsche courant,828
238720,1866/01/11 00:00:00,320,ddd:010113702:mpeg21:a0030,http://imageviewer.kb.nl/ImagingService/imagingService?id=ddd:010113702:mpeg21:p005:image&x=73&y=4759&w=746&h=320,ddd:010113702:mpeg21,819,5079,73,4759,6,"I AÖOrl Overleden HENRICUS CAROLUS GRANSBERG derde zoon van 1 H. C. A. GRANSBERG P. S. GRANSBERG  HOYNCE: VAN PArENDBECHX. ¦g""»™ 8 Januarij 1866. kennisgeving.",http://resolver.kb.nl/resolve?urn=ddd:010113702:mpeg21:a0030:ocr,5,ddd:010113702:mpeg21:p005,"Nieuwe Rotterdamsche courant : staats-, handels-, nieuws- en advertentieblad",746
4299620,1866/06/14 00:00:00,2699,ddd:010783583:mpeg21:a0009,http://imageviewer.kb.nl/ImagingService/imagingService?id=ddd:010783583:mpeg21:p004:image&x=1742&y=1959&w=1700&h=2699,ddd:010783583:mpeg21,3442,4658,1742,1959,4,"J M. GEHUWD. 7G. van Eden en A. M. Lansdorp. Krommenie. 7 C. J. van üoens en G. J. J. ten Cate Coster. Zwolle. 7 J. W. van Gellekum en AI. 8011 Eethen. 2 Dr. J. Vroesom de Haan Jr. en A. E. Kuiler. Veenhuizen. 8 Mr. H. J. Kist en C. S. Wesseling. Tiel. 7 Jhr. Mr W. E. van Panhuijs en Jkv. L. C. W. C. van Panhuijs. 's Hage. 8 P. Pz. Proost en G. M. Gebhard. ■ Amstordam. 6 li. J. van de Koemer en C CA. Gutteling. Oude Tonge 6 Mr. J. L. van Sloterdijck en Jkv. T. van Beijma. Leeuwarden 6 W.L. Slotemaker enE.G. Outsboorn. Kotterdam. 7 W. Steft'eus en J. J. JBeets. Leijden. 7 T. J. Wijnoldy en S. Wijnoldy. Brummen. UEVAELE.V. 9 A. M. Bicker Caarten geb. Duuring z. Rotterdam gP.E. de Geer geb. Bechcring z. Doesburg. 6 A. Haremaker geb de Wit d. Leyden. g Van Heemskerk geb. Te Gcmpt d. Epe. 10 A. E. Hoogvliet geb. Kist d. .Vlonnickcnd. 11 H. C.van Ing»-n d. Oosterbeek. 7 J. E. A. Kool geb. Diemer z. V.nlo. 7 L. de Looze geb. Lopse Hoeke d. Zicrikzee. 9 J. du Lange geb. Latenstein van Voorst z. Haarl meer. 10 H. D. Laugebaerd geb. Tobbe d. Zaandam. 1(1 A. G. W. Lauullard geb. Roos d. Amsterdam. 10 M. E. Ledeboer geb. Adriani z Amsterdam. 8 E. J. S. Ncijs Wed. H. W. van Oijen . z. 's Hage. 9L. L.; J Ortt geb. de Baikem z. Groningen. 10 L. Repelaer geb. dé Watteville d. 's Hage. 8 W. G. Schimmelpenninck geb. Gravin vau Limdurg Stirum z. 's Hage. 10 M. T. I). Segers geb. Westhoff z. Leersurn. 10 F. H. C. Schaaij geb. Brandts z. Kotterdam. 10 J. Schaap geb. Schots z. Krommenie. 7 J. E. H. U. van Vloten geb. van Gennep  z. Deventer. OVERLEDEN. 5 A. Ii; Attema. 81 j. Wolvega. 7 E. C. J. Badon v. d. Berg. Hoogmade. 30 F. .1. Buckers 51 j. Eiburg. BC. Bouman Wed. (i. Baaij. 79 j. Amsterdam. 6 C. G. va'i Kaab van Canstein Wed. B Voorhout. Leeuwen. 15 W. S. M. E. Bar"" van Dopff 71 j. Zierikzee. 5 .1. Houwink Wed. Mr. A. Kiers 93 j. Meppcl. 7 H. Homan gel). Zeper 60 j. Groningen. 7 A. M. Hotte geb. Kips. Amsterdam. 10 L E. Hinrichs 77 j. Gorinchem. 9 11. J. Klerk 79 j. Delft. 9P. ten Kate 74 j. Zaandam. 7 A. Lehman de Lehnsfeld. Ams erdam. 9 J. van der Leeuw 70 j. Rotterdam. 8 M. van Metman Wed. K. de Vries ""5 j- Haarlem. 7A. Sichte man 6 m. Groningen. 7 K. ühlenbroek 31 j. Haarlem. 8 t. Visser 60 j. Rotterdam. 10 A. Vis Albz.: 34 j. Woimeerv. 7 Z. J. van Wieringen 6 j. Lokkerkerk. Prijzen der Effekten. AMSTERDAM 13 Junn"" 1866. Nederland. Cert. Werk. Schuld . 2%pct 51% 53'% 53% ' » • .. 3 ■ 62% 62% » » « .. 4 1 82% '83 Aand. Handelm. reak. .. . |i2S 129/ j 129% Aand. Ceutr.-Spw.-Maata.. . 9 Oblig. Centr. Spw.-Maats. / 62 61 Spanje. Obligatiën 2%pci 25% 28% 28% dito Binnenl. / 6250 3 « 27% 27% 27/* dito ƒ1250 en/2500 3 » 27% 27% Portugal. Obligatiën 3 pel 39 Obligatiën 1856-63 .8 1 39 39% ■tuisland. Oblig. Hope & C». . 5 > 90 Ins. sde Serie .... 5 < 52% 52% Ins. 6de Serie .... 5 > 69% 71 6Ji/4 Oblig. te Amst. 1864 5 > 86 Oblig. bh"" Hope 1860 4% « 77% Inschr. 20 3e 4e L. 4 t\j 55% 555/ Ins. 5e Leen. te Lond. 3 « ! 16 Inschr. Assign 6 » 32% Cert. van Assign. .. 6 t 33 Aand. Gr. M. Sp.. . / 67 168 168 Aand. 5 pet. Rs. 100. .. / 143 145 145 Polen. Obligatiën 4 pet 53% Oostenrijk» Oblig. Metaliek. .. . 5 pet 37% 37% 37'7s « 1 .... 2% . 19'/ 19% f Rente Amst. .5 1 57/4 57% # « inZ.1864 5 1 46 46% 46% a « » o 1865 5 < 45% 46% 46 « Nationale 1854 5 1 39 39% 39'7É» Ween.Ad.4pet.fl. 2501854 / I — » a 5 a a 500 1860 • [2)3 297 297 1 » » f 100»1864 a 48 48% | Fr. Oost. Spoorw. Oblig.. . 95 ■ talie. Cert. inschr 5 pc». 32% 35 Cert.L.&B.enß.fcZ. 5 pet. 34% Turkije. Oblig. buit. 1865. .. 5 pet. 22% 23% . Amerika. Vereen. Staten 1874 5 > 62'/g 62% • a 1881 6 f 68% a 1 1882 6 > 67'/I 6 67% 67%» Min. Spoorw. Aand 78% s Amst Cert 7-1 78% 78'/; a ' Oblig. C. B 67% Braz. Geldl. 1852-60 4'/ » 64% 64% Braz. Geldl. 1863 . . 4%pct. 58% Mexiko Oblig. 1851 . 3  13'/ 14% 13% Mexico Oblig. 1864 . 3 1 11% 11% ll'/« Mexico Aand. 1865 frs. 500 97 98 Grenada Obl. gest. werk . . 10% Grenada uitgestelde 5 / 5% Venezuela Oblig.. .. 3 pet. 9% 9% Venezuela Oblig. . . .l%pct. 5 Ven. Oblig. leen. 1862 6 « 21 N. Russ. Aand. 1866 132 133% 133; Gr<V' 7% 7%; Redcmp. Bonds 54%; Obio Sp. 49; V Ohio 52%; Pac. Sp. 49% 50. A'oar» wan Geld: Bel. -. Prol. 6 6%- g«. De markt vervolgde heden op nieuw hare ter0( gaande beweging vooral betrof dit OostenrijkBo Russische. Portugesche en Turkscho fondsen. Gcconfed.. 15% %. Grenada Hektares 34. r 2e sektio 46. Stoomdruk van L. E. BOSCH & ZO©**' <",http://resolver.kb.nl/resolve?urn=ddd:010783583:mpeg21:a0009:ocr,4,ddd:010783583:mpeg21:p004,Utrechtsch provinciaal en stedelĳk dagblad : algemeen advertentie-blad,1700
2686000,1866/06/20 00:00:00,2686,ddd:110536586:mpeg21:a0010,http://imageviewer.kb.nl/ImagingService/imagingService?id=ddd:110536586:mpeg21:p002:image&x=189&y=3606&w=1000&h=2686,ddd:110536586:mpeg21,1189,6292,189,3606,8,"Op ZATURDAG den 14 Julij 1800. morgens ten 10 ure zal bij bet Vendu-Departement ie Buitcnzorg publiek worden verkocht het Land TEMOEGOEXGA3 rn TJIIOLEAI. gelegen inde Assistent-Residentie Buiten zorg alsmede PADIE KARBOUWEN en HOUTWERKEN enz. lielioorende tot den Boedel van wijlen den lieer •/. f. T. ran Motman. Inforinatien t.- bekomen bij 'i Vendu-Departement aldaar en bij (32-10) F. 11. C. VAN MOTMAN. mxsssrvux?-ttt—irr.Tt f n nrrr nnnrriii n I^——■ n Coiiegie vau esoeuee.--\ •s£s? \\ IWEEISTEitEjI maakt beop DONDERDAG den 19 Julij aanst. des voormiddag ten BO ure Voor rekening van Tjio Anima Tjio Soenlong Tjio Sienlong Tjio Peklmg Tjio Tjieleen Tjio Soenjoe en Tjio Kolot krachtens magtiging van den Land raad Ie Batavia bij dispositie dd. 8 November 1 865  zal worden verkocht door tusselienkoinsi van hel Vendu-Kantoor: Een stuk TUIN- en ZAAILAND genaamd T-p J^-£LI^r:E3:o:F bij de verponding geregistreerd Sub Ko. 0051 en getaxeerd op / 30.000.-— waarvan de afmetingen zijn: Aan de Noordzijde: Beginnende aan de Westzijde langs den weg 1"" negen en vijftig Rh. R. zes voeten van daar in de rigting Z. 6° O. een en vijftig Rh. R. negen voelen dan '/.. 12° O. drie en dertig Rh. R. vervolgens Z. 95c O. acht en twintig Rh. R. vnn bier No. 18 O. een en twintig Rh. Tl. negen voelen dan N. 20° W. zestien Rh. R. van daar N. en Z. zeven en zeventig Rh. 11. achl voeten en eindelijk tol aan de Rivier Krokol in de kners Oost en West een honderd drie en zeventig Rh. 11. drie voeten. Aan de Zuidzijde: In de Kners O. en W. een honderd twee en vijftig Rh. R. Aan de Oostzijde: Noord en Zuid gemeten twee honderd zes en twintig Rh. R. Aan de Westzijde: Beginnende van den grooten Westerweg in de Koers N. 130° O. een honderd Rb. R. en van hier N. en Z een honderd en vijftien Rh. R. Batavia Namens het. Collegie den 19 Junij 1*66. Be Secretaris (8470) C. F. m'sscin.R",http://resolver.kb.nl/resolve?urn=ddd:110536586:mpeg21:a0010:ocr,2,ddd:110536586:mpeg21:p002,Bataviaasch handelsblad,1000
1828160,1866/05/03 00:00:00,985,ddd:011193510:mpeg21:a0011,http://imageviewer.kb.nl/ImagingService/imagingService?id=ddd:011193510:mpeg21:p005:image&x=1330&y=96&w=1856&h=985,ddd:011193510:mpeg21,3186,1081,1330,96,6,Koninklijke Assurantie Maatschappij. Vv. MQM der grootste Assurantie Maatschappijen-der Wereld. ' VerzekênMg legen BRANDSCHADE. n LEVENS VERZEKERING. Bureau le LiverpaoL: ■ Zij inuut uit door den|| Deie onderscheidt zich Buréau te Londont North John; bthwt. spoed waarmede hare ait j door hare groote dividen- Lombard Street. ■ _ : President.- betalingen wordea be- den ei» .matige preiuien. Secretaris C. Turner *fasq.pP. L. werkstelligd. . • J. B. Johnston Esq. liet eeu aantal oakvrame —-— I Aanzienlijke deelverkrij» Met een aantal bekwam* Directeuren. r- Voorbeeldelooa snelle toe-ljgiiig in de Voordeeieu. Directeuren.' neiuiug. || i; Het toegenoilien beschikbaar kapitaal bedraagt Een millioen sterling. l)e moeste dörinvloedrijke Nieuwsbladen in de Wereld hebben gewezen op den buitengewoon uitslag dezer Maatschappij en op den voldoenden waarborg weikon hare groote hulpmiddelen aanbieden. .,http://resolver.kb.nl/resolve?urn=ddd:011193510:mpeg21:a0011:ocr,5,ddd:011193510:mpeg21:p005,Surinaamsche courant en Gouvernements advertentie blad,1856
3356080,1866/12/01 00:00:00,3227,ddd:110536658:mpeg21:a0017,http://imageviewer.kb.nl/ImagingService/imagingService?id=ddd:110536658:mpeg21:p003:image&x=72&y=3089&w=1040&h=3227,ddd:110536658:mpeg21,1112,6316,72,3089,8,"Notice. la> ir n-teri' u li ebanre tl ■ > ;'; BORN*3O ÜJA.PAN} IdMTÏEI here int - Mr. ï&lefcard HtitehtireoiK 130'jr proc^.""l tl on (7490) P. W. AUCHIN L 3S Batavia 2 Ith November 1866. ""fiSSSBNatoIV' TOKO der >'m c'_v:..'..n.c'i iie&a Passer Pisang. (7506) H. & A -I RAI 4. ■H|||rlM in WITTEN» !! VPPELUKen PRAK- ÏÏ>«'H WERKTCïCKI NHKIK . wenscht zijne tegenwoordige positie ti \eramleien en zoekt plaatsing op een Scikcr fabriek 'iefst op een die werki of zich inrigten wil mar de Methode van den Heer Montclar Ï514) \lrs letter V. Uitgever dezer Courant. Rrieven/rascff. iwn—i ■ n ■■-«■•iws ilm- mivih. umi .«» - —-ij^^jaiSsj^^jk: (imldireteekende uiaa eerde II i""ili»'k;""u'!'l ~at ""■'l!l' bonden van -ien ."" en 6 D ianst.de kOfFiJ KAMER iiaasl iknSdioii^kr(|zaiziju <j<spead alwaar Ververschingen Kinderspeelgoed. etc. zullen *'• bekomen zijn waarbij ook \. ■ ZIJ*! zal wort LOA POSEN.-.-. Meuwe Rotterifamschi * ail-Courant AO. 1867. AjJONNEMENTS-GELDEN ten bedrage van veertig Gulden worden tijdig inir. ■ NIEUWE VTONNENTEN on (rcw >-o'jr*'/„d;n ite nog resterende nummers van .li. jaar gratis. •■ gÖT"" Let Wel! -^ Loterij Sociëteit Harmonie te Pasoeroean. Het groot aantal loten in de afgcloopen maand van dr hand gezet versterkt de Direktie in haar voornemen om de trckkinq zoo spoedig mogelijk Ie doen plaats hebben en wel voor net einde van het jaar. Enkele ■ loten zijn nog verkriigbaai bij di bekend geraaakie debitanten. De Directie betoont zich eenegen de te Batavia Samarang u Soerabaija u vallen prijzen .. die plaatsen te doi e aitb. talen. >! «roidt verzoent brieven over tb LOT_~EtïJ han... v voorkoming van verwarring niet aan den Secretaris maar aan den President ler Sociëteit gratis ~ adres r n 0 Vresvxeni ""» g ~„■..'. Sociëteit VAN i. A\ 'CX vAN PABST. Tasctroeau 1 Novembti i- '> (7489 J |",http://resolver.kb.nl/resolve?urn=ddd:110536658:mpeg21:a0017:ocr,3,ddd:110536658:mpeg21:p003,Bataviaasch handelsblad,1040
2302650,1866/04/17 00:00:00,2150,ddd:010140663:mpeg21:a0006,http://imageviewer.kb.nl/ImagingService/imagingService?id=ddd:010140663:mpeg21:p002:image&x=1129&y=53&w=1071&h=2150,ddd:010140663:mpeg21,2200,2203,1129,53,2,"! 50 GULDEN BELOONING 1 aau dengene die de GEBOORTE- of de DOOP-AKTE kan bezorgen ; of aanwijzing daarvan doen van ! I Mleolaas Venls ©f Cornelïs renis geboren zijnde in de jaren 1700 tot 1735. Franco brieven aan het i Gemeentehuis te Zevenbergen. (9299) | ERUIDENIERSBEDÏENDE. '! Met I°. Mei wordt in eenen Kruidenierswinkel verlangd: een bc': kwaam BEDIENDE van de P. G. tegen genot van Kost Inwo- 'ining en Salaris naar bekwaamheid. Adres franco lett. K. bij den • ? Kantoorboekhandelaar H. G. KOS T E R HGz. Nieuwendijk I alhier. . (9160) Tfi HOOPT i Een nieuwe SDCIABLE met losse Knechtszitting op Collin-assen i een VIGBLANTE twee TENTWAGENS eenEZEL WAGEN. Te bevragen met franco brieven bij J. VAN IJSENDOORN Rijtuig"" maker te Zeist. (9156)' i Men vraagt in de nabijheid van Amsterdam liefst digt bij een Spoor voor de Zomermaanden TE HUREN een GEMEUBE LEERD HUISJE of BOVENHUIS bestaande uit drie Vert trekken met Keuken en verdere gemakken; zonder bediening. Re flecterende gelieve zich met opgaaf van Huurprijs te adresseren met franco brieven onder letter T. bij den Boekhandelaar H. W. HELWIG Stilsteeg te Amsterdam. (9302) ) Bij eene Familie in de omstreken van Haarlem wonende wordt eene KEUKENMEID gevraagd die volkomen berekend voor hare taak is en bewijzen van goed gedrag en eerlijkheid kan overleggen . Loon ƒl5O 'sjaars. Adres onder letter W. bij den Boekhandelaal i E. E. VON MÜNCHEN teHaarlem. _ (9284) j Eene fatsoenlijke bejaarde DAME zoekt tegen half Mei e. k. ge- B legenheid om 2k 3 maanden buiten door te brengen in een Lo._ gement of bij fatsoenlijke Burgerlieden tegen den prijs van ƒ 1.50 per dag waarvoor zij verlangt eene VRIJE KAMER benevens Kost eh Bediening; het een en ander eenvoudig doch goed en zindelijk. De voorkeur zal worden gegeven daar waar een Spoorweg station in de onmiddellijke nabijheid en een Tuin bij het huis aanwezig is waarvan zij gebruik kan maken. Brieven franco onder lett. D. bij den Boekh. H.W.HELMIGc te Amsterdam. (9301) Een TIMMERMAN sedert jaren werkzaam in eene Houtkooperij als zoogenoemd naloo p e r biedt zich aan als vast TIMMERMAN  in eene Fabriek of ook weder als naloo p e r bij den Honthandel. De wensch naar drukkere bezigheid doet hem uitzien naar eene oerplaatsing terwijl hij overtuigd is dat de informatien ten aanzien van zijn persoon en bekwaamheid de beste uitkomsten zullen opleveren. Adres franco onder lett. A. S. bij den Boekhandelaar J. NOOBDENDORP te Amsterdam. (9251) ' Een JONG MENS'CH 19 Jaar Oud R. K. Godsdienst van de beste getuigschriften voorzien eene nette en vlugge hand Schrijvende en volkomen bekend met het GALANTERIE VAK de . Talen en Administratieve bezigheden en ook thans in eene voor\ name dusdanige Handelszaak werkzaam zag zich gaarne verplaatst  op een MAGAZIJN of in eenen WINKEL. Franco offerten .onder lett. ' K. V. Bureau Handelsblad (9254)",http://resolver.kb.nl/resolve?urn=ddd:010140663:mpeg21:a0006:ocr,2,ddd:010140663:mpeg21:p002,Algemeen Handelsblad,1071
2376155,1866/06/09 00:00:00,2747,ddd:010783580:mpeg21:a0008,http://imageviewer.kb.nl/ImagingService/imagingService?id=ddd:010783580:mpeg21:p004:image&x=2580&y=1937&w=865&h=2747,ddd:010783580:mpeg21,3445,4684,2580,1937,7,"WIJK BIJ DUURSTEDE 6 Jnnij. Roode Tarwe per m. van / 8.50 tot f 9.00. Ruw. dito van / 9.50 tot f 9.75. Rogge van / 6.2* tot / 6.70. Boekweit van / 6.75 tot / 7.00- Paardenboonen van f 9.00 tot f 9.40. Haver van f 4.25 tot f 4.75. Boter por stukje 5 ned. oncea 46% et Eüeren de 100 stulcs f 2.50. AMSTERDAM  8 Junij 1868. Nederland. Cert. Werk. Schuld . 2%pct. 53'% 541 X ' ' » •. 4 . 85 85'/. 85'/. Aand. Handelm. reik. .. . 131% 133 1311/ Aand. Holl. Spoorw 100 100% Aand. Centr.-Spw.-Maat».. . 11 Oblig. Centr. Spw.-Maatg. / 70 74 7u Spanje. Obligatiën 2%pct 28'% 29 29 dito Binnenl. ƒ 6250 3 a 28 28% 28 l'ortnsral. Obligatiën 3 pet. 39% 40 Obligatiën 1856-63 .3 «40 Hunlaud. Ins. sde Serie .... 5 « 58 531 Ins. 6de Serie .... 5 < 73 Oblig. to Lond 1862 5 ■ 77% Oblig. te Amst. 1864 5  87% 883/4 87'/a Oblig. to Lond. 1864 5  85i4 85* /s Oblig. bij Hope 1860 4% « 79% 79% Cert. van Assign. .. 6 » 355. Aand. Gr. M. Sp.. . / 170/ 172 170 V Aand. 5 pet. Rs. 100. .. ƒ 142 Polen. Obligatiën 4 pCt. 52 52% Oostenrijk. Oblig. Metaliek. .. . 5 pet. 3978 40 39% « f .... 2% . 20% 20% 20% « Rente Amst. . 5 > 62V 63% 62% » f inZ.1864 5 . 47' 47% 47'/ i tin 1865 5 a 46% 47% 46% » Nationale 1854 5 • 41 % 42'/. 41 % Aand. Nat. Bank j 564 565 Ween.Ad.4pet.fl.2so 1854 ƒ 149 150 » 15 f i 500 1860 « 305 306% » » 1 100 1864 1 50 50% Fr. Oost. Spoorw. Oblig. . . 97'/ 98 Italië. Cert. inschr 5 pet. 32% 35 Cert.L.&B.enß.&Z. 5 pet. 34 Turkije. Oblig. buit. 1865. .. 5 pet. 25% 25% Amerika. Vereen. Staten 1874 5 § — • 1 1881 6 1 69%  « 1882 6 » 67""' 68%6 67""/|» Min. Spoorw. Aand _ » Amst Cert 79 Brat Geldl. 1865 .. 5 pet. 64% 65 Mexiko Oblig. 1851 . 3 < 14% 15% j 5% Mexico Oblig. 1864 . 3 > 13 13% 13/9 Mexico Annd. 1865 frs. 500 104 105 Grenada Obligatiën . 2 pet. 29 Grenada Obl. gest. werk . . 11% ]i»'s Grenada uitgestelde 5% Venezuela Oblig.. . . 3 pCt 9% Ven. Oblig. leen. 1862 6 » 23 Oblig. uit do konv. . 6 pet. 17% 17% 17's N. Russ. Aand. 1866 132; Obl. Tunis 173; Veb' Ohio 52%. Koers van Geld: Bel. 6. Prol. 0%. De markt was heden in een doen handel en vari' ation waren op nieuw weinig beteckenend; allecII oostenrijksche blijven eindbeurs flaauwi gestemd. Geconf. 15'/; %. Grenada Heet. 40. Spaanscb» Pandbr. 62. Stoomdruk van L. E. BOSCH h ZO«W",http://resolver.kb.nl/resolve?urn=ddd:010783580:mpeg21:a0008:ocr,4,ddd:010783580:mpeg21:p004,Utrechtsch provinciaal en stedelĳk dagblad : algemeen advertentie-blad,865
3119064,1866/08/01 00:00:00,1538,ddd:110536604:mpeg21:a0025,http://imageviewer.kb.nl/ImagingService/imagingService?id=ddd:110536604:mpeg21:p004:image&x=97&y=4801&w=2028&h=1538,ddd:110536604:mpeg21,2125,6339,97,4801,8,üfËm Definitieve Keg-elingr der diensten van <lc IVed. Indische Stoomvaartniaatschappij. lieiliirciiilt' I Maarl lul m mei l 11. \hn\k\ iNlïti. Van Haiavla naar Singapore via Mi stok \ Umi win verbinding met de mail dienst van de I. Eu <>. Steam Navigation Co. als iv de maanden Julij op den Isten te loden. „ „ Augustus » „ Isten \ laden. „ „ ~ September / n Isten \ laden. „ „ „ October „ „ Isten .V loden. „ ~ November „ „ alen & lGden. z v ~. December „ „ 2den & 16den. „ „ Samara>g en Soerabaija den le'de l?e&2ssteu van elke maand. de boot die den '.'den vertrekt kan op aanvraag Chebibon Tav.m. & Pkkaloni.an aandoen. „ „  Stngkawang via Biu.iton & Pontianak en terug den uden. „ „ Benkoki.kn en Paoano / lOden V :2..sten. „ *o«»i*al»alja . Samabang en Batavia „ ie üe I7e & 25sten. „ „ „ Macass.vr Timoii de Moi.t kken & terug  lSden. „ „ „ Ban.iermassin via Baweah ii SOsten. door de Boot die den Pden van Soerabaija en den Uden van Samarasc vertrekt kan op aanvraag Pi;k.\i.iiN(. in. Taoai & ('iikhibon worden aangedaan. De Hoofd-Agent en Vertegenwoordiger I30t) A. KMAsKR. NB. naar de Moukken via Timor in de maanden Augustus October \ December. ii f „ Mknauo r Julij; September & November. Bk\T~ Vrarlu en passage te bespreken: te ttaiuaraiig bij McNEILL \ Co. i SoeraP>aja  FRABER EATON & Co,http://resolver.kb.nl/resolve?urn=ddd:110536604:mpeg21:a0025:ocr,4,ddd:110536604:mpeg21:p004,Bataviaasch handelsblad,2028
502758,1866/12/15 00:00:00,318,ddd:010113584:mpeg21:a0063,http://imageviewer.kb.nl/ImagingService/imagingService?id=ddd:010113584:mpeg21:p005:image&x=783&y=4734&w=1581&h=318,ddd:010113584:mpeg21,2364,5052,783,4734,6,ROTTERDAB-HARBÜRG-HAIBÜRfi De Stoomboot ELVE Kapitein G. J. HAVEN vertrekt Zondag ±6 December. (19805) De Agenten P. A. VAK IS & Co.,http://resolver.kb.nl/resolve?urn=ddd:010113584:mpeg21:a0063:ocr,5,ddd:010113584:mpeg21:p005,"Nieuwe Rotterdamsche courant : staats-, handels-, nieuws- en advertentieblad",1581
2131290,1866/05/26 00:00:00,2786,ddd:010332742:mpeg21:a0008,http://imageviewer.kb.nl/ImagingService/imagingService?id=ddd:010332742:mpeg21:p004:image&x=1617&y=167&w=765&h=2786,ddd:010332742:mpeg21,2382,2953,1617,167,4,"GOUVERNEMENTS SECRETARIE. Curacao den 18 Mei 1866. DV Gouvernements besluit van den 15 dezer *^ No. 291 is aan den Heer P. Cranereldt op zyn verzoek met ingang van den 1 Juny a. s. een eervol ontslag verleend uil de betrekking van Marktmeester op dit eiland. De Hoofd Commis belast met de functien van den Gouveruements Secretaris W. B. MELLINK. GOUVERNEMENTS SECRETARIE. Curacao deu 18 Mei 1866. DV Gouvernements besluit van den 15 dezer No. 292 is de Wachtmeester titulair der marechaussees A. Riedel met ingang van den 1 Juny a. s. belast met de functien van Marktmeester op dit eiland met toevoeging als assistent van den Marechaussee van Embden. De Hoofd Commis belast met de functien van den Gouvernements Secretaris W. B. MELLINK. TE KOOP by August Muller á kontant ÜOODE WYN by kisten van 50 halve "" flesschen ; Madera wyn by kisten van 25 flesschen en kisten van 50 halve flesschen; Rhynwyn by kisten van 24 flesschrn; Lil keur by kisten' van 12 flesschen ; Bier by manden van 25 kruiken; Oude Rum by damejeanen van 2 en van 2-V gallon ; alsmede Zwart en Blaauw Laken en Zwart Half Laken ; en ZEER SCHOON GE OF ZOUT. TB KOOP by T. & M. Capriles PP. PLANKEN RIBBEN en BALKEN. _-- ■ i | TB KOOP by H. P. Kranwinkel BESTE KWALITEIT STYFSEL. Curacao den 18 Mei 1866. TE KOOP by A. Schwarts IfOLLANDSCHE Hammen Gerookt * Vleesch baucises de Boulogne Haring in flesschen Zuurkool Snybooneu Boter in vaatjes van 10 lb Koek Banket Broodsuiker Pruim*11- Rosynen Notenmuskaat Raapolie in pullen Gekookte eu Ongekookte Lyuolie enz» Curacao den 11 Mei 1866.",http://resolver.kb.nl/resolve?urn=ddd:010332742:mpeg21:a0008:ocr,4,ddd:010332742:mpeg21:p004,De Curaçaosche courant,765
1078573,1866/01/21 00:00:00,710,ddd:010113713:mpeg21:a0015,http://imageviewer.kb.nl/ImagingService/imagingService?id=ddd:010113713:mpeg21:p003:image&x=866&y=627&w=1560&h=710,ddd:010113713:mpeg21,2426,1337,866,627,8,(1355) Voor zoo vele hartelijke deelneming  mij eu mijne familie betoond in het onherstelbaar verlies door het ontslapen mijner lieve zoo beminde Echtgenoote MARIA BREEDVELD mij overkomen  betuig ik mijnen innigen dank. 2i ___%%%_. »¦ DE ™N- Meeren Ontvangers der Birecte Belastingen in Zuid-Holland in wier Gemeenten voor 1860 op de Grondbelasting geheven worden 4L&J/_ opcenten op de gebouwde eu 37 op de ongebouwde eigendommen en die wenschen te ontvangen TARIEVEN TER BEREKENING van de hoofdsom der gebouwde en hoofdsom en rijks opcenten der ongebouwde eigendommen  gelieven een postwissel kf l te zenden aan hunnen ambtgenoot te Zwijndrecht. (1320) Voor dc vele bewijzen van deelneming betoond bij het overlijden van mijnen geliefden Echtgenoot den Heer H. W. PRILLEVITZ betuig ik b'j deze ook namens wederzijdsche betrekkingen mijn hartelijken dank. Rotterdam A. E. ZEEMAN 19 Januarij 18S6. Wed. H. W. Pkillevitz. (1333) Bij vonnis der Arrondissements-Regtbank te Rotter damzijn JACOBUS JOHANNES THIJSSEN en MARIA KROPMANS  Echtelieden uitoefenende het beroep van Winkelier wonende te Schiedam verklaard in staat van faillissement. In dit Faillissement ingegaan op den achttienden dezer maand  is benoemd tot Regter-Commissaris de Edel-Achtbare Heer Mr. JAN JACOB LOKE Regter in de Regtbank en tot Curator Mr. JAN KNOTTENBELT Advocaat te Rotterdam. De Curator 3. KNOTTENBELT.,http://resolver.kb.nl/resolve?urn=ddd:010113713:mpeg21:a0015:ocr,3,ddd:010113713:mpeg21:p003,"Nieuwe Rotterdamsche courant : staats-, handels-, nieuws- en advertentieblad",1560
985749,1866/07/06 00:00:00,457,ddd:010585522:mpeg21:a0011,http://imageviewer.kb.nl/ImagingService/imagingService?id=ddd:010585522:mpeg21:p004:image&x=128&y=1050&w=2157&h=457,ddd:010585522:mpeg21,2285,1507,128,1050,6,"TOEN BE CHOLERA. De onfeilbare MAAGOROPPELS van dr. STaPPEL die reeds honderden lijders aan Maagkwalen hebben genezen al v aren die ook nog zoo verouderd worden steeds ten zeerste aangeprezen. - Als preservatlef en zelfs ÏDeclflck middel teoen CHOLERA kan het ieder niet genoeg worden aanbevolen daar er velen reeds door Eelfzjn Het"" Middel werkt oogenblikkelijk>darendL en genezend en versterkt de-Ingewand»' «'J^^Zl Verdere aanbeveling overbodig. Te bekomen a r 1.50 de Flacon bij den Heer S. S. BEINTEMA .Apotnecar en riooiu St voor FreSd te Leemvarden en S. G. ZWART te Gorredijk. - Collega's die het Dépót wenschen vervoegenzich tot den Heer BEINTEMA. G. van MEETEREN  Apotheker te Utrecht. - Doofddepot.",http://resolver.kb.nl/resolve?urn=ddd:010585522:mpeg21:a0011:ocr,4,ddd:010585522:mpeg21:p004,Leeuwarder courant,2157
3866112,1866/05/12 00:00:00,5034,ddd:010113824:mpeg21:a0036,http://imageviewer.kb.nl/ImagingService/imagingService?id=ddd:010113824:mpeg21:p004:image&x=1654&y=85&w=768&h=5034,ddd:010113824:mpeg21,2422,5119,1654,85,8,"HEIPALEN te koop te Botterdam lang 14 a 25 Ned Ellen. Te bevragen by J. DE BREIJ  Goudschestraat Wijk 13 No. 591:'. .7777) Ifewsglj». ~ ~~TE KOOP: .S^'i32_£_L Eene fraaije ligt bij den weg loopende vry 'W en in goeden staat zijnde Groote BAROUCHET geschikt voor 12 personen. Te bevragen lij VAN RIJZEN Mr. Rijtuig- en Zadelmaker  Goudsche Wagenstraat te Rotterdam. (7791) L. SEIDEL J-.N.T Privaat Docent - Oppert 176 geeft onderwys in Talen Wiskunde  enz a f' _ per uur bij kwartalen te voldoen. (7784) CAFÉ WATÊHLÖÖ7 De ondergeteekende maakt het geëerde publiek kenbaar dat zijn LOKAAL is VERGROOT en voorzien van 2 goedloopende Biljarden. KRUISKADE  Wijk 14  N°. 594. (7798) J A. iarSLECERS. In het bezit zijnde van een Middel tegen de Rimderpcst hetwelk ik met een goed geweten kan aanbevelen en voor welks uitmuntende werking mij vele attesten der voornaamste Riddergoederen zijn ten deel gevallen bied ik dit TE KOOP voor 2 RclcllSthalcr per Quart en ben bereid onder iedere mij gestelde voorwaarde garantie te geven. De Homoeöpatische geëxamineerde Apotheker G. DOERRE te Greussen Thüringen (in Duitschland.) (7735) (7765) De ondergeteekende maakt met deze bekend dat hij heden zijn SPEKSLAGERSWINKEL GEOPET*.» heeft op den Goudsche Weg hoek van de Lange Warande wijli rf 3 no. S__; belooft alles te zullen aanwenden wat tot eene prompte en civiele bediening behoort. n Mef _7c6. J w- NAJS RU. mm TAK THEE. De TREEËIV uit het Thee-Magazijn van JAN VAK BEES «f* ZOON te Zwolle uitmuntende door Kracht Geur en bovenal door Waterhoudcndheid zijn voortdurend in verzegelde Pakjes vnn 2% en 5 Ons voorzien van Stempel Prijs en Nummer verkrijgbaar hij . C. J. W. SNABILIÉ Groote Markt No. 148 te Rotterdam alwaar Prijscouranten te bekomen zijn en bij A. J. VAST ROOSEIVPAAL te Dordrecht. (ó) IJZËRMËNIËvanAÜDERGHEI 14 Medailles en Eervolle Vermeldingen. Eervolle Vermelding. Tentoonstelling te Londen 18G2. Vcrwstoff uitmuntende door soliditeit door onschadelijkheid voor de gezondheid en door groote bezuiniging tot bewaring van IJzer Hout en Metalen. Adres voor Prospectus en Monsters bij de Heeren VAN DEN HELM & ZOON te Rotterdam en MASION ALBERT te Dordrecht. (7174) jgS»*s^^^*]? MIÉLINE RJIrIGELSON IHJ.««/Hf/Jlicir^ah » • Allcenig onfeilbaar belat »•*' 'af' 'j|st*ïïtS__ oogenblikkelijk: het uitvallen ¦* ''""raKlfiUWraßm 'i Tn he n<l!lr> •"" vernietigt ¦""* __»lalSl?_3__wi4* Toor a'loo* eebrorming der _\ __\\wÊ_sssih . rer flae°n ¦ tr- V_fi__?S__^____J_^ I DEPOT: Rotterdam bij ll_WrTlfc_tea<-lT%j_.a o_ooi;Ami.-T_!a_.bijUlot__; SXfij3Cr3KFK-SI-^| 'iGrinmhagc bij Rennes.* hoteutbainsdTlarösë; propriétaire PIERRE WEBER (auparavant tenu par Mme. Vve. KUBERj. Borcette prés d'Aix-la-Chapelle. Renouvcllé a neuf et comfortable nécessaire. 80 Chambres 20 Bains dont _t vapeur et douches. Vaste Jardin souree principale dans la Maison même. Prix modérés. (6914) EAMILII.-GROEPEK dezelfde prijs. FRANSCHE IJZERVITRIOOL CSulphas FerrosusJ blijft bij groote hoeveelheden voor den handel verkrijgbaar bij de Ondergeteekenden ; zoomede mededeelingen omtrent deszelfs gebruik ter deslnfeetatte van fecale Stoffen  Mestvaalten Slagtplaatsen enz. (7581) Rotterdam « r- MAI ¦ _P l»« 8 Mei 1866. U. ____« IWUI-U «Ui WÖRÏ^T~ENI3POEDIGSTE GEVRAAGD: Een Bekwaam (7769) MOLENMAKERSKNECHT tot November e. k. of welUgt langer op nader te bepalen Conditiën. Brieven franco doch liefst in Persoon aan N. H. BEVERSLUIS Mr. Timmerman en Molenmaker te Middelharnis Flakkee. _T_m_imm__~~WÖrdrGEVßAAGD om~da~deïijk |f HSp> of wel met I°. Augustus in dienst een Bekwaam HUISKNECHT voorzien van goede Getuigschriften. Adres in Persoou of met franco bri«ven Haringvliet Zuidzijde  12—42  alhier. (7767)",http://resolver.kb.nl/resolve?urn=ddd:010113824:mpeg21:a0036:ocr,4,ddd:010113824:mpeg21:p004,"Nieuwe Rotterdamsche courant : staats-, handels-, nieuws- en advertentieblad",768
553566,1866/02/21 00:00:00,141,ddd:010113744:mpeg21:a0015,http://imageviewer.kb.nl/ImagingService/imagingService?id=ddd:010113744:mpeg21:p002:image&x=96&y=2401&w=3926&h=141,ddd:010113744:mpeg21,4022,2542,96,2401,6,". . ________mmm^^mm^^ÊÊmÊ^me^^^memeemmm_mmeemm^_____________m__________mm_m__w___ _______^___________________________^^B^^^MmmaMmmma^__mm__m___mmm^ÊÊmm^^ Van een tot zes regels / 1.30. «= V^VTmm FSH ""HEB ""raT SVI TT TCT IWT Bovendien 45 Cents voor Zegelregt en een Nommer der Courant. Per gewonen regel «0.20. _____ JU? \§ Jö JS__ JL ____ ln JL JL Jtl Em ¦ Groote Letters berekend naar Plaatsruimte. REGELS geplaatst aan het slot van de Rubriek BINNENLAND van I—41—4 regels f 2.50; voor iederen regel meer 50 Cents.",http://resolver.kb.nl/resolve?urn=ddd:010113744:mpeg21:a0015:ocr,2,ddd:010113744:mpeg21:p002,"Nieuwe Rotterdamsche courant : staats-, handels-, nieuws- en advertentieblad",3926
1682901,1866/08/13 00:00:00,2101,ddd:010783629:mpeg21:a0003,http://imageviewer.kb.nl/ImagingService/imagingService?id=ddd:010783629:mpeg21:p002:image&x=2576&y=89&w=801&h=2101,ddd:010783629:mpeg21,3377,2190,2576,89,6,"ADVERTENTIE!^ CHOLERA-COMMISSiE. Tot den 10. Augustus ontvangen door de iRj/ A. H. SCHLüTER uit de bus: van L. ƒ i ; B' ƒ I;R. M /5; B. f1: N. N /2; diverse» ƒ 013. — H. W. Th. v. GOUDOEVER: van jV N. / 10. - Jhr. A. J. RETHAAN MACABF/ van v. d. K. uit Maastricht /10. — HERINGA van N. N. f 2.50; N. N. / 10; Mevrouw B. <>!; Zeist / 40; eenige buiten-gevers / 1. — MUjT BERG: van 11. 1 coupon / 12.57=. -S. »; VERNEDE: van Mr. C. uit Roermond / •>' spaarpot E. V / I. — NOLST TRENITE:^11 Mejonkvrouw I. B. de opbrengst eener ven0' ting van een dames handwerk ƒ '28.85 — ':• .1. DE BEER: uit de bussen van S van LooJJ 7 8; G. H van der Sandt & Cornp. f 'lls' Niekerk / 1.25; M J. C. Ham /1.75; de S»* tions Restauratie f 10 85. Totaal van deze week / 155 955. Totaal-Generaal ƒ18.861.905. Geschenken in Natura: van Noteboom. ' halve brooden; Diepenhorst '25 heele broodf'1' Schuurman 50 spijskaarfjes; Groeneveld e Reintjes Barreveld. VV. v. Soest elk 5 dage' soep; N. N. 10 pond vermicelli. NB. Rektilicatie van de vorige week: Bij Mr. P. C. WALLAIND: van N. N. /25- Nog is het niet de laatste maal dat wij o 0( ontvangsten bekend maken. Wij doen dat nt erkentelijkheid voor het reeds genotene tevens met vernieuwde aanbeveling voor '' vervolg. De steeds kleiner wordende opgaV „ van het getal aangetasten en overledej' moeten ieder die ze nagaat met bl^dsc' vervullen. Moge die blijdschap eene dankl>a' zijn en u bewegen waarde stadgenooten! ° i alles in het werk te stellen ten einde den no der nog overblijvende zieken en ueratellei""j f te blijven lenigen  totdat de laatste sporen "" ziekte zijn geweken.  NB. Zij die hunne pretentien ten laste <'* Commissie nog niet hebben ingeleverd word verzocht zulks zoo spoedig mogelijk te doe»-  Utrecht Namens de Commis5' 11 Augustus 1866. HERINGA  Voorzie' VAN BOI.II«Is: ïecret<^/",http://resolver.kb.nl/resolve?urn=ddd:010783629:mpeg21:a0003:ocr,2,ddd:010783629:mpeg21:p002,Utrechtsch provinciaal en stedelĳk dagblad : algemeen advertentie-blad,801
2059129,1866/10/04 00:00:00,2539,ddd:010783675:mpeg21:a0010,http://imageviewer.kb.nl/ImagingService/imagingService?id=ddd:010783675:mpeg21:p004:image&x=97&y=76&w=811&h=2539,ddd:010783675:mpeg21,908,2615,97,76,4,AP VER f ENTjEN. Vrü van do Regten van Zegel en Kegistratle ingevolge het Koninklijk besluit van den 6. September 186ö. no 62. V De BURGEMEESTER der gemeente Abcoude Proostdij; In aanmerking nemende dat door JAN HEIJNEMAN Veehouder te Abcoude aangifte is gedaan dat eene aan hem behoorende zwartbonte pinkvaars van zijn overige vee behoorlijk afgezonderd is lijdende aan de runderpest; Overwegende dat bet ter voorkoming van verdere verspreiding der ziekte dringend noodzakelijk is gedachte vaars onmiddelijk in beslag te nemen te onteigenen en af te maken; Gelet op de schriftelijke verklaring van den Rijks-Veearts der 1. klasse H. J. 11. STEMPEL dd. heden en op art. 1 der wet van den 15. September 1866 (Staatsblad N°. 150); RE§LUIT : Dat de zwartbonte pinkvaars van den Veehouder JAN HEIJNEMAN voornoemd onmiddelijk zal worden in beslag genomen onteigend en afgemaakt en na inkerving der huid onder bijvoeging eener genoegzame hoeveelheid ongebluschte kalk ter behoorlijke diepte begraven. Dit besluit wordt op de gebruikelijke wijze door afkondiging aanplakking en door plaatsing zoo in de Staats-Courant als in het Provinciaal Utrechtsch Dagblad  ter openbare kennis gebragt en in atschrift aan Heeren Gedeputeerde Staten en aan den Heer Commissaris des Konings in de provincie Utrecht medegedeeld. Abcoude den 3. October 1866. De Burgemeester voornoemd DE TOURTON BBUIJNS. lo de annonce betreffende de onteigening van eene zwart bonte kalfdragende schot vanden veehouder Hermanus deWildt voorkomende in ons blad van 2 dezer stond abusivelijk DE WILT in plaats van DE WILDT. Red.) • • Utrecht 1 October. Voorspoedig bevallen van een ZOON M. A. G. R. JORISSEN geb. Baronesse taets van amerqngen. *»* Voorspoedig bevallen van eene DOCHTER de Hoog WelGeboren Vrouwe CALKOEN—van Doorn. 's Gravenhage 3 Octoker 1866. %• Overleden te 's Hage den 27. September in den ouderdom van 54 jaren de Hoog WelGeboren Heer Jhr. Mr. H. A. WTTWAAL VAN STOEI WEGEN Lid van de Tweede Kamer der Staten Generaal Burgemeester der gemeente Kampen hartelijk gehelde Echtgenoot van Douairière WTTWAAL VAN STOETWEGEN geb. Sandberg. Huize Oldhorst bij Oldenbroek 29 September 1866. Eenige en algemeene kennisgeving.,http://resolver.kb.nl/resolve?urn=ddd:010783675:mpeg21:a0010:ocr,4,ddd:010783675:mpeg21:p004,Utrechtsch provinciaal en stedelĳk dagblad : algemeen advertentie-blad,811
1154440,1866/05/18 00:00:00,1085,ddd:010585508:mpeg21:a0015,http://imageviewer.kb.nl/ImagingService/imagingService?id=ddd:010585508:mpeg21:p004:image&x=1183&y=1117&w=1064&h=1085,ddd:010585508:mpeg21,2247,2202,1183,1117,8,V.Ril.-»»: Mr. R. IJ. WARMOL.B te Leeuwarden van de Kelders naar den Eewal letter it no. 10. S. TULP li.Gz. IX LEDER El_ H.IDKXKOOPER  is .illll. I .!> uit de Groote Hoogstraat naar de Voorstreek  Hoek van de Sacrautent_traat . Lett. I No. 332 Leeuwarden. -_ËM_!_'_* I> naar de Kleine Hoogstraat  nabij het Goitvcrnementsplein L. J. L. RADERSMA in Manufacturen die zich steeds in de gunst van zijne geachte Stad- en Landgenooten aanbeveelt. VKRA^KÏÏGvah WOONPLAATS. De Ondergeteekende berigt aan zijne Plaats- en Landgenooten  dat hij is VEHHTISD vau Haskerhorne naar Joure. Beveelt zich minzaam aan tot het uitvoeren van allerlei soorten van TIMMER- en METSELWERKEN alsmede tot het maken van Plannen enz.; hopende door eene nette en civiele bediening zich een ieders gunst te mogen waardig maken. CORN. H. PEN  Joure 12 Mei 1866. Timmerman.,http://resolver.kb.nl/resolve?urn=ddd:010585508:mpeg21:a0015:ocr,4,ddd:010585508:mpeg21:p004,Leeuwarder courant,1064
3531418,1866/03/28 00:00:00,3733,ddd:010507495:mpeg21:a0010,http://imageviewer.kb.nl/ImagingService/imagingService?id=ddd:010507495:mpeg21:p002:image&x=966&y=886&w=946&h=3733,ddd:010507495:mpeg21,1912,4619,966,886,2,"ADVERTENTIEN. *——■■■_a_l-Na:»T_____________a_a____^_i_______________^_i_. (jOuvernements-Secrclai ie. Paramaribo den 27 Maart I«6G. (4754) Ten verzoeke van HANS JUEGEN BLEICHEN wordt van zijn voorgenomen vertrek uit de kolonie aankondiging gedaan. De Gouvernements Secretaris E. A. van EMDEN. Gouvernements-Secretai ie. Paramaribo den 27 Maart 1863. (4755) Ten verzoeke van AUGUST HEINRICH RAETHLING wordt van zijn voorgenomen vertrek uit de kolonie aankondiging gedaan. De Gouvernements Secretaris E. A. van EMDEN. Gouvernements-Secretarie. Paramaribo den 27 Maart 1866. (4756) Ten verzoeke van de Weduwe SU SANA ELISABETH DOBLER geb. SCHLöB wordt van haar voorgenomen vertrek nit de kolonie aankondiging gedaan. De Gouvernements Secretaris E. 'A. van EMDEN. Gouvernements-Secretariè. Paramaribo den 27 Maart 1866. (4757) Ten verzoeke van JACOB ISAAC SPIERING wordt van zijn voorgenomen vertrek uit de kolonie aankondiging gedaan. De Gouvernements Secretaris E. A. van EMDEN. Gouvernements-Secrelarie. Paramaribo den 27 Maart 4866. (4758) Ten verzoeke van ADOLPHE DAN JON wordt vau zijn voorgenomen vertrek uit de kolonie aankondiging gedaan. De Gouvernements Secretaris E. A. van EMDEN. Gouvernements-Secretarie. Paramaribo den 27 Maart 4866. (4759) Ten verzoeke van MAT THE W HENRY MERRIAM ?J wordt van zijn voorgenomen vertrek uit de kolonie aankondiging gedaan. De Gouvernements Secretaris E. A. van EMDEN. I_ll_-ll I --_-_--_-_---_-____---_----- - ■■- l-»-l """"*"" H H ■„ II I-P Gouvernements-Secretariè. Paramaribo den 27 Maart 1866 (4760) Ten verzoeke van BISNEIJ O'BRIEN wordt van haar voorgenomen vertrek uit de kolonie aankondiging gedaan. Ds Gouvernements Secretaris l E. A. van EMDEN.",http://resolver.kb.nl/resolve?urn=ddd:010507495:mpeg21:a0010:ocr,2,ddd:010507495:mpeg21:p002,Koloniaal nieuwsblad,946
2355304,1866/02/08 00:00:00,2456,ddd:010529155:mpeg21:a0017,http://imageviewer.kb.nl/ImagingService/imagingService?id=ddd:010529155:mpeg21:p004:image&x=66&y=2336&w=959&h=2456,ddd:010529155:mpeg21,1025,4792,66,2336,6,"*#* Men vraagt op een buiten nabij Zeist in een klein gezin met Mei eene TWEEDE HEID  P. G. niet ouder de dertig jaren oud die netjes kan naaijen en met de drooge wasch omgaan. In persoon of met franco brieven  onder letter Z. bij J. W. EVERSZ Boekhandelaar  te Zeist. * * Men vraagt tegen Mei eene bekwame"" KEÜKENMEID  die haar vak goed verstaat «n van goede getuigen voorzien is niet beneden de 30 jaren oud; des zomers op een _ „..en bij Utrecht 's winters te 's Hage. Franco brieven onder letters W. C. bij den Boekhandelaar M. J. VISSERJe js Hage. KEÜKEN M E ï D. In Rotterdam vraagt men met 1° Mei tegen goed loon eene KEUKENHEID P. G. die goed kan koken en braden liefst eene geldersche of overijsseische niet beneden de 25 jaren oud en van goede getuigen voorzien. Adres met franco brieven onder letter X. bij de Boekverkoopers M. WIJT ra ZONEN te Rotterdam. ~^'Unl^BE_XblHEliltE de bonne familie denviron trente ans R. P. munie dun acte d'admission pour les quafre langues etc. désire trouver vers le- mois d'Avril ou de Mai une place de GOITVEMNANTE dans une familie respectable ou de SECONBANTE dans tin Institut de quelque nom. Les meïlleurs renseignements peuvent itre requis. Lettres affranchies n°. 54 aux libraires A. FAN HOOGSTRATEN $■ FILS hla Haye. Kerkmeesters en Notabelen der Hervormde gemeente te HOOGCARSPEL geven bij deze den welverdienden lof aan de Heeren L. van DAM ïn ZONEN Orgelmakers te Leeuwarden. Het door die Heeren voor zeer billijken prijs in de Kerk alhier geplaatste ORGELin gothischen stijl vervaardigd  met twee handklaviereu en pedaal twintig sprekende en vijf werktuigelijke registers en een windtóestel naar nieuwe constructie  voldoet in alle opzigten aan de verwachting en zal door ieder deskundige geroemd worden als een werk dat zijnen makers tot eer verstrekt. Genezing van Longtering | natuurmatig zonder eenig inwendig geneesmiddel. ■ Correspondentie in de Engelsche Fransche Italiaan-■ sche en Hoogduitsche talen. Adres W 25 postel restante te Heidelberg 'm Duitschland. | *** Te HUUR wordt aangeboden eene WAGENMAKER» met WOONHUIS en TUIN staande in den polder Groet nabij Kolhorn provincie Noord-Holland te aanvaarden 1° Mei 1866. Te bevragen bij M. ZWAKMAN te Schagen. Brieven franco^ • %* In de omstreken van Haarlem liefst Bloemendaal wordt TE HUUR gevraagd voor de zomermaanden 2 KAMERS met kost en gebruik van tuin voor eene Dame met eene Kinder-jufvrouw en een kind van 4 jaren ; den prijs van ƒ 60 per maand niet te boven gaand». Adres met franco brieven onder letter» E. P. bij den Boekhandelaar B. H. de RONDEN Utrechtschestraat bij de Keizersgracht te Amsterdam.",http://resolver.kb.nl/resolve?urn=ddd:010529155:mpeg21:a0017:ocr,4,ddd:010529155:mpeg21:p004,Opregte Haarlemsche Courant,959
1472707,1866/12/09 00:00:00,1247,ddd:010155879:mpeg21:a0013,http://imageviewer.kb.nl/ImagingService/imagingService?id=ddd:010155879:mpeg21:p002:image&x=1293&y=2876&w=1181&h=1247,ddd:010155879:mpeg21,2474,4123,1293,2876,6,"iftuevfenticit. MMËiIWIWRipiE De ondergeteekenden doordrongen van de wenschelijk— heid  dat ook te Rreda eene Vereeniging tot vrijwillige oefening in den wapenhandel tot stand kome hebben de eer bij deze aan Breda's weerbare mannen tlie genegen mochten zijn deel te maken van de eventueel daar te stellen vereeniging eene uitnoodigino te richten tot bijwoning eener BIJEENKOMST op Maandag 10 December a.s. des avonds te 7 uren in het Hof van Holland leu einde de noodige maatregelen te bespreken en te nemen om tot de oprichting daarvan te geraken. Breda 4 December 1866. ARN"". J. T. VAN ALPHEN. Mr. j[. VAN DER HOEVEN G. VAN ALPHEN Jr. TH. JANS. J. G. BLAESER. R. W. KLEUN. C. P. C. A. VAN DE GOORBERGH. J. A. MOORS. ED. GULJÉ. L. J. F. A. SCHMID. E. F. C. A. HENCKENS. A. W. WAGEMAKERS. P. J. HEYMANS.",http://resolver.kb.nl/resolve?urn=ddd:010155879:mpeg21:a0013:ocr,2,ddd:010155879:mpeg21:p002,Bredasche courant,1181
5624685,1866/11/30 00:00:00,5165,ddd:010585564:mpeg21:a0052,http://imageviewer.kb.nl/ImagingService/imagingService?id=ddd:010585564:mpeg21:p007:image&x=2293&y=364&w=1089&h=5165,ddd:010585564:mpeg21,3382,5529,2293,364,10,"Land ouiier Aruin» Notaris LEDEROER te Makkum zal ten verzoeke van den Heer S. HOEK-TRA  Cand.-Not. te 801-ward op heden Vrijdag den 30 November 's avonds 5 uur  bij W. H. Meijer te Wiimarsum  veilen : 3 b. S r. 60 e. (8 Ij pondm.) bijzonder go.d onderhoude* vruchtbaar BOUWLAND gelegen ouder Arum bekend ten kad. gem. Arum  sectie B no. 633  benevens een gedeelte in den WATERMOLEN  sectie B no. 614. In eigen gebruik bij H. P. Olingius te Arum. Aanvaarding dadelijk na de finale toewijzing. ylrkööpTei\er Zathe en Lalden onder RIJItGWI-.I&I*. Notarissen LEDEBOER te Makkum en VERWER .# Bolsward zullen jiuldiek veilen: Eene vruchtbare ZATHE en LAKDEW met HUIZINGE. SCHUUR VARKENSHOK en Tuin c. a. staande en gelegen aan de Harlinuervaart op liiemert onder Burgwerd groot 15 b. 85 r. 20 e. (431/4 pondm) alle Greidlanden  bij Bauke Kiem*rs Huitema tot St. Petri en Mei 1867 ï» huur en alsdan te aanvaarden. Conditiën te vernemen en verkoopboekjes te verkrrge» bij de Notarissen. Gegadigden ki'tnen Donderdag den 13 December 1860 's namiddags 3 uur bij J. S. Postma te Bolsward. Land oxder wmiAßBi.lL Notarissen OOSTERHOFF en LEDEBOER te Witmarsum en Makkum zullen op heden Vrijdag dea 30 November 's avonds H uur bij W 11. Meijer te Witmarsum veilen. Een uitmuntend stuk BOUWLAND gelegen onder Witmarsum  de Spoke Vier genaamd kadaster dier g meent» sectie C no. 710 groot 1 b. 55 r. 40 e. (4 i/4 pond). Aanvaarding dadelijk na de finale toa wijzing. Huizinge en .Erf ONDER AaLMjaEHSJJM. De Notarissen OOSTERHOFF en LEDEBOER te Witmarsum en Makkum zullen op' Zaturdag den l Dt-cembar 1866 's namiddags precies 2 uur ten huize van Sijbren J Kuipers bij de Kimswerdertille aan den Zeedijk onder Kimswerd . veilen : Eene HUIZINGE en ERF met E_ieu_inge e. a. waart» Woonhuis  Stalling voor Koeijen en Paarden  staande en gelegen aan den voet van den Zeedijk onder Almenum kadaster gemeente Sexbierum  sectie A no. 996 ter grootte >an 3 r. 45 e.  bij Sietze Kienstra in huur. Vrij te aanvaarden den 12 Mei 1867. Land oFliAAiifiEiißtiiE^ ONDER AEÏI. DeNotarissen OOSTERHOFF en LEDEBOER te Witmarsum en Makkum zullen op Zaturdag den L December 1865 's avonds 6 uur bij S. v. d. Plaats te Arum veilen: a. Een stuk uitmuntend BOUWLAND liggende op Baarderburen onder Arum kadaster dier gemeente sectie B no 294 groot 1 b. 29 r. 70 e (3 I__ pond.). b. Een stuk dito BOUWLAND gelegen aldaar  kadaster sectie B no. 296 groot 89"" r. 50 e (2 1 2 pond). c. Een stuk dito BOUWLAND liggende aldaar _# Breede Akker genaamd kadaster sectie B no 247  groot 19 r. 90 e. en no. 962 groot 5 r. (V 4 pond). Aanvaarding dadelijk na de finale toewijzing. RUS M ERF TE PiNGJIïH. De Notaris OOSTERHOFF te Witmarsum zal met regterlijke magtiging op Maandag den 10 December 1866 des avonds 6 uur  bij S. N. de Boer te Pingjum veilen: Eene in den jare 1854 nieuw gebouwde HUIZINGE c. a. te Pingjum bestaande in 2 Woonkamers  bij Fokke Hoving en Comelis Tij metra als huurders bewoond  kadaster secti» A no. 978  groot 93 el en no. 979  groot 85 el. Vrij te aanvaarden 12 Mei 1867. De conditiën zijn intussehen- te vernemen ten kantor* van voornoemden Notaris. VERHURING TE PIXGJMI. De Notaris OOSTERHOFF te Witmarsum zal op Maandag den 10 December 1866 des avoi-ds 6 uur bij S. N. de Boer te Pingjum  publiek verhuren : Voor hjaar: Een stuK uitmuntend BOUWLAND gelegen achter den Dijk onder Pingjum sectie A no. 80 groot 1 b. 17 r. 90 e. (8 l/4 pond) eigen aan Jaeob Tol. Voor 2 jaar: Een stuk dito BOUWLAND gelegen onder Pinjgum sectie A no. 522 groot Ib. 11 r 20 e. (3 pond.) eu een stuk dito GREIDLAN D aldaar sectie B no. 676 groot 1 b. 37 r. 20 e. (312 pond) eigen aan Saapke Tol. — Te aanvaarden de Bouw dadelijk eu de Greide St. Petri 1867. ÏËÜÜ EN LAM TE OLDEBÖOR\T~ "" De Notaris EVERTSZ zal op Maandag 10 December 1866 's avonds 7 uur bij Kimstra te Oldeboorn linaad verkoopen : 1. Eene ruime en wel betimmerde HUIZINGE met Erf en vrije -.teeg ten oosten op een gunstigen stand aan het oosteinde vau de Weeze te Oldeboorn arm deu Straatweg naar Beetsterzwaag en de mier de Boom; te aanvaarden 12 Mei 1867 ; waarop slechts geboden is ƒ 1750. 2. Eene HUIZINGE en ERF aan deu Grindweg bij da Brug te Oldeuoorn; dadelijk te aanvaarden ; staauda op ƒ 440. DEZELFDE NOTARIS zal op Woensdag 12 December 1866 's avonds 7 uur bij Raadsveld te Oldeboorn  finaal verkoopen : 1. 1-15-50 uitmuntend WEILAND te Oldeboorn te» zuidoosten van de Gebuurte. 2.2-89-20 d.to HÖOILAND in Zomerjwjder aldaar beide perceelen b.evoonegt met Weg n*|(J!öldehö'orh.; dadelijk te aanvaard* Staande perceel l op ƒ 1380 en perceel 2W££j2lSiQ. F.KRATI""... 'e advertentie Verkoop^jj_slgsÈjy|JE laud te Akk. _j froadtfn door Notaris EVwKTSZ^ voorkomende op 4 .'s* bet lste ' [ ( had dé  gebodcue som van ""perceel I moeten zijn f 5500.",http://resolver.kb.nl/resolve?urn=ddd:010585564:mpeg21:a0052:ocr,7,ddd:010585564:mpeg21:p007,Leeuwarder courant,1089
2232802,1866/11/10 00:00:00,2321,ddd:010529335:mpeg21:a0019,http://imageviewer.kb.nl/ImagingService/imagingService?id=ddd:010529335:mpeg21:p004:image&x=60&y=81&w=962&h=2321,ddd:010529335:mpeg21,1022,2402,60,81,4,"Kiesdistrict HOORN. Bij de aanstaande verkiezing van een lid van de Tweede- Kamer der Staten-Generaal wordt door de ondergeteekenden met aandrang eu volle overtuiging aanbevolen een mau in het district woonachtig en algemeen erkend als onafhankelijk kundig en onpartijdig de Heer H. MEXSDVIDES Burgemeester te Hensbroek en Obdam. Namens eenige kiezers in het district A. W. van der DEURE te Hauwert. H. BALK te idem. 11. KOSTER te Twisk. K. MOLENAAR Baasdorpermeer. HOOFD-KIESDISTRICT HOORN. Bij de herstemming op 13 November e. k. over een Lid voor de Tweede Kamer der Staten-Generaal voor dit district wordt deu kiezers aanbevolen : de Heer Mr. W. TERPSTRA te 's Gravenhage. Door hunne Medekiezers C. J. BEK iv de Rijp. S. APPEL „ „ „ C. GRAFTDIJK te West-Graftdijk. P. HONIG te Zuid- en Noord-Schermer. ""~ MEDEKIEZERS IX HET DISTRICT HAARLEM! Dringend noodigen wij n bij deze uit op Dingsdag 13 dezer getrouw ter stembus op te gaan bij ac herstemming van twee Vertegenwoordigers voor ons district ter Tweede Kamer der Staten-Generaal en met ons uwe stemmen uittebrengen op de beide Leden der ontbonden Kamer: M\ J. H. GEERTSEMA Cz. bn MR. A. S. van NIEROP. De eerste werd nog in den loop dezes jaars met het vertrouwen des Konings vereerd die hem tot zijnen Minister van Binnenlandsche Zaken koos en met eere bekleedde hij die hooge waardigheid. De tweede werd in 1864 in twee districten Hoorn en Haarlem gekozen; hij nam het onze aan. Ook hem te herkiezen is onze pligt. Eene eer zal het voor ons district zijn de beide bovengenoemde mannen onze Vertegenwoordigers te kunnen uoemen. Beide werden. eens door ons gekozen. Beidp waren en blijven die keuze ten volle waard. Ja. AVIS Cz. ) ... . C. DEKKER Jz. ) ""<*'*""'»'■ T. ÜUIJVIS Jz. j „ h „ P. HONIG Cz. | Ko°9 «>* z""a't' A. HOUTTUIJN. j „ . Jb. VIS Pz. ) ZnandVk- S RO\T Assendelft.",http://resolver.kb.nl/resolve?urn=ddd:010529335:mpeg21:a0019:ocr,4,ddd:010529335:mpeg21:p004,Opregte Haarlemsche Courant,962
5197830,1866/12/11 00:00:00,3135,ddd:010783735:mpeg21:a0015,http://imageviewer.kb.nl/ImagingService/imagingService?id=ddd:010783735:mpeg21:p004:image&x=70&y=1493&w=1658&h=3135,ddd:010783735:mpeg21,1728,4628,70,1493,4,"Bij de meeste Boekhandelaren is voorhanden de NIEUWE PROVINCIALE ATLAS VAN HET  g ___ DER :l Vee Atlassen _ het Koningrijk der Nederlanden zien het licht P_| _ QOCn noe voortreffelijk eenigen mogen zijn bestaat er geen die alle •■''_/^§l%•'•:•'•' __| lS behoeften kan bevredigen. Wie Nederland of een zijner deelen uit ™ ! een maatschappelijk of staathuishoudkundig gezigtspunt wil leeren :-;*""!%_|[^\* '■'«lir'' kennen zoekt te vergeefs naar provinciale kaarten waarop de wars V-imÊESI-'--;V'.:'SS_i"";"": verdeeling harer grootte is aangegeven. Moge het al heeten dat op ';ftvS_xTis ::V.?;.■■*•'•: sommige kaarten de grenzen der arrondissementen en kantons zijn /::\^/:_.t^:. gebragt die verdeeling is doorgaans zoo ellendig geteekend dat de kaart — al ware ze in alle opzigten onberispelijk — daardoor totaal I wordt bedorven. Hei is bij toeval zoo een enkel grenspunt met de waarheid overeenstemt; want zonder eenige kennis van de werkelijke nitgestrektheid der onderscheidene districten zijn de lijnen alle»n  »op de gis"" getrokken dat is om de dorpen heen die in eene of |Z»HOLL»ND| andere naamlijst als deelen van zoodanig district zijn aangegeven. In»hdll»nd ; li De gedurige nabootsing van zoo valsche teekeningen bewijst hoe ■ |- > 19.5 -'-JtM groote behoefte bestaat aan hetere voorbeelden. Zelfs mannen wier naam 03 -_j Sjj* a'B aanbeveling voor topographische kaarten gold of nog geldt lieten 3 '3 z'c"" t'oor e vaar S'ss'nn geteekende kaarten op dwaalwegen voeren. SjßP'&r  O ■''':-''SM: '•'■' Wil iemand in aeie leemte voorzien door het aankoopen van pi BM'§BoB | I^3 _T- ''l&MfiM''-' speciale kaarten op last of onder begunstiging der provinciale besturen IB ' 03 S *_!s__?■ uitgegeven hij moet zich eene opoffering van circa f 200 getroosten RjSEjJg !§! J^H  zonder geheel voldaan te worden. -•aHrtiii Wt w « -. Deze Atlas levert in alle opzigten eene trouwe af beelding des lands. pWWBB fl' 22 I—l jg_s__jj) Alle jongste veranderingen zijn er op gebragt namelijk de nieuwe k^ËMïJP?' J:^f spoorwegen kanalen slroomwerken indijkingen straat- en griendwegen ""T 3 9 I 1 nieuwe dorpen en gehuchten de hoogte van eb en vloei op xee en 1 utrecht"" I § g  suunc 1 rivieren ._e hoogte van de belangrijkste heuvel- en duintoppen; de I Sj SS *. l_ J - *'<?''' ""**""■ 'aay»k polders; de uitgestrektheid der nieuwe ontginningen. J| « —« <8a Daarenboven is eene uitvoerige statistiek bewerkt door den heer § c 3 «£ P. H. Witkamp aan iedere kaart toegevoegd behelzende: bestanddeelen __Jj pj _ rffi __ll ** *»**»' £™o«<! en bevolking der gemeenten ; onderscheidene oude '•■'■': '■'■'■% Ö 'V 3 verdeelingen; mdeelitig in kiesdistricten zoo van de staten-generaal i:g^vÈÊ-':'■'■ ""_ &2 als van de provinciale stalen; regterlijke en administratieve verdeeling; ;r^fejpfV tchooldisl'rieten § kerkelijke gemeenten; militiedistricten ; postkantoren !SlPi_§|__S |""© 33 ielegraafkantoren die zoowel voor den geaohiedvorsoher en =.£.. O den magistraat als den koopman au iederen staatsburger K^E_|;.: | Er* O. :: JJ vau veelvuldig belang in. *&';v'""^^ Hx 'a _»___ Bi [GRONINGEN | | LI MBURO. | [~D R ENT HEI Bekroond met dö medaille op de nationale tentoonstelling in het Paleis voor Volksvlijt te Amsterdam. Vervaardigd naar de Topograpnische au Militairs Kaart van het Ministerie van oorlog en naar Scbetsen der Gemeente) door P. H. WITKAMP geteekend en gegraveerd door A.. J. SMULDERS. De gïhtelï atlas met bijvoeging van eene zeer nette uitvoerige kaart van het KONLNGBUK DE& .NEDERLANDEN met de daarbij behoorende statistieken titel en omslag kost slechts __<__T C_T_TXj_>_E!_r. Wegens de groote oplage geschiedt de algemeene verzending 15 December. '«H:i_o<_bosch kn 'sGiuv*N_as DE UITGEVEES HENRI BQGAERTS en J. MULDERS * C*>.",http://resolver.kb.nl/resolve?urn=ddd:010783735:mpeg21:a0015:ocr,4,ddd:010783735:mpeg21:p004,Utrechtsch provinciaal en stedelĳk dagblad : algemeen advertentie-blad,1658
9231000,1866/04/16 00:00:00,4250,ddd:010140660:mpeg21:a0016,http://imageviewer.kb.nl/ImagingService/imagingService?id=ddd:010140660:mpeg21:p003:image&x=1133&y=1122&w=2172&h=4250,ddd:010140660:mpeg21,3305,5372,1133,1122,6,Brouweri^raetit Hoek Meizersffracltt * SS 536« Onze CHEMISCHE VÈRWERIJ. en NIEUW-WASSCHERIJ. bevelen wij bij voortduring in de protectie onzer respectiv'ö Begunstigers zoowel binnen als buiten de Stad aau onder verzekering de ons op te dragen zoo groote als kleine Commissiën te zullen in orde brengen met de meeste zorg en tot billijk gestelde prijzen. Ook VERWEN wij van STAATSIE-en LEDEKANT-GORDIJNEN. ZIJDEN JAPONNEN en STUKGOEDEREN EERST STAAL TER BEOORDEELING. PRIJSCOURANTEN zijn steeds op franco aanvrage te ontbieden bij *• WIN XE L & COMP. (9276) van Ij. HIRSCHFSXJ) & C°««> ÜoÊïïi M !^5 WORDEN ALLE GOEDEKEN ONDER GUARANTIE VOOR HOOGST REËEL EN SOLIDE VERKOCHT EN VOOR DE DEUGDZAAMHEID ZELFS NA DE WASCH INGESTAAN. Het Magazijn is van eenen enorm grooten voorraad voorzien zoodat men eene buitengewone keuze in kwaliteit en patronen kan aanbieden. LINNENS in 4/4 9/8 5/4 R/4 8/4 tot 12/4 breedte. Echt Handgcspin zuiver Linnen Garen van Bielefeldsch Hernhutter Greifenberger. Russisch ECHT HENNEP-LINNEN Osnabrücker Bohcemsch lERSCH Silcsisch Brabandsch Overzeesch Kortrijksch Ylaamsch fabriecaat in do grootste sortering van meer dan duizend stuks voorhanden in stukken van 50 tot in de 60 el het stuk van af ƒ 15 16 18 20 25 tot en met het fijnste ƒ5O. TAFEL- en SERVETGOEDEREN in zuiver Linnen en in half Linnen als: Een TAFELLAKEN zuiver Linnen van ƒ 1.50 2 tot 5; in half Linnen het Tafellaken van ƒ1 25 tot ƒ 3.50; TAFELSTELLEN met 6 en 12 SERVETTEN; ZAKDOEKEN in Linnen en half Linnen het half dozijn van 75 Ct ƒ1.25 tot 4; HANDDOEKEN MADAPOLAMS GRASLINNEN SHIRTING WATERTWISTEN KEPER DIEMET PIOUE MOLTON OOGJ.SSGOER RLOKJ.ESGOED  SERVETGOED aan het stuk. GORDIJINKATOEN. DIEMET' ÏLANELLEN ROODE WOLLEN TAFELKLEEDEN OVERHEMDEN in geheel Linnen en van Madapollam met Linnen Borsten en Linnen Manchetten. THEEDOEKEN voor de keuken het half dozijn 65 Ct. betere en beste soorten vau af 20 tot 50 Ct. per stuk. Vingerdoekjes in Damast. het half dozijn ƒ 1.50. GORDIJNEN' NETELDOEK effen gestreept geborduurd damastetreej) in stukken van 13 El tot 32 El in verschillende soorten en prijzen. ECHTE LVONSCHE ZWARTE ZWARE ' ZI.IDE Prima Kwaliteit de el van af ƒ 1.50 tot en met de beste ƒ 3.50. CRINOLINES in de allerbeste kwaliteiten en de nieuwste modellen van af ƒ 1 tot ƒ 5.75 het stuk. OVERTROKKEN CRINOLINES die tegelijkertijd als BOVENROK kunnen gebruikt worden met de nieuwste RANDEN en ook met VOLANTS het stuk van afƒ3 tot 6. JONGE JUFVROUWEN CRINOLINES (Cages) van 16 Rijen Veeren tot 30 Rijen Veeren het stuk vaa ƒ1.50 1.75 tot die met 30 Rijen Veeren a/2. (9220) L. limSCIIFELD y €  Rokin E IGO. É hebben ontvangen eene bniSengewoon mooije sortering FASSEUf Ei\TEME]\T in alle soorten CMMILÏMES van af 60 Cents tot Fl. 8 en noodigen hunne geëerde Begunstigers vriendelijk uit deze Nouveautés te komen bezigtigen. ¦ ¦¦ (8789) ÜH GHOiriIMENSE DE: ~~ fITI7~ C€*STUMUS COHPIjGTS (Mobe et Casaque) AÜJL PODR PROMENADE TÓÏAGB CAIPAGSE ET EADX. VILLES en ALPACA FOULAMVDE LYON nr » MOM AM SULTANE m^nn » LENOS ' TON MN rRANIiE » TOiLEDEWICHY CIIISSAILLE heerengraciit k PARTIR DE FL. 25 TOUT CONEECTTONNÉ.- pjès (Mnfeeiimm cm soie et cm €Mimap9 mCmw^pjvm ROBES ÏI MET PODR COSTiffi x 37 ' & PARTIR DE EL. 35- (8893 ' BORSTELWEBR. DAIwIBAK L 135. 001TWAUEN. Het Magazijn van f. H. HUYGSN & ZOON is steeds ruim voorzien van alle sooren van Borstelwerk en Houtwaren voor Huishoudelijk- Stal- en Scheepsgebruik ook voor Exr.oi-latle. |^p- Goede kwaliteiten en billijke prijzen. {mn) Saisoen van 1 Mei Tusschen Keulen .tot .15 Oot. en Coblcnts AAN DEN RIJN IN HET ROMANTISCHE AHRDAL. ALKALISCHE 20 tot 40 gr. CELSIUS WARME THEfIfffiAALBRONNEIV van zacht oplossende maar tevens versterkenda werking vooral in Ziekten der Ademhaling*- en Verteringsorganen tegen Galachtigheid Graveel Rheumatismus Jicht ongesteldheden van Blaas en Uterus. Door de bekwaamste Geneesheeren ook bijzonder aanbevolen als KLIKATISCHE BADPLAATS voor Borst- en Zenuwliiders. Het KOEH HOTEL met de Post- en Telegraaf bureaux staat in regfatreekseke verbinding met de BADEN LEESZAAL en BOEKERIJ. Het Hotel GARNI MARUAYSPRUDEL insgelijks Baden namelijk Gaz-Baden is nabij den Koertuin en de Bronnen gelegen. Tusschen Neuenahr en de stations Remagen en Sinzig bestaat dagelijks veelvuldige postgemeenschap en buitendien rijden getarifiëerde huurrijtuigen. Gedurende het Voor- en Nasaisoen zijn de Logiesprijzen matiger. Men heeft er ook Apotheken. Even als  vroeger wordt in het Koerhotel Evangelische en Engelsche Godsdienstoefening geHonden. AUGUSTA- VICTORIA- en SPRUÏÏEI.WATER. verbeterde wijze van Vulling per kruik aan de Bronnen 2. Sgr.; o«k ! NEUENAHR-FASTILLEN zeer dienstig bij Maag-ongesteldheden (indigestie) -per doos 8 Sgr.; alles met gebruiksaanwijzing van do Directie of de Depots te ontbieden. ; (8551) J3JST CORK steam-ship-companYT ®Èü ROTTERDAM EM MVERPOOfj. HET STOOMSCHEOEFSOHIP EGRET 1000 Tons Kapt. JAMES DORAN Vertrekt van Rotterdam naar Liverpool ZONDAG MORGEN 22 APRIL (9291) . Aires bij den Agent Ph. VAN OMMEREN.,http://resolver.kb.nl/resolve?urn=ddd:010140660:mpeg21:a0016:ocr,3,ddd:010140660:mpeg21:p003,Algemeen Handelsblad,2172
1376934,1866/10/27 00:00:00,1651,ddd:010113535:mpeg21:a0022,http://imageviewer.kb.nl/ImagingService/imagingService?id=ddd:010113535:mpeg21:p004:image&x=872&y=3402&w=834&h=1651,ddd:010113535:mpeg21,1706,5053,872,3402,8,"URBANUS PILLEN ï Bereid volgens het aloude en oor- 8 spronkelijke voorschrift. Zij zijn een onfeilbaar Geneesmiddel voor Gal- ] Slijm- en Maagongesteldheden slechte Spijsvertering. Zij versterken het Gestel verdrijven de Huiduitslagen  verwekken Eetlust zuiveren het Bloed en verdrijven Hoofdpijn. Vorige jaren wareD deze bij anderen verkrijgbaar doch nu zijn de van ouds beroemde alleen en doorniemandanders voor ouder staande Steden door tusschenkomst van onderstaande Heeren verkrijgbaar. (16996) Te Botterdam C. JF. W. S!V<VBI__IE. Amsterdam T.C VAW SOWLaurierstraat FP7. A Dordrecht 3. EJ-in Jr. Middelburg G. L.de Jager. 's Hage J.L.F.C.Snabilié. Nieuwveen Doctor S isse. v Gouda C. Hoog. Uden  J. G. Pulser. Mathenes 3. Vons. VlaardingenG.N.Hóehel. JJ TANDMIDDELEN LAROZE I MET KINA KAVIJLWORTKL EN POKHOBT Voor het behoud van de tanden en eon het tandoleesek. g TAND-ELIXIRE om de tanden wit te maken en te 8 conserveren en de pijnen te genezen veroorzaakt h door bederf of te weeg gebragt door aanraking met k iets warms of iets kouds. Prijs f. » ÏS. b ROSÉ TANDPOEDER A BASE DE MAGNÉSIE om * ds tanden wit te maken en te conserveren enhet le*. d raken daarvan te voorkomen veroorzaakt doorliet VOU T«wTnan ll(U den terugkeer belet. Prijs f. » 70. v * i OPIAAT lot versterking van het tandvleeseh dat hei geZOnd hoiult; tot voorkoming van bederf der e' CttblÏttp ""i?£feliek! aandoeningen. Prijs f. .80. v' v^A IFl DENJAIRE tot bet hygiënisch plomberen h «n zieke tanden tot hot doen ophondeS vin het -2 bederf van Aeze en liet voorkomen van fenwerinnu ÏV en pijnen welke zulk» veroorzaakt. De flacon l"" vet? I knjjèbaar met of zonder instrument. Priis fa. Deze TANDMIDDELEN gaan steeds vergèieidvJ; ____ V' gebruiksaanwijzing voorzien van het Fabriekmerkren 61 JT. P. LAROZE rue des Lions-St-Paul 1 teParör T Hoofddepöt te jlmslerdaro bij H.H.m«Ui apotheker. d Botterdam: Wed. DE KOSTER Hoogstraat oon°. 487 ;M. CLOOS (Friesche Apotheek) Hang E wijk 2 n°. 441; 's.Gravenhage:.. SNABILIÉ. L Utrecht: GROOTENDORST; Arnhem: OTTER- g< BEIN en Deventer: V.B. MOEB Apoth. (12238) di",http://resolver.kb.nl/resolve?urn=ddd:010113535:mpeg21:a0022:ocr,4,ddd:010113535:mpeg21:p004,"Nieuwe Rotterdamsche courant : staats-, handels-, nieuws- en advertentieblad",834
199949,1866/10/20 00:00:00,79,ddd:010791425:mpeg21:a0018,http://imageviewer.kb.nl/ImagingService/imagingService?id=ddd:010791425:mpeg21:p006:image&x=8&y=4299&w=2531&h=79,ddd:010791425:mpeg21,2539,4378,8,4299,6,TE 'S GRAVENHAGE TER ALGEMEENE LANDS-DRÜIOOERIJ.,http://resolver.kb.nl/resolve?urn=ddd:010791425:mpeg21:a0018:ocr,6,ddd:010791425:mpeg21:p006,Nederlandsche staatscourant,2531
3391808,1866/01/19 00:00:00,3164,ddd:010585474:mpeg21:a0007,http://imageviewer.kb.nl/ImagingService/imagingService?id=ddd:010585474:mpeg21:p002:image&x=2296&y=2349&w=1072&h=3164,ddd:010585474:mpeg21,3368,5513,2296,2349,8,"HEERENHUIS lET TIM €. 1. Vit de hand TE Hl' Vil voor den tijd van vijf jaren: Een HEERENHUIS met grooten van diverse Vruchtboomen voorzienen Tnin  _Vagei__.tt.is en Paardeiistaltlng  staande en gelegen in de nabijheid van de Buurt van den dorpe Kimswerd en aan den Grindweg. Voorts ongeveer 92 roede puik WEIDLAND onder Kimswerd en nabij gemeld Heerenhuis gelegen. — Nadere informatien te bekomen bij den Heer R. A. de RUITER te Harlingen. ~TË ÏlITR7ÖPI2 MEI 18667 Twee roijale in aanbouw zijnde INTREKKEN met vrije Opgangen  bestaande ieder in 5 ruime Kamers  één met Alcove  Keuken  Zolders  Regen- en Putwaterspomp  doorloopend Privé en verder van alle gerijllelijkheden voorzien ; de eerste verdiepingen geheel geplafoneerd. Een dito ONDERHUIS bestaande in 2 groote roijale Kamers  dito kleine Alcove groote Keuken  Plaatsje en verdere gerijfelijkheden  een en ander staande op het aangenaamste der Oosterkade te Leeuwarden ; te bevragen bij den Aannemer E. J. VISSER in het Droevendal alhier. TE HUUR wegens sterfgeval: Eene uitmuntende sints jaren beklante GROFSMEDERIJ met completen Inventaris  zeer ter nering staande HUIZINGE groote SCHUUR en Tuin  van alle geriefelijkheden voorzien  op Mei eerstkomende of des verkiezende dadelijk te aanvaarden. Te bezigtigen en verdere inlichtingen bij den Ondergeteekende bij wien ook de briefjes gesloten en franco vóór of op den 15 Februarij eerstkomende moeten worden ingediend. Noordwolde. Wed. P. K. GROENEWOUD. Tl. HITÏTft * Een BURGEKHUIS aan den Buiten-lEi II Li Lil . Cingel Noordergracht lett. P no. 45 aldaar aan Huis te bevragen. 12 Mei e. k. te aanvaarden. ~mW\ 111 in op 12 Mei 1866: Een HUIS. 'J'|J II met 4 Vertrekken groote Keulij Il ken en verdere gemakken op J.U II U lIH 9 de Put te Leeuwarden. Te bevragen bij A. PIETERSON  op de Tuinen aldaar. Een HUIS TE HU F. in de Weerdt  te bevragen aan de GROOTE SOCIËTEIT alhier.* lÜßim^ Men verlangt in bovengenoemde Steden ten spoedigste TE HL..EN : Een HUIS geschikt tot uitoefening eener nette zaak. Reflecterende adressere men zich met franco ™f_i_. 01lder letters R"" S- - b;J den Boekhandelaar B. DEKEMA  Lijnmarkt te Utrecht. EEN ROIJALE INTREK TE HUUR op de breedzijde van de Nieuwestad. Te bevragen bij G IJPES Koek- en Banketbakker te Leeewarden."" BIT DÏ HAND TE HBBR: ~"" Een HUIS met twee Kamers een ACHTERHUIS me vier Koestallen en 1-10-23 (3 pond) zeer vruchtbaar Greidland gelegen aan den Nieuwe Dijk nabij Harde garijp  te bevragen bij den eigenaar H. L. FEENSTRA te Hardegarijp. ~WWlhnd~te koop: Eene florissante HUIZINGE en HERBERG met alle oeden' aan den Kunstweg te Bozum en he HALVE SCHIP en VEER varende in de vaste beurt va» Bozum op Leeuwarden en Sneek. Te bevrasen bij H. MEI JER te Bozum. °",http://resolver.kb.nl/resolve?urn=ddd:010585474:mpeg21:a0007:ocr,2,ddd:010585474:mpeg21:p002,Leeuwarder courant,1072
774272,1866/03/23 00:00:00,736,ddd:010140623:mpeg21:a0030,http://imageviewer.kb.nl/ImagingService/imagingService?id=ddd:010140623:mpeg21:p005:image&x=1142&y=80&w=1052&h=736,ddd:010140623:mpeg21,2194,816,1142,80,6,"Tm ntJiiM Met I°. Mei te aanvaarden zeer net GESTOÏEEERRE KAMERS matig m prijs op de Heerengracht in de nabijheid van den Dam. Adres iranco onder lett. A. Z'„ bij do Kantoor-Boekhandelaars BEEKMAN & SCHOUTE Rokin 144 (6866) BHtTHMëf Een vrij BOVENHUIS ""f HU3SJ(E den huurprijs van f 150 a f 160 met te boven gaande in den omtrek van den Buitenkant Binnenkant Gelderschekade Waal Oudeschans of omtrek. Opgaaf van stand en huurprijs franco ouder lett. B„ bij den Kantoorboekverkooper J. J. WIJCHERS Oude Leliestraat bij den Singel. (6942) GEIÏ2EÜBILEERÖE VOOR. EN ACHTERKAMERS met doonoopende Alcove gelijkvloers en suite iv ecu stil gezin  zijnde °J o™ e lc.amel's van een Bovenhuis o» de Leidschestraat Huurprijs ./300 per jaar. Te bevragen bij den Boekhandelaar J.C. GOOSSEN S bt. Luciensteeg E 384. (6988)",http://resolver.kb.nl/resolve?urn=ddd:010140623:mpeg21:a0030:ocr,5,ddd:010140623:mpeg21:p005,Algemeen Handelsblad,1052
499225,1866/01/12 00:00:00,1051,ddd:010113703:mpeg21:a0019,http://imageviewer.kb.nl/ImagingService/imagingService?id=ddd:010113703:mpeg21:p003:image&x=3047&y=4028&w=475&h=1051,ddd:010113703:mpeg21,3522,5079,3047,4028,8,Sectii&ittöeu- Brouwereh. (ZW.) 11 Jan. Niets gepasseerd. KeUei oet. (Z.t.W.) Aangek. 113an.Zephgr(a) Londen Bij Dungeness van loods voorzien: .FVeyGallas v.N.-Yorkn. Rott. Vertrokken. Prins v. Oranje (s) Duinkerken Albert(s) Huil De st. Adm. Cator eu Levant zijn van Goereehaven n.zee. Brielle. (ZW.) Aangekomen. 11 Jan. Orion (s) Londen Vertrokken. Ravensbury (s) Harwich Texel. (WNW.) Aangekomen. 10 Jan. Z.M. kotter Vlinder Adriaans Tenig uit zee llDionysia Catharina Berkelbach v.d.Sprenkel Batav. vertrok 14 September. Zeilklaar Botterdam 11 Januarij. ïnvïcta Hopkins Bochester,http://resolver.kb.nl/resolve?urn=ddd:010113703:mpeg21:a0019:ocr,3,ddd:010113703:mpeg21:p003,"Nieuwe Rotterdamsche courant : staats-, handels-, nieuws- en advertentieblad",475
5700472,1866/05/07 00:00:00,2866,ddd:010140695:mpeg21:a0016,http://imageviewer.kb.nl/ImagingService/imagingService?id=ddd:010140695:mpeg21:p004:image&x=38&y=2474&w=2172&h=2866,ddd:010140695:mpeg21,2210,5340,38,2474,4,~ TE HOOR WEGENS VERPLAATSING. *. . I*^**< gelegen op een der beste standen van de Keizersgracht bevattende Zes Kamers Meidenkamer een groote en kleine Kelder twee Zolders en Vliering verder voorzien van Duinwater Binnenplaats en Tuintje tegen 15 Mei of I°. Junij te aanvaarden. Huurprijs f 620 per jaar. Franco brieven onder lett. A. Z. aan SCHLOMANN'S Boek- en Muziekhandel Vijgendam. ' (11328) IËIUEVOLGE VAN UOOIDAWwöRDËT «TE SOOP AAMERODEH; de STOOMSCHEPEN bëregier en AUHOCJAVAa. elk van 1000 Ton en dc STOOMSCHEPEN thaksis en pkwgo elk van 600 Ton Ladingsruimte benevens de OVERNEMING van de POSTDIENST tusschen CADIX en de CANARISGHE EILANDEN voor den tijd dien het tegenwoordig Contract nog te loopen heeft. Aanbiedingen voor gezamenlijke of afzonderlijke Overneming van een en ander moeten vóór den Sisten Mei e. k. ingeleverd worden ten Kantore van. de Heeren BOFILL MARTORELL & C . in liquidatie te^Barcelona^bijrwietevensnadere informatien te bekomen zijn. (11322) Een Eigenaar van een uitgestrekt terrein te Amsterdam en door hem daarop uitgevoerd-woraende FABRIEKMATIGE ZAKEN van DAGELIJKSCHE BEHOEFTEN zoekt door het overlijden van zijn Compagnon .weder een medewerkend DEELGENOOT die zich met de administratie zoude willen belasten en fn staat is tot het drijven der zaken wanneer die zulks vorderden suceessivelijk plus minus 40 mille te kunnen fourneren. Bijzondere kennis wordt hiertoe niet vereischt daar de zaken zeer eenvoudig en vatbaar zijn en tevens gcnoegelijke bezigheden verschaffen. Men adressere zich met franco brieven lett. X Bureau Handelsblad. (11297) ƒ 160. PIANINO. 7160. Door Sterfgeval biedt men te koop aan een Brillant 7 Octaafs PIANINO groot obliek voorzien van ijzeren platen en stangen besloten in eene fraaije kast met vergulde ornamenten. Te bevragen bij den Boekhandelaar W. C. BERK Prinsengracht bij de Leidschestraat CC 492. Brieven franco. (11298) Bij E. S. WITKAMP Koningeplein te Amsterdam is uiter-Éfeven de Eerste Aflevering van: MAA_¥B§CHIIÏFT VOOR DE ARREIDENDE KLASSE. Inhoud. Leesvereenigingen. — Goedkoop tijdschrift voor de arbeidende klasse. — Verslag van het verhandelde in het Paleis voor /Volksvlijt omtrent Arbeidersvereenigingen. — Patroons Werklieden Werkloonen. — Arbeidersvereenigingen. — Benj. Franklin. 40 bladz. kl. B°. in gedrukten omslag 20 Cts. Bij abonnement per halfjaar van 6 afl. f 1.20 of bij vooruitbetaling te Amsterdam 90 Cts. elders franco per post tegen franco toegezonden postwissel ƒ 1.121. (11242) f io9000. Voor TIEN DVIZEND GULDEN TE KOOP: Eene in volle ; -werking zijnde FABRIEK van dagelijksche behoefte met al derzelver losse en vaste gereedschappen waartoe vorder weinig kapitaal benoodigd is. Adres franco onder letter A. F. B. Bureau Handelsblad. (11334) WIJNKOOPERSKNEGHT. In eenen voornamen WIJNHANDEL te Amsterdam worat verlangd ' een bekwaam WI.INKOÖPERSKNECIIT zijn vak ten volle kundig van goed zedelijk gedrag en in staat als oudste knecht voor te gaan. Reflecterenden adresseren zich met franco brieven onder lett. M. X. bij de Boekhandelaren M. SCHOONEVELD & 'Lts. Beurssteeg aldaar. (11339) . ITALIAANSCH BOEKHOUDEN ! *;r. Eng. & Hoogd. Talen. Voor ƒ SO wordt in bovenstaande vakken grondig en volkomen onderrigt gegeven door een Bekwaam Boekhouder en Correspondent k Brieven franco lett. H. B. bij de Beekh. M. SCHOONEVELD & Zn. I te Amsterdam. (11335) Voorradig eene uitgebreide keuze in nieuwe ZIJDEN PALETOTS en ROTONDES. Alsmede in wollen Stoffen tegen mijne bekende billijke prijzen. J. C. NOOTEBOOM DELGORGE (11342) Heerengracht bij de Heisteeg XX 118. ATTfEMTIiE. Men biedt op het vrolijkste en aangenaamste gedeelte van Hees ({ uur van Nijmegen) TE HUUR aan voor de Zomermaanden of langer eenige net gemeubeleerde APARTEMENTEN met kost en .ediening. Adres met franco brieven onder lett. W. S. aan het Hulpkantoor te Hees bij Nijmegen. (11299) IAMTOOR-LOGAAL. Met I°. Junij komt TE HUUR in dc nabijheid der Beurs een KANTOOR-LOCAAL met ALCOVE (geschikt tot Bergplaats) a ƒ 200 's jaar. Terzelfder tijd TE HUUR eene GESTOFFEERDE VOORKAMER met ruime ALCOVE. Brieven franco onder lett. K. T. Bureau Alg. Nederl. Advertentieblad Damrak H 161. (11206) LET WEL. TÈTISTÊRDAI in een der voornaamste Koffij huizen en Logement wordt gevraagd om zoo spoedig mogelijk in dienst te treden een EERSTE BEDIENDE bekend met de Fransche taal. Degenen die niet in dergelijke betrekking zijn geweest maar hiertoe lust en geneigdheid fevoelen kunnen evenzeer in aanmerking komen men zal echter van e beste informatien moeten voorzien zijn. Adres franco brieven onder lett. H. M. bij den Boekhandelaar H. W. MOOY Heerengracht bij de Leliegracht. ('1282) GJ A _LIkIST B RI BW» Hiermede heb ik de Eer te berigten dat ik de zaak in GALANTERIEN in de Kalverstraat hoek Naauwe Kapelsteeg E 38 van den Heer J. F. SIERERG heb overgenomen en noodig het Geeerde Publiek uit mij wel met hunne genegenheid te willen bevoorregten de verzekering gevende dat ik niets onbeproefd zal laten mij dit in alle opzigten waardig te maken. _.._.„._ (11309) «• ¦*¦• vAN EIJK. ~ WOLLENNAAIJEN. JONGE JUFVROUWEN die het Wollennaaijen grondig wensehen te leeren kunnen dade 1 ii k geplaatst worden. Adres franco onder lett. U. W. bij de Boekhandelaren M. WESTERMAN & ZOON Kalverstraat E 5(1 te Amsterdam. (11308) _OMÏRTOR-OT_ In de omstreken van Nijmegen en Cleef waar men heerlijke Environs heeft biedt zich de gelegenheid aan in een Hotel van den Eersten Rang voor Ontbijt om twaalf uren Koffij Diner Thee Souper vrije Kamer en Bediening voor ƒ 1.50 per dag. Brieven franco mder lett. H. 0. Burean Handelsblad. (11255) _e.4_¥D¥o__tM_ËRi ; runnen dadelijk geplaatst worden aan de Fabriek 'van STOOM ! i EN ANDERE WERKTUIGEN van J. ZIMMER & ZONEN (11321) ALHIER. I,http://resolver.kb.nl/resolve?urn=ddd:010140695:mpeg21:a0016:ocr,4,ddd:010140695:mpeg21:p004,Algemeen Handelsblad,2172
3130855,1866/04/03 00:00:00,2044,ddd:010113784:mpeg21:a0010,http://imageviewer.kb.nl/ImagingService/imagingService?id=ddd:010113784:mpeg21:p006:image&x=102&y=109&w=1558&h=2044,ddd:010113784:mpeg21,1660,2153,102,109,6,"Jf\\ ligt in Lading lik D E Cl M A jJJII_^ kana'gawa gÉSBÉfiffISJH« voor goederen eu het extra snelzeilend nieuw gekoperd Nederlandsch Barkschip JACOB Kapt. J. Mtjldeb Dbenth  om zeer spoedig te ver trekken. Adres bij de Cargadoors P. A. VAN ES & C°. en VLIERBOOM & SUERMONDT alhier en DE CONINGH &¦ C°. te Amsterdam. (1828) Voor PASSAGIERS enGÖEDËREK. gi SURINAME JLYl\\ . ligt te Amsterdam ***pfPv\. COosterdok) 73jiilyKV\ in Lading IU^RIL liï^'^7 om ™ en 00P der maand April _*£All&^vim-^*«»^ te worden geëxpedieerd : C*3m IjfIWEEIEJ 'iet Sun9t'S bekende Geko- ÜÊS§£ mmW perd Clipper-Brikschip PAEAMABIBO Kapitein T. Jaski » met deszelfs comfortable Hutten en elegante Inrigtingen voor Passagiers. (5107) Adres HOIJMAN en SCHUURMAN. ?'""Ki Te Amsterdam L_JknJ\ . ligt ln lading jËf^ NEW:YORK rimlfw|W?A\ voor PASSAGIERS en -?- hot snelzeilend gekoperd 3§! B^*_§_fïl||lfiSi *s*e klasse Noorweegs.-he ¦nwiiWli Wr-«lW»*la.'-/ Clipper-Barkschip AMIXTA** .3/3 l i.i. Kapitein Jacob B. Böckmann. Vertrekt 10 April. Adres bij de Cargadoors Ths. BREUKER en VINKE & Co. te Amsterdam en RUYS & KELLAR  te Botterdam. (4810) ROTTERDAM EN HULL. Voor Passagiers en Goederen. Het Stoomschip Albert Kapt. Th. Hutton  vertrekt van Rotterdam naar Buil Woensdag 4 April des avonds. (5320) Adres SEEUWEN Sf Co. ROTTERDAM EN HULL. Stooinbootdienst voor PASSAGIERS en GOEISEBBSI. Het Engebche Stoomschroefschip Sea Mor Se Kapitein John Ceoss  vertrekt van Rotterdam naar Buil in den nacht van Dingsdag op Woensdag  3/4 April ten 12 ure. (5387) Adres bij de Agenten BOUTMY Sr Co. ROTTERDAM EN LEITH. Stooinbootdienst voor PASSAGIERS en GOEBEBEIV. Het Engelsehe Stoomschroei'schip Osborne  Kapt. J. Johnston  vertrekt van Rotterdam naar lielth Zaturdag den 7den April des morgens vroeg. (5373) Adres bij dc Agenten BO UTMYSf Co. Wekelijksche Stoomvaartdienst TUBSCHEN . (3154) BOTTERDAM ffl DUINKERKEN. Het Stoomschip Prins van Oranje Kapitein D. Visseb  vertrekt des Woensdags van hier en Zaturdags van Bulnkerken. Adres bij de Cargadoors JOHs. O OMS Ez. S( Co. DE STOOMBOOT DEN BOMMEL zal in plaats van Woensdag den 4den April aanstaande den vorigen dag des namiddags ten 1 ure van Rotterdam vertrekken. (5354) De Stoombooten ZUID-WILLEMSVAART N°. _ „2 die gewoon waren op Maandag van Veghel te vertrekken  zullen zoo lang het verbod van invoer van Vee in Engeland zal voortduren voortaan des BlngSdagS van Veghel om 4= ure 'smorgens naar Botterdam afvaren. Van de tusscheniiggende Plaatsen op dezelfde uren als vroeger 's Baandag». (53C0)",http://resolver.kb.nl/resolve?urn=ddd:010113784:mpeg21:a0010:ocr,6,ddd:010113784:mpeg21:p006,"Nieuwe Rotterdamsche courant : staats-, handels-, nieuws- en advertentieblad",1558
827661,1866/10/21 00:00:00,1049,ddd:010113529:mpeg21:a0091,http://imageviewer.kb.nl/ImagingService/imagingService?id=ddd:010113529:mpeg21:p008:image&x=1651&y=61&w=789&h=1049,ddd:010113529:mpeg21,2440,1110,1651,61,8,TE HUUR EEBRUARIJ OP MEI VOOR ƒllOO 'SJAARS: Een kapitaal BOYENHUIS aan de Westzijde van de Leuvehaven. Adres tusschen 12 en 2 ure bij D. VAN AMEYDEN VAN DUYM & ZOON Schiedamschen Singel. (16713) TE HUUR AAN DE KRUISKADE: BOYENHUIZEN van ƒ 375 tot ƒ 150; Ecu BENEDENHUIS met TUIN f 240 per jaar. Te bevragen inde Gouvernestraat Wijk F  No. 22. (16701) DOOR STERFGEVAL TE HUUR: Een _.et BENEDENHUIS en TUIN voorzien van __a*_toestel en verde»-e Gemakken huurprijs f 200 per jaar. Adres met franco brieven  onder het nommer dez sr advertentie. aan het bureau dezer Oourant. (16722) TE HUUR~VOOR ƒ 600 's JAARS~ Een HUIS gelegen aan een der kleine Havens van de buitenstad bestaande in net ingerigt BOVENHUIS KANTOOR en licht en luchtig PAKHUIS 12/374. Aldaar tebevragen. (16641),http://resolver.kb.nl/resolve?urn=ddd:010113529:mpeg21:a0091:ocr,8,ddd:010113529:mpeg21:p008,"Nieuwe Rotterdamsche courant : staats-, handels-, nieuws- en advertentieblad",789
3252387,1866/03/14 00:00:00,3217,ddd:010484446:mpeg21:a0013,http://imageviewer.kb.nl/ImagingService/imagingService?id=ddd:010484446:mpeg21:p002:image&x=2120&y=2769&w=1011&h=3217,ddd:010484446:mpeg21,3131,5986,2120,2769,8,Per Mail ontvangen: Het Eerste nummer van de Nieuwe Rotterd. Mail-Courant 1866 en aan de Abonnés verzonden. Abonnementen tegen vooruitbetaling van ƒ 40— steeds te bekomen bij de Agenten G. KOLFF & Co. te Battvia. DE GROOT KOLFF k Co. Samarang. (1392) THIEME KOLFF & Co. te Soera'mija. Nieuwe Uitgave. Zelfbewaring. Een GENEESKUNDIG VOLKS HANDBOEK over de genezing der Zenuwen-verslapping vau het Ligchaam als een gevolg van geheime gewoonten of buitensporigheden die de verrigtingen waartoe de manbaarheid den mensch iv staat stelt vóór den tijd uitputten alle hoop op nakomelingschap vernietigen en het huwelijksgeluk in gevaar brengen door de vervulling te beletten vau de verbindtenissen die een der grondslagen vau het leven zijn ; — door Dr. LA'MERT No/37 Bedford Square te Londen Lid van het Heelkundig Genootschap in Engeland enz. Hij is dagelijks ten zijnen huize te consulteren. Wie niet bij hem kunnen komen worden met goed gevolg door middel van briefwisseling behandeld en de Geneesmiddelen worden in het geheim en op veilige wijze naar alle deelen der wereld verzonden. De ZELFBEWARING (La Préscrvation Personelle) versierd met zeer veel Afbeeldingen is verkrijgbaar bij de Boekhandelaren H. M. VAN DORP te Batavia en G. C. T. VAN DORP te Samarang. PRIJS/ I—. De Geneesmiddelen zijn alom verkrijgbaar. IVI3. Men gelieve opmerkzaam te zijn dat de éénige uitgave van dit Werkje onder toezigt en met toestemming van den Schrijver Doctor SAMUEL LA'- MERT gedrukt die is die verschenen is bij IL A. MEIJER te Amsterdam. (1395) «bevestigd in 1833. BRISTOL'S SARSAPARILLA. In groote kwart Flesschen. Steeds te bekomen in het Hoofd-Depöt te Batavia bij G. WILCKE (1397) Rijswijk's Apotheek — Batavia. Let weil Particuliere Posterij TUSSCIII-N Batavia en Buitenzorg. p^- 30 nieuwe Kngelsclie %P^s& Reiswagens ter beschik- W?%ié%^%>l?^? king der Reizigers. Jt__ngelselie JEt eis wagen 4. paarden f 30—. Adres: op Weltevreden naast het Postkantoor en bij G. K. VAN DER MEULEN ten kantore van de Heeren A. A. VAN DER CRAB & Co. (1372) F. GREMER. ' Door en Boekhandelaar 11. ]\l. vau Dorp te Batavia is uitgei**^ geven en alom verkrijgbaar gesteld: De inlijving van het Landschap PASOEM AH (MET EEN SCHETSKAARTJE) door J. S- Gr. Gramberg. (1410) Prijs / 3—.,http://resolver.kb.nl/resolve?urn=ddd:010484446:mpeg21:a0013:ocr,2,ddd:010484446:mpeg21:p002,"Java-bode : nieuws, handels- en advertentieblad voor Nederlandsch-Indie",1011
5489176,1866/10/30 00:00:00,5159,ddd:000010718:mpeg21:a0018,http://imageviewer.kb.nl/ImagingService/imagingService?id=ddd:000010718:mpeg21:p004:image&x=56&y=56&w=1064&h=5159,ddd:000010718:mpeg21,1120,5215,56,56,10,"LOADINfI IN LONDON for CALCUTTA the twin Screw-Steamer FarEast A.l 12years sailing Novbr.24. Freight £5.— — & 10 %• 'i YOKOII IMA the fine Clipper llifie A. 1 13 years sailing Novbr. 25. Freight 50 shillings and primage. ii VWKOIIAJni and NAGASAKI FAiza S/iaw A. 1 15 years Bailing Novbr. 20. Freight 50 shillings and primage. ' SAN FRANCISCO Ivanhoe A. 1 13 years sailing about Novbr. 10. Freight 45 shillinf-s and primage. Fer Freight apply to the Agents KALTENBACH & SCHIHITZ (24874) 1. Alderman'B XValk London. De Ondergeteekende heeft de eer te berigten dat door het in werking treden zijner STOOMFABRIEK de prijzen der Vlaggendoeken aanmerkelijk zjjn verminderd beveelt zich beleefdelijk in do gunst van HH. Exporteurs Zeil- en Vlaggenmakers aan. IM. VAN WEEREN Fabriekant in Polemiet Camlets Saai en Vlaggedoek. Leïdex October 1866. l-irf •iiwi / (24D01) VOOR ƒ5OOO TE KOOP DOOR TOEVAL Een nieuw HUIS waarin thans eene flinke WINKELZAAK wordt uitgeoefend staande op do ilorissantste streek eener zeer welvarende plattelimdsclie Gemeente van 10000 zielen in Noord- Nederland waar vele Affaires op verre na niet ep de hoogte van den tijd zijn. Hot Koopschat kan grootendeels beleend blijven tegen 4. pCt. Adres: NAPOLEON HIRSCH & CO. Warmoesstraat te Amsterdam. Brieven franco. (24661) GEEN T«il- OP KIESPIJN MEER. Oogenblikkelijke pynverligting zonder den zieken tand of kies aan te doen door de beroemde TA ND WOL van BERGMAN & C°. te Parijs. Het pakje met gebruik kost 50 ets. Brieven franco aan het Hoofddepot van Nederland bij M. CLKBAN Huidenstraat 278 Depot te Arnhem bij GEBRs. VAN DEN HEUVEL Baarn bij VAN NIEUW CASTEËL Hoogkarspel bij DE WIT Nijmegen bij W. J. WILLEMSE Leyden bij SWEMER Utrecht bij VAN ANTWERPEN Vlissingen bij GASILLE Zierikze bij DE JONG ZIJLSTRA Monnikendam bij KEIZER. (24380) ¦^jËIII lilii ¦ WHI IBil ii II WVmWM nmmmmmmmmmmmthi KEELZIEKTEN Ontsteking van den Mond PASTILLES VAN PETHAN WET lOIT VAN BEKTHOLLBT Ainbrvol.n do&r de gcnccshecrcn In de Parijsche en Belgische hospitalen tegen fceeliiekten _ecl""ernaauwinf. eroup iwecren en ontste-inf -an den mond. Zij zetten lenigheid aan den slokdarm bij maken dc stem friseh Terfceteren een kwalijk riekenden adem nemen de prikkeling wes door het Kebruik van tabak veroorzaakt en bestrijden den -erderfeltjkeu invloed dien het kwik op den mond uitoefent. TAND OPIAT VAN OETHAN HET ZOUT VAN BERTHOLLET Aanbevolen aan hen wier tanden uitvallen en weibrokkelen wier tand leejeti bloedt als onk aan hen die gebruik maken van kwik; hel onderhoudt ook de witheid der landen. TANDPOEDER EN TANDEUXIR MET ZOUT VAN BERTHOLLET .—. Hun reuk hun aangename smaak hunne versterkende ca vcrfrisichcide |_? .ig-nsehappen maken hun gebruik onschatbaar voor het toilet en hoogst i_ iiuti;* voor hit bi-huud der tanden. Zij verdrijven monduntstekingen ver- — frissrhen den mond vn bevorderen eiae gematigde ca behoorlijke aalivatie. Zij w word«u gezamenlijk gebruikt. HOOFD-DtPOT VOOR NEDERLAND : Te Parijit Apotheker Delban Vontadt St-Denis 90.—Voorts bijd» Apnthrk. rslllolli te Amsterdam;— Van Naaten Kolft en Hl. Cloas IJiuif; -J/lil le Rotterdam;—Snofollleen Van llrurme te'« Haje;— 01l il.rln tt Arnhem; — Ton de Moer te Deventer; — Ityooort van ~_eiir» i. Dordrecht; — Mlraatmon ti't Hertogenboteh¦;— l«e)«« le Le.dcn von de Kamer te Middelburg;— Van Berk (i Kir.uwedi'-p;—(.loolcnd-rit Ie Utrecht;—Ha-jelo te Zttlfhsn;— IMeolcnllolf. te Zwollt. fmMVBmWgmWBSaWafMm^mmVSBmWÊÊgÊggBmWÊgÊKÊm^t Troote prijsmedaille eerste^kusseT A Q'PÏIIVI A Drukking op de Borst Verstikking beklemde AU 1 JuLllliJL. Ademhaling gelenigd en genezen door het FAFIEH ItKOl  Chemist te Parijs Boulevard Sebastopol 104 Leverancier van verschillende Hospitalen Goedkeuringen der heroemdste Geneesheeren. Prijs/ 1.50. Hoofd-Dépot te Amsterdam in de Pharmacie Francaise bij H. H. ULOTH Zeedijk. Depots bq de Apoth.: Alkmaar SCHUT Arnhem OTTERBEIN Deventer VAN DE MOEB Enschedé HAZENBERG  Gorinchem SUURHOFF #¦ ZOON Gorredijk ZWART Gouda BOEKENOOGEN Groningen LEEK Haarlem VAN MARLE 's Hage SNABILIE  Leeuwarden S. BEINTEMA Levden REYdT Midd.dburg VAN DE KAMER Nieuwediep VAN BEUK Rotterdam CLOO3 Utre-rit VAN OLST Zierik.eo DE LOOZE Zutphen HASSELO. (24151) mnmm mum g^MSw^Sk BEDERF VAN HET BLOED pii&^Jcffl HUIDUITSLAG. \fy\mm\\ Èlgff^r Spoedige genezing en in het geheim <X!^ BE s7j__rvan Pr'm^ieve ol> constitutionnels ziek- ten der beide seksen door de BISCUITS DÉPÜRATIFS VAN Dr. OLLIVIER te Parijs. In dit aangenaam en gemakkelijk geneesmiddel zijn de actieve beginselen chemisch verbonden met de voedende bestanddeelen wat nunne vertering gemakkelijk maakt en oorzaak is dat zij doordringen tot in alle organische vezelen waar zij den wortel van het kwaad •wegnemen waaruit radicale genezing voortvloeit. Dit belangrijk resultaat  dat uitsluitend de zoogenaamd alimentaire methode van Dr. OLLIVIER kenmerkt zou door goen ander geneesmiddel onder do gewone pharmaceutische vormen verkregen kunnen worden. Nadat vier jaren lang openbare proefnemingen genomen en met den besten uitslag bekroond waren% zijn do BISCUITS OLLIVIER goedgekeurd door de Académie impériale de Médecine geauthoriseerd door de Regering en is bovendien eene belooning van 24000 francs toegekend aan Dr. OLLIVIER. — De BISCUITS worden met goed gevolg aangewend tegen alle ziekten welke voortspruiten uit bederf van het bloed of uit scherpte der vochten. — Vooral genezen zij zeer spoedig de geheime ziekten den huiduitslag de scrofulense ziekten van welken ernstigen aard van welken vorm of hoe verouderd ook herhaalde accidenten aan mond neus oogen en ooren rheumatieke pijnen jeukingen roode vlekken in het aangezigt enz. — Te Parijs ruePernelle N°. 13. Consulten gratis met gefrankeerde brieven. (24655) HOOFD-DEPOT VOOR NEDERLAND: Bij de HH. H. 11. ULOIH Apoth. Zeedijk te Amsterdam. DEPOTS Bij de HH. Apotlis. VAN RENESSE en J. L. F. C. SNABILIE te 'sGravenhage; VAN BERK te Nieuwediep; STRAATMAN te's Bosch; V-D.KAMER te Middelburg- CLOOS in 't Hang te Rotterdam; GROOTENDORST te Utrecht; A. J. EAASEN te Tiel; D. TIMMERMAN 'e Roermond: APPELBOOM t« Bergen' ' Zi-.rikzfr-: .1. g. L^EK  tt ö «i iHLJIS&«v. d. MOER te LVventer; BEINTEMA te Le*>tV'«den HASSELQ te Zutphen- BOEKENOOGEN te' <Gouda Blieven xtauco.",http://resolver.kb.nl/resolve?urn=ddd:000010718:mpeg21:a0018:ocr,4,ddd:000010718:mpeg21:p004,Algemeen Handelsblad,1064
759924,1866/04/06 00:00:00,909,ddd:010113787:mpeg21:a0015,http://imageviewer.kb.nl/ImagingService/imagingService?id=ddd:010113787:mpeg21:p003:image&x=43&y=1746&w=836&h=909,ddd:010113787:mpeg21,879,2655,43,1746,8,DE ROTTERDAHSCHE KATOMBMKKIEI. De DIRECTIE heeft de eer Heeren AANDEELHOUDERS kennis te geven dat op de Algemeene  gehouden den 4den April 11. het DIVIDEND over het eerste boekjaar 1865 is bePaald op 8 % of Tachtig «uiden per fwideel welk Dividend van af heden tegen intrekklng vau Dividend-Bewijs n°. 1 ten haren Kantore *ordt uitbetaald. «otterdam 5 April 1866. (5498) rNAAR (5588) -Ia jersey f^J_p\ het Engelsche Schoenerschip d^\SEABIRD _S_Hmlm--_ Kapt. Tir. Nuttau.  wl WB om na arrivement spoedig te Adre» de Cargadoors HUDIG & PIETERS.,http://resolver.kb.nl/resolve?urn=ddd:010113787:mpeg21:a0015:ocr,3,ddd:010113787:mpeg21:p003,"Nieuwe Rotterdamsche courant : staats-, handels-, nieuws- en advertentieblad",836
5040128,1866/11/21 00:00:00,4922,ddd:000018709:mpeg21:a0022,http://imageviewer.kb.nl/ImagingService/imagingService?id=ddd:000018709:mpeg21:p003:image&x=2126&y=89&w=1024&h=4922,ddd:000018709:mpeg21,3150,5011,2126,89,6,"De Notaris 11. ter HORST te Blokzijl zal op Vrijdag 30 November 1866 des avonds 7 uur ten huize van VV. DROST te Blokzijl voor de Erven van wijlen den Heer G. PIJKEREN finaal verkoopen: 6 Perecelen Hooi-. Weide- en liitcrd ij kaland • te zamen ingezet op / 10563. TiANUFACTIJREN. Er bestaat te Zwolle gelegenheid voor EEK JONG MENSCH niet beneden de 15 jaar ora opgeleid te worden in het vak van Manufacturen. Belanghebbenden worden verzocht metfranco brieven letter K. zich te adresseeren bij deu Boekhandelaar J. M. W. WAANDERS te Zwolle. ¦ ¦*«*w Portraiten voor Album Medaillon-  A Steréoscoop- en Salon Portraits Reproduc- S&ijf ties vaar Schilderijen Daguerreotypes Panotopies Gravures-Teekeningen enz. enz. worden dagelijks vervaardigd bij V. IV. H. DEUT» MANN Photographe Bitterstraat alhier. Groepen enz. in alle grootten en prijzen. 12 Album Portraits ƒ5. Alle bestaande Portraiten kunnen bij overname des verkiezende verkleind of ook wel vergroot worden. VOOR TANDLIJDERS. Wanneer de zorg voor den mond en de tanden naar het oordeel van alle geneesheeren noodzakelijk en heilzaam is voor de gezondheid van den mensch en hem voor veel lijden en onaangenaamheden bewaart dan is het pligt hiertoe het beroemde en door de heerlijkste gevolgen bekroonde Anatherin Mondwater van dr. POPP in herinnering te brengen. Geen middel werkt zoo krachtig en zeker tegen Tandsteen Vinnen Schimmel onreinheid in den Mond zelfs tegen den Scorbut als deze heerlijke essence die tegelijk voor gezonden het beste behoedmiddel tegen allen Mondkwalen is. Terwijl zij als op nieuw leven geeft verfrischt en den adem zuivert werkt zij vooral op de Tanden wier gezondheid en natuurlijke kleur door haar bewaard eu hersteld wor.lt. Zij verwijdert den wijnsteen de pijnen van holle en braudige tanden en geneest het ligt bloedende tandvleesch. Tegen alle kiespijn (rheumatisch of zenuwachtig) behoedt zij zeker en bewaart tevens de fnsehheid van den adem door alle schadelijke deelen uit den mond te verwijderen. De heilrijke werking van deze essence kan daarom niet genoeg aan alle tandlijders aanbevolen wordeu. ANATHERIN-TANDPASTA is a »5 Silbergrosehen TANDPOEDEB a 15 Silbergrosehen TANDPLOMB a 15 Silbergrosehen te verkrijgen bij mejulvrouw T. van der VEN Melkmarkt te Zwolle a/1.75 per flacon. Aanvragen om dépöts gelieve men te rigten aan de heeren A. HU ESTER «fc Co. te Amsterdam en eonsultatiën schriftelijk in de Fransche of de Iloogduitsche taal aan deu heer dr. J. G. POPP • prakt. tandheelmeester in Weenen. Du Barry's Revalenta Arabica. Eeue Jufvrouw te Terlicyden \ uur van Breda heeft bij mij 2 bussen EEVALENTA van 1 ffi gehaald voor haren man die gedurig aan maagpijn leed en de genuttigde spijzen telkens uitbraakte. De REVALENTA at hij echter gaarne en gevoelde alsdan ook geene neiging tot braken zoodat hij thans na de 2 bussen gebruikt te hebben geheel van zijue Maagkwaal welke hein dikwijls 3 weken lang aan het bed kluisterde volkomen genezen is. Den naam van dezen heer kennende zal ik denzelven op aanvraag gaarne mondeling mededeelen. Breda. (get.) HENRI SPRENGERS. ZWAKKE MAGEN die geenen substantiëlcn kost verdragen kunnen moeten DD BARRY'S REVALENTA gebruiken om hnnne krachten te herwinnen. De REVALENTA is geen medicament maar een voedsel dat zeer gunstig op de spijsverteringsorganen werkt en daardoor eene menigte ziekten eu oupasselijkhedeu genezen en voorkomen kan. Er zijn voorbeelden in groote menigte dat zij zonder hulp van medicijnen langdurige ongesteldheden genezen heeft. Duizenden hebben openlijk verklaard dat zij hunne genezing aan haar te danken hebben. Men kau ze zomlcr inconvenient gebruiken en de genezing volgt gewoonlijk spoedig. De echte REVALENTA van de lleeren BARRY DU BARRY & 0. 77 Regeustrect Louden wordt alleen verkocht door het VERKOOPHUIS en deszelfs Depots. De prijs is: 1 fi. ƒ2 2 ff ƒ350 5 ffi ƒB 12 ffi ƒl6. Kleine bussen om er de proef mede te nemen kosten 87^ Cent. Men lette er vooral op dat ieJere bus lot waarborg der eshtheid met de handteekening van „E. von WINDHEIM & 0. VERKOOP iIUIS"" voorzien is. VERKOOPHUIS te Amsterdam. Hasselt 11. J. van der Vecht. Zwolle A. A. van der Kolk. Kampen Mej. M. Vooght. G. Eleveld en Zoon. » Mej. G. W de Ruitei en Co. Almelo C Rosmark. Noordwolde Jacob Veenstra. Coevorden T. R. Koek. Nijkerk Wed. F. Koelman lelden . A. B. Gerritsen. Meppel P Lagro. Hedemsvaart II L. v. d. Vecht. Oldemarkt C. e. d Wenden. Deventer Mej. van Meurs en Co. Oldenzaal W. B. Banning. „ Wed. Louwerens. Olst A. van Enk.  / Boerboom. Steenwijk K. Timmerman. Enschede Wed. A. Stevent. Wijhe P. Westhof. Roor ff. J. Krüseman. Zwartsluis Wed. A. Schurink. En in de bekende dépóts in de andere steden. 2x\lf en Pillen van Hoiloway. Uelioedmiddeleii tegen den onlust tot eten. Deze Zalf is de krachtdadigst werkende oorzaak tot de genezing der wonden der verouderde ettergezwellen en van al de lastige huidziekten die door locale of uit het gestel voortkomende oorzaken tot op den tegenwoordigen dag aan al de gewone wijzea van behandeling hebben weerstand geboden. De Zalf van Hoiloway op deu onderbuik gewreven en bijgestaan door eene welbegrepen behandeling der Pillen werkt wonderdadiglijk op de spijsvertering eu ueemt alle verstoppingen weg uit de ontstoken klieren gekend door de bleekheid de vermagering en de verzwakking  die van dag tot dag bij den zieke toenemen. De langdurigste ziekten die altijd ongesteldheid van de spijsvertering van den omloop van het bloed en van het klierstelsel veroorzaken kunnen niet weerstaan aan de lamenverbondene uitwerking van de Zalf en Pillen van Hoiloway. De geneesmiddelen van Hoiloway zijn geschikt voor eiken leeftijd en voor alle standen. voor alle luchtstreken eu alle ligchaamsgestellen. Door het vermeerderd debiet zijn de prijzen als volgt: Doosjes Pillen f 0.80 f 1.85 f 3.00 f 6.75 f 13.60 f 20.50. Potjes Zalf  0.80 „ 1.85 „ 3.00 „ 7.05 „ 13.85 „ 20.95. Zijn op franco aanvragen a contant te bekomen bij den Heer J. J. BRANDT Roggenstraat te Zwolle en bij J. STRAATMAN Hoofd-Dépótouder te 's Bosch alsmede te Londen Strand 224 en te New-York i op Macden Lane Holloway's Etablissementen.",http://resolver.kb.nl/resolve?urn=ddd:000018709:mpeg21:a0022:ocr,3,ddd:000018709:mpeg21:p003,"Provinciale Overĳsselsche en Zwolsche courant : staats-, handels-, nieuws- en advertentieblad",1024
4260321,1866/09/11 00:00:00,4529,MMWFA01:000184177:mpeg21:a00007,http://imageviewer.kb.nl/ImagingService/imagingService?id=MMWFA01:000184177:mpeg21:p00002:image&x=1581&y=341&w=979&h=4529,MMWFA01:000184177:mpeg21:p,2560,4870,1581,341,2,Advertentie BAZAR Groote Moord HOORN lusschen de Nieuwe en Kemsleeg. De ondergeteekende heeft de eer zijne geachte Stad- en Landgenooten te berigten dat hij zijn reeds bestaanden Winkel heeft uitgebreid en i i associatie is getreden met den Heer II. W. BROESE DIJKHOFFZ welke zaak op Vrijdag 14 September a. g. geopend zal worden onder de firma RROESE DIJKHOFFZ en COMP. Zij geven de verzekering dat zij niets onbeproefd zullen laten om hunne begunstigers door eene civiele bediening te voldoen hebbende eene ruime keuze in PENDULES LAMPEN VAZEN. BLOEMSTOLPEN GALANTERIëN BYOÜTE?IfvUIp?D~BSPEELG0ED’ fiJ'n en ordinair LAKWERK Engelsch en Fransch PORCELEIN KRISTAL en GLASWERK. Wedgwood en Inlandsch AARDEWERK alsmede LEDIKANTEN WIEGEN VUURMANDEN HAARDSTELLEN en’ STANDAARDS TURF- en KOLENRAKKEN. J. GIJIiEllr. Aan bovenstaand adres wordt verlangd een fatsoenlijke EOOPJOXGEX Prof. v. LIEBIGS VOEDSEL . VOOR KINDEREN ZWAKKE PERSONEN EN HERSTELLENDE  EN IIOOFDZAKELIJK BESTEMD OM VOOR * ZUIGELINGEN DE MOEDERMELK TE VERVANGEN 3 /afgesteld naar liebigs voorschrift door J. KNORSGH te Mors (Rhijn-Pruissen). Moeders welke iet noodige zog voor hunne Kinde ren missen en tot eene Minne ongaarne hunne toevlugi nemen zullen met belangstelling vernemen dat d( wereldberoemde Scheikundige Prof. v. LIERIG een nuddd heeft uitgevonden hetwelk in vereenigine met de Koemelk aan deze dezel/de voedende eigenschappen der moedermelk mededeelt. Dit middel met bijzondere zorg bereid en waarvan in iedere afzonderlijk gepakte portie de bestanddeelen naauwkeimg afgewogen en vermengd zijn  kan men gemakkelijk koken. Men zie de gebruiksaanwijzing welke bij ieder pakje gevoegd is. Goed toebereid is het een soepje zoo zoet als melk vereischt geenc suiker blijft 24 uren versch en is zoó dun  dat het aatf het Kind in een zuigfieschie toegediend worden kan. ° J In verzegelde Pakjes a f 0 Portiën 50 Cts. per PakjeAMSTERDAM WFRKOOPHÏJIS. loorn P. J. Ruitenberg. Monmckendam K.Slol. n'Yra-i’ Jn Br°n?ers Gz' Nieuwe Diep W. V.Bruinvis Fnhh /^Ipberg. Nieuwe Diep CarelA.J. van VakhuizenJ .Rienderho/r.Gz. Rosendael. I Hoogwoud II Storm. Purmerend S. J. Veen. Koog a/Zaan II. de Jager. Schagen W. A. Ilazeu Krommenie wed. Ii. J. van Uitgeest Wed. J. Daas' <i ’ f r. Zaandam/: Nieuwenhu i. Medembhk K II. Idma. Zaaudam H. G. van Aken en in de bekende Dépots in de andere Sleden. niillN TI HOOI in het Lokaal van Ei. DAXM£ELlfIAX. Koninklijke Hollandsclie Toonecliston onder Directie van den Heer J. C. V \L()1§ Op DINGSDAG 18 SEPTEMBER 1866 : SIMON DE DIEF. Drama in 3 bedrijven en een voorspel naar het Fransch van Laurenein door den Heer C. R. II. Spoor. — (Nooit alhier vertoond). daarna: Mi0£$tprö als m\ ^rfjaothanMc. Vaudeville in eón bedrijf naar het Fransch van den Heer Lambert Thiboust. En op WOENSDAG 19 SEPTEMBER 1866 • IACQUES BDRIE OF 'TGOÜfl ER DE DOOD. Drama in 5 tijdvakken naar het Fransch door G. van Beek. EENE VERGISSING. audeville in één bedrijf naar het Fransch door den Heer Rosier Faassen. Aanvang ten half Zeven Ure. PRIJZEN DER PLAATSEN. * lste Rang 99 Cent. 2de Rang 60 Cent. laatsen kunnen op den speeldag aan den Schouw- burg besproken worden ë 10 Cents extra per Plaats. y De ODdergeleekende berigt ook doordeze.dat j in deze maand een LIJST voor WINTER- a OORSTELLINGEN zal gepresenteerd worden. L DAjfKEIiMAH',http://resolver.kb.nl/resolve?urn=MMWFA01:000184177:mpeg21:a00007:ocr,2,MMWFA01:000184177:mpeg21:p00002,Hoornsche courant,979
4236129,1866/08/11 00:00:00,4149,ddd:011101137:mpeg21:a0015,http://imageviewer.kb.nl/ImagingService/imagingService?id=ddd:011101137:mpeg21:p004:image&x=48&y=99&w=1021&h=4149,ddd:011101137:mpeg21,1069,4248,48,99,6,"ondcrgeteelcende Eerstaanwezend Ingenieur ler Sumatra's Westkust maakt . . .. 'bekend ingevolge daarioe bekomen last dat hij op Woensdag den 22 Au{jiistUs a. s. do's i/forgcn's len 'J lire 'ten zijnen burele -eene . PUBLIEKE UITBESTEDING zal houden van het werk: ~ • v '. • - .• "" : het bouwen van eene Öpzienerswoióig ts Oelakkan. Bestek en voorwaarden van iiithesteeding ztfomede de tcckening en liegrcoting liggen voor belanghebbenden ter io«age ten hurele-voornoemd. c De Ecrstaanw Ingenieur voornoemd 391 'Jhr. TEDING VAN BERKHOUf. Padanc den 1 l«Aug. -18G6. ;-De Pillen van HoUoway. > > Deze Pillen zijn krachtiger Joih 'ceft'c terzwakte gezond'hchi to Versterken dan rik ander middel 'ter wérêll. Mên- van zenuwachtiger ""aard'en * allen 'die 'aan'zwakke verleringsórganen lijden of welker gezöndheid van streek is door galaandoeningen'ongeregelde uiaag of lover kwalen behoorden 'geen tijd te verliezen om deze ' bewonderenswaardige middelen eens goed' op de • proef te stellen üoesten verkoudheden asthmas of-kortheid van adem zijn ook Linnen het bereik der geneeskundige krach?le~n vsn dit opmerkelijk'middel. De'genezingen door deze Pilien * bêwerkt zijn 'niet "" oppervlakkig -of tijdelijk waar volkomen •en • brtiemlJg; <iij zijn even zacht als krachtig en kunnen 'gerust * aan'zwakke vrouwen 'en-jonge kinderen •gegeven wórden. ""Hunne werking oplever maag en dar'inen is'cmmiddeiijk verhgtcnd en bestendig terwijl zij tevens orde' en gezondheid in elk geval herstellen. Doosjes Pillen *è ƒ 1 .30 j 5 50 ƒ 5 80. n *Potjès zalf a f 1.50 f 550 ƒ 5.50. ■'■Te öenkoelen hij NA TIAN PlfcX >'Te Padang bij . v ' van ZADELHOFF & FABRITIUS. » ■RAADGEVING AAN ZIEKEN. Pillen Canvin. Dit cTCa 'zuiver 'sis"" goedkoop geneesmiddel heeft zoowe *~ een zuiverende als herstellende kracht en is het beste mid' del tegen alle onaangename cn ziekelijke toestanden die 'nit ccne slechte spijsvertering verkeerde afscheiding der gal 1 enz'voortspruiten. Het is tot neg toe het béste geneesmiddel tegen buik! cn leverziekten rhcumatiek' jicht periodieke verstoringen van het organische leven cn in 't algemeen tegen die ziekten welke haar oorsprong hebben in een ziekelijken toestand van het bloed. 'Doozcu. vaa 30 Pillen f 2— van 60 stuks f 350 Parijs' Phtiraaric • Cauvin Place de I'Arc de Triomphe. 'Wo.-l Datavia L. PLATON. 48 CubébiDC Suikerplaatjes vau 'Copaija 'Balsem van Labelonyc. TTit publieke proefnemingen gedaan aan -liet hospitaal *~<du Yal-dc-Graco te Parijs blijkt dat deze Suikerplaatjes uit het zuivere poeder van Cubebe gemaakt zijn cn met het beste • gevolg * tegen geheime ziekten gebezigd worden die in weinige dagen genezen zelfs als zij de Cnbèbc-cn'Copaija afzonderlijk genomen wederstaan icbben; zij veroorzaken geen misselijkheid 'cn men kan ze gemakkelijk inslikken zonder nasmaak. 50 GOl) S'B> I'E'IÏ BTOËÏE KA M G I'i'oicsfóiilsclic Gemeente ZONDAG 12 Aug. NEDERDUITSCH des morgens ten O ure. |t. C. Gemeente ZONDAG 12 Aug. ' Green - dienst.",http://resolver.kb.nl/resolve?urn=ddd:011101137:mpeg21:a0015:ocr,4,ddd:011101137:mpeg21:p004,Sumatra-courant : nieuws- en advertentieblad,1021
3667440,1866/02/08 00:00:00,2183,ddd:010389794:mpeg21:a0039,http://imageviewer.kb.nl/ImagingService/imagingService?id=ddd:010389794:mpeg21:p004:image&x=60&y=1802&w=1680&h=2183,ddd:010389794:mpeg21,1740,3985,60,1802,6,(HUL STUIMAH-ÜTIM CÖf M. ROTTERDAM m LOIVDOM. De Stoomschepen voor Passagiers Goederen en Vee vertrekken: Van ROTTERDAM Zaturdag 10 Februarij 's morgens 7 ure. Dingsdag 13 Februarij 's morgens 9 ure. Zaturdag 17 Februarij 'snamidd. 1 ure. Tan _OND_9_ eiken Woensdag en Zaturdag 's morgens ten 11 ure van St. Catherlne's Wharf. PASSAGIERS-VRACHTEN. GROOTE KAJUIT f 12.00. ' VOORKAJUIT f 0.00. IDEM Heen en Terug - 18.00. IDEM Heen en Terug . . - 13.50. De Billetten voor Heen en Terug zijn geldig gedurende ééne maand. Kinderen beneden ÏO jaren de helft der Vracht. GEBROEDERS SMITIL Agenten. iflill (JlllLl TMIITLIII 8 Place Vendóme Paris. PAQÏÏEBOTS-POSTE FRANCAIS. f.» _ Départ de St. STazalre le 6 de chaque mols pour la Martinique la Guadeloupe Ste. Lucie St. Vincent la Grenade la Trinidad. Deroerari Surinam Cayenne Ste. Marthe (Etats- Unis de Colombie) et Colon-A^pirwall (Isthme de Panima). Correspondances a I'lsthme de Panama avec les services de bateaux a vapeur du Sud Pacifique de l'Amérique Centrale et du Nord Pacifique. La Cie. Gle. Tran?atlantique délivre des billets de passage et des connaissements directs pour VaJparalso Coquimbo Oaldera Iquique Callao Payta Guyaqutl Panama San José La Union Corinto Acapulco Manzanillo San Franclseo etc eic. 2.° — Départ de St. HTazatre le 16 de chaque mols pour St. Thomas Porto-Rico Haïti Santiago de Cuba la Jamaïque la Guadeloupe la Martinique laHavane la Vera-Ci uz Tampico ______________________ 8° Ligne du Htvre a New-York avec escale a Brest. Départs du Havre: les Jeudis 11 Janvier 8 Février 8 Mars 1866. Départs de Brest: les Samedis 13 Janvier 10 Février 10 Mars 1866. PRIK DE PASSAGE. 1r e _la__e. 2me classe. 3me classe. De Paris _ Wew-York par le Havre on Brest (billet de ■ chemin de fer compiis) 785 fr. _15 fr. 31© ir. Da ll&vre on de Brest _ New-York . • . . ÏOO » 100 » 300 ■■■ S'adresser pour passages tret et tous autres renseignements:  _ . .  jio -112 boulevard des Capucines: k Paris aux bureaux spéciaux de la Compagnie |108 f faubourg St Dpm^. a St. Nazaire k Mr. BOURBEAU agent principal; au Hdvre a M. M. V. ISELIN & Cie.; k Brest k M. M. KERJEGU et VILLEFÉRON; a Botterdam a M. M. RUYS & KELLAR.,http://resolver.kb.nl/resolve?urn=ddd:010389794:mpeg21:a0039:ocr,4,ddd:010389794:mpeg21:p004,Rotterdamsche courant,1680
1504654,1866/01/19 00:00:00,1787,ddd:010389764:mpeg21:a0045,http://imageviewer.kb.nl/ImagingService/imagingService?id=ddd:010389764:mpeg21:p004:image&x=1743&y=2739&w=842&h=1787,ddd:010389764:mpeg21,2585,4526,1743,2739,6,Ziekten. _^_r_M_l'.\v%k BelcrfvanhetHloe«l. W^-f-tl^lf*?^!! sPoodi-5e genezing en in geheim van primitieve ■^S_^4M_ï^_4(Ër oiconstitutionneleziekten __*^?S^ der beide seksen door de BISCUITS DÉPÜRATIFS VAN Dr. OLLIVIER te Parys. In dit aangenaam en gemakkelijk geneesmiddel zijn de actieve beginselen chemisch verbonden met de voedende bestanddeelen wat hunne vertering gemakkelijk maakt en oorzaak is dat zij doordringen tot in alle organische vezelen waar zij den wortel van het kwaad wegnemen waaruit radicale genezing voortvloeit. Dit belangrijk resultaat dat uitsluitend de zoogenaamd alimentaire methode van Dr. Ollivier kenmerkt zou door geen ander geneesmiddel onder de gewone pharmaceutische vormen verkregen kunnen worden. Nadat vier jaren lang openbare proefnemingen genomen en met den besten uitslag bekroond waren zijn de Biscuits Ollivier goedgekeurd door de Académie impériale de Médecine geautoriseerd door de Regering en is bovendien eene belooning van 24000 francs toegekend aan Dr. Ollivier. — De Biscuits worden met goed gevolg aangewend tegen alle ziekten welke voortspruiten uit bederf van het bloed of uit scherpte der vochten. — Vooral genezen zij zeer spoedig de geheime ziekten den huiduitslag de scrofuleuse ziekten van welken ernstigen aard van welken vorm of hoe verouderd ook herhaalde ac-identen aan mond neus oogen en ooren rheumatieke pijnen jeukingen roode vlekken in het aangezigt enz. — Te JParifS rue Pernelle n.° 12. Consulten gratis met gefrankeerde Brieven. Hoofddcpöt voor Nederland: bij H. H. ULOTH Apotheker Zeedijk te Amsterdam. Depots bij de Apothekers VAN SANTEN KOLFF te Rotterdam; CLOOS in 't Hang te Rotterdam VAN RENESSE te 's Gravenhage; VAN DE KAMER; te Middelburg; GROOTENDORST te Utrecht en STRAATMAN te 's Hertogenbosch.,http://resolver.kb.nl/resolve?urn=ddd:010389764:mpeg21:a0045:ocr,4,ddd:010389764:mpeg21:p004,Rotterdamsche courant,842
3198885,1866/02/22 00:00:00,3831,ddd:010389812:mpeg21:a0047,http://imageviewer.kb.nl/ImagingService/imagingService?id=ddd:010389812:mpeg21:p004:image&x=1753&y=1250&w=835&h=3831,ddd:010389812:mpeg21,2588,5081,1753,1250,4,"Buitengewone genezing van Hoest. De volgende Brief werd door mij ontvangen: » Nightingale Hall Edmonton (Engeland). » Waarde Heer. — Ik heb onlangs vee] geleden door een zwaren Hoest voortspruitende uit eene prikkelbare aandoening in mijne borst waarvan ik door geen der geneesmiddelen uit de vele waartoe ik mijne toevlugt nam kon afkomen. Mijn hoofd veroorzaakte mij voortdurend pijn terwijl mijn geheele gestel in beweging was. Daar ik de goede gevolgen had gezien bij vele leden van mijne familie van uw Balsem van Anijszaad kocht ik eene kleine flesch en wanneer ik 'snachts naar bed ging nam ik er een theelepel vol van op 2eetlepels vol water dat even warm was. Onmiddellijk gevoelde ik er het effect van; het deed de prikkelbare aandoening m mijne borst ophouden; ik sliep goed en stond 's morgens geheel verkwikt op ofschoon ik mij nog zwak gevoelde door de vermoeijenis wegens het onophoudelijk hoesten ia de vorige dagen. De hoest ging geheel over en kwam nooit terug. Ik hoorde sedert dat een meisje in den omtrek alhier sedert lang aan een zwaren hoest had geleden en dat zij alle mogelijke middelen had gebruikt. Ik zond haar het restant van mijne flesch waardoor die zoo langdurige hardnekkige en zoo als zij dacht ongeneselijke hoest geheel genezen is. »Ik blijf waarde Heer uw zeer toegenegen WILLIAM BOARDS."" y>Aan den Heer THOMAS POWELL."" Powell's Balsem Tan Anijszaad is een onschatbaar geneesmiddel voor hoest verkoudheid kortademigheid asthma prikkelbaarheid in de keel en alle aandoeningen van de longen. Het wordt vervaardigd en verkocht bij THOMAS POWELL 16 Blackfriars-road te Londen. ' In het groot en klein wordt hetzelve verkocht i bij den Hoofd-Depöthouder F. E. VAN SANTEN i KOLFF Korte Hoofdsteeg te Rotterdam in Fiesschen van ƒ O.SO en f 1.69 ieder. Depot te 's Hoge ;bij den Heer J. L. F. C. SNABILIÉ; te Alkmaar bij de Heeren W. SCHUT & ZOON. Aanvragen om Bepöt moeten franco ingezonden worden aan het Hoofd-Depót te Rotterdam. Nederlandsche Handel-Maatschappij. OPENBAEE AANBESTEDING onder nadere goedkeuring van het Departement van Koloniën in twee en negentig Perceelen van: 14363 Stukken Blaauw geverwd KUSSENSLOOPENKATOEN. 3900 » Gezuiverd en Gecylindreerd HEMDENKATOEN. 1650 » IMITATIEKATOEN. 89 » BEDLAKENKATOEN. 800 » VERBANDKATOEN. 884 » BONTKATOEN. 17500 Stuks Gestreepte Katoenen SPREIJEN. 23000 » Geweven SARONGS. Militairen Gouden Zilveren Kemelsharen en Wollen PASSEMENTWERKEN. 600 Stuks LEPELS en VORKEN. Diverse BENOODIGDHEDEN. 60 Stellen Houten SCHALEN met Toebehooren 3000 Stuks Perkamenten OMSLAGEN. 12000 Stukjes Wit BAND. 450 Ned. ffi Spinaal GAREN. 36100 Stuks KWARTIERMUTSEN. 3700 » VELDFLESSCHEN. 400 » PATENTLANTAARNS en KANTOORLAMPEN. 31000 » Blikken EETKETELTJES. 14500 N./El Donkerblaauw GREIN. 1200 b Oranje ZIJDEN LINT. 64000 Stuks losse HALSDASSEN van Camblettine. Divers BORSTELWERK. 3500 Stuks PAARDEN- en WOLLEN DEKENS 35500 b MANEN- en HAARKAMMEN. Tinnen en Metalen KNOOPEN en KNOOPPLAATJES. 18000 Paar HOOGE SCHOENEN. Diverse MATEN en GEWIGTEN. 500 Stuks NAAIZAKJES compleet. De Voorwaarden van Levering welke in geen geval den gegadigden zullen worden toegezonden liggen ter inzage aan het Departement van Koloniën aan het ' Koloniaal Magazijn te Amsterdam en op eiken Werkdag van 10 tot 3 ure ten Kantore der Directie der Nederlandsche Handel-Maatschappij en van hare Agenten te Rotterdam Dordrecht Middelburg Schiedam en aan den Helder en voor zoo verre het de Katoenen betreft ook te Nijverdal. Zij zijn voorts zoo lang de voorraad strekt bij 3e Directie en hare Agenten verkrijgbaar tegen 25 Cents voor elk exemplaar. De Inschrijvingsbilletten waarvan een model op Ie .enoemde plaatsen te bekomen is moeten allen op Vrijdag den tweeden Maart eerstkomende les voormiddags ten elf ure vrachtvrij (ongefrankeerde zullen niet worden aangenomen) ingeleverd zijn lan het Lokaal der Maatschappij te Amsterdam rp welk uur de Bus zal worden geopend. Daarna ial onmiddellijk tot de voorloopige toewijzing der Perceelen 1 tot en met 39 worden overgegaan „rwijl die van de Perceelen 40 tot 92 ten één ure :al piaats hebben. Amsterdam 14 Februarij 1866.",http://resolver.kb.nl/resolve?urn=ddd:010389812:mpeg21:a0047:ocr,4,ddd:010389812:mpeg21:p004,Rotterdamsche courant,835
1394181,1866/06/11 00:00:00,873,ddd:010140746:mpeg21:a0017,http://imageviewer.kb.nl/ImagingService/imagingService?id=ddd:010140746:mpeg21:p003:image&x=1626&y=2053&w=1597&h=873,ddd:010140746:mpeg21,3223,2926,1626,2053,4,"Saldo Winst volgeus vorige Balans ......ƒ 1-88_.-i 5 pCt. rente hierop . .........'' 644.32 Voorloopig Dividend van 1 Maart 1864 op 1 Janurij 1865 nog uit te keeren . 313.— ?-. J ° —r— . 14.053.; 3 i Hoofdagentschap op Java ......- ...... n 30186.44 Diverse goederen voor eigene rekening deels hier deels op Java verkocht ? • • "" <57662.921 Diverse goederen voor eigene rekening elders verkocht . . . . "" 16425.30 Diverse afschrijvingen voor koersverschil .....».."" 5554.66 Commissie.Rekening ''-Jfviu'» • • •-** 6~>640J8 Delcredere Rekening . ............•"" 10644.39 Interest Rekeniug ?......» 71458.63| Q A kJP * i ƒ283616.26",http://resolver.kb.nl/resolve?urn=ddd:010140746:mpeg21:a0017:ocr,3,ddd:010140746:mpeg21:p003,Algemeen Handelsblad,1597
1288876,1866/04/22 00:00:00,1084,ddd:010155813:mpeg21:a0015,http://imageviewer.kb.nl/ImagingService/imagingService?id=ddd:010155813:mpeg21:p004:image&x=67&y=2744&w=1189&h=1084,ddd:010155813:mpeg21,1256,3828,67,2744,4,"Slfcucvieniicn.. 7&hg_WSf^^ Wordt gevraagd op een groot Kasteel nabij S^ Rreda: eene KEUKENMEID af7o en eene ™ WERKMEID a f OO loon per jaar tegen I°. Mei a. s. Te bevragen bij den Heer G. G. DE VOOGT te Rreda. Iklbiie lo)W«stefe ti k§@p -""fU****» De Notaris SWAAN te Merxplas zal provisoir *gfïsl|l\|| °P 27 April en definitief op 11 Mei 1866 om 5 ure «h«SSh@» namiddag bij P. VAN OPSTAL op de Paal te Meersel publiek VERKOOPEN namens Jufvr. A. C. MARL/NISSEN te Antwerpen : Eene schoone en goede BOERENSTEDE HUIS STAL SCHUUR HOF BOUW- HOOI-en WEILANDEN SCHAARHOUT MAST en HEIDEN- gestaan en gelegen op Heerstaai onder Ginneken nabij Strijbeek; groot circa 21 hectares; bij den steenweg vau Hoogstraeten op Breda. — Palende onder anderen .jacobus van de Veede  Wed"". Claessen  den Heer Montens de rivier de Marck enz.",http://resolver.kb.nl/resolve?urn=ddd:010155813:mpeg21:a0015:ocr,4,ddd:010155813:mpeg21:p004,Bredasche courant,1189
623100,1866/06/16 00:00:00,670,MMGAVL01:000002363:mpeg21:a0009,http://imageviewer.kb.nl/ImagingService/imagingService?id=MMGAVL01:000002363:mpeg21:p002:image&x=1166&y=3428&w=930&h=670,MMGAVL01:000002363:mpeg21,2096,4098,1166,3428,4,Advertentie Aan ■ Heeren Kiezers in hel Ries-Distnct Boermond. Ik vervul voor mij eenen aangenamen pligt met aan de Heeren Kiezers die mij op heden als lid van de 2' 1 Kamer der Staten Generaal herkozen mijnen hartelijken diep gevoelden dank te betuigen. liet zal voor mij steeds eene aangename vleijende innering zijn dat mijne landgcnooten reis mij een nieuw vereerend blijk var hebben geschonken. Mijn streven zal onophoudelijk zijn woorden. UwelEd.Dw. Dienaar P. L. de Lom de Berg. Vf.nlo 12 Junij 1866. hervooral ook deze hun vertrouwen daaraan te beant­,http://resolver.kb.nl/resolve?urn=MMGAVL01:000002363:mpeg21:a0009:ocr,2,MMGAVL01:000002363:mpeg21:p002,Venloosch weekblad,930
1585920,1866/09/08 00:00:00,1792,ddd:010274764:mpeg21:a0016,http://imageviewer.kb.nl/ImagingService/imagingService?id=ddd:010274764:mpeg21:p004:image&x=1922&y=2144&w=885&h=1792,ddd:010274764:mpeg21,2807,3936,1922,2144,8,DOOR VOORDEELIGE INKOOP: Zouteviscb 13 Keelen en Lippen 14 Koolvisch 10 Bot 8 Leng 8 en Kibbelen scent perö ons; nieuwe Hollandsche Haring 5 a 6 cent en nieuwe Noorweegsche 3 a 4 cent; Groene Zeep 20 cent per 5 Ons; Patent-olie 45 en Petroleum 32 cent per Kan bij DEHHEK Smalle Kade. Met November een Bakkersknecht benoodigd bij P. LOOIS te Middelburg. Een Kruideniersjongen benoodigd bij M.L. VAN DER HARST Zuidzijde van den Dam. Wordt gevraagd zoo spoedig mogelijk in een klein Huishouden met twee Dienstboden eene Keukenmeid vau goede getuigschriften voorzien. Adres franco Brieven of in Persoon bij den Boekhandelaar MESTDAGH te Vlissingen. Bij den Boek- en Steendrukker T. P. ROEST is gedrukt en verkrijgbaar eene Brochure: DE ZEEUWSCHE SPOOKWEIw met een Kaartje van een gedeelte van Walcheren Zuid- en Noord Beveland hoofdzakelijk aanwijzende de oevers van het Sloe het Veergat en de Zandkreek door DIRK DRONKERS in verband met de Brochure vanden Heer Kapitein-Ingenieur Verduchènb. Prijs 30 cent. STOOMBOOTDIENST TUSSCHEN MIDDELBURG EN ROTTERDAM. Uren van vertrek in September 1866. VAN MIDDELBURG: VAN ROTTERDAM: Zaterdag B'smorg. 11 uur. Zaterdag B'smorg. Buu». Zondag 9 „ 1130 Zondag 9 „ 8  Maandag 10'smidd.12 uur. Maandag 10 „ 8 Dinsdag 11'smorg. 6 „ Dinsdag 11  • 1030 Woensdag 12 „ 6„ Woensdag 12 „ 1030 Donderd. 13 „ 6 „ Donderd. 13 „ 1030 Vrijdag 14 „ 6 „ Vrijdag 14  1030 Zaterdag 15  6 „ Zaterdag 15  1030 Zondag 16 „ 6 „ Zondag 16 „ 1030 Maandag 17 „ 6 „ Maandag I7'smidd.l2uur. Dinsdag 18 „ 6 „ Dinsdag 18  12 Woensdag 19 „ 7 „ Woensdag 19 „ 12 „ Donderd. 20 „ 8 „ Donderd. 20'smorg. 6  Vrijdag 21 „ 9 „ Vrijdag 21  6 „,http://resolver.kb.nl/resolve?urn=ddd:010274764:mpeg21:a0016:ocr,4,ddd:010274764:mpeg21:p004,Middelburgsche courant,885
1412874,1866/11/24 00:00:00,1481,ddd:010776604:mpeg21:a0007,http://imageviewer.kb.nl/ImagingService/imagingService?id=ddd:010776604:mpeg21:p003:image&x=65&y=71&w=954&h=1481,ddd:010776604:mpeg21,1019,1552,65,71,4,"ZATURDAG den lsten December 1866 en volgende ""erkdagen ten kantore van de ONTVANG- en BETAAL- Ai> le Amsterdam en verder bij de Hoofdagenten van 'ooruoemde Bank (te Assen: Mr. H. J. SMIDT.) HYPOTHEÈKoEIGATIEN. Rentebetaling. Het BESTUUR van de NËDERLAKDiCHE «XPOTHKEKBAraK berigt. dat de COUPOXS !»'■ hare SCHUIéBBBIEEEX vervallende 1 Deccm- b*r 1866. betaald zullen worden op ZATURDAG 1 Decenter aanstaande en volgende werkdagen . *e ten kantore «an Amsterdam. de ONTVANG- en BETAALKAS. Alkmaar den Heer CORNs JOHs. HE LANGE. Arnhem  de Heeren E. C. ENGELBERTS en Co. Assen den Heer E. A. SMIDT. ""reda. . J. REIJNDERS. ""ordrecht de Heeren STOOP en RENS. «Gravenhage • SCHEURLEER en Zonen «roningen . MESDAG en Zonen. Haarlem. den Heer G. W. BANNIER. s Hertogenbosch  • F. VAN LANSCHOT. Leeuwarden . . A. GRATAMA. Leiden dc Heeren A. L. REIMERINGER en .... Zonen fi'ddelburg. den Heer B. A. FOKKER «oiierdam  de Heeren H. C. VOORHOEVE en Co. ~!!• u deu lieer Z. DE JONGH. Ulre<<nt. de Heeren VAN SCHERMBEEK en VAN 7.„ ~ «ALL. £Wo'*<"". . . A. VAN DEVENTER en Zonen.  November 1866.",http://resolver.kb.nl/resolve?urn=ddd:010776604:mpeg21:a0007:ocr,3,ddd:010776604:mpeg21:p003,Provinciale Drentsche en Asser courant,954
1634556,1866/02/02 00:00:00,1708,ddd:010254253:mpeg21:a0022,http://imageviewer.kb.nl/ImagingService/imagingService?id=ddd:010254253:mpeg21:p004:image&x=1948&y=2205&w=957&h=1708,ddd:010254253:mpeg21,2905,3913,1948,2205,6,"VITA JESU GHRISTI E QDATÜOR EVANGELIIS ET SCRIPTORIBUS ORTIIODOXIS CONCINNATA per JLUDOLPHVN DE gtxoxii EX ORDINE CARTHUSIANORUM. 840 bladz. ƒls.— Deze uitgave van het bewonderenswaardig werk van LudolP11 den haxer is bezorgd door de Eerw. isolard en KigolK* t is een prachtuitgave in folio vercierd met eene afbeeldt van den Zaligmaker afkomstig van Keizer Tiberins. Le R. P. HUGUET Les Perles de S. Franco!* de S.ile». Les plus belles peusées de Bienlieureu*) t S""J rwT de 1)leu' avec vn choix de prières fOP'. Le R. P. EIIENNE BINET. Abandon de Tan»' a IMcu Consolatious des a.ues désolées qui sOü'l dans les aridités et les abandonnements ƒ 0.7* LE CHANOINE PUY-PÉNY. Vie de In reverend' ' roere P;uiline de Faülonuet* 2 volumes/2.6° i mD^ lilffch°l' van Sa'""t- ié zegt inde Voorreden „De Ker^ Moeder Pauline de F. verdient eene plaats in 1e rij der Merk» I vrouwcri die op elke bladzijde der kerkgeschiedenis voorkom* maar die de Voorzienigheid schijnt le vermenigvuldigen in d«*s eeuw welke misschien meer dan eenige andere een werkkrWS aan ijver en offerwill^heid opent."" Qua.'re Femme» au temp» de Ia Etcvoli»' Ion ƒl.7* ; ..Vla ie-Antoinette Mevrouw Roland' Charlotte Corday «"" Madame de .viontagu fraet hare moeder en zns.ersj terug* woordden treffend"" zegt de. schrijver »de gevoelens <le vV oordcelen den haat de deugden de hartstochten den helde»' ! moed die in tijden van burgertweedracht de gemoederen pl«' gen te bezielen. . La C««"" IDA HAHN-HAHN Pérégriu* 2 dln. /8.6° Goede fransche verta ing door MaeC Vurdon van den nieuwe» roman der beroemde schrijfster. LOUIS DE LAINCEL. Promonade aux Cliainp*' Elyctce» y0.50 Een weinig kunsikritiek van een ander standpunt I dan dat van Pkouimion en Tame.",http://resolver.kb.nl/resolve?urn=ddd:010254253:mpeg21:a0022:ocr,4,ddd:010254253:mpeg21:p004,De Tĳd : godsdienstig-staatkundig dagblad,957
482690,1866/03/22 00:00:00,611,ddd:010783515:mpeg21:a0007,http://imageviewer.kb.nl/ImagingService/imagingService?id=ddd:010783515:mpeg21:p004:image&x=2541&y=26&w=790&h=611,ddd:010783515:mpeg21,3331,637,2541,26,4,"SERENADE van Vrijdag 23 Maart. •„* WEGWIJZERS zijn van af hede' te hekomen zoo hij de Boekhandelaren a; bij de firma L. E. BOSCHifc ZOON Kort1 Nieuwstraat Prijs 2 C's Jonge Drukkersgezellen *«• of Jongens  die het drukken we"" schen te leeren kunnen geplaatst worden a?J de drukkerij der firma L. E. BOSCH ZOON  Korte Nieuwstraat.",http://resolver.kb.nl/resolve?urn=ddd:010783515:mpeg21:a0007:ocr,4,ddd:010783515:mpeg21:p004,Utrechtsch provinciaal en stedelĳk dagblad : algemeen advertentie-blad,790
3745944,1866/02/03 00:00:00,4209,MMKB08:000087815:mpeg21:a0014,http://imageviewer.kb.nl/ImagingService/imagingService?id=MMKB08:000087815:mpeg21:p004:image&x=1021&y=100&w=921&h=4209,MMKB08:000087815:mpeg21,1942,4309,1021,100,4,Advertentie TE KOOP: OBLIGATIES  elk groot ten laste 4 OBLIGATIES  elk groot 1000 Gulden rentende 4'/j proc. ten laste van den Straatweg tusschen Arnhem en de brug van Bavoort bij Amersfoort. Reflecteren den kunnen zich adresseren onder Letter B. R. T. bij den Uitgever dezer Courant. MEN VERLANGT voor een klein Gezin met P'. Maart a s. te Huren  te Nijmegen of environs TWEE KAMERS  ALKOOF en KEUKEN gemeubeld of ongemeubeld. Adres met opgaaf van Huurprijs onder Letters A. M. Bureau Handelsblad  Amsterdam. Om terstond in dienst te treden biedt zich aan Eene bekwame Keukenmeid van goede getuigschriften voorzien. Adres aan het Bureau dezer Courant onder Letter Z. MEN VRAAGT tegen lo. Mei aanstaande in een klein gezin van Man en Vrouw waar 3 Dienstbo den worden gehouden : EENE KEUKENMEID Prot. Godsd. goed kunnende koken vooral eerlijk zindelijk en goed humeur tegen HONDERD GULDEN loon naar bekwaamheden daar men op 30 a 40 Gulden verval kan rekenen. Adres onder Lett. C H bij den Boek- en Kunsthandelaar H. tbn HOET te Nijmegen. Twee Geldersche Dienstboden worden GEVRAAGD met Mei op een Buiten nabij Nijmegen als: eene bekwame zindelijke KEU KENMEID tevens huiswerk verrigtende en eene nette TWEEDE MEID  goed kunnende Naaijen Mazen  Strijken en met de Wasch omgaan  Loon naar Bekwaamheden. Adres met franco Brieven onder Letters A. Z. bij den Boekh. H. A. ZWEERS Singel bij de Munt te Amsterdam. ONTVANGEN! MANDARIJN APPELEN W A. tan der HORST & C omp.  Turf straat A No. 46  Arnhem. C. Nieuhoff-fxoetgebuer hebben de eer te berigten dat het Magazijn is VERPLAATST in de Koningstraat No. 51 regt over den Heer TROOST Notaris. Verhuisd J. B. A. Potet C No. 42  boven de Heercn PREL Rijnstraat LEB en Co. VERHUISD van de Oeverstraat naar de Vossenstraat de Wed HAGT geb. HAGAR Modiste. PATTI-GONGERT. ARNHEM. De Heer ULLMAN heeft de eer te berigten dat hij op den 6den Pebruarij e. k. bepaald EEN EENIGST CONCERT zal geven met de Uitstekende Artisten Carlotta Patti G-ustave Roger VIEUXTEMPS BRASSIN en DESWERT. No. Schouwburg te Arnhem. ZATURDAG 3 FEBRUARIJ 1866 Voorstelling door het Hoogduitsche Tooneelgezel schap onder Directie van MAX D'HAIBE. 12 of laatste voorstelling van liet abonnement. DER S0NNENWENDH0F oder Der Brandstifter. mit Gesang in 5 Acten von (Verfasser der Deborah). ÜESANGSVORTRAG von Herrn Freund Herzoglich-Braunschweigischer Hofsanger. Nach dem 1 Act: Arie des Sarastro aus der Oper: Die Zauberflöte von Mozart. „ „ 2 „ Der lustige Musikant. „ „ 3 „ Arie des Osmin aus: Die Entführung aus dem Serail von Mozart. Aanvang ten ZEVEN ure. Volksschau9piel Mosenthal,http://resolver.kb.nl/resolve?urn=MMKB08:000087815:mpeg21:a0014:ocr,4,MMKB08:000087815:mpeg21:p004,Arnhemsche courant,921
2799590,1866/08/14 00:00:00,3373,ddd:010783630:mpeg21:a0021,http://imageviewer.kb.nl/ImagingService/imagingService?id=ddd:010783630:mpeg21:p005:image&x=863&y=61&w=830&h=3373,ddd:010783630:mpeg21,1693,3434,863,61,6,§—IBij het onderzoek in de afdeelingen derjTweede Kamer van het wetsontwerp tot onteigening van perceelen voor den spoorweg Meppel-Groningen werd door enkele leden in verband met den financiëlen toestand des lands de opmerking gemaakt dat de uitgaven voor dit spoorwegvak konden worden uitgesteld tot nadat de lijn Harlingen-Hannoversche grenzen zou zijn voltooid. De overige leden prezen daarentegen de houding van den minister in zoover bij ter vervulling der door den min. Thorbecke gedane toezegging dit wetsontwerp nog vóór het einde der tegenwoordige zitting heeft willen indienen. Bovendien gold het hier nog slechts voorbereidende maatregelen voor de onteigening om den spoorwegaanleg zoo geleidelijk en spoedig mogelijk te kunnen voortzetten. Bij deze gelegenheid werd teruggekomen op de vroegere klagt betrekkelijk den te ver gedreven centralisatiegeest bij de bepaling der aan de lijnen te geven rigting. De grootste grief werd daarbij gemaakt van het weinige gezag dat ten deze van de gedep. staten wordt toegekend. Men wees hierbij speciaal op het gebeurde met de bepaling der rigting voor de lijn Meppel-Groningen en voor de sektie Assen-Groningen. Te meer moest dit bevreemding wekken dat die rigting niet meer aan de bestaande behoeften voldoet omdat daarvoor vroeger bij herhaling opnemingen gedaan en plannen gemaakt zijn en wel eerst door de koncessie-aanvrage de lirrna Balkeiman later door de koncessionarissen Sloet Beuchlin eindelijk op last van den minister van Heemstra  wien men het staatsspoorwegnet te danken heeft; met die opnemingen is  ook onder overleg met de gewestelijke besturen een ontwerp gevormd dat aan alle redelijke eischen scheen te voldoen en alle partijen bevredigde. Waarom — werd gevraagd — heeft men dat vroeger plan niet meer op den voet gevolgd 'l Het laat zich toch niet onderstellen dat het bij den ontwerper van het tegenwoordig plan onbekend was. Men gaf in overweging om ter vervulling van den wensch der belanghebbenden met voorloopig behoud der tegenwoordige uitbakening van de sektie Assen-Groningen die lijn ook althans voor het hier in aanmerking komende gedeelte in den geest van het vroeger ontwerp te doen afbakenen de Gedep. Staten der beide belanghebbende provinciën over de zaak te hooren en vervolgens eene eindbeslissing te nemen. Daardoor zou geen tijd verloren gaan omdat alles toch in twee jaren zal kunnen afgewerkt zijn. In velband met deze zaak werd de wenschelijkheid betoogd van eene meer oostelijke ombuiging der lijn in 't belang der gemeente Zuidlaren. — De meeste leden bepleitten ook het belang van de gemeente Hoogeveen in hare opname in de spoorwegverbinding. §_ Naar aanleiding van het onteigeningsontwerp voor den spoorweg Tilburg—Belgische grenzen werd de wenschelijkheid betoogd dat de regering nu zij hier het belang heeft gevoeld dat de ingezetenen bij de inrigting van stations en halten aan de spoorwegen hebben hare medewerking wel zal willen verlëenen om die alsnog aan de staatsspoorweglijnen in 't leven te roepen op die plaatsen waar het gemis daarvan zich thans laat gevoelen. §— Bij het onderzoek van eenige naturalisatie-ontwerpen heeft men uithoofde van het geringe gewigt dat de reg. schijnt te hechten aan het zich verzekeren van de opheffing van den band waardoor de genaturaliseerde aan zijn] geboortegrond gehecht was aan de reg. in overweging gegeven terug te keeren tot de vroeger steeds gevolgde handelwijze om bij naturalisatiën op de overlegging van zoodanige bescheiden niet aan te dringen iets dat alleszins overeenkomt met de door Nederland steeds aan den dag gelegde gastvrijheid tegenover vreemdelingen.,http://resolver.kb.nl/resolve?urn=ddd:010783630:mpeg21:a0021:ocr,5,ddd:010783630:mpeg21:p005,Utrechtsch provinciaal en stedelĳk dagblad : algemeen advertentie-blad,830
1610832,1866/08/30 00:00:00,907,ddd:010274759:mpeg21:a0022,http://imageviewer.kb.nl/ImagingService/imagingService?id=ddd:010274759:mpeg21:p004:image&x=1022&y=143&w=1776&h=907,ddd:010274759:mpeg21,2798,1050,1022,143,4,ROTTERDAMSCHE HYPOTHEEKBANK ¦vooier 3NT©<-lerl.£*___L<-l_ Kapitaal ƒ5000000. Uitgegeven de le serie ƒ1000000. Birectie: de Heeren Mr. B. MEES B. VAN ROSSEM E. C. W. HOIJER. Commissaris in Zeeland: Jhr. Mr. J. W. M. SCHORER. Hoofdagentschap te Amsterdam: de Heeren CHEMET & WEETGENKERKHOVEN & Co. RAHUSEN & WALLER WESTENDORP & Co. WURFBAIN & ZOON. Agenten: te Middelburg de Heeren J. A. TAK & Co.; te Zierikzee de Heeren VAN DER STARP & BERG; te Tholen de Heer M. W. J. DE VISSER. De Bank heeft ten doel: 1. Het leenen van geld onder eerste hypothecair verband op onroerende goederen uitsluitend in Nederland; 2. Het uitgeven van Pandbrieven op naam of aan toonder tot een bedrag nimmer te boven gaande dat der ten haren voordeele gesloten hypotheken. De Pandbrieven worden a pari afgelost bij jaarlijksche loting. Zij worden gedekt zoowel door alle hypotheken te zamen door de Bank gesloten als door het maatschappelijk kapitaal en het reservefonds. — Deze Pandbrieven rentende 4}; pet. groot f 1000 f 100 en f 50 voorzien van coupons die betaalbaar zijn ten kantore der Bank en der Agenten worden uitgegeven tegen 981 pet. Aanvragen om Hypotheken eu Pandbrieven kunnen dagelijks bij de Agenten geschieden.,http://resolver.kb.nl/resolve?urn=ddd:010274759:mpeg21:a0022:ocr,4,ddd:010274759:mpeg21:p004,Middelburgsche courant,1776
1993170,1866/04/12 00:00:00,1682,ddd:010155810:mpeg21:a0017,http://imageviewer.kb.nl/ImagingService/imagingService?id=ddd:010155810:mpeg21:p004:image&x=1311&y=110&w=1185&h=1682,ddd:010155810:mpeg21,2496,1792,1311,110,4,Modes et Confections. 11 mliFi li cm GROOTE MARKT letler D W. 10 BREDA. Heeft de eer de Dames te berigten dat zij van Parijs geretourneerd is met eene fijne sortering MANTELS en MANTILLES alsmede HOEDEN MUTSEN COIFFURES LINGERIES en alles wat verder tot het modevak behoort. Aangenaam zal het haar zijn van heden af door een bezoek te worden vereerd. April 1866. _ *jj* Bij de Uitgevers dezer is heden verschenen: VERSLAG VAN DEN TJOESTAND DER GEMEENTE BREDA OVER HET JAAR 1865 DOOK BURGEMEESTER EN WETHOUDERS UITGEBRAGT AAN DEN GEMEENTERAAD. 10 blad in grool octavo. — Prijs f 125.,http://resolver.kb.nl/resolve?urn=ddd:010155810:mpeg21:a0017:ocr,4,ddd:010155810:mpeg21:p004,Bredasche courant,1185
2719988,1866/06/12 00:00:00,2588,ddd:010140747:mpeg21:a0023,http://imageviewer.kb.nl/ImagingService/imagingService?id=ddd:010140747:mpeg21:p003:image&x=2209&y=93&w=1051&h=2588,ddd:010140747:mpeg21,3260,2681,2209,93,6,"— "" — r j. i_ j wo^lP^ifl TCT™*. MANUFACTUUR-WINKELS te Arnhom v __* ___l___t.A-11Swbaa of _°- September gevraagd: Twee be_S_ v W-KEMIJFVRW-VEJ-N waarvan dl eene tevens volledige kennis moet hebben van Mantels en Mantilles enz. te knippen Alleen diegenen komen in aanmerking welke goede recom- SJ-ir *w? mien °™le8& _ ei> gelieven zift franco te adresseren onder JN . 68 aan het Advertentie-Bureau vanG. J. THIEME te Arnhem. (14054) MAMiEi Met primo Julij worden op de Vijzelgracht in een Toehuis TE __SHtk'SSb™ en* wf G?.me«be leerde ruime VOOR- en ACHi_Kh__tHmet Alkooi voorzien van de noodige Gaztoestellen. BRÖÖDBAIKËRI.^ BHOOD«__-__™__™ KOOP aangeboden eene welbeklante BROODBAKKER! J in het midden dezer stad hetwelk een goed bestaan oplevert. Het Huis is tegen een matigen prijs te huur. Adres franco brieven onder lett. V. Bureau Handelsblad. (14078) GEVRAAGD Een klein HUISJE of BOVENHUIS in de omstreken van den Dam Huurprijs circa ƒ2OO Franco brieven onder lett. Q. bij den Boekdrukker en Boekh. P. M. VAN DER MADE te Am .tedam Stilsteeg G 87 en 88. (f4ff^ter Ter algemeene kennisse wordt gebragt het bestaan der Naamlooze Vennootschap: AMSTEL-HOTEL-MAATSCUAPPI3 gevestigd te Amsterdam en opgerigt bij acte den 26stcn April 1866 ten overstaan van den ondergeteekenden Notaris aldaar verleden Deze acte is geplaatst in de Nederlandsche Staatscourant van den Biten en 9den dezer maand Nos. 133 en 134 (14*>001 _Amsterdam 9 Junij 1866. J>. _'. WERTHEIM Notaris. Le propriétaire dun vignoble renommé dans la Gironde (Bordeaux) demande vn AGENT pour le placement de ses Vius en Barriques ala elientelle Bourgeoise. Commisskm liberale: profit de la mise en bouteilles a Amsterdam et 1000 francs premium par année: Bonnes reicrences. l . Un ex-négociant de Vins serait préfcré. Écrire au Bureau de oe journal a Mr. de R. qui se rendra tres prochainement a Amsterdam. (.______ DE POIERANZEN SPIRITUS van de_ Fabriek van H. KET JEN & ZOON te Doetinchem is voor Amsterdam door tusschenkomst van den Ondsrgeteekende op alle verschillende soorten van Flesschen waarop dit smakelijk en aangenaam Bitter wordt afgeleverd verkrijgbaar. Ook zijn bij hein Prijscouranten en inlichtingen v«or Export te bekomen. TH. W. SANDERS N. Z. Achterburgwal bij de Raainsteeg (13804) F 224 te Amsterdam. _ MIDDEL ¥AN BESTAAN. Ét _ .°^i?° JuniJ e* k*' 's middags 12 uur zal in de HAAS \ê_% I_ kloirg worden Verkocht de in volle werking zijnde |P| WIND-OLIE-MOLEN genaamd DE KOMEET ___S_ met Inventaris en bijbehoorende Grasgrond nader omschreven in vroegere Nommers dezer Courant; zijnde dit Perceel met de Knechtswoningen bij inzet en verhooging gebrast on slechts ƒ 5 100 en het Pakhuis op ...f L 640! Deze goederen zijn zeer aan te bevelen : ï. door derzelver onmiddelijke ligging aan de haven te Elburg; 2. uithoofde noch zeepziederij waarvoor dezelve ook zeer geschikt ziju noch bovenstaande zaak bestaat tusschen Elburg en Amersfoort ten gevolge waarvan op dezelve ook veel voor loon wordt gemalen. JDe helft der koopsom kan tegen 5 pCt. rente in het goed gevestigd worden. Nadere inlichtingen te bekomen ten Kantore van den Notaris HOEFHAMER te Elburg. (14033)",http://resolver.kb.nl/resolve?urn=ddd:010140747:mpeg21:a0023:ocr,3,ddd:010140747:mpeg21:p003,Algemeen Handelsblad,1051
2234650,1866/10/20 00:00:00,1195,ddd:010254470:mpeg21:a0021,http://imageviewer.kb.nl/ImagingService/imagingService?id=ddd:010254470:mpeg21:p004:image&x=1013&y=2766&w=1870&h=1195,ddd:010254470:mpeg21,2883,3961,1013,2766,4,"FLORIJN BOON. \MeiUge Weg bij de JKalverstraat r^™!ileïl iv mime sorteriug Wollen Gebreide ROKKEN- BROÏ^j' i-?W^°KSEW' KOü™' SOKKEN gecouleurde KOUSEN MOFJfJ ;;^!_^H™SCMÖENEN &e' &c'> ruim voorzien in vele sooi« JUTTEN; gekleurde eu witte BREIWOL waaroiuler zeer sterke k^ vrije; eu verder alles wat tot liet vak vau Garen en lint behoort BOESÏ2IAN&EI: C. JL. VAN JLANGENISWESEN. Ciugel hoek Beulingstraat. Vaii de pers gekorn-:.: _— _._. VIJFBS DRIE VA3Ï: DE ANTICHRIST volgens de H. Schrift en cic Overlevering*. Prijs ecu Guldesi. *t g^>» 18. Bij kontante overmaking van het bedrag worden de Exemplaren f'""11 per post door het geheele rijk verzonden.",http://resolver.kb.nl/resolve?urn=ddd:010254470:mpeg21:a0021:ocr,4,ddd:010254470:mpeg21:p004,De Tĳd : godsdienstig-staatkundig dagblad,1870
4845535,1866/05/17 00:00:00,4695,ddd:010529121:mpeg21:a0017,http://imageviewer.kb.nl/ImagingService/imagingService?id=ddd:010529121:mpeg21:p004:image&x=1026&y=73&w=1936&h=4695,ddd:010529121:mpeg21,2962,4768,1026,73,8,"BES T E D I N G. Dijkgraaf en Heemraden van den Assendelver Zeedijk zullen op Zaturdag den 26sten Mei 1866 des middags] 12 ure in het logement het Wapen van Amsterdam te Zaandam aanbesteden: het UITVOEREN van de werken van onderhoud aan gemelden dijk met levering der daarbij gevorderde materialen over het jaar 1866 en eindigende ultimo Februarij 1867  alles volgens bestek hetwelk vau heden ter visie ligt in voornoemd logement alsmede ten huize van den opzigter KLOTS die van het bedoelde werk aanwijzing zal doen op Vrijdag 25 Mei des namiddags ten 3 ure van de sluis bijNauerna af. Zaandam 14 Mei 1866. De Dijkgraaf van den Zeedijk  . W. S M I T. H6T E L Woud- en Bergoord TE DRIEBERGEN. De ondergeteekende beveelt door deze bovengenoemd Hotel vroeger bewoond door den Heer Velaars bij het geëerde publiek minzaam aan zoowel voor LOGEMENT als tot het geven van PARTIJEN en het verhuren van APARTEMENTEN aan familien. Tevens belast hij zich met het aan huis doen bezorgen van DINERS zullende eene prompte en nette bediening in acht worden genomen. Driebergen Mei 1866. J. C. W. van der LINDE STEENWEG. _*- Als verhuurder van PAARDEN en RIJTUIGEN  ook bij de aaukomst der Spoortreinen beveelt hij zich mede beleefdelijk aan. HSTËL BELLEVUE. Het nieuw gebouwd Hotel te Groesbeek  is gelegen in de nabijheid van den spoorweg van Nijmegen op Cleef tegenover het stations-gebouw en is ingerigt tot het houden van PARTIJEN L-OGE'S enz. Dit thans zeer gezocht en aangenaam oord benevens eene zindelijke en solide bediening bevelen zich als van zelven aan. J. HEYNE Logementhouder. *** lemand Landbouwer van beroep en in dit vak wèl onderwezen van de Herv. Godsdienst en die goede getuigenis kan produceren wenscht tegen November e. k. eene BOEBEN-HOFSTEDE te huren voor Melkerij geschikt of eene plaatsiug te bekomen tot ADMINISTRATIE van LANDERIJEN. Brieven franco \ onder het woord Landbouw intezenden bij den Boekver-  kooper J. H. SCHELTEMA te Amsterdam in de Beurs- 1 steeg E. 183. 1 TYVOOBÏURG l door toeval terstond te HUUR een HUIS met zes kamers  keuken turn en verder alle gemakken. Franco te bevragen bij M. W. SPOOR aldaar bij wien tevens te bevragen is een BENEDEtfHUIS van vier kamers keuken eij zolder en vrije wandeling in den^uin desvef' kiezende gedeeltelijk gemeubeleerd. Eene echte Fransche Pianino pas van Parijs ontvangen  dus geheel nieuw  wordt voor rekening van den afzender voor den zeer geringen prijs van ƒ 290 te KOOP aangeboden ; zij is krachtig van toon 7 octaaf en 3 snarig terwijl men van soliditeit verzekerd kan zijn de kist er bij. Te bezigtigen Gravenstraat 275 achter de Nieuwe Kerk te Amsterdam. E. de PRO UW. TE KOOP NEGEN extra mooije JONGE VOSSEN. Franco te bevragen bij den Jagtopziener F. W. GANETZEN te Oldebroek. BRUILOFTSLIEDEREN in 250 soorten  steeds gedrukt voorhanden bij GEBR. KOSTER Leliegracht R. R. 78/79 te Amsterdam. Een MODELBOEK bevattende van al de gedrukte soorten één exemplaar wordt op franco aanvrage dadelijk toegezonden. — Men betaalt nog minder dan een derde van den prijs dien de liederen zouden kosten indien men' dezelve apart liet drukken ; heeft het voordeel eener ruime keuze en is het wat laat voordat men er om gedacht heeft dan is men altijd spoedig bij ons klaar omdat alle liedereu gedrukt gereed liggen. — Brieven franco Leliegracht^ R. R. 78 te Amsterdam. *#* Een nieuwe Roman van Miss MILOCK Schrijfster van JOFIN HALIFAX Set«ew.- EEN WELBESTEED LEVEN  uit het Engelsch door ANTONIE  Prijs ƒ3 ziet het licht bij P. N. VAN KAMPEN te Amsterdam  bij wien onlangs mede verschenen : Ch. DICKENS  De recepten van Dr. Marigold. Eene Kerstvertelling vertaald door Mevr. van WESTRHEENE ƒ 190. M. S. SCHWARTZ Huwelijken uit berekening. Een verhaal. / 225. Miss VONGE (Schrijfster van Violette) Rachel Curtis vertaald door Mej. J. C. KAPTEYN. 2 dln. ƒ 650. Miss MULOCH Lord Erlistoun en Alwijn's eerste vrouw. Twee verhalen f 240. Miss CUMMINS (Schrijfster van de Lantaarnopsteker)  Beklemde Harten. Een verhaal uit Nieuw- Engeland. 2 dln ƒ 575. ""~%* J. V. SCHATTEN_ÊRK~tel)ö_borghr geeft uit: OPVOEDING EN ONDERWIJS. EEN ÏÏOOBD aau den Wel Edelen Heer R. E. de HAAN Hoofd-onderwijzer te Amersfoort naar aanleiding van zijn open brief aan den H. W. Geb. Heer Baron van ZUYLEN van NYEVELT te'sHage door 11. H. DIEPERINK LANGEREIS Hoofd-onderwijzer te Doetinchem. Pr^js ƒ030.",http://resolver.kb.nl/resolve?urn=ddd:010529121:mpeg21:a0017:ocr,4,ddd:010529121:mpeg21:p004,Opregte Haarlemsche Courant,1936
882628,1866/04/24 00:00:00,839,ddd:010585501:mpeg21:a0024,http://imageviewer.kb.nl/ImagingService/imagingService?id=ddd:010585501:mpeg21:p002:image&x=2280&y=4690&w=1052&h=839,ddd:010585501:mpeg21,3332,5529,2280,4690,14,"ILanclgeiaooSeai! Op den 7 Maart dezes jaars trof een arbeider aan den staatsspoorweg met name Gerrit Plantinga te Zwaagwestcinde woon achtig een zwaar ongeluk. Ten gevolge van het overrijden doo een kar moesten drie zijner teenen worden weggenomen  en anders vlijtige man is daardoor buiten staat voor vrouw en twe jonge kinderen iets te kunnen verdienen. Buiten uwe algemeen bekende weldadigheid zal dit huisgezin weldra ren sober onderhoud moeten vinden nit de reeds al te zeer bezwaarde af' men-kas. Het is ter voorkoming hiervan dat wij U die reeds door menig offer getoond hebt niet ongevoelig te zijn voor het lijden va den natuurgenoot dringend verzoeken  door uwe bijdragen ' den nood van dit ongelukkig gezin te willen helpen voorzie»' terwijl van uwe giften die door de Ondergeteekenden gil!irlloi ontvang zullen worden genomen dankbare vermelding i"" c blad zal worden gemaakt. Zwaagwesteinde F. D. LOURENS  Armvoogd. den 7 April 1566. K. J. v. d. SCHANS Armmogd- E. J. CONRADI 0 T n kantore van deze courant alwaar men zich ooi.' 9""a t 7nct tle ontvangst van giften voor bovengenoemde ongelukkige btw is ontvangen van 11. fl. ƒ2.",http://resolver.kb.nl/resolve?urn=ddd:010585501:mpeg21:a0024:ocr,2,ddd:010585501:mpeg21:p002,Leeuwarder courant,1052
3209726,1866/09/22 00:00:00,3011,ddd:110536628:mpeg21:a0025,http://imageviewer.kb.nl/ImagingService/imagingService?id=ddd:110536628:mpeg21:p004:image&x=1078&y=74&w=1066&h=3011,ddd:110536628:mpeg21,2144,3085,1078,74,8,"Naar AMSTERDAM /..il tegen hel laat»! van Oetober \an Batavia vertrekken het zoo guu-5 2; r\ stig bekend Nederl. Clipperfregalsckip !%£ India Packet . ""'. Kapt. (f. l/ieprriug bijzonder gese likt voor den overvoer vau Passagiers en vooiv.ien . voor ruime luchtine hutten. \:n boord ueviiidt zich ecu bekwaam gcnee*heer; terwijl het plan der kajuit ter inzage ligt bij e ■ ... '■■""■■■ Passage naar Nederland wordt aangeboden met bet snelx x 5 zeilend Ned. Clipper Schip >Li 'i ARIA & BETSIJ '. Kapitein lla*i crltiilt. om '""... in de tweede belft der maand September e. k. van hier te vertrekken. Door de doelmatige en nette inrigting van i kajuit en hutten is deze bodem vuur repatriee' reilde familien üteer aan te bevelen. Aau boord bevindt zicli een geëxamineerde ! doctor. Nadere informatie» Ie bekomen bijden Gezagvoerder en bij de Agenten B. KOPERSMIT & Ct>. (5S5l] te Balaria Samarang en Soerabaija. .■>■'■■ ■■■■■""i ü— I I'— a ——4—mm—Mn —— ' * — Passage naar Nederland wordt aangeboden uut lat snelzeileud Mli Soerabaija Packet >• 4- $ ï f Kapitein S. C. J. OLIVIER. •;■' -—.—**— "" |ii _uiir*tig bekende schip zal in de '"" tweede helft dezer maand van hier vertrekken en heefl nog eenige hutten dispouibel. liiturniaii.ii luj iteii liezagvoenler en luj de Agenten rs-. B. KOPERSMIT b. ('o. t J Z>'r£ ) Passage naar Nederland  Wur.lt aangeboden in- hel si.elzei- l' A- v huil uitmuntend mgerigle en goed e <y-'iÖßa i uitgeruste Nederlan«lsch Pregatschip k JASON il f **ir*--■■•"" • Kapitein W. H. Rusman ■ - *' -' .'mvarende een geëxamineerde Docter en Melkgevende K..e om iv 1 laatste helft van Oetober van hier te vertrekken. /■ Men ad*-eee fcicll tot KËIJNST ï. \ IN.ll en :*;; DORREPAAL & Co teSemar-ng.",http://resolver.kb.nl/resolve?urn=ddd:110536628:mpeg21:a0025:ocr,4,ddd:110536628:mpeg21:p004,Bataviaasch handelsblad,1066
1992424,1866/06/30 00:00:00,2632,ddd:010332747:mpeg21:a0003,http://imageviewer.kb.nl/ImagingService/imagingService?id=ddd:010332747:mpeg21:p002:image&x=853&y=1971&w=757&h=2632,ddd:010332747:mpeg21,1610,4603,853,1971,4,"GOUVERNEMENTS SECRETARIE. Curaeao den 29 Juny 1866. TW AMENS deu HoogEd. Gestr. Heer Gouverneur dezer kolonie wordt bierby bekend gemaakt dat ecu exemplaar van «!c voorloopig vastgestelde liegrooting van Uitgaven en Inkomsten voor de kolonie Curafaö voor het jaar 1867 ter Gouvernements .Secretario ter inzage van belangstellenden ligt. De Hoofd Commis belast met c]t; functien vau den Gouvernements Secretaris W. 13. MELLINK. GOÜVË RNEMENT3 's""Ë(IRETA RIE. Curaeao den U'J .Juny 1806. ""VAMENS den Heer Gouverneur wordt by deze bekend gemaakt dat de Ketting van het brood voor de volgende week eindigende den 7 July als volgt Is bepaald : het brood Van vyftien Cents moei 13:{ (meen wegen on van mimlere pryzeu naar evenredigheid ; zullende het zoogenaamde frausche brood van den voormelden párys een once minder mogen wegen ; op poene als by de Publicatie van den 16 -Maart 18__4 is vastgesteld. De Hoofd Coinmis belast met de functien van deu Gouvernements «Secret-iris W. B. MELLINK. •Administratie van Financien. Publieke Inschryving. IEN verkoop in 's Lands Magazyn te Bonaire aanwezig zyude eene hoeveelheid vau p. m. 30 tonnen Roodccrwhout (het monster in 's Lands Magazyn alhier te bezigtigen) zoo gelieven degenen die daarin gading hebhen zich met besloteiie biljetten vau nschryving te vervoegen ter Administratie van Financien op aanstaanden Dingsdag den 3 July uiterlyk tot en met het vallen vau het middagschot. Wordende de belanghebbenden geïnformeerd dat de aflevering te Bonaire of wel alhier zal kunnen plaats hebben naar verkiezing van den inschry ver in zyn biljet op te geven ; zullende ingeval de levering alhier geschiedt de per de bark Jane welke daartoe zal worden gebezigd telken reize aangebsagte hoeveelheid teu spoedigste na de aankomst van dat vaartuig aan boord van hetzelve moeten worden ontvangen. 'De belanghebbenden worden verzocht om by de opening der biljetten tegenwoordig te zyn of wel zich te doen vertegenwoordigen. Curasao den 29 Juny 1866. De Administrateur van Financien GORSIRA. ■JET vertrek der Pakket is bepaald op Zamrdag den 7 July a. s.; de brieveuzakken voor Europa en St. Thomas zullen op dien dag des namiddags om 2 ure gesloten worden. Curaeao den 20 .tuny 1866. Do Cominir belast met de Post-diretüe P. GORSIRA. OS».",http://resolver.kb.nl/resolve?urn=ddd:010332747:mpeg21:a0003:ocr,2,ddd:010332747:mpeg21:p002,De Curaçaosche courant,757
3336840,1866/08/29 00:00:00,2015,ddd:010389832:mpeg21:a0050,http://imageviewer.kb.nl/ImagingService/imagingService?id=ddd:010389832:mpeg21:p004:image&x=925&y=650&w=1656&h=2015,ddd:010389832:mpeg21,2581,2665,925,650,6,"fl.otto]r__L£txxi.solxo HYPOTHEEKBANK VOOR NEDERLAND GEVESTIGD TE ROTTERDAM. Kantoor: BOOMPJES wijk 1 ne 32. Maatschappelijk Kapitaal f 5000000 waarvan de eerste Serie groot f 1000000 Is uitgegeven. DIRECTIE: Mr. B. MEES Advocaat. — B. VAN ROSSEM. — E. C. W. HOYER. TT m .. OOMMIiSABÏiSES: H. T. LÖHNIS Lid der Provinciale Staten van Zuid-Holland en van den Gemeenteraad te Rotterdam. Mr. J. C. REEPMAKER Secretaris der Kamer van Koophandel en Fabrieken en Advocaat te Rotterdam. G. J. HUYGEN Lid van den Gemeenteraad te Rotterdam. W. A. VIRULY VERBRUGGE Lid van de Tweede Kamer der Staten-Generaal te Rotterdam. J. E. VAN DER AA CRIELLAERT te Rotterdam. Mr. A. C. VAN ROSSEM te Rotterdam. J. J. DOVER Lid der Firma Doyer & Kalff te Zwolle. Mr. J. U. DE KEMPENAER Rijks-Advocaat te Arnhem. P. N. ROCHE Lid der Firma Overklift & Co. te 's Hage. E. H. KOL Lid der Firma Vlaer & Kol te Utrecht. C. VRIESENDORP Lid der Firma Dekker & Vriesendorp te Dordrecht. Jhr. Mr. J. W. M. SCHORER Advocaat te Middelburg. BAAD TAST BESTUUR EN TOEZIGT: H. T. LöHNIS. — Mr. J. C. REEPMAKER. — G. J. HUYGEN. KASSIERS: R. MEES & ZOONEN. Hoofd-Agentschap te Amsterdam. CIIEMET & WEETJEN. — KERKHOVEN & Co. — RAHUSEN & WALLER. — WESTENDORP & Co. — WURFBAIN & ZOON. De Bank leent Gelden onder eerst hypothecair verband op Onroerende Goederen in Nederland. Zij geeft voor een bedrag gelijk staande aan dat der ten haren voordeele gesloten Hypotheken Pandbrieven uit van f 1000 f 100 en /"" 50 rentende 4£ pCt. Me vereischte inlichtingen zijn te bekomen ten Kantore der Bank en hare Agenten. De Directie Wv. B. mSSes. B. TAST ROSSE9I. E. C. IV. HOIJER. Wmm\\ W^ Men verlanSt tegen November eene StOOÜIbOOt Vaart I^^ KEUKENMEID die ook Huiswerk kan verrigten en eene ROTTERDAM 811 HULL. ISLiaac_.orTcia.oici voor Passagiers en Goederen. van de P. G die gewoon is met jonge Kin- De Rader-Stoomboot SEA GUL! Kapitein deren om te gaan. R Dunipace vertrekt van ROTTERDAM naar a. nll mt aMCMBwTVTen""'Bo^exT^etter D>' bl] HULL Zaturdag 1 Septgmber des namiddags. de Boekverkoopers M. WIJT & ZCNEN. Adrea bij J. B. CROL Sr Co.",http://resolver.kb.nl/resolve?urn=ddd:010389832:mpeg21:a0050:ocr,4,ddd:010389832:mpeg21:p004,Rotterdamsche courant,1656
1990685,1866/10/24 00:00:00,2021,ddd:010484542:mpeg21:a0018,http://imageviewer.kb.nl/ImagingService/imagingService?id=ddd:010484542:mpeg21:p003:image&x=74&y=3948&w=985&h=2021,ddd:010484542:mpeg21,1059,5969,74,3948,8,"______ In dank ontvangen van een onbekende E^ ƒ ÏO— voor het Djati-_J-e- Namens de Directie van het Djati- Gesticht (6158) H. PRANGE Secretaris. voor *eestelij ke geleg-enlie „en (6140) te bckomm bij T. GORS. Lel Wel! Uithoofde van verkeerde geruchten acht de ondergeteen'le _icn verpligt te kennen te geven dat niettegenstaande de ernstige ongesteldheid der eigenaresse het *^ot_l Persévérance te Buitenzorg blijft dopend. (6Ui) C. M. VAN ABKOUDE. ' ._fl__*te e ondergeteekende belast zich voortdurend _P»_et Commissiën op VENDUTIEN. J. KLEIJKAMP (6142) Fasnr Baroe. . 0. J. BEKÏËR 18 Verhuisd van Gang Secretarie naar _Jgl*3) Gang -Pool. T_ u h w a g e""T_IT"""" verkrijgbaar bij JACOJ3S 16174) achter het Hoog Geregtshof. Periodieken over 1867. Geabonneerden op de verschillende Europesche Tijdschriften worden verzocht vóór half November aanstaande aan de ondergeteekenden te berigten of met de abonnementen over 1867 voortgegaan dan wel daarin verandering verlangd wordt. Geen berigt ontvangende zal de toezending even als in dit jaar geschieden. Complete lijsten van alle periodieken zijn gratis verkrijgbaar. Be Boekhandelaren LANGE & Co. Batavia October 1866. (6231)",http://resolver.kb.nl/resolve?urn=ddd:010484542:mpeg21:a0018:ocr,3,ddd:010484542:mpeg21:p003,"Java-bode : nieuws, handels- en advertentieblad voor Nederlandsch-Indie",985
1016566,1866/12/15 00:00:00,1031,ddd:011101155:mpeg21:a0012,http://imageviewer.kb.nl/ImagingService/imagingService?id=ddd:011101155:mpeg21:p004:image&x=76&y=3711&w=986&h=1031,ddd:011101155:mpeg21,1062,4742,76,3711,6,IiEÜOEJIDE I'ARFUMERIEN va» RHI3IEL. YBAIOIIE DE TOILETTE ut 11IMMEL l>ctcr cn doe!- matijjci' dan de Eau de Coijjjne. EAU DE LWANDE de IUM.MEL gedistilleerd van bloeden. I'AKFUMS EXPRES van RIMMEL voor den zakdoek. SAYÖN a LA GLYCERINE van RIMMEL ccnc voor-1 lri'fl*olijkc Zeep voor de huid. ODüNIINE van RIMMEL zeer geschikt voor hel vcrfraaijtn der kleur. \ . NAPOKISATfcUR DE PARFUMS van I SIMM EL: waarmede i:ii?u de lucht van alle kwade dampen zuiveren cn vtrliissclirn kim. ' Yeïkrijgliaar hij alle Parfumeurs ia Europa. llimmcl Parfumeur ivi« 11. SI. de Koningin der Nederlanden. Lum.kS: % Strand 21 Cumhill en 128 Rcgcjitstreet. ' Paiujs: 17 boulevards' des Italiens. aii,http://resolver.kb.nl/resolve?urn=ddd:011101155:mpeg21:a0012:ocr,4,ddd:011101155:mpeg21:p004,Sumatra-courant : nieuws- en advertentieblad,986
959616,1866/06/01 00:00:00,1088,ddd:010079886:mpeg21:a0014,http://imageviewer.kb.nl/ImagingService/imagingService?id=ddd:010079886:mpeg21:p004:image&x=91&y=3030&w=882&h=1088,ddd:010079886:mpeg21,973,4118,91,3030,4,GROOTE VERKOOPING VAN TEN VENDÜHÜIZE VAN J. N. CREFCOEUR in de Kerkstraat te 's Hertogenbosch op Dingsdag den 5 «Rlinij 186© om 3 ure ten o-evoWe van finale Kwiteeiïng der Sigarenfabriek ?an den Heer JT. F. VAU' ZEJTI \ aldaar bestaande in Massa 119586 mi% in verschillende soorten op gedrukte Billetten juist omschreven. Een uur voor de Verkooping tegen eene kleine vergoeding proeven te bekomen.,http://resolver.kb.nl/resolve?urn=ddd:010079886:mpeg21:a0014:ocr,4,ddd:010079886:mpeg21:p004,De Noord-Brabanter : staat- en letterkundig dagblad,882
657609,1866/10/30 00:00:00,417,ddd:010389982:mpeg21:a0043,http://imageviewer.kb.nl/ImagingService/imagingService?id=ddd:010389982:mpeg21:p004:image&x=1780&y=93&w=1577&h=417,ddd:010389982:mpeg21,3357,510,1780,93,6,Notarishuis te Rotterdam HEDEN Dingsdag 30 October 1866 des avonds ten 6 ure VEILING VAN: Diverse AANDEELEN in Maatschappijen Geldleeningen enz.,http://resolver.kb.nl/resolve?urn=ddd:010389982:mpeg21:a0043:ocr,4,ddd:010389982:mpeg21:p004,Rotterdamsche courant,1577
2327640,1866/04/15 00:00:00,2282,MMGARO01:000166978:mpeg21:a0012,http://imageviewer.kb.nl/ImagingService/imagingService?id=MMGARO01:000166978:mpeg21:p004:image&x=2133&y=180&w=1020&h=2282,MMGARO01:000166978:mpeg21,3153,2462,2133,180,4,Bij J. SUYKERBUYK te Rosendaal Bij J. SUYKEIIBUYK Ie Rosendaal zijn onder anderen te bekomen: Stolz A. B. C. voor volwassenen. ƒ0.60. De Ségur Gemeenzame onderrigtingen. l e dl. ƒ0.90. Rationalisme en Liberalisme beschouwd in hunne verhouding tot de Katholieke Kerk ƒ1.25. Handboek der Kinderen van Maria of Gebedenboek voor de vrouwspersonen die in hare oefeningen van godsvrucht bijzonderlijk Maria tot voorbeeld en Patrones nemen. Gebonden. ƒ 1.75. Le Sage ten Broek De Hemel is mijn deel of brieven over de volharding na de eerste H. Communie. ƒ0.80. Faber Alles voor Jesus of gemakkelijke wegen tot de goddelijke liefde. ƒ0.75. Cabrini De Zaturdag toegewijd aan Maria of overwegingen over de deugden en heerlijkheden van de allerheiligste Maagd voor al de Zaturdaeen des jaars. ohl Ave Maria. Onbevlekt. Het Paradijs. Stabat Mater. ƒ1.00. ƒ1.00. ƒ1.00. ƒ1.00. ƒ1.00. Gebeden van de H. Theresia door den H. Alph. Maria de Liguorio ƒ0.40. Gebeden van de H. Geertruda. ƒ0.50. Pagani De vrome ziel voor het H. Altaargeheim. °ƒ0.75. Kan een regtgeloovig Christen Vrijmetselaar worden ƒ0.50. Veuillot Het leven van O. H. J.-C. ƒ2.00. Bos mans Practische leerwijze om de kinderen te onderrigten in den kleinen en grooten Mechelschen Catechismus. ƒ2.00. Hen ekens Korte onderwijzingen over de christelijke leering of beknopte uitlegging van den Mechelschen Catechismus. 3 deeien. ƒ3.00. Eer uwen Vader en uwe Moeder Proeve eener verklaring van het vierde gebod. Een geschenk van Ouders en Overheden aan hunne kinderen en onderhoorigen. ƒ1.30.,http://resolver.kb.nl/resolve?urn=MMGARO01:000166978:mpeg21:a0012:ocr,4,MMGARO01:000166978:mpeg21:p004,Rosendaalsche courant,1020
2062620,1866/02/06 00:00:00,2551,MMKB08:000087817:mpeg21:a0016,http://imageviewer.kb.nl/ImagingService/imagingService?id=MMKB08:000087817:mpeg21:p004:image&x=1902&y=694&w=826&h=2551,MMKB08:000087817:mpeg21,2728,3245,1902,694,4,"Advertentie DEPOTHOUDERS worden in alle voorname plaatsen van Gelder] GEVRAAGD  geneden tot verkoop van Pu rp pf GLISH PEPPERMENT (Doublé Stronenessï rrv GER-PEPPERMENT (GEMBER-PEPEfiMtï tegen zeer ruim rabat. Franco Brieven aan WILLEMS en Co. te sterdam  Haarlemmerdijk No. 219 b./d. Oranjestad H et GEMEENTE-BESTUUR van DELFSHI VEN verlangt eene opgave van den prijs van getrokken klinker Waalmoppen berekend per duizend stuks vry aan wal; terwijl er ongeveer 100000 stuks zullen benoodigd wean De opgaven worden binnen veertien dagen f ingewacht op de secretarie dier gemeente. W aar schuwing. De ondergeteekende waarschuwt een ieder GE© CREDIET te verleenen aan zijn Zoon G J BREMER daar deze schulden door hem niet zullen worden voldaan. H. A. BREMER Laders aan Maagkwalen!! Worden ten zeerste aanbevolen de beroemè Maagdroppels van De . STaPPEL uit Londen Maagpijn  Hartwater  ook Watergal genaamd worden even als andere Maagkwalen ontstaan doorsleclti Bigestie Windzucht Rheumatische krampen hu enz. er spoedig door hersteld al zijn die ookTet ouderd. Honderden lijders hebben hier te lande i reeds hunne radicale herstelling aan te danken waarom het middel reeds algemeene bekendheid Ter werft en zijne reputatie ten volle handhaaft. Te bekomen bij G. van MEET EREN A te Utrecht Centraal Bépót voor Nederland  a/1.5? de Flacon met gebruiksaanwijzing en te Arnhei speciaal bij den Heer F. ROMEIJN Apotheker. Schouwburg te Arnhem. Voorstellingdoor de Toor.eelisten van den Rotterdst schen Stads-Schouwburg onder Directie van J. EDUARD DE VRIES op WOENSDAG 7 FEBRUARIJ.1866 De Bruid Daarboven f Oorspronkelijk Tooneehpél in vijf Bedrijven (metk kortingen) door Multatuli. EEN GETROUWD MAN DIE TE VEEL GEKOESTERD WORDT. Een tafereel uit het huwelijksleven. Blijspel in één bedrijf met nieuwe Coupletten "" a den Heer W. N. Peijpers. Aanvang ten ZEVEN u fe",http://resolver.kb.nl/resolve?urn=MMKB08:000087817:mpeg21:a0016:ocr,4,MMKB08:000087817:mpeg21:p004,Arnhemsche courant,826
3343826,1866/04/30 00:00:00,3314,ddd:010287021:mpeg21:a0011,http://imageviewer.kb.nl/ImagingService/imagingService?id=ddd:010287021:mpeg21:p002:image&x=1088&y=2674&w=1009&h=3314,ddd:010287021:mpeg21,2097,5988,1088,2674,4,"Padangsche GELD-LOTEUIJ ten bedrage van 100000.— GULDEN. Met referte aan bovenstaande Advertentie worden de Directiën der verschillende Sociëteiten in Nederl.-indië beleefd uitgenoodigd om de door hun ontvangen en onverkocht geblevene Nummers vóór den 15 April e. k terug te zenden aan het adres van den ondergeteekende en daarbij tevens per Postwissel het bedrag te voegen der door hun afgegeven Loten. De bedoelde Directiën gelieven voorts deze algemeene dankzegging voor hunne genomene moeite aan te nemen als ware die in het bijzonder aan ieder hunner gerigt. Namens de Commissie belast met de regeling dezer Loterij [314] A. H. J. DIEMONT. ':'lLmWia*> De Societeit »IJE EENDRAGT"" te Êf§«S|^ Padang Sumatra's Westkust heeft bij ' besluit van den 2lsten October 1864- No. 5 van het Gouvernement vergunning erlangd tot het openen eener GELD-LOTERIJ ten bedrage van 100000.™ GULDEN waarvan de trekking onherroepelijk in den loop der maand MEI aanstaande zal plaats vinden. De Loten zijn alleen tegen contante betaling verkrijgbaar bij de Directiën der verschillende Sociëteiten in Nederlandsch-Indië alsmede bij de Heeren: BRUINING & WIJT te Batavia. W. OGILVIE id. H. M. VAN DORP id. G. Vi. T. VAN DORP Samarang. DE GROOT KOLFF & Co. id. ROSEMKIJER Soerabaija. THIEME KOLFK & Co. id. De Commissie belast niet de regeling derzelve S. BUL ZEVERIJN. T. B. INTVELD. (313) A. H. J. DIEMONT. :'Ff?^\ het H vis op Zeeslran4 vroe\g^ ger bewoond door Ds. Fortman. Te bevragen bij [882] INGTJANG. '-'^^^mm^>W^^ in de Oude Stailhuisstraat laatst als Toko-Lokaal geoccupeerd door den Heer GÜASZUOFE; te bevragen bij [845] UITGEVERS DEZES. jfiÖS/ftYmf DÜ inschrijving: r?!^s^élfe^' Het gunstig gelegen Koffijland Tawang toebehoorende aan de Erven E. F.MarckS producerende bij de 1000 pikols. OFFERTES inhoudende: le. de te stellen Koopsom 2e. de wijze waarop die zal voldaan worden kunnen aangenomen worden tot den 15de"" Mei a. s. Informatiën bij SENTIUS; Solót (831; MA RC KS Samarang Uit de handt Eene echte Ameririkaine met twee Paarden en Tuigen te bevragen bij GöLLNER. (853) Adj. Ingenieur der Telegrafie.",http://resolver.kb.nl/resolve?urn=ddd:010287021:mpeg21:a0011:ocr,2,ddd:010287021:mpeg21:p002,De locomotief : Samarangsch handels- en advertentie-blad,1009
3826134,1866/05/15 00:00:00,1773,ddd:010140706:mpeg21:a0029,http://imageviewer.kb.nl/ImagingService/imagingService?id=ddd:010140706:mpeg21:p006:image&x=1139&y=3539&w=2158&h=1773,ddd:010140706:mpeg21,3297,5312,1139,3539,6,*OMTVAMGr_E]_¥ een groot Assortiment van de navolgende Goederen: Thee- en Bejenné-Serviesen§ Tafel* Servfesen Verlalite Groecleren9 Brittannia Metaal» Gilas- en Krïstalwerk* (11942) E WILLE * C°_ —.—________——-—————. - * Schroefsto ombootdienst 2|M^ AMSTERDAM-NIEÜWEDIEP V. V. H-*™gm3i-^-__y Kegtstreeks doorvarende zonder overladen. GEBR. tmmmfjMljMN. Voorloopige Dienstregeling. — Van af 15 Jtlei a. s„ DAO_EI_IJK§: Van AMSTERDAM des morgens B ure en 's namiddags 4£ ure. „ ALKMAAR des namiddags circa 1»J ure en 's avonds circa 8 ure. Van -iIEI'WEBIEP des morgens 7% ure en 's avonds II ure. „ ALKMAAR des voormiddags circa lOf ure *en 's nachts JB_ ure. * Dit vertrekuur staat in verbinding met den SPOORTREIN ton 9. ure van den HELDER naar ALKMAAR vertrekkende. Directe Correspondentie Staatsspoorweg-lijn Alkmaar-Nieuwediep: Van AMSTERDAM fles morcr. n* m ?___. $ Corresponderende op den Trein ten 11 ure 10 minuten van ALK» van am»iehiiam üeb morgens * ure . . . |MAAE _£„ NIEÜWÊDIEP vertrekkende. at uwa sr Ac* _vnr.fl- *l . In Correspondentie met den Trein ten 6 ure van NIEUWEDIEP „ ALKMAAR des avonds ï| nre .... |naar ALKMAAR vertrekkende. RETOÏ RHILLETTE ST tegen verminderde Vrachtprijzen onbepaald gangbaar op alle bovengemelde -Diensten. Nadere informatien: te Amsterdam bij den Commissaris GOETZIJT Nieuwestadsherbergbrug naast de Jagthaven; en te Nieuwediep bij dea Commissaris H. LASTDRAGER Hoek Binnenhaven. (12063),http://resolver.kb.nl/resolve?urn=ddd:010140706:mpeg21:a0029:ocr,6,ddd:010140706:mpeg21:p006,Algemeen Handelsblad,2158
1823976,1866/08/18 00:00:00,1848,ddd:011101138:mpeg21:a0007,http://imageviewer.kb.nl/ImagingService/imagingService?id=ddd:011101138:mpeg21:p002:image&x=1083&y=113&w=987&h=1848,ddd:011101138:mpeg21,2070,1961,1083,113,6,«nderjeteekende beveelt ach aan M{L k.| tot opmaken van Dameskleederen en voor alles wat tot het vak van eene Modiste behoort. De Wed. A. DRAGER 409 tegenover het Potikantoor. Padang 18 Aug. 1866. Ontvangen en aan HU. inteekenaren afgeleverd: 8. van Deventer J. Szn. . Bijdrage tot de kennis van het Landelijk Stelsel op Java: Deel 11 franco per post / 15—. . Si? Men wordt beleefd verzocht de Abonneraents-prijs per Postwissel over te naken aan 395 VAN ZADELHOFF & FABRITIUS. Bij de ondergeteekenden zjjn verkrijgbaart Degroote SCHOOLKAART VAN JAVA j . . en idem van den INDISCHE» ARCHIPEL zamengesteld door de HH. OEHLER & CRONENBERG. op linnen met rollen. NEUER ATLAS der ganzen Er de 28 KARTEN nebst TABELLEN von Dr» C. CF. D Steltu Brieven en gelden franco. 384 VAN ZADELHOFF & FABRITIUS.,http://resolver.kb.nl/resolve?urn=ddd:011101138:mpeg21:a0007:ocr,2,ddd:011101138:mpeg21:p002,Sumatra-courant : nieuws- en advertentieblad,987
6400808,1866/04/12 00:00:00,4452,ddd:011209271:mpeg21:a0023,http://imageviewer.kb.nl/ImagingService/imagingService?id=ddd:011209271:mpeg21:p004:image&x=1774&y=423&w=1621&h=4452,ddd:011209271:mpeg21,3395,4875,1774,423,4,"« :...  M(/acfu i. cnwtn/te/.' ONTPAKT EN TEGENIBIL; LIJKEN PRIJS VERKRIJGBAAR: v bOÜDLN); ; do."" do'. Cachetten 'do Vingerringen  ; . (lo; v.: Meuaïlons"" wi'j Albums do'. Manchet Knoopen;: ; ; ■- ; .■ Borst ' do. •; /. i 'iMdq<yp''g'.: Forte . crayons ÉT . plumes ' do. TaNDENSTOOKERS CU OORLEPELTJES ' do ■ . Ketting bij dc • El .do. V estenkettingen-'; 1 do. •• Coliers ■- ''■*»> do. Paêrlen  BLOEDKOHALEX do. In v o o riia d : Gouden ' Parures  &olïtrirjfe-ti  . HalsketUiigêll ~ | ■ yt© / ■ ■ ■ •/' • ■' c*j oucteit en (Jpe-n é/Ceuiffjf &6i-jailr/henl waaronder: . PpïAGHIEPELS Suiker do.  Sorvetbandeii ; ' £LVuc(/e'ti-c/o od/es< .• ' / Zout- zuur- Suiker- Thee* en Mostard schepjes Gember f;VORKEN / ' TBANCH E ERMESSEN on %VORK1 N ' met zilveren hechten  Saladescliaren • en TAN GEN; THEEBOSSEN nel Zilver Gémo^.. «WBd^6k<iKereS.' . SOIEERSTBOOIJEES . Sauslepel s- . : KINDERBEf r.KN TAARTOI'ANNEN. UIERGtAzEN  Bekers Cacwetprukkers: Vuurslagen *; Aschbkkjes Sigarendragerè Thee KistjêsZOüT eD PEPERSTELLËN; SUIKER EN VRUCHTBAAR DEN FLACONS SIGARENKOKERS % Werk d o O z en * rt; . \ etc. etc. etc. ; ' Mooi gekleede : POPPEN Fijne Franscht wit Katoen. ■ • Gebrs.' \AN rPBAAG Bje/>ix. hebben ontvangen per de laatst gearriveerd e schepen en bieden te koop aan : Eng Ingenieurs- Smids -  Timmermans-Metselaars- Kuipers- Schoenmakei's en Blikslagërs G- E E B B DSG H PPE IT iri soorten Veld rum en <êfhcu/ien qeiecdJc/ici/i/ien  Eombnizen» compleet Toonbank en TREKSCHAIEN  B ou w m al erialon. Verfwaren in. soorten. BOEKENDUKATEN IN BRONSCOUD ■ ae/icfïdte ' cu. unaeAooA/e 'jifj* Machine Olie MOLENSMEER ll5L"" ©&!©£§ ■ Gospo.:neu . HENNIJg|^fS Ï3 61'kj ij! JtjL ciX'X)UIS • SfiuYve'ii. &/aghëcfóeA- #■ JLMTiïWJEÏJSr in soorten  ANKERS Touwwèrls Koper en Gegalvaniseerde -. IJzëren SUIKERLEPELS 'Braad en Ga at schuimers f Koperdraad en geschilderd G^AJS ac/e-n >oCaaigee/fey TROMMELS i vpï BLIK  Hijgro- en Sachronietérs  Bobbels Staal! taSyinoor  kroon en zweedsch rond. vierkant en Plaat ij z e r van verschillende afmetingen IJZEREN' en KOPERFNPL ATEN ||van verschillende dikte Koperen en G-eg al v aniseerde % SOHEEPSPLATEN  IN VOORRAAD: Arner. Provis ie n ( mmmiÊM k Balen Witte Rijst  Qd i t < . GLAUBER en EPSOMZOUT etc *. /-'■.^•''v> •»» —n—m— ■—"" -SnelpeAdruk van fiOSE & C°. te Paramaribo . f'.vy.'f. * JMfi&it?-",http://resolver.kb.nl/resolve?urn=ddd:011209271:mpeg21:a0023:ocr,4,ddd:011209271:mpeg21:p004,De kolonist : dagblad toegewyd aan de belangen van Suriname,1621
2905500,1866/10/06 00:00:00,2980,ddd:010529304:mpeg21:a0013,http://imageviewer.kb.nl/ImagingService/imagingService?id=ddd:010529304:mpeg21:p003:image&x=3006&y=2903&w=975&h=2980,ddd:010529304:mpeg21,3981,5883,3006,2903,4,"DE MELODIËN DER EVWGELISCII LDTHERSCnE GEZAIVGEIV VIERSTEMMIG BEWERKT voor Orgel met of zonder Pedaal Plano orgeiiicngd Koor DOOR W. P. _. VAJT DE POIX» ONDER TOEZIGT VAN W. F. G. XICOEAÏ Directeur der Koninklijke Muziekschool te 's Hage zullen bij inteekening worden uitgegeven. Prijs bij Inteekening f 6. Prijs na den termijn van inteekening ƒ 735. De inteekenlijsten worden vóór ult°. October e. k. bij de Uitgevers terug verzocht. 818. Zijnde de lijsten ter inteekening bij alle Muziek - en Boekhandelaren alsmede bij alle 1111. Kerkvoogden en Regenten der Evangelische Luthersche Gemeente van Nederland voorhanden. De Uitgeven  _. j. i.iiiinti:. F. _ . __ EIC.AXD en C°. ZOO EXEN UN DE PERS GEKOHEIV : 24« druk van het eerste zestal \IKIIVC __A_!_- WUZEBï gezet voor eene stem niet begeleiding van Orgel of Plano  door G. M. II iTTtS  bekroond door de Heeren J. H. LUBECK  W. F. G. NICOLAÏ G. A. HEINZE J. C. BOERS eu Fr. HAGEMAN als Leden van de Commissie ter beoordeeling van nieuwe Psalm-melodièn die in antwoord op eene door de Uitgevers uitgeschreven prijsvraag zyn ingekomen. Prijs ƒ 080. De Uitgevers li. _ . EEFEBRE  F. J. U K11.UI) en C°. *^* J. H. HAMBURG 9_v___B_f? Geoct. Chir. Dentiste van Z. M. den Koning jftas""&Wj3sr berigt het geciviliseerd publiek te Haarlem j^^TTrlvagyg dat hij Maandag t den 8'tm dezer en verder elke 14 dagen te spreken of te ontbieden zal zijn in het hotel de Kroon op de Groote Markt wegens het inzetten van zijne nieuwe vinding van R_ STTAXDE\ en (.'EBITTEX welke worden ingezet zonder het uitnemen der nog aanwezige wortels; voorts over tandheelkundige operatien en het abonueren van familien tot regehng der kindertandjes enz. zonder vooruitbetaling. Adres  Halsteeg  n°. 2/j te Amsterdam. *#* Te Haarlem by eene respectabele familie van de P. G. bestaat eene gunstige gelegenheid tot plaatsing van een paar KIXDKKKV Ouders of voogden die hierop aanmerking mogten maken  adresseren zich franco onder letters G. L. V. bij den Heer A. KNOOP Klein Heiligland te Haarlem. %* Wegens vertrek naar elders wordt in eeue der voornaamste steden van Z. 11. ter overname aangeboden een sedert vele jaren bestaande BOKkIIIVDKI.. Het huis op een der beste standen staande kan desverkiezende gedurende een geruimen tijd op billijke voorwaarden in huur worden overgenomen. Bij spoedige overeenkomst is de eigenaar bereid  eenigen tijd belangeloos in de zauk werkzaam te blijven. Adres met geteekendefranco brieven onder n°. U bij den Heer A. KNOOP Klein Heiligland te Haarlem. Brood- en Koekbakkerij. TE KOOP in eene der voornaamste steden van Noord- Holland eene goed beklante BROODBAKKER» waarbij tevens gelegenheid bestaat de Koekbakkerij uitteoefenen met het florissant buis enz. Informatien met franco brieven lett. B. 8. adres den Heer A. KNOOP Klein Heiligland te Haarlem.",http://resolver.kb.nl/resolve?urn=ddd:010529304:mpeg21:a0013:ocr,3,ddd:010529304:mpeg21:p003,Opregte Haarlemsche Courant,975
158848,1866/04/14 00:00:00,128,ddd:010782303:mpeg21:a0017,http://imageviewer.kb.nl/ImagingService/imagingService?id=ddd:010782303:mpeg21:p004:image&x=1374&y=64&w=1241&h=128,ddd:010782303:mpeg21,2615,192,1374,64,6,Inlichtingen 'kunnen worden verkregen bij den Eerstaanwezenden Ingenieur te Delft.,http://resolver.kb.nl/resolve?urn=ddd:010782303:mpeg21:a0017:ocr,4,ddd:010782303:mpeg21:p004,Nederlandsche staatscourant,1241
3640305,1866/04/30 00:00:00,3615,ddd:010897185:mpeg21:a0008,http://imageviewer.kb.nl/ImagingService/imagingService?id=ddd:010897185:mpeg21:p002:image&x=69&y=2350&w=1007&h=3615,ddd:010897185:mpeg21,1076,5965,69,2350,4,#W_lß_3M!g'JM!!-_-_^i'JJ!-^ Logement - Samarang ii;»ji>.l <le Loge. [156 J J. .7. PAPELARD. N^i---4»'»4-»--4»44.-4»»--44»44*'^^ l'hotographisch-Atclier H. VEE NT Karang-Bidara naast liet Roomsche Weeshuis van 's morpens 8 tot 11 nor dagelijks geopend uiigezonderd des Woensdags op welken dag alleen Gezigten van Woonhuizen Landschappen enz. genomen worden. [6 17] Fhotograpliisch. _A_telier VAN J. ECRSTEIN Zeoslnind h. 57. voor korten tijd dagelijks geopend van af den 15deu tlezer ten 8 ure des morgens. Heiast zich niet het maken van Landschappen en Porti ei ten in alle. genre. (72) Pliölograliseh Atelier IC SCHITLZ. Alle dagen geopend op Zeestrand. (243) JiïfjÊË M*'t referte op onze circulaire van 10 April 11. maken wij ondergeteekenden langs deze aan Ouders en \ oogden bekend flat wij onze school Op 4 Junij e. k. op Bodjong in Int huis van tien WelEd. lieer J. Busselaak. zullen openen. Kadere informatiën zijn te bekomen des voormiddag vnu 9 tot 11 ure bij Mevrouw van Keuvel in de llooge/tdorp Slroomslraat No. 527. J. E. VAN KERVEL [893] geb. Uuijshart. A. S. KROM. \olaris Houthuysen woonl op Bodjong iv het huis van den Heer van Lennep. tn«sc!ieii de Heeren Miesegaes en Prosper van den Broek. [894] LOTERIJ van Twintig prachtige SCHILMERIJEX en een SPIEGEL alle in vergulde lijsten bestaande uit elf prijzen en verdeeld in Honderd loten _. Vijftien gulden. Ie Schilderijen en Spiegel zijn te bezigtigen in de Toko van (895 W. KEK HOUT & Co. Hotel der Nederlanden Batavia. Recommandeert! zich door geheel vernieuwde inrigting zindelijkheid goede tafel billijke prijzen en niet door Boom Commissionuaira de eigenaar C. VAN SANTEN. ÏPF GEVRAAGD! Eene DAME van trt-vorderdeii leeftijd om in een Logement op een der kustplaatsen van Java de huishouding te besturen. Adres onder letter M. aan G. KüL-'_' _ Co. te Batavia. [897]3,http://resolver.kb.nl/resolve?urn=ddd:010897185:mpeg21:a0008:ocr,2,ddd:010897185:mpeg21:p002,De locomotief : Samarangsch handels- en advertentie-blad,1007
2298351,1866/02/20 00:00:00,2827,ddd:010783489:mpeg21:a0014,http://imageviewer.kb.nl/ImagingService/imagingService?id=ddd:010783489:mpeg21:p004:image&x=1736&y=1763&w=813&h=2827,ddd:010783489:mpeg21,2549,4590,1736,1763,4,Hf an vTa q<A teSen Mei a- s- • een niet JlLeil Vrdagl te klein WINKELHUIS  met minstens 2 4 5 Benedenkamers liefst aan 't benedeneinde der stad. Adres met franco brieven onder lett. A. V. bij den Boekh. W. J. A. MULDER Zadelstraat. WINKELIERS IN BARËN_N BAND wordt een net en zindelijk artikel dat zuiver 20 % provisie geelt in commissie aangeboden. Aanvrage franco onder het motto Commissie aan het Bureau van dit Blad. lilrmotoYW~bandoniüFs7 van 8 tot 100 Toonen zijn heden in de nieuwste Soorten ontvangen bij P. J. HUINCK Bazar Oudegracht G. 17—18 Lijnmarkt E. 30—37. V Bij DEKKEB & VAN DE VEGT Heerenstraat kan dadelijk geplaatst worden een liKERLixn voor de Binderij en een IOOPKn. V De ondergeteekende geeft bij deze zijnen stadgenooten te kennen dat hij zeven jaren hier ter stede als werkzaam is vijf jaren den overledenen HENDBIKS en ook SCHBADEB behulpzaam is geweest. Daar laatstgenoemde groefbidder wegens ouderdom en zwakte zijne betrekking niet meer waarneemt zoo beveelt de ondergeteekende zich beleefdelijk aan. A. BINNENDIJK Groefbidder. Korte Jansstraat. Utrecht-'s Hertogenbossche STOOM- EN ZEIL-VEREENIGIKG. Hervatting van Dienst. mDc Stoomboot de Brie Provinciën zal op Maandag den 26. Februarij 1866 de dienst tusschen de steden sHertotogenbosch en Utrecht hervatten. Van 's Hertogenbosch Jlaandag Woensdag en Vrijdag des morgens ten 7 ure. Van Utrecht Dingsdag Donderdag en Zaturdag des morgens ten 8 ure van de Waard-barrière ten B'_ ure van de Bijnkade en ten 8% ure van de Tolsteeg-barrière. DE DIRECTIE. %• Bij J. G. BROESE te Utrecht is verkrijgbaar gesteld: ïBSifne maatregelen tegen «le Stiniderpest; — «Ie adekteversoliiinsclen;—aangewende middelen ; teekenen van hersfclling en toestand dei* koe na de her- Stelling door VAN FRANKENIIUYZEN. 15 Cents.,http://resolver.kb.nl/resolve?urn=ddd:010783489:mpeg21:a0014:ocr,4,ddd:010783489:mpeg21:p004,Utrechtsch provinciaal en stedelĳk dagblad : algemeen advertentie-blad,813
2686362,1866/03/07 00:00:00,2681,ddd:010484443:mpeg21:a0004,http://imageviewer.kb.nl/ImagingService/imagingService?id=ddd:010484443:mpeg21:p001:image&x=1097&y=3280&w=1002&h=2681,ddd:010484443:mpeg21,2099,5961,1097,3280,6,"Op de Vendutie van Donderdag S Maart 1866 zuüen alsmede worden verkocht: VS ""W 177 BS&C 180 193 205 8 balen a 20 ps. ;;; ruwe drills 244 251 min of meer door zeewater beschadigd gelost uit het Ned. schip Vertrouwen. (.1218) E - CASSALETTE k Co. Op de Vendutie van den 8 Maart a.s. zullen de Ondergeteekenden alsnog verkoopen: <Gr.Es. 1 kist 50 pees IVo. 64 6/4 Madapollams beschadigd gelost uit het Ned. Schip „ Vertrouwen."" (1293) F. CASSALETTE U Co. Vendutie op Donderdag 8 Maart 1866 voor het huis van den heei KUSSEIVDRAGEB  op het Molenvliet tegenover de Bazar door Van Slooten Morgan & Co. van eenen zeer netten Inboedel bestaande uit een compleet AMEUBLEMENT van Mahoniehout bekleed met Velours d'Utrecht CONSOLES TAFELS KNAPEN met Marmeren bladen sroote SPIEGELS en SCHILDERIJEN PENDULES petroleum LAMPEN een PSYCHE 1 ETENSTAFEL voor 48 personen een DRAAIORGEL VOLTAIBES Hollandsche en bastaard DUIVEN voorts: 1 TENTWAGEN 2 MYLORDS 1 BENDIE 3 Spannen groote Preanger PAARDEN goed gedresseerd voor Bendie eu Wagen BENDIE en WAGENTUIGEN etc. Geene goederen kunnen worden bijgebragt. (1227) Verkoop van een Schip. Op Vrijdag den 9 Maart aanstaande r\ zullen de ondergeteekenden voor rekening i^|^>#\ van wien zulks blijken zal aan te gaan f^4^^_E\\. Publiek verkoopen: 4___L_i* _ï__^ B^ kopervast Nederlandsch Barksehip iF.«lïWïïff»Êïisabeth en Marie metende STT ton met deszelfs staand Tuig waarlooze Rondhouten Ankers Kettingen verdere Inventaris restant Provisiën etc zoo als het is liggende ter reede Soerabaija. Informatiën en inzage der Inventaris bij (1177) GE BUS. ROSELJE k Co. Op de Vendutie van Vrijdag O Maart zullen bij Gebr. ROSELJE & Co. worden verkocht: (1297) 27740 stuks STROOZAKKEN.",http://resolver.kb.nl/resolve?urn=ddd:010484443:mpeg21:a0004:ocr,1,ddd:010484443:mpeg21:p001,"Java-bode : nieuws, handels- en advertentieblad voor Nederlandsch-Indie",1002
3578344,1866/05/20 00:00:00,2849,ddd:010782333:mpeg21:a0014,http://imageviewer.kb.nl/ImagingService/imagingService?id=ddd:010782333:mpeg21:p005:image&x=65&y=211&w=1256&h=2849,ddd:010782333:mpeg21,1321,3060,65,211,12,houden van de werken der Zuid-Willemsvaart voor het gedeelte in het Hertogdom Limburg van de grens van België nabij Loozen tot de grens van Noordbrabant voor den tijd van vijf jaren te rekenen te zijn ingegaan met den lsten Januarij 1866 en eindigende met den 31sten December 1870 uit hoofde van de hooge aannemingsom andermaal is afgekeurd. Eene Herbesteding van dat werk is bepaald op Maandag  den 28sten Mei 1866 des voormiddags ten 10 ure aan het gebouw van het Provinciaal Bestuur te Maastricht. In het Bestek N°. 33 goedgekeurd den Bsten Januarij 1866 worden de volgende wijzigingen gebragt: 1. Onder het onderhoud der beplantingen  vermeld in art. 1 is niet begrepen het vervangen van doode kwijnende of beschadigde boomen door inplanting van levende poten; 2. Het onder profil houden van den bodem van het Kanaal ingevolge de eerste alinea van § 13 van het Bestek zal geschieden volgens het tarief van art. 6 van het Bestek waarvoor de aannemer in zijne aannemingsom moet begrijpen eene som van f 625 ; 3. De vierde alinea van § 22 is niet toepasselijk op do meerdere lengte nieuwen tuin die volgens art. 1 in 1866 en in 1867 moet worden gemaakt; de meerdere lengte tuin welke in die jaren wordt vernieuwd zal in mindering komen van de lengte die volgens gemeld artikel in 1866 moet worden uitgevoerd. De oplevering der nieuwe tuinen in 1866 wordt op den Isden December 1866 bepaald. 4. De Herbesteding geschiedt bij inschrijving en opbod ; 5. In plaats der Algemeene Regelen en Bepalingen worden de Algemeene Voorschriften goedgekeurd den lsten Maart 1866  n°. 177 op dit werk van toepassing verklaard; mitsdien wordt gelezen: op bladz. 21 van het bestek in plaats van § 291 der A. R. en B.: § 343 der A. V.; op bladz. 22 van het bestek art. 2 in plaats van Algemeene Regelen «n Bepalingen: Algemeene Voorschriften; op bladz. 23 van het bestek art. 2 in plaats van Algemeene Regelen en Bepalingen: A. R. en B.: Algemeene Voorschriften A. V.; op bladz. 23 van het bestek art. 4 in plaats van Algemeene Regelen en Bepalingen: Algemeene Voorschriften; op bladz. 23 van het bestek art. 4 §13 in plaats van §261 §309; op bladz. 23 van het bestek art. 4 § 13 in plaats van §§ 258 259 en 260: §§ 306 307 en 308; op bladz. 24 van het bestek art. 4 § 20 in plaats van art. 47 § 275: art. 51. § 324: op bladz. 24 van het bestek art. 4 § 21 in plaats van art. 1 2 17 18 19 32 33 37 38 en 42: art. 1 2 18 19 20 36 37 41 42 en 46; op bladz. 25 van het bestek art. 4 § 23 in plaats van art. 28: art. 32; op bladz. 25 van het bestek art. 4 § 23 in plaats van art. 47 § 276: art. 51 § 326; op bladz. 25 van het bestek art. 4 § 23 in plaats van § 158: § 189; op bladz. 25 van het bestek art. 5 § 24 in plaats van art. 18 tot en met 56 der A. R. en B: art. 52 tot en met 61 der A. V.; op bladz. 25 van het bestek art. 5 § 24 in plaats van art. 57 § 369 der A. R. en B.: art. 62 § 431 der A. V; op bladz. 25 van het bestek art. 6 § 25 in plaats van art. 60 § 302 der A. R. en B.: art. 65 § 444 der A. V.; op bladz. 28 van het bestek art. 8 § 27 in plaats van art. 47 § 265 der A. R. en B.: art. 51 § 314 der A. V; op bladz. 28 van het bestek art. 10 § 31. in plaats van art. 47 § 267 der A. R. en B.: art. 51 § 316 der A. V; op bladz. 30 van het bestek art. 14 § 38 in plaats van art. 59 tot 82 der A. R. en B.: art. 64 tot 87 dor A. V.; op bladz. 30 van het bestek art. 15 § 39 in plaats van § 58 § 372 der A. R. en 8. art. 63 § 433 der A. V. 6. De kosten der eerste Bestedingen bedragende ongeveer f 50 komen mede ten laste van den aannemer. Inlichtingen zijn to bekomon bij den Hoofdingenieur en den Ingenieur te Maastricht en den Ingenieur te Roermond 's Gravenhage 17 Mei 1866. Van wege den Minister De Secretaris-Generaal 3. Schröder.,http://resolver.kb.nl/resolve?urn=ddd:010782333:mpeg21:a0014:ocr,5,ddd:010782333:mpeg21:p005,Nederlandsche staatscourant,1256
8591300,1866/04/21 00:00:00,6160,ddd:110536561:mpeg21:a0012,http://imageviewer.kb.nl/ImagingService/imagingService?id=ddd:110536561:mpeg21:p003:image&x=1147&y=113&w=2071&h=6160,ddd:110536561:mpeg21,3218,6273,1147,113,8,"Te Koop: 03L.ÏE XSLGIfiiSSJEïT^a* (22!»7) bij P. F. WILLEMS qq. """"""*'* Marine-Kantoor o u iro ' / Sttha 'ie. Adres 2-2:52) CIIAMH >N ijq. U *-""''-ff3W*«HlT\ 2 om /'.«•--225Ü) Wed VOER MA NS. Ongemeubileerd rs te Hi ut legen I MEI n i 2221) Adres : TOKO BAIU >E. rr—*trn-r--vtt* j^^«^j-?.-^--cit-jw* i in-?ry-j«v~:-'.r ~ »»:.••■• ti 'i'-'1 1 Jjinij hetlßlUS -~— wuond n«or ven lieer ';'-/w;;i/w;'--luformatien Ie bekomen bij 22».*) ENGELHARD \ Co. ü— ii. miii ■ — ip i» ■■■! ii in ■■ m ■ in ■! m iti n '~rr~^  - -x-jrer*. Ken ruim steenen Ëtitii* '.-/; ~- bewoond door en Ie bevragen bij de eigenares. :':;i- Wed. M.C. VAN DER MEIJDEN Frank. iujèpjk *e * I-uur: /.: *4?t.rK.. .'Ke u lillS iv Cunu &i'Ott -eaound door den Heer Bemier Ie bevragen i.ij den Heer 1! I . ItAHRELL (2223) uf bij Thos. HALL I e mand  vroetrer opziener van een «ÊrNsT *- <Jiri.""£%.S en 3ÉSLO££L3— X<^XX*d7 l-ekend mei deszelfs Administratie enz  wenschl eene plaal -in.: als z lodanig. ■""> 1 2 Adres franco brieven L. A. L ilg» ver dezes. (levraagd [»assage naar Europa. —SËsÊÈ®*l* J"" **""""£** da3Jse. bekend . met reizen vn-enide lul. n. nuzijk •wl en wal verder tol eene beschaafde opvoeding behoort wenschte ler be«clei iiu""'van Kinderen viel of zonder hunne familie of tot gezelschap of verzorging FCner dame de reis naar Xederland o( naar laat land ;(. maken lc°""en - - r. genot van vrtij |»;ja*;ii».:» per mail ui'fier schip. Adres franco bij den l itgever van den Java- Ihii/c. onder het nuunner dezer Advertentie. —Qg?ffië»%^.Ycn Ambtenaar op wachtgeld Jj vrnaiit tegen billijke voor-3""W waarden friosi en S.wons;ig bij eene gezellige familie. Adres franco brieven bij den uitgever dezes onder letter AL (2298) ""mÜS***!!''' l('kcMiin""Cll ViV"" PAKHTJIS.. II HUUR voor alhier («i öüirepo•»J secrde Goederen over liet Ie kwartaal 1866 'en kantore van den Ondergeteekende ter ontvangst gereed liggende zoo worden belanghebbenden verzocht dezelven voor Ultimo dezer te. voldoen ter vermijding van de poenaliteiten welke voor nalatigen daaromtrent bij de wet zijn vastgesteld. Be Ontvanger der hk. en Vitg. Regten- (2229) HEIDSIECK. Batavia den KI April lblifi. <)l''l' r--''""'r!n n !'' ""'i'll vanaf . |«§s3t IF heden te Etciitcmzorg eene akm IOKO opgerigt en belast zich tevens met OQTMTn 1 mtsx% frYX-1 («280) .1. W. BEttNON .Tr. j:aßftgiËfe vouée pi'ti.l mi jilusieu*.s an&i*3 néi's aKéducaüou tic 1 i jeu- ! nesse désire trouver anc place coniuie l;i'*»ssitiirice dans une fainille. Elle voudrait aussi volontiers se eharger des fonctions 1)K DAME . DE COMPAGNIE ou DE L'ADMINISTRATION  DUN MENAGE. Renseignenu uls sous ITniliale X. Baiaviaasch Handelsblad. (22.ï*) ""^JP^*3* f 1'"" Ondergeteekeude belast zich voort- 9 1 durend met . Conmiissiëii op Vendiitiën '•■■.V .1. KLEIJKAMP Gang X- ■ d/rijk. ?^g|g^K£5-- jj i. d.' Leesbibliotheek vnii Holland*ir*^ J -*- üche en fransche K». ken vun & Co. op Rijswijk Kun men zich voortdurend nl>on neren. De CATALOGUS is grutis verkrijgbaar. (2282 I?*'"" '■'''Udiu; Landbouwer en ar; B**«l|p* Ui Suikerristplantc-r bh at ach aau bij t .:-■_? L .'XS.J— C>_XClo3.v voor Suikerriej teelt. Adres letter Q. Uitgever dezer. (2293) 6* 2V ' 'iiil.-i-i'i-t. i-ki-in'.c lx lei-h zi.-li aan als *&**& U t'.iiiiiiiiissiiiniiair np Vciditiëi | als ook tot het Koopen en Verkoopen van Goedereu uit ide hand li»-i inkassereu en Uitbetalen van Gelden enz. j belooveade eeue Recele ui Soiiede bediening ; (2257) .1. A. EMANUEL Pataar Baroe. Hotel der Nederlanden Geheel nieuw Ligerigt Heropend. Tegen verkeerd verspelde geruchten annonceert de ondergeteekende dal de prijzen met andere lli.tei-j Ie rang gelijk staan. (2249) C. VAN SANTEN. Batavia April is;;. J. IJ. 11 ooi«ti van Nooten Makelaar in effecten producten >""... o. '1 Batavia . (11 fier oost/j de. r-w au in ii !■■ ■iin i » m■ - '■' ~~ i 1 Toko P.assar Baroe. Debiteuren worden verzocht hun delwl ten spoedigste aun te zuiveren leu einde ziclt te vrijwaren voor geregtelijkc vcrvolgin (2«Sl] ~ li. I X.EL. 12 Portretten 10 &ÜLDEJ . Ak'liei' v\\ I*. A. ES §5 EE»EES O P«w /;- l;jks geopend van 6'« tol 10 ur.- 's morgen». A rukken vau vroegere Clichés ook van die door den heer Louian gemaakt per dozijn/ 6 Inlandsche Tijp n.. .  „ ~ 6 (2278 I Kennisgave. Blijkens resolutie gearresteerd in de Algemeene Vergadering der Vereeniging vun Assuradeuren alhier dd. :. Eebruarij 1866 zal voorstaan en wel te beginnen met lö April 1866 voor alle Zeeverzekeringen behalve de premie volgens premie Tarief hel navolgend Polisgeld in rekeuing worden gebragt ais: Voor elke polis in üriginale over reizen naar ... van het buitenland ....ƒ«--n "" < «PIJ i/ I— * n polis over reizen in de Imlis.-be wateren „ 1—■ Namens «Ie Directie der Vereeniging A. R. .1. CRAMERUS President. Til. SCHUURMAN Joh/:. Secretaris. Batavia April 1866 (2313)",http://resolver.kb.nl/resolve?urn=ddd:110536561:mpeg21:a0012:ocr,3,ddd:110536561:mpeg21:p003,Bataviaasch handelsblad,2071
10501774,1866/10/15 00:00:00,4522,ddd:010287069:mpeg21:a0009,http://imageviewer.kb.nl/ImagingService/imagingService?id=ddd:010287069:mpeg21:p001:image&x=47&y=1483&w=3038&h=4522,ddd:010287069:mpeg21,3085,6005,47,1483,4,"A_<i ver ten tiëm Vendutiën van Soesman 4» Co. °P 16 dezer in een der Lokalen van de internationale Crediet- en Handelsvereeniging „Rotterdam"". Op Dingsdag 23 dezer. Toko-Vendutie in hun Locaal. ¦ Op Woensdag 24 dezer ten huize van den WelEdG. «eer Helmkampf op Blakang-Kebon wegens vertrek. ?°P Donderdag; 25 dezer ten huize van den Heer •«• M. Zorab op Pontjol. Op Vrijdag 26 dezer Balken-Vendutie aan den _I_°m- (2213) Groote Vendutie. Op Dingsdag 16 dezer zullen SOBSMAN k Co. voor rekening der Internationale C. en 11. Vereeniging „Rotterdam"" in de Lokalen dier Fereeniging verkoopen-. 100 picols goede en inferieure Koffij. 5000 Rijstzakken. [2217] Voorts: Eene belangrijke partij Koopmanschappen diverse Eijnwaden Provisiën in kavelingen Dranken in soor*en en wat meer ter tafel zal worden gebragt. Vendutie op Woensdag den I7ib October in onze Lokalen van Producten Lijnwaden en diverse Koopmanschappen. [2218] CHEVALLIER & Co. Op onze Vendutie van den 17den October zullen wij verkoopen : 100 balen Tabak Oogst 1865 te zamen ca 15000 Amst. ponden inhoudende. (2219 J CHEVALLIER & Co. Op onze Vendutie van den 17den October zullen wij verkoopen: 500 dozijn goed schuimend Bier merken Hooiberg- Kroon- en Haantjes Bier. f 2220] CHEVALLIER & Co. Op onze Vendutie van den 17den October zullen wij verkoopen: 200 kistjes Perzische AMANDELEN. 80 kalabassen délicieuse SHIRAZ-WIJN. (2221] CHEVALLIER & Co. Op onze Vendutie van den 17den October zullen wij verkoopien: 14 kisten „ 50 pees gebleekte ShirtingS. (222 >j CHEVALLIER & Co. Op onze Vendutie van den 17den October zullen wij verkoopen : . 150/ mille Java Sigaren in kistjes van 500 en 250 pees. (2223] CHEVALLIER & Co. Op onze Vendutie van den 17den October zullen wij verkoopen: 36 manden gesneden Tabak geschikt voor de Inlandsche markt. (2224] CHEVALLIER & Co. Op onze Vendutie van den 17den October. zullen wij verkoopen : 600 picols Koffij waarvan 65 picols le. soort 50 picols 2e. soort en liet restant inferieure eu zwarte Koffij. [2225] CHEVALLIER & Co. Op onze Vendutie van den 17den October zullen wij verkoopen: 150 picols Suiker. (2226) CHEVALLIER & Co. Op onze Vendutie van Woensdag 17 dezer zullen wij verkoopen : Een Tentwagen met een span hardloopende Sandelwood Paarden compleet en twee Heeren Zadels. '2265) CHEVALLIER & Co. Op onze Vendutie van Woensdag \1 dezer zullen wij verkoopen: Een partijtje Zilveren Lepels Vorken en Messen. (2266) CHEVALLIER & Co. Op Woensdag den 17den dezer Tokü-Vendulic in ons locaal van diverse Koopmanschappen Dranken Provisiën Lijnwaden Wagens Paarden Koeijen en bijgebragte goederen. [2227] VOORNEMAN & Co. Vendutie. Op Donderdag 18 October 1866 in de Pakhuizen van Salomonson Ac IMeyer. Onder anderen zal worden verkocht a tout prix: 1 Braeck (Fransche Jagtwagen) nieuw. 16 kisten Propatria-papier. 1 kist Eransche Crinolines. 1 „ „ Organdie. Fransche. Pendules pleeten Presenteerbladen Degenstokken Glas- en Aardewerk enz. (2228) A. MEIJER. Toko-Vendutie op Vrijdag den IDilen Octolier a.... van Lijnwaden Geelkoper Kar assen en bijgebragte goederen. [2229] THOOFT & Co. Op de Toko-Vendutie van Soesman # Co. op Dingsdag 23 dezer zal worden voortgegaan met de opruiming van de Factuur Cavitas en Europesche Sigaren benevens van eene partij Wijn in kisten van 4 en van 1 dozijn eeue partij Keukengereedschappen enz. enz. [2231 J Mn Vendulie. In liet Veniiulocaal van SOEMI/t\ k Co. op Donderdag 23 dezer van diverse Koopmanschappen Dranken Provisiën en aangebragte goederen. (2230) Op de Vendutie van Dingsdag; 23 dezer zal men verkoopen: 200 picols Kolf ij in kavelingen. (2282; SOESMAN & Co. Vendutie. Op Woensdag lh dezer zullen Soesman & Co wegens vertrek Vendutie houden ten Huize van den WelEdelGestr. [leer E. F. M. HELMKAMPP op Blakang-Kebon van ZEdG. uitstekend fraaijen Inboedel bestaande uit: Bataviasche en andere Meubelen zullende tevens verkocht woeden: Een gemakkelijk rijdende HANDCHAISE. (2233 Vendutie. Op Donderdag 25 dezer zullen de ondergeteekenden Vendutie houden op Pendahaau [Pontjol] ten Huize van den WelEd. Heer ivi. ai. z;oü_a_i_s van Zh'ds. zeer netten Inboedel Wagens Paarden enz. enz zullende van een en ander later specifique annonces gedaan worden. [234] SOESMAN & Co. Groote Hout-Vendu.ie. Op VRIJDAG 26 dezer aan den Boom. Door aankomst van het Schip „lillen"" mei eene aanzienlijke lading Hout kunnen wij op deze Vendutie leveren: 1001) stuks zware en zuiver gekapte Djattiehouten Balken van meest gewilde afmetingen zijnde deze Balken te bezigtigen op de Stapelplaats aon deu Boom dor Internationale Crediet en H. Vereeniging „Rotterdam."" [2235] SOESMAN & Co. Vendutie te Demak. Op ilauiidatj en llini|sdaij 29 en liö dezer xulleu Soesman Ac Co. in den Dalem van den Regent vau Demak voor rekening van den Boedel van Wijlen den pangeran ARIO TJONDRO NEGORO Vendutie houden van Wijlen ZEdG. zeer netten Inboedel bestaande uit: Europesche Bataviasche en andere Meubelen waaronder een Ameublement van Mahonyhout met Leder bekleed prachtige Spiegels en Schilderijen Ronde Tafels Consoles Waschtafels Buffetten met marmeren bladen Hang- en Staande-Lampen Ledikanten groote Etenstafels Speeltafels Kleêr- en Legkasten Matten een goede Reiswagen. Voorts: Eenige met Atap en Pannen gedekte Huizen Gedogan enz. melkgevende Koeijen met Kalveren een groote Gamelang Slendro en wat verder te voorschijn zal worden gebragt. Met Commissiën belasten zich gaarne [2236] SOESMAN & Co. Op de Vendulie van Maandag en Dingsdag 29 en 30 dezer. te Demak znllen wij nog verkoopen .-2 groote Gamelangs compleet waarvan één Slendro met Gongs enz. enz. wegende aan koper 14.08 picols en één AVatang of Senen wegende 2.72 picols. Deze Gamelangs zijn goed bekend en zuiver van toon. Met Commissiën op deze belangrijke Vendutie willen zich gaarne belasten [2237] SOESMAN & Co. ~ Op 12 November 1866 des voormiddags ten tien ure zal ten overstaan van het Vendu-Katoor te Soeracarta onder nadere goedkeuring van het Gouvernements van Nederlandseh- Indië worden geveild de Koffij- en Indigo Onderneming genaamd Satrian zijnde de huurregten op den grond waarop de Onderneming wordt gedreven ter uitgestrektheid van 53; Solosche Jonken gelegen nabij Boijolalie en al wat verder tot de Onderneming behoort. Informatiën te bekomen bij G. Weijnschenk te bjocdjacarta en A. van Bronckhorst te Satriai. [2238] W. K. VAN DEDEM qq. ~~ PiTiW/WCIIT ontvangen: ÏOO StukS puike Hammen vau het bekende merk GT II P. ÏOO manden versch echt Selterswater ÏOO vaatjes puike Boter T. O [2241] THOOFT & Co.",http://resolver.kb.nl/resolve?urn=ddd:010287069:mpeg21:a0009:ocr,1,ddd:010287069:mpeg21:p001,De locomotief : Samarangsch handels- en advertentie-blad,3038
3140634,1866/12/10 00:00:00,3182,ddd:010287086:mpeg21:a0029,http://imageviewer.kb.nl/ImagingService/imagingService?id=ddd:010287086:mpeg21:p003:image&x=3086&y=2832&w=987&h=3182,ddd:010287086:mpeg21,4073,6014,3086,2832,4,"Op onze Icüfliil. van Donderdag zal -/.og verkocht worden: lfl stuks ijzeren Ledikanten. 8 „ „ Flessenrakken. o i '„ Bloemenstaandaards. lo -TgT-clui Kroonlampen van 2 .-; êü 4 Iït. ton. [_. ii-j THOOKT & C„. Vrijdag' 14 December Vendutie iv da Pakhuizen van Salomonson & Meijer lo! sluiting vau Facturen _ (out prix: ! kisten ii 50 blik Kransctïc Provisiën. ""S „ Roode.uijn \ vau het beroemde merk 2 7 „ Champagne j Ifranflëuïï ürg Freres 10 » Cognac ) liordeaux. tien. partij Portwijn Madeira Vermouth Ifhij.iwijn alles puike kwaliteit 3 paar groote Kranscbe Spiegels . stel groote Fransche Schilderijen 1 nieuwe Pianino' en nog meer andere goederen te veel om op te noemen. f 2680 A. MEITKR. Vendnlie wegens vertrek. Op Donilenlai) tien 2751.n dezer zullen SOKSHAV _ Co. Vendutie houden ten Huize van den Wc]KdG. Heer H. L. Benjamins Officier van (iczon.lieii! achter het Hospitaal van ZKdG. netten Inboedel beslaande uit: goed onderhouden Meubelen waaronder prachtige Schilderijen. Voorts van: Eene Europesche Koets-Coupé een Mylord twee span goedloopende Overwals che Wagenpaarden enz. I 665] SOKSMAN & Co. ïn Commissie ontvangen: Eon partijtje Goudwerken bestaande uit: Parures Armbanden Broches Oorringen Médaillons Ijreloques Horologiekettingeii etc. etc alhs naar den laatsten smaak zeer geschikt voor nieuwjaars — cadeaux. '¦2680; SOKSMAN & Co. Ontvangen: Versch Selterswater Valkerbier van Vollenhoven $ Co. Lagerbier vau Peter Overbech Pale Ale en Porter-Bier geassorteerde Likeuren vau boeking Peters Rum Punch Absinth en Kirsch wasser Marasquino. [2669 J THOOFT & Co. REGEN-JASSEN steeds en zeer goedkoop bij PKISIGKR & Co. (2678) Zoetemeiksehe RAAS. Per Q/iinlet ontvingen wij: Een pariijlje ileliriense Z.M. KAAS. [2690 J REISIGER & Co. Verkrijgbaar bij Tan Kooboean llaijelanij Salaliija en Ambarawa. Verschillende soorten van Provisiën en Dranken Manufacturen en vele andere Goederen. (2677;",http://resolver.kb.nl/resolve?urn=ddd:010287086:mpeg21:a0029:ocr,3,ddd:010287086:mpeg21:p003,De locomotief : Samarangsch handels- en advertentie-blad,987
633846,1866/12/03 00:00:00,709,MMKB08:000087764:mpeg21:a0017,http://imageviewer.kb.nl/ImagingService/imagingService?id=MMKB08:000087764:mpeg21:p004:image&x=997&y=72&w=894&h=709,MMKB08:000087764:mpeg21,1891,781,997,72,10,Advertentie Amhemsche fideel- en Broodfabriek. ^ De prijzen van het Brood zijn gebleven als de vorige opgave. TOELICHTIItfG. Geheime Ziekten. Nood en Hulpboek. Het Zelfbehoud. Impotentia Virilis. Préservation Personnelle. Zelfbewaring. lnjection Brou. Savonules Lebel enz. enz. Aangaande deze en soortgelijke Schriften en Annonces is er eene belangrijke Toelichting verschenen in de Voorlezingen van Doctor MEINERT verkrijgbaar gesteld tegen 50 Cents bij W. J. THIEME & Co. te Zutphen  en bij E. ter HAAR te Dieren.,http://resolver.kb.nl/resolve?urn=MMKB08:000087764:mpeg21:a0017:ocr,4,MMKB08:000087764:mpeg21:p004,Arnhemsche courant,894
678612,1866/03/17 00:00:00,318,ddd:010140613:mpeg21:a0017,http://imageviewer.kb.nl/ImagingService/imagingService?id=ddd:010140613:mpeg21:p003:image&x=1149&y=5009&w=2134&h=318,ddd:010140613:mpeg21,3283,5327,1149,5009,6,- Bij -FRANS B_J_P_FA __ 2SONEW is verkrijgbaar gesteld: PLAK. voor de plaatsing- van een Centraal Spoorweg-Station te Amsterdam en voor den aanleg: van een Ceintuurbaan om die Stad opgemaakt door de Hamer van Koophandel en Fabrieken te Amsterdam. Frijs f 2.50.,http://resolver.kb.nl/resolve?urn=ddd:010140613:mpeg21:a0017:ocr,3,ddd:010140613:mpeg21:p003,Algemeen Handelsblad,2134
2649436,1866/02/21 00:00:00,2698,ddd:010484511:mpeg21:a0004,http://imageviewer.kb.nl/ImagingService/imagingService?id=ddd:010484511:mpeg21:p001:image&x=1098&y=3274&w=982&h=2698,ddd:010484511:mpeg21,2080,5972,1098,3274,6,Vendutie op Maandag den 26 Februarij a.s. ten huize van den Heer f. o. üose in Gang Cornelis nabij Gang Ilalkema door VAN VLEUTEN & COX. van eenen netten Inboedel waarbij SPIEGELS en SCHILDERIJEN Amerikaansche BANKEN met paardenharen bekleedsel Amerikaansche STOELEN en WIPSTOELEN mahoniehouten SPEELTAFELS MEDAILLON SCHILDERIJEN PENDULE een fraai JAGTGEWEER SABELS een stel FLORETTEN MASQUES en HANDSCHOEN EN eene SCHRIJFTAFEL KASTEN LEDIKANTEN on WASCHTAFELS MODERATEUR LAMPEN Engelsche HANGLAMPEN PLEET- en PORCELEINWERK enz. Palembangsche ROT'LTNGMATTEN. Voorts: 1 HANDWAGEN met lossen bok 1 BENDIE 1 RIJPAARD 1 BENDIEPAARD fraaije ZADELS TUIGEN mz. (950) Openbare Verkoop op MAANDAG 26 Februarij a.s. ten overstaan van het vendu-kantoor te Poerwalïierta te houden op TJILAIX K A Ï». Vooreerst van den INVENTARIS der aldaar gelegen Suikerfabriek waaropder: Een Suilierrietpersmolen gedreven door stoom van R. A. Robinson met een vermogen van 15 paardenkracht. Een Sutilzerrietpersmolen van Lowmoor gedreven door water met een djattiehouten waterwiel van 29 voet diameter. Eene .A_ralistol£erij van Burosne 8f C'ail met 24 gistingkiiipen. En wijders: een MORTELMOLEN 3 TJENG BATTERIJEN 2 SUIKERBATTERIJEN 1 S TROOPRATTERU IJzeren VERGAARBAKKEN en do. TJENGKISTEN met flotteurs ieder inhoudende 2500 Ned. kannen SUIKERPOTTEN KARREN PLOEGEN en verdere GEREEDSCHAPPEN van landbonw en den SMIDSWINKEL benevens FABRIEKBENOODIGDIIEDEN. Ten Tweede Vier Honderd Vijftig pikols RIJST. Ten .Derde voor afbraak de op het perceel Tiilankap staande GEBOUWEN als WOONHUIS BIJGEBOUWEN FABRIEK OPZIENERS WONINGEN LOODSEN PAKHUIZEN enz. Ecu en ander inmiddels dagelijks te beïigtigen. SIMON qq. Tjilankap 16 Februarij 1866. CJ69) Op MAANDAG^n DINGSDAG 12 en 13 Maart 1866 zullen de Ondergeteekenden VENDUTIE houden  ten huize van den WelEdGestr. lieer IV. TJR.A. Kïfc^INTISIS aan het Koningsplein van deszelfs zeer goed onderhouden INBOEDEL zullende later worden omschreven. (908) F. CASSALETTE k Co.,http://resolver.kb.nl/resolve?urn=ddd:010484511:mpeg21:a0004:ocr,1,ddd:010484511:mpeg21:p001,"Java-bode : nieuws, handels- en advertentieblad voor Nederlandsch-Indie",982
4565367,1866/10/04 00:00:00,5020,ddd:010113512:mpeg21:a0038,http://imageviewer.kb.nl/ImagingService/imagingService?id=ddd:010113512:mpeg21:p004:image&x=2459&y=60&w=1566&h=5020,ddd:010113512:mpeg21,4025,5080,2459,60,6,"BELANGRIJKE DITGAVEN van (15673) JOH. NOMAN en ZOON te Zalt-Bommel. I. BIJDRAGEN TOT DE KENNIS VAN HET LANDELIJK STELSEL OP JAVA op last van Z. Exc. den Min. van Koloniën I. B. Fransen van de Putte bijeenverzameld door S. van Deventer S. Jz. 3 deelen kompl. royaal &"". . . ƒ34.75. 11. DE JURISPRUDENTIE EN LITTERATUUR nopens Art. 986 B. W. (Art. 939 Ind. B. W.) rakende den vorm der Uiterste Willen bij Openbare Aeten met Ophelderingen en Opmerkingen door W. de Gelder. Gr. 8° f 2. 111. DE VOOGDIJ EN DE TOEZIENDE VOOGDIJ DER WEESKAMERS IN NEDERL. INDIE door W. de Gelder. Royaal 8° f I.SO. IV. KOLONIALE PARLEMENTAIRE REDEVOERINGEN door Dr. W. R. van Hoëvell 1849—1862.4 dln. royaa!B °. ƒ14.10. V. BURGERLIJK WETBOEK V. NEDERL. INDIE met de Verwijzingen en uitvoerige Aanteekeningen doorMr.CA.de Jongh. Royaal B°. geb. in Linnen Band /'W.TA. VI. DE GEOLOGISCHE BEWIJZEN VOOR DE OUDHEID VAN HET MENSCHELIJK GESLACHT en Aanmerkingen op de Leer van het ontstaan der soorten door verandering door Ch. Eycll. Uit het Eng. door T.C. WINKLER. Met vele Houtsneêfiguren. Royaal. 8° f 7.50. VII. OPMERKINGEN OVER DE BEHANDELING DER GEVANGENEN IN lERLAND ENZ. Naar den 2den druk uit het Engelsch door C. H. PleijtC. Met eene Voorrede van Mr. Alstorphlus Grevellnk. Gr. 8° ... f 2. VIII. ALGEMEENE ORDERS VOOR HET NEDERL. LEGER IN OOST-INDIE met uitvoerig Alphab. Register verzameld door Majoor W. A. Tan ReCS onder medewerking van den Oud-Kapt. IV. A. Banlëls. Geb. in Verg. Linnen Band postform f 10. IX. MILITAIR WETBOEK VOOR HET NED. 0.-I. LEGER bewerkt door Majoor W. A. van Kees en Kapt. R. ST. Bar. Geb. in Verg. Linnen Band postform. ƒ4.50. X. DE WERKEN VAN POTHIER door Aanteekeningen in verband beschouwd met het NEDERL. BURG. WETBOEK op het voetspoor van Bugnet Hoogl. in de Regten te Parijs door Mr. G. E. Verhandeling over de Verbindtenissen. 2 deelen gr. 8° f 10.30. PROTESTANTEN. In plaats van f 9 voor slechts f 3.45 en een keurig werk van /""3.4i op den koop.toe: DE KERKEN DER WOESTIJN of Geschiedenis van de verdrukking der Protestanten in Frankrijk van het einde der regering van Lodewijk XIV tot op de Fransche omwenteling meerendeels naar oorspronkelijke en onuitgegeven stukken bewerkt door C. Coquerel. 2 deelen 1000 pagina's B°. In plaats van ƒ 9 voor slechts Aan de Koopers van dit hoogst 'g^aiÈ^' interessante werk  dat nog nimmer in mT^ST pr]ja jg verminderd geven wij boven. dien nog Cadeau een Exemplaar van De Yerfoorgenheden van het Yatikaan of de geheime en openbare Zonden van het Pausdom. Naar het Hoogduitseh van Th. Griesinger  door H. M. M. Happard Tts. Predikant te Zaandam 2 deelen p. m. 800 pagina's De prijs van dit werk waarvan de Duitsche uitgiive dezer dagen den lOen druk mogt beleven is f 3.45. Thans wordt hetzelve aan de koopers van bovengenoemd werk Cadeau gegeven. Bij toezending vaneen postwissel van/ 3.45 ge-< schiedt de aflevering onmiddellijk. Brieven franco. GEBROEDERS KOSTER Leliegracht Amsterdam. (15706)  (14875) G. W.YA3. ' --- . Veer Botterdam heel onWed g j • SPEELKMgg die tegen «teer lage pHjt.nna Maria uitverkocht. mw. Adres' i HH. Societeits- en KoffijhuiBhotflokhu„Zg (15676) Bij IJ. ROGGE >MNOS. verscheen heden: LV S T VAN DE - VOORNAAMSTE VORSTEN EN REENTEN UIT BE ;_ _ ' Oude- Middel- en Nieuwe Geschiedenis met opgave van de regeeringsjaren en eenige gene»"" logische bijzonderheden. Prys ƒ0.50. Boekhandel van J. J. VAN MASTRIGT te Arnhe»- Alom verkrijgbaar: DE MODERNEN AAN SE POLS GEVOELD. Prijs 60 Cents. In den loop van dit jaar zijn er in het Odeo* te Amsterdam Voorlezingen gehouden over * Bijbelschc Berigten aangaande het lieven V»* «Fezus inzonderheid over het .ÏohauiK""""* Evangelic door E. W. B. VAN BELL' H. P. BERLAGE S. HOEKSTRA Bz. Ph. & HUGENHOLTZ A. D. LOMAN W. T. LOMA& E. MODDERMAN Az. en J. G. SCHUURINÖ- Hoogleeraren en Predikanten te Amsterdam. Naar aanleiding dezer Voorlezingen verschijo* bovengemelde brochure. (15629) TLMjMUMMfci "" Geheel 1 talie spreekt van hem. De Hnlffl _^ "" Appenijnen en Sicilië's dalen weef' ™»^"" ii galmen van den naam RINALDINI • ii Deze naam bezielt de Canzonetten der Elorentij' ii nen de gezangen der Calabriers en de romancen « der Sicilianen. RINALDO is de held der vertel' ii lingen in Calabrië en op Sicilië. Aan den '•e' ir suvius en den Etna onderhoudt men elkander ove' ii de daden van den valoroso Capitano RINALDINIii De herders en de landman vrouwen en meisjes «jongelingen en knapen hooren met verrukking vaß i RINALDINI spreken. Hij is de held der ver» halen in de wachtkamers en verschaft aan de zee' » lieden stof tot onderhoud bij een werkeloos leveß '/aan wal of bij windstilte op zee enz.enz.enz. (Voorberigt.) (13839) RIMLDO RIILDIII OVERSTE DER ROOVERS ROMANTISCHE GESCHIEDENIS UIT D 3 XVIIIe EEUW. Derde geheel nieuwe en herziene druk coß>* pleet in twee deelen groot Octavo met fraai)8 Lithograflsehe Titelvignetten. Het eerste deel van dezen boeijenden Romaßi 351 bladz. groot verschijnt op heden en is in aUe Boekwinkels te bekomen. Prijs f 3. Amsterdam G. THEOB. BOM 1 September 1866. Kalverstraat E 10.",http://resolver.kb.nl/resolve?urn=ddd:010113512:mpeg21:a0038:ocr,4,ddd:010113512:mpeg21:p004,"Nieuwe Rotterdamsche courant : staats-, handels-, nieuws- en advertentieblad",1566
1931480,1866/06/15 00:00:00,886,ddd:000024599:mpeg21:a0043,http://imageviewer.kb.nl/ImagingService/imagingService?id=ddd:000024599:mpeg21:p004:image&x=793&y=4317&w=2180&h=886,ddd:000024599:mpeg21,2973,5203,793,4317,4,Magazijn van Bedden Matrassen en Ledekanten. TH. A A. SIMONIS 36 Dagelijksche Groenmarkt over de Groote Kerk 36. VOORHANDEN: alle soorten HOUTEN en IJZEREN LEDEKANTEN'BEDDEN MATRASSEN WOLLEN en CHITSEN DEK«NS WITTE PIQUÉ en TULLEN SPRIJEN MEUBELCHLTSEN en GORDIJN-DAMASTEN GESTREEPTE GORDIJNLINNENS RUSTBANKEN en GEMAK-STOELEN voor Zieken CAOUCHOU per El ter besparing van Beddengoed VACHTEN. WIEGEN VUURMANDEN LUIJERMANDJES Botte Inodore IJZEREN WASCHTAEELS KARPETTEN en BEDDENKLEEDJES en nog vele andere Artikelen. VELD-BEDDEN zeer geschikt voor Heeren Officieren voor deu Kampt ijd. Deze Veldbedden kunnen als Stoel Canapé en Bed gebruikt worden en zijn voor het vervoer zeer gemakkelijk. (4071),http://resolver.kb.nl/resolve?urn=ddd:000024599:mpeg21:a0043:ocr,4,ddd:000024599:mpeg21:p004,Dagblad van Zuidholland en 's Gravenhage,2180
2898903,1866/06/10 00:00:00,2263,ddd:010782350:mpeg21:a0020,http://imageviewer.kb.nl/ImagingService/imagingService?id=ddd:010782350:mpeg21:p007:image&x=1362&y=69&w=1281&h=2263,ddd:010782350:mpeg21,2643,2332,1362,69,12,Marine. Openbare Aanbesteding aan 's Rijks Werf te Amsterdam op Woensdag ' den 2' 'sten Junij 1866 des voormiddags ten elf ure van: het gedeeltelijk bevloeren van 's Rijks Lijnbaan aldaar. Het Bestek en Voorwaarden waarnaar de Aanbesteding zal geschieden liggen ter lezing aan het Departement van Marine te 's Gravenhage bij de Directien der Marine te Willemsoord Vlissingen en Hellevoetsluis in de localen der Provinciale Besturen van Noordbrabant Gelderland Eriesland en Overijssel ter Secretarie van de Gemeentebesturen te Rotterdam en te Dordrecht en ten Burele van den Hoofdingenieur aan voormelde Werf zullende de aanwijzing in loco geschieden op den 16den en 18den Judïj te voren des voormiddags van 10 tot 12 ure. _De Inschrijvingsbiljetten op zegel behelzende de aannemingssom in cijfers en in letterschrift mitsgaders eene duidelijke opgave van de namen en woonplaatsen van den aannemer en zijne borgen zullen behoorlijk gesloten  vóór of uiterlijk op den dag dor Aanbesteding des voormiddags ten elf ure franco moeten bezorgd worden ter Griffie van de Directie der Marine te Amsterdam. Amsterdam  den Bsten Junij 1866. De Vice-Admiraal Aajudant des Konings in buitengewone dienst Directeur en Kommandant der Marine Bij afwezendheid De Kapitein-Luitenant ter zee  Onderdirecteur J. Vos. Openbare Aanbesteding. De Eerstaanwezende Ingenieur te Woudrichem zal onder nadere goedkeuring van den Minister van Oorlog in het openbaar bij inschrijving en opbod Aanbesteden : het Bouwen van een Kruidmagazijn te Woudrichem. Deze Aanbesteding zal geschieden op Dingsdag den 12den Junij 1866 des voormiddags ten Uure in het Zwarte Paard bij de Wed. Bax  te Woudrichem  alwaar van den sden Junij het Bestek zal liggen. Inlichtingen kunnen worden verkregen bij den Eerstaanwezenden Ingenieur te Woudrichem. Gedrukte Bestekken en Teekeningen zijn van den sden Junij voorwaardelijk te verkrijgen op het Bureau der Genie te Woudrichem. *»* Op Woensdag den 27sten Junij 1866 des middags ten 12 ure zal door don Ondergeteekende ten behoeve der Garnizoens-bakkerij te Maastricht te zijnon Burele (Brusselsche Straat n°. 1941) onder nadere goedkeuring van het Ministerie van Oorlog in het openbaar worden Aanbesteed de leverantie van : 8 Lasten Roode of Rhijntarwe wegende minstens 77 Nederlandsche ponden per Mud ; 8 Lasten Zeeuwscho Tarwe wegende minstens 74 Nederlandsche ponden per Mud; 4 Lasten Inlandsche of blanke Pruissische Rogge wegende minstens 72 Nederlandsche ponden per Mud. De Voorwaarden dezer Aanbesteding liggen ter lezing in genoemd Bureau des morgens van 9 tot 12 ure. De omslag van het Inschrijvingsbiljet en de in te zenden Monsters moeten van hetzelfde merk voorzien zijn. Maastricht den Bsten Junij 1866. De Militaire Onder-Intendant der lste klasse van Hees.,http://resolver.kb.nl/resolve?urn=ddd:010782350:mpeg21:a0020:ocr,7,ddd:010782350:mpeg21:p007,Nederlandsche staatscourant,1281
56090,1866/09/27 00:00:00,79,ddd:000024724:mpeg21:a0027,http://imageviewer.kb.nl/ImagingService/imagingService?id=ddd:000024724:mpeg21:p004:image&x=58&y=1173&w=710&h=79,ddd:000024724:mpeg21,768,1252,58,1173,6,ADVERTENTiEftL,http://resolver.kb.nl/resolve?urn=ddd:000024724:mpeg21:a0027:ocr,4,ddd:000024724:mpeg21:p004,Dagblad van Zuidholland en 's Gravenhage,710
2410810,1866/05/28 00:00:00,2455,ddd:010287029:mpeg21:a0006,http://imageviewer.kb.nl/ImagingService/imagingService?id=ddd:010287029:mpeg21:p001:image&x=3119&y=3549&w=982&h=2455,ddd:010287029:mpeg21,4101,6004,3119,3549,4,"~GROOT£ TOKO-VENbUfïE op Dingsdag den oden Junij in het lokaal der ondergeteekenden van eene groote partij Lijnwaden Provisiën en aangebragte goederen. [1003] -SOESMAN & Co. Pas aangevoerd: Eene groole versclieideiilioid van Rock in blikken. Hanket en Suikerwerk in flesschen heerlijke Gember en diverse Liqueuren tegen lage prijzen [1054] bij ' REIS IG ER & Co. Verwacht per »örtclius"": Valker-Bier op | en _ flesschen Jeffreijs Pale Ale op \ en i_ kruiken Champagne van het zoo gerenommeerde merk Louis liöderer alsmede Moet ')• Chandon op j en -.'.- flesschen etc. (1055 j SOESMAN & Co. Ontvangen: Makassaarsche Roode Vischjes in flesschen. (1030; W. EEKHOUT & Co. Per Mail ontvangen: L'Africainc Opéra en cinq actes musique de Meijerbeer prijs ƒ 18.— \ ietor Hugo. Les Chansons des mes et des bois „ 6.—¦ id. id. Les Misérables illustrcs 200 dessins par BRION. „ 12.— (103 Ij DE GROOT KOL FE & Co. Petroleum Lampen. De ondei geteekend en ontvingen cc:.e prachtige factuur Petroleum Lampen als: Kroonen van 6 4 3 en 1 lichten Hang- Tafel- Kantoor- Nacht- en Stallampcu alsmede: waarloozc Glazen Ballons Lampenpit en beste gezuiverde Petroleum in blik en in kelders. [1056] SOESMAN & Co. Ontvangen: Geassorteerde Likeuren Annizette Roode & Witte Curapau Persico Crème de Vanille Crème de Rosé van Focking en van Hulstkamp <fe Molijn. Bonekamp en Maag-Hitter van der Veeu's Elixer Pommeranzen Spiritus in stopfleschjes Alpen-Krauter-13itter Sirope de Punch Frambozen-Azijn Kirchwasser & Absinth Barcelona Brandewijn. Bordeaux Wijnen op fust en gebotteld Bourgogne Nuits Chambertin Volnay Champagne Rhijnwijnen. (1011] THOOET & Co.",http://resolver.kb.nl/resolve?urn=ddd:010287029:mpeg21:a0006:ocr,1,ddd:010287029:mpeg21:p001,De locomotief : Samarangsch handels- en advertentie-blad,982
4423815,1866/05/06 00:00:00,4965,ddd:010113817:mpeg21:a0026,http://imageviewer.kb.nl/ImagingService/imagingService?id=ddd:010113817:mpeg21:p003:image&x=848&y=142&w=891&h=4965,ddd:010113817:mpeg21,1739,5107,848,142,10,"¦ P. DE KOSTER I VEEHUISD ¦ ga»ff *¦ 4de Huis van de Prinsenstraat. I De Horologiemakers-Affaire enz. TAK ¦ S. J. EBER I vau d lS pVEEPIAATST : ¦ T t^*0""* naar de Bierhaven i? 'N°\ **W:f »bÜ de Scheepmakersh. Westz Rotterdam 3 Mei 1866. (7454) I (745T9^BiJ A!tte' °P den 5 Mei 1866 gepasseerd I J00; JA^ CO-BSÜLIS PAATS Notarislte Rot fl -SSvl^18 door de Ondergeteekenden JOHANNES ¦ K™ER SMALT PIETER HENDRIK SMALT ¦ en WILHELMUS JOHANNES ERINS tIW ¦ Comm^i""iairs wonende te Rotterdam. aangegaan fl üf™ ' gevestigd aldaar ten doel liebbende ¦ het voor gemeenschappelijke rekening voortzet¦l ten van den Commissichandel in «ranen _a- I Ti"" V meel eu daaraan verwante"" Artikelen. H„ A ii ™} WiJTen die waaronder de beide eerst- I °udf geteekenden dien handel verscheidene jaren mt hebben gedreven en alzoo ¦ Wm. & ALBs. SMALT & Co. I wordt fil'ma- d£ol\die beMen Provisionneel alléén zal I tTf geteekfud' z°?der haar te mogen bezigen I vloerende6 handelmS. uiet direct uitde zaken voort- I „;'De Vei?oiot9chaP is ingegaan met de dagteeke¦ nmg der Akte om voort te duren tot ultimo De¦ eember 1867 mits door een der partijen zes maan¦ den bevorens opgezegd zijnde bij gebreke waarvan ¦ zy geacht zal worden voor een jaar te zijn verlengd ¦ en zoo telkens voor één jaar totdat die opzegging I ¦ zes maanden te voren zij geschied. I Geschiedende hiervan openbare aankondiging ter fl ¦ voldoening aan Artikel 28 van het Wetboek van I I Koophandd. j. E. SMALT. T™ I fl P. H. SMALT. ¦ ¦ - W. J. PRINS. ¦ I (7458) Bij Akte van den 3den Mei 1866 ge- fl ¦ passeerd voor den Notaris GROSHANS te Rotter fl Mdam is de VEWSOOTSCHAI» X» I ¦ geweest onder de Firma wjn"""" > geclievon ¦ ¦ W. J. PRINS en Co. I ¦J gevestigd te Rotterdam ONWBOjVJUEIV Ip fl ¦J rekenen van af den lsten Mei 1866; zullende'de I ¦ liquidatie geschieden door de beide Vennooten die fl ¦ daartoe zullen bezigen de teekening der Firma 'met fl m bijvoeging van de woorden: in liquidatie. ' fl ¦ W. J. PRINS. H I. K. AELBERS. ¦ It (7435) De ondergeteekende geeft hiermede zijnen I ¦ Begunstigers kennis dat zijn Koffij- en Bier- fl ¦ huls Nieuwehaven n° 354 alhie^¦metjZ.vf I ¦ Mei is OVEKMTr* »»r ' ™3de"" H ¦jan s^lo^^\^;ze^f:r dJè I |CdelKn.beVeelt hÜ ® I ¦ —^ VAIf SCHIJNDEL. I ¦ vrijheid mijn Koilii- en BierhulV minzaam I ¦ aan te bevelen terwijl ik mij tevens ook aanbeveel I ¦ «t«^„aan fr"" b?zorgen van «""e soorten van I ¦ «leren zullende ik mets onbeproefd laten mij fl ¦ door eene spoedige en nette bediening de mii te I ¦ betoonen begunstiging waardig te maken. ¦ ¦ Nieuwehaven B ¦ Wijk 12 N°. 354. J VAN HOBOKEN. ¦ ¦ (7434) De ondergeteekende maakt aan hare ge- I ¦ eerde begunstigers bekend dat zij hare Affaire I ¦ m Ujjnen eu Likeuren genaamd het fl ¦ -'«'""""'c Cmracaosche aagt Steiger fl l_.vr_l_.Korenbeurs sedert den eersten dezerheoft I ¦ OVEBCrEBAArV aan haren Schoonzoon den H ¦ Heer H. F. BECKHOLDT. Dmkbaar voor het I ¦ genoten vertrouwen  beveelt z\j hem in TTEd. gunst I ¦ minzaam aan. H I Wed. VAN VLIET. fl Mij referende aan bovenstaande annonce beveel I ik mij bij mijne geëerde Stadgenooten beleefdelijk fl aan tot het leveren van alles wat totdenHan- I del m Wijnen en Likeuren betrekking heeft I hopende my hetzelfde vertrouwen waardig te ma- ¦ ten'heeft m'JUe Schoonmoeder zo° vele jaren geno- I e^M ef Ts66. ïï' *' BECKHOLDT. I T^Ë^ËRMiS I riAC-\ -.r De Burgemeester _jl^/) _ Mr. J. F^DE MEIJ MECIMA I HOOGERE lIWÜKOÖL I VOOE fl Middelbaar onderwijs. I of PEPT™ V°O&DEN welke hunne ZONEN fl ot irUIIELEN metdeneerstvolgendenlJ'UJH-.Strta I mi de Hoosere Burgerschool van Mirt- I delbaar <J*iwloi wijs te Rotterdam weuschen fl te plaatsen worden uitgenoodigd hiervan in persoon I bij den Directeur opgave te doen vóór 18 Mei e. k. I De Directeur zal daartoe gelegenheid geven 'des fl Dingsdags Woensdags Donderdags en Vrijdags I van I—3 viur in het gobouw der School in den I Oppert wijk 6 n°. 247. — Na 18 Mci worden I geene opgaven meer aangenomen. Tijd en plaats van het tegen September te hou- fl den toelatiugs-examen zullen nader worden bekend fl gemaakt. ¦¦] De Commissie van toezigt en beheer over I de Hoogere Burgerschool W. A. VIRULY VERBRUGGE ¦ Voorxitter. flfl| (655r\ ¦Dr' H' J- SLEURS —^ J' en Secretaris. H EEEPMAKPK^O^33?11 TAN DEE ÏÏ00P & I tent! i ' te Rotterdam adverteren dat fl tototBßduMnde de maanrf^nBe6l «J!_W!S DER WTDEELING I [ I*VAN DErTJSy ¦",http://resolver.kb.nl/resolve?urn=ddd:010113817:mpeg21:a0026:ocr,3,ddd:010113817:mpeg21:p003,"Nieuwe Rotterdamsche courant : staats-, handels-, nieuws- en advertentieblad",891
2260920,1866/11/12 00:00:00,1245,MMKB08:000087746:mpeg21:a0013,http://imageviewer.kb.nl/ImagingService/imagingService?id=MMKB08:000087746:mpeg21:p003:image&x=853&y=3077&w=1816&h=1245,MMKB08:000087746:mpeg21,2669,4322,853,3077,8,Advertentie Wij blijven voortdurend de aandacht vestigen op onze meest geperfectioneerde doelmatigste goedkoopste echte Amerikaansche YVheeler & Wilson's Naaimachines bijzonder aan te bevelen voor Huisselijk gebruik en voor DaT.es en Heeren Kleedernakers. Uitsluitend alhier verkrijgbaar  alsmede ZIJDE GAREN en NAALDEN daartoe benoodigd bij den A?ent H. KOPPENDRAIJER Broerenstrsat A. 122. Men wordt gewaarschuwd dat de Echte WHEELER en WILSON's Machines door niemand anders hier ter stede kunnen verkocht worden dan door bo~engenoemden Agent. Xfl CS i w W M EH 6 14 DEUTSCHEÏt'sCHREIB-CURSUS in 4*Nommers !!!!!!!! MUZIJKBOEKJE LEESBOEK. Verzameling van brieven in verschillend Schrift .... REKEN-CAHIERS in 5 Nommers TEEKEN-CAHIERS „4 „ NIEUWE SCHOOLSCHRIFTEN in 12 Nommers CAHIERS voor de Vervoeging van Fransche Werkwoorden in 5 Nommers LEESBOEKJE voor Eerstbeginnenden met Schrijfletters in 5 Stukjes . a 7 Ct. w 7 ff tf 7 tf )9 8 ff ff 15 ff ff 25 ff ff 5 yf 20 :* ff 7 >y ff 5 » ff 8 ff 65 worden steeds met succes gedebiteerd. Arnhem  October 1866. G. J. THIEME Uitgever. 'ZfSjSÉp* Ten gerieve van den handel zijn bovenstaande artikelen steeds in genoegüamen' voorraad voorhanden bij mijnen eenigen Depothouder A. TIOOGENBOOM  Schoólboekhandelaar te Amsterdam.,http://resolver.kb.nl/resolve?urn=MMKB08:000087746:mpeg21:a0013:ocr,3,MMKB08:000087746:mpeg21:p003,Arnhemsche courant,1816
3126975,1866/03/25 00:00:00,4325,ddd:000024494:mpeg21:a0009,http://imageviewer.kb.nl/ImagingService/imagingService?id=ddd:000024494:mpeg21:p002:image&x=782&y=64&w=723&h=4325,ddd:000024494:mpeg21,1505,4389,782,64,6,"n^P"" Eene JUFVROUW van fatsoen-3""^^ lijke familie P. Q. 23 jaar oud  thans nog in betrekking zag zich liefst met Mei of later GEPLAATST tot adslstentie ln de huishouding en mede verzorging van kinderen. Zij is driejaren in zoodanige betrekking geweest waarvan goede getuigen kunnen gegeven worden. Adres met franco brieven No. 133 bij de Boekhandelaars A. VAN HOOGSTRATEN & ZOON alhier. (2057) BORDEAUX-WIJNEN. Men vraagt ter verkoop van fijne Wijnen AGENTEN die goede relatién hebben. — Adres Franco post restant te Bordeaux onder de letters K. O. S. met opgaaf waar men de noodige inlichtingen kan bekomen. (2037) MEN VRAAGT EEN FATSOENLIJK JONGELING. niet beneden de 14 jaren die goed kan lezen en schrijven  om behulpzaam te zijn in eene WINKELZAAK. Adres met eigenhandig geschreven brieven onder letter M. Bureau Dagblad. (2044) (TSOg) -pviqßvrj m-amg '-Q JSj|9[ JBpno ' oouvjf ng.iaujj — •pe-.g sp n9|tnq jo j.iq 'SVVHHïaNO •""""""* ""WAW -OIZJO si*3 I»* *lpun»|ainoa ££?Z**\ ""rag u; nt-B putjuia* qojz j;j oScLx* <!_<-- Een bekwaam KOET-j-gjU^^^""! SIER van middelbaren ftjfepji*r""Qttc|r^ leeltljd sedert kort uit Gel-2_>_l3______L_ derland in Holland alwaar hij negen jaar in ééne betrekking was en van goede cetuisen voorzien zag zich gaarne GEPLAATST. — Adres Franco letter A„ bij den Boekhandelaar H. J. GERRETSEN te 's Hage. (2049) In een stil gezin VERLANGT MEN tegen Mei eene zindelijke DIENSTBODE van goed humeur in staat redelijk te kunnen koken en het werk verrigten tegen/50 a ƒ6O loon. Die van goede getuigen voorzien zijn vervoegen zich in Persoon met gesloten briefjes letter X. bij den Boekhandelaar H. J. GERRETSEN Spui. (2048) Eene JUFVROUW sedert eenige jaren onderrigt gevende in het vervaardigen vau Dames- Kleedingstukken beneven alle Linnenwerk ten huize der geëerde Families doch thans eenige uren ter harer beschikking hebbende wenscht zij die weder vervuld te zien. Ook geeft zij onderrigt in het werken met de Stik- en Naaimachine. Adres onder de letters A. Z. Bureau Dagrlad. (2027) Wordt VERLANGD tegen 1». MEI eene KEUKENMEID. Alleen met franco brieven  onder letter D te bedragen bij den Boekverkooper A. H. BAKHUIJZEN te 's Gravenhage. (2042) &Aj*W Tegen Mcl WORDT VERLANGD: ¦te3_* eene Blenst bode  als MEID ALLEENgoed kunneude Werken en Koken. Loon ƒ6O. Adres: Bureau Dagblad. (2022) TE HÜÜR AANGEBODEN. Een geheel Gemeubileerd Bcnedenhuis  of een gedeelte daarvan staande in de WILLEMSTRAAT. Te bevragen met geslolen brieven bij den Boekhandelaar J. VAN GOLVERDINGE  Vlamingstraat onder letter B. (2028) TEGEN 1». MEI OF LATER TE HUUR een BOVENHUIS in de Hoogstraat tot matigen huurpiijs; desverkiezende kunnen goede TAPIJTEN GORDIJNEN etc tot matigen prijs worden overgenomen. Te informeren bij OSTHOFF & COMP. Groenmarkt No. 12. (2052) TE KOOP: twee losstaande Winkel-KASTE* met Toonbank en Toonkasten. ADRES: Molenstraat 12. (2061)",http://resolver.kb.nl/resolve?urn=ddd:000024494:mpeg21:a0009:ocr,2,ddd:000024494:mpeg21:p002,Dagblad van Zuidholland en 's Gravenhage,723
5589363,1866/10/27 00:00:00,5161,ddd:000010713:mpeg21:a0040,http://imageviewer.kb.nl/ImagingService/imagingService?id=ddd:000010713:mpeg21:p008:image&x=31&y=80&w=1083&h=5161,ddd:000010713:mpeg21,1114,5241,31,80,8,"f Km/JONG MENSCH Tan onbesproken Jfcdrag 24 jaren ottd» „T.'.-CX eene nette hand schrijvende en bekend met de Stel- en Jleetlunde zag zicu gaai ie; geplaatst op eene rabriek of Kantoor. Adres franco onder lett. X. V. Bureau Handel«blad. (24772) BOOFDKIE-WSTRiTAPJiOÖRT Eenige Kiezers te AMERONGEN en LEEKSITM noodigen l.wine JMedekiezers in bovengenoemd kiesdistrict dringend uit om op J'ingsdag 30 October a. s. trouw ter stembus op te komen en voor leden van de Twe>de Kamer der Staten-Generaal hunne stem . it te brengen op de Heeren.: __^-l™_-l Me! 11. VERLOREN VAN THE MAAT Raadsheer in het Provinciaal Geregtshof van Utrecht en W. R. KOER Lid der Provinciale Staten en Wethoudei van Utrecht. EKNIGE KIEZERS. Amerosgix eu Lj.eusvm  26 Oct. 1866. (24830) •ifftiiff.'-si 5P KIEZERS uit het kanton Loenen verlangende af te vaardiger ren' man welken zij leerden kennen als kundig onafhankelijk en -vaar ecu burger verongelijking ondervindt moedig voor hem opko mende zender iemand te ontzien  maar ook daarom vaak miskend stellen voov om met hon te kiezen tot Lid der Staten-Generaal .Mr. E. T. VAN DER BHCJCXHEN Ond-Kantonregter. NB. Daar het hier wel gebeurt dat men bij de Kiezers komt om namen op het biljet in te vullen wordt herinnerd dat het aar de Kk-_. Vs vrijstaat dio namen weder door to halen en den naan vau hun eigen Kandidaat daarvoor in de plaats te stellen. (24829) De Vereeniging heeft de eer ter openbare kennis te brengen dal •rij in hare Vergadering van 25 October  tot Kandidaten voor d< Tweede Kamer der Staten-Generaal bij de aanstaande verkiezing-en gekozen heeft de Heeren: Mr. C C. Jl. VAN REENEN. Jf. J. ROCHIISSEN Mr. M. H. GODEFROI Mr. Jl. HEEMSKERK Bz. Mr. Jl. Jl. W. VAN DEN BIESEN Mr. IM. Jl. PIJNAPPEL. Zij herinnert verder dat hare Kandidaten zijn. voor de Provtn. tiale Staten van Noovd-Holland de Heev: Mr. L. A. A. VAN WENSEN en voor den Gvmeenteraad de Heer: Mv. B. H. M. DRIESSEN. Het Bestuur der Vereeniging Mr. J. G. A. FABER. Amstkkd.oi  Voorzitter. •.-..> October 1866. J. A. ALBEJRDINGK THIJM 837) Secretaris. _ RIOTPIGING raMKIGI De Vereeniging noodigt met bijzonderen ernst alle Kiezers uit op 30 October aan 's Konings roepstem gehoor te geven. Naar hare vaste overtuiging behoort Amsterdam mannen naar de Tweede Kamer af te vaardigen  die als hunne beginselen de handhaving van 's Konings onschendbaarheid en van de verantwoordelijkheid der Ministers voor alle regeringsdaden overeenkomstig onze grondwettige instellingen op den voorgrond plaatsen. Hiermede in overeen'emming heeft de Vereeniging in hare vergaderingvan 19 October waarin 122 leden aanwezig waren tot Candidaten gekozen de Heeren: Mv. G. €.. Jt. VAN REENEN Mr. Si. il. GODEFROI .viv. .ff. HEEMSKERK Bsu Luitenant-Generaal Jf. VAN SWIETEN Mv. «J. VAN HEI KI FOM Mr. P. P. VAN BOSSE. Voorts beeft de Vereeniging in dezelfde vergadering besloten als lid van den Gemeenteraad aan te bevelen den Heer F. C. TROMP en als Lid van de Provinciale Staten den Heer JOAN MI TEER. De Commissie van Bestuur: Amstebdav F. C. ZILLESEN 26 Octobcr 1866. 11. 3. KELDERMAN I). F. TEESTEEG (24810) T. DOMELA NIEUWENHUIS. H. J. KOPEK C. J. LINA J. H. VAN DER MEULEN Lcz. J. REGTDOORZEE .1. SCHAAP Hz. _ Hoor/geachte JUedekiezers van liet MiesdUlrset GOUiIA en omstreken! Wij Kiezers van Haastrecht Oudewater Schoonhoven Krimpenenvaard  L.kkerkerk  Berkenwoudo  Ouderkerk  Nieuwerkerk en andere gemeenten roepen tot ome me lokiezers : blijft op aanstaanden Dingsdag van de stembus niet terug maai- wendt u met ons tot de stembus. om daar onze stem uit te brengen  waartoe onze geëerbiedigde Koning zijn dierbaar volk heeft uitgsnoodigd. Daar zijn er die op onze DE BRAI'W en HOF*'ivS*N een smet willen •werpen en zoo doende de menschen op een verkeerd spoor brengen. Laat u daar toch niet toe gebruiken maar kiest de mannen die onpartijdig zijn en hun Vorst vaderland en volk liefhebben die zoo veel voor ons gedaan hebben. Het is u geachte kiezers! goed bel:end wat zij voor Schoonhoven Oudewater Kvimpenevwaavd Gouda enz. gedaan'h»bben waaraan wij do grootste opkomst en welvaart nnzer gemeenten hebben te danken. Laten wij ons dan niet aan grove ondankbaarheid schuldig maken om het oor te leeuen aan hen die listen iv het werk stellen om onze vertegenwoordigers den voet te ligten. Neen zulks vertrouwen wij dan ook van n niet maar wel dat gij allen met ons vult opkomen om de stem uit te brengen op die waardige mannen «He wij kennen van wie wij weten wat zij voor ons gedaan hebben en nog zullen doen hetwelk wij van anderen zouden moeten afwachten. Komt dan met ons getrouw ter stembus op! Geeft aan onze roepstem gehoor en kiest op aanstaanden DINGSDAG den 30sten OCTOBER 1866 de twee achtingswaardige mannen Joükhier Mr. W. M. DE _Ut*l W en M. A. F. H. HÜFFJMAN. (24809) KIESDISTRICT HOORN. In de Pnrmerender Courant worden met veel ophef en omslag in onderscheidene advertentien de Heeren van Goltstein en Terpstra tot candidaten voor deTweedeKamerderStaten-Generaalaangeprezen. MJENSÜNIDES moet alzoo niet meer gestemd worden. Waarom niet? men weet daar niets anders voor op te geven dan omdat hij tegen do wet tot wering van de veeziekte gestemd heeft: Maar? •waarom heeft Mensonides daartesren gestemd? omdat hij tegen het afinaken is van ziek en verdacht ot gezond vee dat daarmede in aanraking konde geweest zijn. Van Goltstein iieeft roor dio wet gestemd omdat hij voor het sifinahen is. Diegenen dia voor het afmaken zijn hebben alzoo nog eenige reden om van Goltstein te stemmen Die JÊTezevs echter welke tegen het afmaken zijn zouden alzoo dwaas en ondankbaar zijn wanneer zij van Goltstein in de plaats van Mensonides stemden. De Heer Terpstra kan wegens zijne veelvuldige Ambtsbezigheden sis Advocaat-Generaal niet in staat zijn het mandaat als volksvertegenwoordiger behoorlijk waar te nemen Dit moet hij zelf toe- Moeten wij er iemand uit den vroemd-B bij hebben? kiezen wij dan den Heer Mv. P. P. van Bosse die als bekwaam financier eene JEuropesehe vevinaardheid verkregen heeft en door den Keizer van Oostenrijk werd uitgenoodigd om aldaar de verwarde finantien Dat wg ons door de Purmerender niet laten verschalken!!! maar stemmen de Heeren : 11. MENSONIDES en Mr. P. P. VAN BOSSE. J-emge Kiezers die tegen het afmaken zijn maar op de finantien letten. "" (24807)",http://resolver.kb.nl/resolve?urn=ddd:000010713:mpeg21:a0040:ocr,8,ddd:000010713:mpeg21:p008,Algemeen Handelsblad,1083
1455120,1866/02/14 00:00:00,940,ddd:010113737:mpeg21:a0018,http://imageviewer.kb.nl/ImagingService/imagingService?id=ddd:010113737:mpeg21:p004:image&x=116&y=3775&w=1548&h=940,ddd:010113737:mpeg21,1664,4715,116,3775,6,"«.. JW. JWW. JWJ«E«»r.Ta_. y«g.^^ Vm^ni-gmÊmi______^_m__________________mim-mmmnt _r_TarrTrn""' pq^ju T'.'"" ""-_ ""~"" — Hoezeer de MOFF'sche MAL_-PRAEl'_._l_llE¥ geene verdere verbreiding be-_ hoevéa van daadwerkelijke gunstige resultaten en steeds toenemende glansrijke gevolgen  waarin dezelve zich reeds naar verdienste mogen verheugen achten wij hel niettemin in bet belang der bjdende menschheid pligtmatig  voort te gaan met openlijke bekendheid te geven aau de erkenningen en dankzeggingen  zoo aan den Fabriekant zelven als aan het Centraal-Depót te AmUerdam gerigt daar ons dit als de meest eenvoudige weg voorkomt om de Zieken op dit in zijn ' aard hoogst eenvoudig maar tevens heelkracht-g middel opmerkzaam fe maken en verlrouwen in te boezomen. Wij veroorloven ons derhalve nevensgaauden zoo even ontvangen brief mede te deelen  gerigt aan het Ccntraal-tlépöt te Amsterdam O. lE. Voorburgwal J 3*2. Mijnheer ! Ik kan niet nalaten TJEd. mede te deelen  dat. mijne Vrouw  die sedert jareu erg verzwakt »¥TB l(PTl>l>mSeil _«pl""i'gd geweest is door het gebruik van het MOFF'sche MALZ*__?__. 1 KMT van het begin af gebeterd is en wel zoodanig dat mijn Doctor van de goede eigenschappen van hetzelve overtuigd zijnde het ook goedgekeurd en het verdere gebruik daarvan -. voorgeschreven heeft. Haarlemmermeer 28 Novemlier 1865 C. RIK AARD. Hoofd-Depot: Rotterdam 11. IV. PRILLGVITZ J.C.Z11. V_'cslnicunland. j _. Dépóts: Dordrecht J. van de Graaf. Nijmegen F. J. Backcr. \r\ \ ... laassen- Gouda J. B. van Vreuninger. Oud-Beijeriand A. Tasselaar. Jrin' tl' i fnBBL Leiden  K. Block. Schoondijke A. van Overbecke. Delft hv yeenenboß Jbz- Lekkerkerk W. van de Voet. Zierikzee M. T. C. de Kater. TL ¦ iJau_kamP> Maastricht J. P. T. Deplaie. Zevenbergen E. W. Zangter. m de bakende Depots in de andere plaatse». (2422)",http://resolver.kb.nl/resolve?urn=ddd:010113737:mpeg21:a0018:ocr,4,ddd:010113737:mpeg21:p004,"Nieuwe Rotterdamsche courant : staats-, handels-, nieuws- en advertentieblad",1548
2663334,1866/04/01 00:00:00,3441,ddd:010113783:mpeg21:a0016,http://imageviewer.kb.nl/ImagingService/imagingService?id=ddd:010113783:mpeg21:p003:image&x=879&y=137&w=774&h=3441,ddd:010113783:mpeg21,1653,3578,879,137,12,"De ONROERENDE GOEDEREN bestaande in: N°. 1. Het HUIS met PAKHUIS ZOLDERS BOVENHUIS en ERVE Wijk 12 n°. 258; N°. 2. Het HUIS met PAKHUIZEN open PLAATS BOVENHUIS en ERVE Wijk 12 n°. 259 en N°. 3. Het HUIS  met open PLAATS  BOYENWONINGEN en ERVE  Wijk 12  n°. 260  allen aan de N/Z van de Nieuwehaven alhier 11. Woensdag door de Notarissen VAN DER HOEVEN & SPEELMAN in het Notarishuis te Rotterdam geveild zullen aldaar op Woensdag den 4 April aanstaande door genoemde Notarissen worden afgeslagen en verkocht eerst afzonderlijk en daarna bij combinatiën. (5239) Openbare VrijwilligeVerkooping. j&\ De Notarissen VAN DER HOOP en ff:!:? REEPMAKER residerende te Rotterdam £sS3___-_als last hebbende van hunne Principale zijn voornemens om op Woensdag den Aden April 1866 des voormiddags ten 5 ure in het Notarishuis aldaar in het openbaar te vellen en te verkoopen t Een hecht sterk en goed gesitueerd HUIS OPEN PLAATSJE en ERVE  aan de Oostzijde van het Hang te Rotterdam wijk 2  n°. 401  kakaster sectie O n°. 433  groot 36 ellen. Grondbelasting over 1866 ƒ 32.63. Verhuurd tot 30 April 1867 voor ƒ 224 'sjaars. Inmiddels zijn nadere onderrigtingen te bekomen ten kantore van de gezegde Notarissen en is het te veilen perceel daags vóór en op den dag der veiling te bezigtigen mits men voorzien zij van een permissiebillet daartoe door voornoemde Notarisrissen af te geven. (4380) Openbare VrijwilligeVerkooping. _v»&\&/!S«*K!<re_ De Notarissen DALEN & /Élf^^^^WfeVAN WIJNGAARDEN resiggiaeimjM<f-.i'[i»ii|M|||>f erenfje (e Eotterdam als last hebbende van hunne Principalen zijn van meening om op Woensdag den Uden April 186 G des namiddags ten 5 ure in het Locaal der Publieke Verkoopingen aan de Geldersche Kade te Rotterdam in het openbaar te vellen en te vcrkoont.n : N°. 1. Eene BOU WïtlAlVS .VOMII.G met ZOMERHUIS ACHTERWONINGEN STALLING voor 8 Paarden en voor 12 Koebeesten WAGENSCHUUR  LOOTSEN verdere Getimmerten ER VEST en (1(..\1_. staande en gelegen aan de Westzijde van den Goudschenweg nabij den Singel te Rotterdam zijnde het geheel genaamd: Op Hoop van Beter en de woning: In de Bonte Koe strekkende van den weg en van het na te melden Perceel tot den eigendom van de Diaconie der Nederduitsche Hervormde Gemeente t_ Rotterdam  belend ten Noorden het volgende Perceel en den Heer J. Webeb en ten Zuiden Mejufvrouw de Wed. G. J. Aenoids met een afzonderlijken uitgang naar den weg loopende ouder Perceel n°. 2 een en ander door grootte en ligging zeer geschikt voor bouwterrein en in het bijzonder voor den aanleg van Fabrieken of andere ruimte vereischende Lokalen wijk 13 n°. 767 kadaster sectie D nis. 807 811 3071 en 3072 te zamen groot 5 roeden 58 ellen. Aangeslagen in de grondbelasting over 1866 op ƒ 21.95 zijnde geheel in eigen gebruik en te aanvaarden den 1 Junij 1866. N"". 2. Een róór weinige jaren nieuw gebouwd W l""-VKEI_HUIS met BOYENWONINGEN en ERVE  staande en gelegen als voren  naast of ten Noorden van het vorige Perceel wijk 13 nc. 766 kadaster Sectie D n°. 3070 groot SO ellen. Grondbelasting over 1866 ƒ 41.50. Verhuurd per maand: het Benedenhuis met de Iste Boyenwoning voor ƒ 31 en de 2de Boyenwoning voor ƒ 10  te zamen alzoo voor ƒ 492 's jaars De gemelde Perceelen zullen eerst separaat en daarna gecombineerd worden afgeslagen. N°. 3. Een HUIS met BOYENWONING open PLAATSJE en ERVE  staande en gelegen aan de Slakade te Rotterdam wijk 13 n°. 274  kadaster Sectie E n°. 848  groot 58 ellen. Grondbelasting over 1866 ƒ 13.87. Belast met cene recognitie ten behoeve van den Polder Kralingen groot ƒ 1.50 'sjaars. Verhuurd in drie gedeelten per week te zamen renderende ƒ 197.60 'sjaars. (5244) De te veilen Perceelen zullen kunnen worden bezigtigd twee dagen vóór en op den dag der Veiling van des voormiddags ten 10 tot des namiddagsten 3 ure mits men voorzien zij van een permissiebillet  door een der voornoemde Notarissen afgege ¦ I yen te wier kantore aan de Zuidblaak te Rotterdam \ inmiddels nadere informatiën zijn te bekomen.",http://resolver.kb.nl/resolve?urn=ddd:010113783:mpeg21:a0016:ocr,3,ddd:010113783:mpeg21:p003,"Nieuwe Rotterdamsche courant : staats-, handels-, nieuws- en advertentieblad",774
2935338,1866/05/25 00:00:00,5276,ddd:010140719:mpeg21:a0015,http://imageviewer.kb.nl/ImagingService/imagingService?id=ddd:010140719:mpeg21:p004:image&x=1144&y=77&w=2153&h=5276,ddd:010140719:mpeg21,3297,5353,1144,77,6,"MIDDEL VAN BESTAAN.  Voor f 6000 biedt zich eene gelegenheid aan tot het overnemen "" ! der HELFT in eene SCHUITEN VOERDERIJ welk half Aan- s deel ƒ 100 per Maand opbrengt. Reflecterenden gelieven zich ter T nadere informatie per franco geteekende Brieven te adresseren bij f den Boekhandelaar RANNING EYLERTS Schippersgracht 416 r te Amsterdam. (12707) fHEgLr TE MOOP. - ____£fe»_!n_ Een zeer schoon vlug en sterk gespierd bruin rnim : v «.Tfa Wiffffi driejarig MERRIEPAARD  geboren op het eiland ; I Ameland nog nimmer betuigd en bereden. Te bevragen met franco  S Brieven by «len Heer B. D. K. VAN DER LAAG te Edam. (12635) - INSTITCTION ÉiNCAISE-ANGLAISE pour Demoiselles.dirigée par les DAMES SQUILLER a Vilvorde prés de Bruxelles. Le prix de la Pension y compris fournitures classiques blanchissage' et literie est de 600 ou 650 Francs par an 1 d'après I'age. 02604) J ! T E II UUR"" Eene GESTOFFEERDE KAMER in het midden dezer Stad gelegen voor een HEER of DAME met of zonder Kost. Te bevragen Brieven franco Bureau Handelsblad Letter G. K. N . 170. (12640) EENE KINDERJUFVROUW P. G. gewoon om met Kinderen om te gaan en in alle opzigten voor i hare Betrekking bekwaam kan dadelijk GEPLAATST worden. : I Geene dan voldoende getuigschriften komen in aanmerking. Adres T ' onder Lett. A. bij den Boekhandelaar R. C. LEPPER Rokin. (12679) l TE HUUR a ƒl6o's JAARS. Door bijzondere omstandigheden TE HUUR tegen Primo Augustus of vroeger a ƒ 160 's Jaars EEN BOVENHUIS in den om- i trek van de Nieuwmarkt bestaande in TWEE GROOTE KAMERS EEN KLEIN KAMERTJE KEUKENTJE DOORLOOPEND PRI-  1 | VAAT DÜINWATER ZOLDER en verder van alle Gemakken voor' zien. Reflecteerende gelieve zich Pranco te adresseeren onder Letter 1 1 A. Z. bij den Boekhandelaar J. KRAAN O. Z. Voorburgwal bij de . Halsteeg. (12680) Een KOEK- en BANKETBAKKER te UTRECHT verlangt een BEDIENDE als Banket-Bakker om tegen 1 Julij of eerder in dienst te treden. Reflecterenden adresseren zich met franco brie* ven onder Lett. A. 8. Bureau Handelsblad. (12701) Op eene der Hoofdgrachten wordt door eene fatsoenlijke Weduwe TE HUUR aangeboden: Twee net Gemeubeleerde KAMERS met BEDIENING prijs ƒ35 per maand. Adres Franco onder Lett. 1-> bij J. J. KRIJNE Kantoor- en Kerkboekh. Korsjespoortsteeg tusschen Singel en Heerengracht. (12678) In eene APOTHEEK hier ter Stede verlangt men met primo Ang. of vroeger een BEKWAME BEDIENDE EXTERNE Vlug en accuraat kunnende Recepteren en van goede Getuigenissen voorzien. Adres met franco Brieven Lr. A. Z. V. Bureau Handelsblad (12703) ZONDER SALARIS. Een fatsoenlijk PERSOON  35 jaren oud  bekend met de Administratie en vreemde Talen wenschte bij voorkeur ter dezer Stede tegen genot van KOST werkzaam te zijn op een Fabriek Magazijn Kantoor of wel tot Adsistentie in eenen Winkel onverschillig in welk Artikel Slijterij of dergelijke. Brieven franco Lett. A. Z. Bureau Handelsblad. (12708) VERNISSEN. STANDOLIE. DRUKINKT LOUIS VAN SON te Amsterdam VRAAGT een met bovenstaand Vak kekend geroutineerd en solied REIZIGER. Geenen behoeven zich aan te melden die bovenstaande vereischten niet bezitten en daarvan voldoende informatien kunnen overleggen. Adre* tranco of in Persoen. (12677)",http://resolver.kb.nl/resolve?urn=ddd:010140719:mpeg21:a0015:ocr,4,ddd:010140719:mpeg21:p004,Algemeen Handelsblad,2153
4041972,1866/01/20 00:00:00,3894,ddd:110536524:mpeg21:a0013,http://imageviewer.kb.nl/ImagingService/imagingService?id=ddd:110536524:mpeg21:p002:image&x=2193&y=2419&w=1038&h=3894,ddd:110536524:mpeg21,3231,6313,2193,2419,8,"Voortdurend Verfn'ijybtiai': Vei""sche Samarangsche BESCHUIT. -■':-! bij A. A. VAN DER CRAB \ Co. las Ontvangen : Gerookl i PALING in hik . LENGVISCH in blik BLOEMKOOL in potten . X. ERKI » »L tlo. ROODEKOOL do . Brnsselsclie SPRUITJES do. ANDYVIE do. A. A. VAN DER CRAB & Co. Puike Manilla SKIAKKN Corlados. (5375 bij A. A. VAN DEB CRABic Co. Kstraniiiic en Zwarte Oordmirwnl. (537.5) bij A. A. VAN DER CRAB i «'o Heeren Hemden diverse soorten. (5376) A. A. VAN DER CRAB & Co. «•(k.o.k n Ongekookte LIJNOLIE. VERFWAREN en GROS en EN DETAIL. (S4BI A. A. VAN DER ( RAB \ Co. Imitatie h'dcr twvv soorten 5373 bij A. A. VAN DER CRAB & Co. SS.ISBB'.ütA Ie kwaliteit. R»*»3CT a l*o3K'ï' Ie (S37Ï A. A. VAN DEB CRAB \ Co. \\ ederoni nul van«ïi ii in Commissie . n kl in i'iirt'jtji Poiiimü's Agassae Lüdcn. -ö-l A. A. \ AN DEB CRAB X Co. [;s«' SSsssïes'üo^s-oiießlle Oiilvinijen mei de aanijekomen srliepn: I LIPJES & KEELTJES en ANDERESOI UITEN PROVISIEN in blik \(83? I ' A. A. VAN DER CRAB V Co. I 'Puike MAMMEM pas aangebn vi 5123) bij A. A. VAN DER CRAB & Cu. ■37ols.cz> Benin. Ei.E.'! A NTTE DA MES \V ER KD( N >SJ ES. »SIGARENKOKERS. 121) bij B. CHARLES. \ erkrijghaar legen zeer billijke prijzen: STOOri-SUIKERMOLENS. ■ MOLENS voor trekvee. SUIKERPANNEN enz. bij de BORNEO COMPANÏ LIMITED Batavia. (8310) COOK HOMANS & Co. Soerabaija. Toko Senin I'tt.s Ontvangen: Een lak! uur I*l .iflt J i ü<' lli'Oia/4'il htM'Meci. bij R. CHARLES.",http://resolver.kb.nl/resolve?urn=ddd:110536524:mpeg21:a0013:ocr,2,ddd:110536524:mpeg21:p002,Bataviaasch handelsblad,1038
2532852,1866/10/31 00:00:00,2622,ddd:010529325:mpeg21:a0020,http://imageviewer.kb.nl/ImagingService/imagingService?id=ddd:010529325:mpeg21:p004:image&x=1051&y=53&w=966&h=2622,ddd:010529325:mpeg21,2017,2675,1051,53,4,%* Une JEUNE PERSOmm de la Suisse- Francaise qui a passé quelques années dans ce pays désire se replacer en qualité de Bonne-Gouvernante. S'adresser  lettres affranchies sous l'initiale A. au libraire J. VAN GOLVERDINGE  a la Haye. *** A young english Lady 20 years of age who hos been educated with a view to teaching both in her own country and in France is anxious to obtain a situation as GOVEMtXESS to children not exceeding the age of 12 years. A comfortable home is much more desired than a high sdlary. A travelling or other companionship might be eligible. Good references can be giveti. Letters prepaid C. VAN DOORN AND SON Booksellers Molenstraat the Ilague. V. H. AANBESTEDING. GASFABRIEK. Het Gemeentebestuur van GOOR is voornemens op Dingsdag den 6den November 1866 's namiddags 2 uur ten Raadhuize aldaar in het openbaar te besteden: Het bouwen eener GASFABRIEK met alle daartoe benoodigde materialen in twee percelen waarvan de bestekken en voorwaarden ter leziiTg liggen in de volgende logementen: Te Almelo  bij Bakker ; „ Arnhem  bij Jansen  in de Paauw - „ Deventer  bij Duim  aan de Brinkpoort; „ Zutphen bij de Wed. Burgers in 't Rad; „ Zwolle  bij Scheuer  in de Zeven Provinciën ; voorts met de plannen en teekeningen op het Raadhuis te Goor. Exemplaren van het bestek zijn verkrijgbaar ter Secretarie vau Goor tegen betaling van ƒ1  en aftrekken der voornaamste teekeningen  tegeu betaling van / 5. Aanwijzing in loco op den dag der besteding des voormiddags vau elf tot 's namiddags 1 uur. Informatien  op franco aanvrage te bekomen bij den Architect J. BOSCH te Lochem. STOVEN. Zyn konde voeten nadeellg voor de gezondheid veel meer nadeellg ls het gebruik der gewone Stoven door de ongestadige soms te felle hitte en door de zwavel- of houtskooldamp die als een langzaam vergift vele kwalen en slepende ziekten veroorzaken. De thans zeer volmaakte geoctrooijeerde Hydmulique en met-Hydraulique Stoven hebben geen der gebreken van de gewone stoven want zij geven eene gelijkmatige warmte en vereenigen nut gemak voordeel gezondheid en geen gevaar voor brandstof of zwaveldamp. Zij vorderen echter even als de lampen eene goede evenwel zeer eenvoudige behandeling. Verkrijgbaar in de meeste steden van Nederland. %* Te HUUR tegen 1 April of vroeger eene BUITENPLAATS  alferriantst eu gunstig gelegen op een uur afstand van Utrecht ingerigt voor zomer- en winterverblijf met of zonder den daaraan verbonden grooten MOESTUIN TUINMANSWONINC  STAL en KOETSHUIS. Adres onder lett. S. 1. aan den Heer J. MADO Boekhandelaar te Utrecht.,http://resolver.kb.nl/resolve?urn=ddd:010529325:mpeg21:a0020:ocr,4,ddd:010529325:mpeg21:p004,Opregte Haarlemsche Courant,966
1498599,1866/03/05 00:00:00,807,ddd:010254279:mpeg21:a0027,http://imageviewer.kb.nl/ImagingService/imagingService?id=ddd:010254279:mpeg21:p004:image&x=1000&y=66&w=1857&h=807,ddd:010254279:mpeg21,2857,873,1000,66,4,MAGAZIJN VAN NAAIMACHINES. Jgf^ j|§ |.-i;i|Jvt Ut tic voornaamste Amerikaans ehe en pm 1 &-. |j f.s  ' ) Vngelsehe Vaarleken. % 1 r?Cf ï- - >u^ . '^~~m y [t  . _^- A-lle soorten voor Nijverheid als voor Schoenmakers Kleeder- __^==~>*[ ' f*wT makers Zadelmakers enz. als ook -voor Huishoudelijk gebruik '-^fcistaSP Hij :.'^'|ifi__. en Naaisters op welke men kan Zoomen Koorden Rimpelen Sou- =mm*>^. J^' —^^^^^yU lacheren Boorden Plooijen enz. /^_s^%i_\ ?*flQVS__&RftS__fts Het Onderwijs is Gratis en voor de soliditeit wordt gegua- fSW'^^^ti 3KWING MACHINES laluleelcl- \W_ __°«. 1$ t 's Gravenhage _..«.» 22. \?_v -&f T ¥ FRIEI-RH-H _ Amsterdam 2fe«.«.«y 187. X~2^ J. r..IIUDUIUfII j Rotterdam TV.on/Moot 130. Agentschap te Maastricht de Heer Leon irnonlt!. „ „ Baardwijk „ „ C. G. v. d. Heijden. „ „ Waalwijk „ „ L. Dnuionlfn Verviel. „ f 's Bosch (Vugtherstraat) de Heer P. Jl. Odenkirchen. (7763) „ „ Leiden (Breedestraat. „ „ J. Brüggeuiaun.,http://resolver.kb.nl/resolve?urn=ddd:010254279:mpeg21:a0027:ocr,4,ddd:010254279:mpeg21:p004,De Tĳd : godsdienstig-staatkundig dagblad,1857
379860,1866/06/23 00:00:00,390,ddd:010484484:mpeg21:a0003,http://imageviewer.kb.nl/ImagingService/imagingService?id=ddd:010484484:mpeg21:p001:image&x=80&y=5584&w=974&h=390,ddd:010484484:mpeg21,1054,5974,80,5584,8,Vendutie op Maandag 25 Junij 1866 voor het Commissiehuis van (3330) N. VAN RIET van diverse negotie-goederen Provisien en Dranken.,http://resolver.kb.nl/resolve?urn=ddd:010484484:mpeg21:a0003:ocr,1,ddd:010484484:mpeg21:p001,"Java-bode : nieuws, handels- en advertentieblad voor Nederlandsch-Indie",974
961337,1866/03/08 00:00:00,1013,ddd:010776493:mpeg21:a0004,http://imageviewer.kb.nl/ImagingService/imagingService?id=ddd:010776493:mpeg21:p001:image&x=1025&y=1016&w=949&h=1013,ddd:010776493:mpeg21,1974,2029,1025,1016,4,De BUUGEMEESTER der gemeente Assen maakt bij deze aan de belanghebbenden dezer gemeente bekend dat het 3c kwartaalsMtohier van het palentregt over het dienstjaar 186*7» door den Commissaris des Konings in Drenthe den 1 Maart 1866 is executoir verklaard en heden ter invordering aan deu heer Ontvanger overgegeven; zullende mitsdien een iegelijk na bckOmene kennisgeving van zijnen aanslag verpligt zijn dien overeenkomstig de bestaande verordeningen ie voldoen op strafte van parate executie terwijl de zoodanigen welke hun aanslagblliet niet mogten hebben ontvangen zich ten kantore van den Ontvanger moeten vervoegen. alwaar ecu dubbel daarvan kosteloos aan de belanghebbenden zal worden uitgereikt. Dat zij die vermeenen te hoog of verkeerdelijk te zijn aangeslagen zich deswege schriftelijk op gezegeld papier in reclame kunnen voorzien gerigt aan heeren Gedeputeerde Staten dezer provincie en des verkiezende in te dienen bij den heer Controleur der directe belastingen mits binnen drie maanden va Üe executbirverklarlng der kohieren terwijl daarnevens zal worden gevoegd: A. Een uittreksel of extract uit het kohier en B. Eene duplicaatkwitantie wegens voldoening der vervalleue termijnen. En opdat niemand hieromtrent onwetendheid kunne voofweiiden zal deze worden afgekondigd en aangeplakt daar waar zulks gebruikelijk is. Gedaan le Assen den 7 Maart 1866. De Burgemeester voornoemd VAN DER FELTZ.,http://resolver.kb.nl/resolve?urn=ddd:010776493:mpeg21:a0004:ocr,1,ddd:010776493:mpeg21:p001,Provinciale Drentsche en Asser courant,949
1693020,1866/08/01 00:00:00,1668,ddd:110536604:mpeg21:a0034,http://imageviewer.kb.nl/ImagingService/imagingService?id=ddd:110536604:mpeg21:p005:image&x=1090&y=3913&w=1015&h=1668,ddd:110536604:mpeg21,2105,5581,1090,3913,8,"iii gojil iren . I UITVOER. > • ■ ' ■/./.' kapt. ..rij ■'■ '.; . kol ij 19 do. nol t 43 dn. v ;  .' ■ I ..''( .•'.!.--• ' - i i ~ Co ..:''!'. ''.: Ei Hl Gips  - 3. K. Animkk i. IV K ... r mil & Co No lerland. ' '.. 2 vn o: oil 1 vt . E. Mmrmann .v Co. 70 pi esa pan - V // M : ma.i .%::ngebragte llegalen. 1 kisljc gemerkt W No I. — 1 do. gemerkt VL B —  Ido t .1 AC 72 — 2 p: kje g< merkt i FS & /.. Van pi r stoomb 0 ipitole. i pnkj W "" - -. dc Lange & Co — 1 kistje gemerkt VV. -2 kistjes v. Oiidart b No. 27-.S. — 1 pakje 'lid man & van Kerchem Batavia.",http://resolver.kb.nl/resolve?urn=ddd:110536604:mpeg21:a0034:ocr,5,ddd:110536604:mpeg21:p005,Bataviaasch handelsblad,1015
2356370,1866/06/14 00:00:00,2839,ddd:010389958:mpeg21:a0030,http://imageviewer.kb.nl/ImagingService/imagingService?id=ddd:010389958:mpeg21:p004:image&x=918&y=72&w=830&h=2839,ddd:010389958:mpeg21,1748,2911,918,72,6,"BONNETEBIE ÜHS Si Kil CHs CÖUCKE 515 S3oogstra».t. DE BESTE VRIEND DES ZIEKEN. Sïc ZAI_F en PIELEN van lI«_LI_OWA¥. Ouderdom. Het is van het grootste belang de krachten der oude lieden in sland te houden terwijl men hunne kwalen verpleegt. De geneesmiddelen van Holloway bezitten die deugd in den hoogsten graad. Ook hebben zij het onmisbaar goed resultaat er van bewezen door dien geessel des ouderdoms «kwade beenen"" te genezen. Weldra vertoont zich de oppervlakte van de onzuiverste etterwond reiner nadat die Zalf er op is aangebragt; de veretteringen worden menigvuldiger en gezonder de brandende pijn vermindert de hevige smart ligter de zwelling en de ziekte verminderen trapsgewijze en verdwijnen spoedig geheel en al. De Zalf en Pillen van Holloway zijn insgelijks allernuttigst voor de roos de brandwonden de open wonden de verstuiking de rhumatismale en jichtige ontstekingen en verscheiden andere ziekten die voortkomen uit toevallige ziekteaanvallen of vermindering der levenskrachten. De Zalf en Pillen van Holloway zijn de beste bekende geneesmiddelen voor de onderstaande ziekten: Ingekrompen geledingen. Aanbeyen. Aamborstigheid. Waterzucht. Brand- en andere Wonden. Ontstekingen. Kanker. Beenkwalen. Puisten. Melaatschheid. Chiego-Voet. Lendensmart (lumbago). Ooco-Bay. Stijve en ingekromp. zenuwen Hoofdpijn. Muggensteken. Zenuwstuipen. Verkoudheden. Likdorcns Biteroogeu enz. Scheurbuik. Sneden en Kloven. Klier- of Kropgezwellen. Wïnterhanden en voeten. Kwade borsten. Huidziekten. Kramp. Roos. Vlekken. Fit»el_. Dauwworm en Hoofdzeer. Gezwellen. Btterachtige verzweringen. Leverontsteking. Tic doaloureux. Bloedzweren. Beving. Schurft. Krampaders jicht. Venerische ziekten. Door het vermeerderd debiet zijn de prijzen als volgt: Doosjes Pillen /0.80 /1.85/3 f 6.15 /13.50 /20.50. Potjes Za1i...... /0.80 /1.85/3/7.05/13.85 /20.95. Zijn op franco aanvrage a contant te bekomen bij de Heeren M. CLOOS Apotheker en Drogist Hang te Rotterdam- i. M. VAN RENESSE Apotheker te 's Hage; H. J. GILTAY Apotheker te Dordrecht en J. STRAATMAN Hoofd-Depöthouder te '* Hertogenbosch; alsmede in HoUoway's Etablissementen te Londen 244 Strand en te New-York 80. Maiden-Lane. Uit gevoel van menschlievendheid zullen om niet raadgevingen worden verstrekt aan de zieken die zich per brief tot Professor Holloway wenden mst opgave vsn hunne bijrondere gevallen.",http://resolver.kb.nl/resolve?urn=ddd:010389958:mpeg21:a0030:ocr,4,ddd:010389958:mpeg21:p004,Rotterdamsche courant,830
2680734,1866/02/27 00:00:00,1743,ddd:010113750:mpeg21:a0025,http://imageviewer.kb.nl/ImagingService/imagingService?id=ddd:010113750:mpeg21:p006:image&x=883&y=1009&w=1538&h=1743,ddd:010113750:mpeg21,2421,2752,883,1009,6,"ONDERLINGE WAARSOBO-HAATSCJIAPPU voor de dienst Mi de NATIONALE MILITIE ¦ In de Provincie Z VIB- HOftft ANJ». Directeur : de Heer L. VAN KOETSVELD.  de Heer IL W. DE CRITTER. Commissarissen i\ « ¦¦ W. VAN DAM H.H.Zn. I . i Mr. H. H. TELS. allen te Rotterdam. Dc cicclueniiiig iv deze Maatschappij is opengesteld voor de Loteliugen van het jaar 1866 zoo ** tot het Stellen van Plaatsvervangers als van Nummerverwisselaars. De Betaling heeft geen plaats dan nadat het getrokken Nummer is gebleken dienstpliglig te fJ Aau de deelneming vSót de Loting is aanmerkelijk voordeel verbonden. De Statuten der Maatschappij zijn verkrijgbaar bij de Boekhandelaren M. WIJT & ZONE*' te Rotterdam. en hij hunne Correspondenten in Zuid.-Holland. ? De Inschrijving geschiedt ten Kantore der Maatschappij in den Open Rijstuin  Wijk 11 N to Rotterdam. (19673)^ """"""IAATSiiPPIJVIïTSMANTIE voor de dienst bij de NATIONALE MILITIE in de Provincie ZTTIO-ROIiLANR goedgekeurd bij Koninklijk Besluit van den 1 September 1863. No. 81. mi....*.......... . i «« Heer L. VAN KOETSVELD. wil ecieurcn • | ? „ L- DROOGLEEVER FORTUIJN.  dc Heer R. MEES. Commissarissen : » • M. H. C. VAN OOSTERZEE. ' - - J. C. LEDEBOER L.V.Zn. allen le Rotterdam. Deze Maatschappij sluit Assurantie zonder eenig voorhehoud  voor de vervulling van de diens' de Nationale Militie voor Jongelingen militiepligtig in de Provincie Zuid-Holland van het jaar (_ geboorte af nan tot op voleindigden 19 jarigen ouderdom zoowel voor enkelen als voor geheele gezin*'' De Betaling der Premie van Assurantie heeft plaats volgens tarief van 3 tot 3 maanden of' bij verkiezing eens in 't jaar. - De Statuten der Maatschappij zijn verkrijgbaar bij de Boekhandelaren M. WIJT & ZONE; te Rotterdam en hij hunne Correspondenten in Zuid-Holland. ( De deelneming geschiedt ton Kantore der Maatschappij in den Open Rijstuin  Wijk 11  Nu- '' le Rotterdam en bij de Agenten: E. J. TERLAAK Brielle. D. HOUTKAMP Dirksland. A. v. HEMERT Dordrecht. A. NORTIER Gouda. G. C. VISSER 's Hage. B. F. VAN ECK Hellevoetsluis. C. v. D. MAARFL  Kralingen. 3. C. VERMEER Middelharnis. A. J. A. ROLDANÜS Oudewater. A. VERDUIJN DEN BOER Poortugaal K. A. DE LIJSTER Pultershoek. O B. VAN BAAREN Schoonhoven. H. J. PEPPINK Spijkenisse. W. O G. H. BROEKMAN Vianen. H. KIP  Woerden. Voor de overige Steden iv Zuid-Holland worclen nog ACJENTEW GEVRAAGD. (191^",http://resolver.kb.nl/resolve?urn=ddd:010113750:mpeg21:a0025:ocr,6,ddd:010113750:mpeg21:p006,"Nieuwe Rotterdamsche courant : staats-, handels-, nieuws- en advertentieblad",1538
890092,1866/01/08 00:00:00,581,ddd:010113699:mpeg21:a0025,http://imageviewer.kb.nl/ImagingService/imagingService?id=ddd:010113699:mpeg21:p004:image&x=2453&y=1648&w=1532&h=581,ddd:010113699:mpeg21,3985,2229,2453,1648,6,£ 1 ___ w _ _ — [ Hoe veel Nederlanders bezochten reeds deze SS^yl/feSOrAtlflXCli I bekoorlijke landen waar de grootsche tooneeleö I der schepping zich zoo veelvuldig afwisselen? TJinliA I Willen zij genieten bij de herinnering aan het mm\»tMtm\J%Sm f veie schoone en indrukwekkende dat zich aan huw eog opdeed zij vragen bij hunnen Boekverkooper ter inzage het werk van G. E. C. CROISET In en over de Alpen. Schetsen - Indrukken. Men bladere het eens door en men zal eindigen met het gretig open te snijden en te behouden. Zij die 't voornemen .hebben Zwitserland en Italië te bezoeken schaffen zich vooral dit wel geschreven boek aan. Er zijn ook exemplaren verkrijgbaar in linnen band. (11912) In alle Boekwinkels voorhanden.,http://resolver.kb.nl/resolve?urn=ddd:010113699:mpeg21:a0025:ocr,4,ddd:010113699:mpeg21:p004,"Nieuwe Rotterdamsche courant : staats-, handels-, nieuws- en advertentieblad",1532
2524130,1866/05/04 00:00:00,2359,ddd:010140691:mpeg21:a0025,http://imageviewer.kb.nl/ImagingService/imagingService?id=ddd:010140691:mpeg21:p006:image&x=2220&y=3037&w=1070&h=2359,ddd:010140691:mpeg21,3290,5396,2220,3037,6,"Heden verscldjiit bij J. NOÖ_.DI_NDO_:P  op de"" Pijpenmarkt te Arasterdam : IS HET MIDDENPUNT DER STAD AMSTERDAM GEZONDER DAN DE FLANTAADJE EN DE BUITENRAND? EENE VRAAG AAN REGENTEN DER BEIDE GASTHUIZEN BEANTWOOHD DOOE C. E. IIEYNSIUS Med. Dr. De publieke zaak wil public* behandeld worden. Uitgegeven ten voordeele der Stichting van een NIEUW ZIERENUUIS TE AMSTEKBAM. | PRIJS %b CENTS. Wordt niet in Commissie gezonden. (111-48)  I paleis voor VolMsvlijt* ZONDAG _ MEI. OCHTEND CONCERT. Aanvang IVa Te' AVOND-CONCERT. Entree 50 Cents. _ .. f.wa^S ¦ Leden volgens Reglement. Coupon-Bewijzen geldig. (1120t______ SCj-01TWBjJRGj_N CONCERTEN JSNZ.___ i ~*STABS SCUOUWBURC. Directie Roobol Tjasink en Peter». Zaturdag 5 Mei (N°. 115 Abonn.): Parijssche zeden of de keerend' der groote Wereld tooneelspel in 5 bedrijven naar het Fransch va» Alexander Dumas (de Zoon). Nooit op dit tooneel vertoond. Waan» Mej. S. Sablairolles als tweede optreding de rol van de Baron.» d'Ange en de Heer P. A. Morin als eerste ontreding die van 01iv»eJ de Jalin zal vervullen. Wegens de uitgebreidheid der voorstelling geen nastuk. Aanvang 71/. ure. Verwacht op aanstaanden Maandag 7 Mei dc sluiting vau het tooneel' 'SALON BES VARIÉTÉS in de Amstelstraat. Vrijdag 4 Mf* Oom uit Oost-Indie of de drie gekroonde Artisjokken nieuwe vrolijk j vaudeville in 3 bedrijven (oorspronkelijk) door""den Heer A. Ri. .!?! gevolgd door de Vrouw in vier t/edaauten nieuwe vrolijke vaudevll' in 1 bedrijf; waarin Mw. Corijn vier .verschillende karakters «** vervullen. (Aanvang 8 ure.) Entree 75 Cent. BOAS & JUBELS. Plaatsen zijn aan het bureau te bespreken. _x> 'Zc.me^Thea-er TIVOLI. Heden Vrijdag 4 Mei (N°. 4 van het Abonn.). Die Terhiingm^oW Nachligall odereine Zeitungs Ente Posse mit Gesang in 1 Act. Doe' Peschke Komische Scène und duett. Le Moulin Jolt Opera Ooi» . en 1 Acte. Le Mari ala Porte Operette de Ottenbach. : Entree 49 Cents . .... Aanvang 7 *f£ ffij_ De Localen zijn dagelijks voor het geciviliseerde Publiek als _.oi»J huis en de Tuin als wandelplaats geopend. Morgen Zaturdag bij gunstig weder Matinee Musicalevanll tot4 ui» Entree 25 Cents. »E BIRECTIE^ GEDEUKT BIJ C. A. SPI_ & ZOON. ____ri__",http://resolver.kb.nl/resolve?urn=ddd:010140691:mpeg21:a0025:ocr,6,ddd:010140691:mpeg21:p006,Algemeen Handelsblad,1070
2955000,1866/09/19 00:00:00,2955,ddd:010484529:mpeg21:a0019,http://imageviewer.kb.nl/ImagingService/imagingService?id=ddd:010484529:mpeg21:p003:image&x=1074&y=3050&w=1000&h=2955,ddd:010484529:mpeg21,2074,6005,1074,3050,8,HOTEL PERSÉVÉRANCE te Buitenzorg-. Vermindering van Prijzen. Een persoon per dag .... ƒ 350. Een Heer en Dame per dag . . „ 7—.  kindje beneden 2 jaar . . „ niets. (5402) „ „ van 2 tot 8 jaar. . „ 1—. ia » » 8 „12 „ . .  105. Honderd Honderd Duizend Gulden. Duizend Gulden. Pf M*et Welf Nog eenige Loten in de Geld-Loterij voor het BATAVIAASCH TOONEEL waarvan de trekking vastgesteld is nog in deze maand 39 September en waarop de KOLOSSALE PRIJS van f 100000— kan gewonnen worden te bekomen bij (5369) J. SPEET. TOKO NOORD WIJ\K. De ondergeteekende maakt met deze bekend dat de Toko NOORD WIJK welke van af 1 Februarij 1866 onder de firma van S. W. VAN HOGEZAND Jr. & Co. eedreyen is geworden van af 1 September jl. door den Heer H. LAVINO voor zijne eigene rekening zal worden voortgezet. S. W. VAN HOGEZAND Jr. Batavia 15 September 1866. (5373) TOKO NOORDWIJK. Met referte op bovenstaande annonce heb ik ondergeteekende de eer bekend te maken dat de Toko NOORDWIJK welke van af 1 Februarij jl. onder de firma van S. W. VAN HOGEZAND Jr. & Co. gedreven is geworden van af 1 September jl. door mij voor eigene rekening zal worden voortgezet mij beleefd bij het geachte publiek aanbevelende. Op eene prompte en civiele bediening zal zoo als vroeger immer gerekend kunnen worden. H. LAVINO. Batavia 15 September 1866. (5374) ~~ .r-^~~iMLSam ■B'J acte °P ca eu September 1866 §M^ No. 27 voor mij Notaris en getuillM'ff-te^y (jen verleden hebben de Heeren GUALTMI-'-n-S SUEBMONDT BERNARO MARIA FRANZ JULIUS HUBERT MULLEB en MARIE HENRI KOLFF allen kooplieden de eerste en derde wonende te Batavia en de tweede wonende te Soerabaya eene Vennoot- SCliap aangegaan ter voortzetting der handelszaken van de firma Cr. Saermondt & Compagnie. De vennootschap is en blijft gevestigd te Batavia en te Soerabaija heeft ten doel hoofdzakelijk den Commissiehandel is aangevangen op den 16den April 1866 om te eindigen ultimo December 1875. BoMogt is zoo wel der firma als den vennooten in privé verboden. (5387) A. M. MEERTENS.,http://resolver.kb.nl/resolve?urn=ddd:010484529:mpeg21:a0019:ocr,3,ddd:010484529:mpeg21:p003,"Java-bode : nieuws, handels- en advertentieblad voor Nederlandsch-Indie",1000
2074708,1866/05/20 00:00:00,1324,ddd:010113832:mpeg21:a0071,http://imageviewer.kb.nl/ImagingService/imagingService?id=ddd:010113832:mpeg21:p010:image&x=2443&y=3274&w=1567&h=1324,ddd:010113832:mpeg21,4010,4598,2443,3274,12,gam _n i _____ ( H°e vee^ Nederlanders bezochten reeds deze ___I^V_r__ vSvA *_3_ii__J_Cl_ I bekoorlijke landen waar de grootsche tooneelen ( der schepping zich zoo veelvuldig afwisselen ? TJbggïvA j Willen zij genieten bij de herinnering aan het _&(_•-*____._;_ [ ve]e sc]loone en indrukwekkende dat zich aan hun ®og opdeed zij vragen bij hunnen Boekverkooper ter inzage het werk van G. E. C. CROISET Sn'é». over de _M_»é_- Schetsen - Indrukke*. Men bladere het eens door en men zal eindigen met het gretig open te snijden en te behouden. Zij die 't voornemen hebben Zwitserland en Italië te bezoëk.n schaften zich vooral dit wel geschreven boek aan. Er zijn ook exemplaren verkrijgbaar in linnen band. (119] 2) . In alle Boekwinkel voorhanden.  j£ % VERVERSCHINGS&EBOUW in het Park. HEDEH ZOKDAG 20 MEI en MORGEBi MAAHDAG 21 MEI' CAFÉ CONCERT met medewerking der belde beroemde Homleken de Beeren GEBROM* DERI GEL.UBCKE en geheel bljhebbend Gezelschap. EXTUÉE VUIJ. (g 32-) Voor dezen avond zullen extra Omnibussen rijden.,http://resolver.kb.nl/resolve?urn=ddd:010113832:mpeg21:a0071:ocr,10,ddd:010113832:mpeg21:p010,"Nieuwe Rotterdamsche courant : staats-, handels-, nieuws- en advertentieblad",1567
1273169,1866/01/19 00:00:00,1277,ddd:010286992:mpeg21:a0019,http://imageviewer.kb.nl/ImagingService/imagingService?id=ddd:010286992:mpeg21:p003:image&x=2107&y=2019&w=997&h=1277,ddd:010286992:mpeg21,3104,3296,2107,2019,6,§ C M U T T K K fl J K M c n as. Bij de Schutterij te Soerabaija ONTSLAGEN; Op verzoek eervol: wegens ziekte de kapitein mr. J.A. Kooiman; wegens vertrek de officier van gezondheid der tweede klasse dr. II. Friedlander en de eerste luitenant C.J. Pieters met vergunning om den aan dien rang verbonden aktiviteits-uniform te blijven dragen. BEVORDERD: Tot kapitein de eerste luitenant H.J. Rosemeier. Tot eerste luitenants de tweede luitenants R. Lavvick en J. Melchers. BENOEMD: Tot otficier van gezondheid der tweede klasse de schutter G.C. P. de Ruijter partikulier geneesheer te Soerabaija. Tot tweede luitenants de adjudant-onderofficier T.A. van der Waal cn de sergeant J.B. Albrecht allen van het korps. MILITAIR DlüFABTlüffl K X T . VERLEEND: Een tweejarig verlof naar Nederland wegens ziekte aan den onder-intendant der tweede klasse van de militaire administratieT. A.P.J. Hees. Een tweejarig verlof naar Nederland aan den ridmeester bij bet. legioen vanden Pangeran Adipatti Ario Mangkoe NegoroA.J. Metzier. BEVORDERD: Bij hel Regiment Oost-Indische Kavallerie. Totridmeester.de eerste luitenant J.A. Diehl. Tot eersten luitenant de tweede luitenant S.F. Gerand. Bij de Militaire Administratie. BEVORDERD: Tot kapiteiu-kwartiermeester de adjunkt-intendant G.Y.C. Eraser. BENOEMD: Tot tweeden luitenant-kwarticrmeester de wachtmeester van het regiment Oost-Indische kavallerie M Willemstijn . OVERGEPLAATST: Als eerste luiteuant-kwartiermeester de eerste luitenante van der Meulen van het 10de bataillon infanterie. UIARISE DEPIBTEMEIT. BENOEMD: Tot onder-baasmodclmaker bij de fabriek voor Je marine eu het stoomwezen de vaste werkman bij die inrigting W .L. A. Cl: rist iaan.,http://resolver.kb.nl/resolve?urn=ddd:010286992:mpeg21:a0019:ocr,3,ddd:010286992:mpeg21:p003,De locomotief : Samarangsch handels- en advertentie-blad,997
693720,1866/06/04 00:00:00,705,ddd:010287031:mpeg21:a0002,http://imageviewer.kb.nl/ImagingService/imagingService?id=ddd:010287031:mpeg21:p001:image&x=69&y=5307&w=984&h=705,ddd:010287031:mpeg21,1053,6012,69,5307,4,"Toko-Vendutie op Diitgsdag den sdcn dezer in het Vendu-Locaal van Soesman Sf Co. van diverse Koopmanschappen Provisiën Dranken e"" eene massa aangebragte Goederen. (1096) ty onze Toko-Venilutie van Dingsdag o dezer zullen wij zonder reserve verkoopen : 50 tobben Zweedsch Staal eene partij LTzerwerei > Keukengereedsehajipen Lijnwaden en door zeewater beschadigde Goederen. (1097) SOESMAN & Co.",http://resolver.kb.nl/resolve?urn=ddd:010287031:mpeg21:a0002:ocr,1,ddd:010287031:mpeg21:p001,De locomotief : Samarangsch handels- en advertentie-blad,984
2188932,1866/05/25 00:00:00,2309,ddd:010529189:mpeg21:a0019,http://imageviewer.kb.nl/ImagingService/imagingService?id=ddd:010529189:mpeg21:p004:image&x=2016&y=823&w=948&h=2309,ddd:010529189:mpeg21,2964,3132,2016,823,4,f3| Openbare Verkooping eene fraaije verzameling ORANJEBOOMEN BLOEMEN PLANTEN enz. benevens TUINGEREEDSCHAPPEN BKOEIRAMEN  met en zonder LESSENAARS  enz. op Vrijdag S Juni 1866 des morgens 9 ure op HET SLOT te Zeist ten overstaan van den Notaris Mr. H. C VAN DIGGELEN  te Zeist. Breeder bij billetten en daags te voren te bezigtigen. *** Op Woensdag den 30iten Mei 1866 des middags ten 12 ure  zal ten huize van den Logementhouder ___. B. Mollenkramer te Abcoude ten overstaan van den Notaris S. VAN KEMPEN in het openbaar worden verkocht: N°. 1. De BOEREN-HOFSTEDE  met derzelver bouwmanswoning gemerkt n°. 87 en verdere getimmerten alsmede daarachter gelegen LANDERIJEN staande en gelegen in den Broekzijderpolder te Abcoude aan den Amsterdamschen straatweg ter grootte van 4 bunders  29 roeden  50 ellen. N°. 2. Een perceel WEI- en HOOIEAND  gelegen in den Holendrechterpolder onder Ab.oude ter grootte van 4 bunders 80 ellen. Welke percelen eerst afzonderlijk en daarna vereenigd worden geveild. Zijnde dadelijk te aanvaarden. N°. 3. Een HUIS  ingerigt tot twee woningen met erf grond en  te Abcoude aaó het jaagpad. N°. 4. Een HUIS gemerkt n°. 53 voorzien van zeven .zoo groote als kleine kamers zeer geschikt tot uitoefening eener winkelzaak erf grond en tuin staande en gelegen iv het dorp Abcoude. Te aanvaarden 1° Augustus 1866. Breeder bij biljetten omschreven en nader onderligt te bekomen bij voornoemden Notaris te Abcoude. *** De Notaris VAN MEERS te Heörde is voornemens ten huize vau J. Bocve aldaar op Woensda°den 13den Junij 1866 des voormiddags ten II ure te doen inzetten en 14 dagen later zijnde den 27sen Junij te verkoopen : Een BOERENERF aan het kanail te Wapenveld gemeente Heerde bestaande in een huis en erf hooiberg  schaapschot tuin beste bouw- wei- en hooilanden akkermaalsbosschen en opgaande boomen te zamen groot 35 bunders 41 roeden 20 ellen. Voorts DENNENBOSCH en HEIDEGROND groot 14 bunders 33 roeden 28 ellen ;te aanvaarden den 22sten Februarij 1867. De verkoop zal geschieden in percelen kolommen en eene massa terwijl op vrachtvrije brieven nadere informatien zijn te bekomen ten kantore van voornoemden Notaris alwaar de veilconditien acht dagen vóór den inzet ter lezing liggen.,http://resolver.kb.nl/resolve?urn=ddd:010529189:mpeg21:a0019:ocr,4,ddd:010529189:mpeg21:p004,Opregte Haarlemsche Courant,948
1381992,1866/03/23 00:00:00,1294,ddd:010585492:mpeg21:a0050,http://imageviewer.kb.nl/ImagingService/imagingService?id=ddd:010585492:mpeg21:p006:image&x=1195&y=2699&w=1068&h=1294,ddd:010585492:mpeg21,2263,3993,1195,2699,10,ROELGOED TE BOLSWARD. De. Notaris E. T. KUIPER zal op Donderdag den 5 April 1866 's voormiddags 10 uur ten huize van Pieter Rosier buiten de Blaauwpoort te Bolsward op gewoon crediet presenteren te verkoopen : 9 volkomen gezonde kalve melke en vare Koeijen en 1 Hokling 1 best 7-jarig bruin schimmel Merriepaard  mak en in alle tuig bereden ongeveer 4 koeseten best gewonnen hooglandsch Hooi; voorts 1 Kapchais  1 Hooiwagen  zoo goed als nieuw  2 Kamen met toebehooren  2 Molkenvaten  koperen Aden en Emmers  uitmuntende Kaaspers met Steen  1 beste Tieme  Harken  Vorken  Hekkels Schoppen Kaastobben en Vaatjes Koeltrog Vleeschvat enz. BOELGOED OP BIUINDIJK ONDER WTHNS. De Notaris E. T. KUIPER te Bolsward zal op Saturdag den 7 April 1866 's voormiddags 10 uur ten huize van Jurjen Tjerks Dijkstra op Bruindijk onder Schettens op gewoon crediet  presenteren te verkoopen: Een uitmuntend BESLAG gezond VEE  bestaande uit: 10 Koeijen waarvan 7 beste vare 1 zwart langstaart Merriepaard^ mak en in alle tuig bereden en 2 Schapen met Lammeren; voorts 1 Glaswagen zoo goed als nieuw 2 beslagen Hooiwagens  1 Aardkar  Kam  Kaasketel Kaaspers met Steen 6 koperen en 6 houten Emmers 2 beste Boteraden  Melk- en Brokaden  Molkenvaten  Kaasvaten  Tonnen  Kret en Planken  Harken  Vorken  een partijtje Stroo en hetgeen meer zal worden aangeboden. Koekdisschen en Hakblokken worden op de Hieming niet geduld.,http://resolver.kb.nl/resolve?urn=ddd:010585492:mpeg21:a0050:ocr,6,ddd:010585492:mpeg21:p006,Leeuwarder courant,1068
3334870,1866/05/18 00:00:00,4270,ddd:010113830:mpeg21:a0050,http://imageviewer.kb.nl/ImagingService/imagingService?id=ddd:010113830:mpeg21:p004:image&x=92&y=882&w=781&h=4270,ddd:010113830:mpeg21,873,5152,92,882,8,"Adres b\j de Agenten (8105) NEDERLANDSCHE STOOMBOOTMAATSCHAPPIJ. ROÏTIMHiDIN. B A TA VIER Kapitein W. SMITH. ""Van Rotterdam naar Londen DINGSDAG 22 Mei 's namidd. . 5 ure. • 29 i 'smorgens - 11 » Van Londen naar Rotterdam  lederen ZONDAG des morgens ten lO ure von de ligplaats Hermitage-Tier. Per Spoor van Fenchurchstrcetstation nam- Rlackwall  'smorgeus 10% ure. Van Rlackwall naar Rotterdam . 's morgens 11 ure. PASSAGIERS-VRACHTEN: Groote Kajuit jfïö.OO Idem Heen en terug . . „ 22.50 Voorkajuit „ 0.00 Idem Heen en terug . . „ 13. ÖO Kinderen beneden IO jaren de Helft der Vracht. Re DIENST van het Stoomschtp FItFENOOIB.It Kal nader geannonceerd worden. De dienst staat in verbinding met de naar en van Mannheim en tusschen gelegen Plaatsen aan den Rijn varende Stoombooten der Nederlandsche Stoomboof-Reederij. Ö3SP** Nadere iuformatiën zijn te bekomen bij de ""flpiWß^ Nederlandsche Stoomboot-Maatschappij en hare Cargadoors D. A. VAN OORD T Sr Co. in de Boompjes to Rotterdam en bij alle Agenten der Nederlandsche Stoomboot-Reederij. (7786) ROTTERDAM EN HDLL. Voor Passagiers en Goederen. Het Stoomschip Steallotc  Kapt A. Hatjt vertrekt van Rotterdam naar Ruil Zaturdag 19 Mei des avonds. (8074) _ Adres SEEVWEN Sr Co. S \ oomboo t-Yaa r t TrsscHEir ROTTERDAM EN HDLL. Voor PASSAGIERS en GOKBEREN. De Rader-Stoomboot Sea Gull Kapitein R. Dïnipace  vertrekt van Rotterdam naar Ruil Zaturdag 19 Mei des voormiddags.  (8102) Adres bij J. B. CROL Sc Co. NEDERLANDSCHE STOOMBOOT-REEDERÏJ. ZOMERDIENST. Afvaart Boompjes. Van Rotterdam langs Nijmegen naar Mannheim dagelijks des morgens ten 10% ure. Van Hymegen naar Rotterdam dagelijks des morgens ten O ure. (7833) ZOMERDIENST STOOMBOOT MAASSTROOM Aanvangende MAANDAG- 21 MEI 1866. Van Raassluls des morgens ten 9 ure en des namiddags ten A ure. Van Rotterdam des middags ten half 1 ure en des avonds ten half 9 ure. Dagelijks uitgezonderd Zondag. (8128) De Agent J. VAN DER MADEN. STOOIBBOOTVMHT op de MAAS. Onderneming P. J. BERGER. Wegens het Pinksterfeest: Zaturdag 10Mei 186© 's avond ten 12 ure geen vertrek vau VENLO naar ROTTERDAM. AJF HO MEI «BAHMM.OMB. TOW VAK VSBTKEK AIS VOMT . van wenlo naar Rotterdam Zaturdag des avonds tenl*„.„ j„ „ • j des avoifds omtrent 9 Z^ZZÏTn Spoortrein 111 van Maastricht. Van Rotterdam raar Venlo alle dagen uitgezonderd Zaturdag'myoaüg A ft Bij de opvaart zal de Boot niet voor S ure d morgens van Grave en O ure van Mooie vertrekken8 • Correspondentie: te Venlo met den Spoortrein ' naar Roermond Maastricht en Luik. (8117-1 Te Mook per Rijtuig van en naar Nijmegen. Agent te Rotterdam L. BERGER. * Amsterdam T. VAN SWIETEN. „ 11 Gorinchem J. E. DALLEU. (8145) De ondergeteekende maakt het Handeldrijvend Publiek bekend dat de BE URT.iM A M ?.  op Groninger Ommemnden uiterlijk den 24 Mei eerstk. vertrekt. Ligplaats Leuvehaven bij de Brandstecg. (8145) G. G. KONING.",http://resolver.kb.nl/resolve?urn=ddd:010113830:mpeg21:a0050:ocr,4,ddd:010113830:mpeg21:p004,"Nieuwe Rotterdamsche courant : staats-, handels-, nieuws- en advertentieblad",781
1616706,1866/02/07 00:00:00,1974,ddd:010509968:mpeg21:a0010,http://imageviewer.kb.nl/ImagingService/imagingService?id=ddd:010509968:mpeg21:p004:image&x=80&y=2186&w=819&h=1974,ddd:010509968:mpeg21,899,4160,80,2186,4,"Op Donderdag den Sn  des voor middags te negeu—en des namiddags"" te \ier ure n op Vrijdag den 9n?  des namiddags op gelijke tijdstip ' zulb""! door den Veudumeester J. C GOMPERTS ten St:erfbui/e van mi wijlen den Heer 13AK EMANTJELS SIMONS op den boek van de Weide <>>i Zivartenhmsnbrugslrulen worden ver .kocht:  Welonderhoudene IfflciSbr2én ■werk. ZILVER WAREN en wat verder te voorschijn zal worden gebragt. Deze goederen zullen op Maandag ■thngsdag en Woensdag fe VOren en op rle verkoopdagen te hezigtigen zijn. Voort- zullen over zes weken  den 3«>slen dag nader te b« palen in bet openbaar worden geveild • i@S Het HULS «ii ERF op den boek gjg van de Ifeide en Zivartenhoven ■ brugstraten La. D. No. 78. Het nCIS en jfRF ;- de s/ma/ La. B. NO. 108. HET ÏHJIS en ERF op den boek Tan de Kromme Elleboog en Water mo lens f raat La. A. IV. 189. HET HUIS en ERF aan de Timmer jansstraat La. E. ]\""o. 382. HET HUIS en ERF aan de Steenbok hersgracht. La. E. No. 9G. {zeergeschikt voot Plantage bewoners.] Inmiddels zijn deze Effecten op zeer voordeeligc conditien LIT DE HAND te Loop. Paramaribo  den 2 Februari; 186 G. M. j. SIMONS.",http://resolver.kb.nl/resolve?urn=ddd:010509968:mpeg21:a0010:ocr,4,ddd:010509968:mpeg21:p004,De West-Indiër : dagblad toegewĳd aan de belangen van Nederlandsch Guyana,819
18954,1866/11/08 00:00:00,54,ddd:010274798:mpeg21:a0017,http://imageviewer.kb.nl/ImagingService/imagingService?id=ddd:010274798:mpeg21:p003:image&x=1256&y=1817&w=351&h=54,ddd:010274798:mpeg21,1607,1871,1256,1817,4,Ztiwirtmtiën.,http://resolver.kb.nl/resolve?urn=ddd:010274798:mpeg21:a0017:ocr,3,ddd:010274798:mpeg21:p003,Middelburgsche courant,351
3018541,1866/01/18 00:00:00,2543,ddd:010155786:mpeg21:a0016,http://imageviewer.kb.nl/ImagingService/imagingService?id=ddd:010155786:mpeg21:p004:image&x=1284&y=1305&w=1187&h=2543,ddd:010155786:mpeg21,2471,3848,1284,1305,4,Onder onze ruime sortering van allerhande bevelen wij bijzonder aan: De Echte Tandzeep van Dr. SUIN DE BOUTEMARDj zij maakt de Tanden zuiver wit zonder het émail aan te doen bewaart ze voor ziekelijke aandoeningen en houdl den mond frisch. Het stuk kost 40 Cts. en is toereikende voor een halfjaar De Echte Dr. Borchardt's Zeep is zamengestèld uit fijne aromatische en etherische Oliën en dcli's toflelijke bestanddeelen verwijdert puisten schubben levervlekken zonnebrand sproeten en geeft na.n de huid door alle jaargetijden dat fluweelige veerkrachtige en i'rissche voorkomen dat de schoonheid zoo zeer verhoogt. Men gebruikt ze met een wollen lapje waarmede men de huid een- of tweemaal daags wascht. De prijs is 40 Cents. Gebr. Leder's Balsamisclie Aardnoot-olie-Zeep die de huid reinigt zonder stramming le veroorzaken  haar zachtheid en lenigheid geeft en voor den invloed der weêrsveranderingen beveiligt als koude hitte wind enz. Het stuk kost 20 Cents. Dr. Hartung's Kruidenpomade versterkt den groei van het Haar en werkt zoo voordeelig dat de laatste levenskiem in den knobbel weder ontwikkeld wordt en een nieuwe wasdom begint. Zij verhindert het uitvallen en ontijdig grijs worden maakt het krachtig glanzend en golvend. Het glazen Potje is 75 Cents. De Kina-Olie van Dr. Hartung werkt zeer weldadig op het Haar en is vooral bij Kinderen zeer nuttig daar zij het buitengewoon digt en fijn als zijde maakt. Aan den Baard geeft zij eene zachte buigzaamheid terwijl zij zich bijzonder onderscheidt door de eigenschap de Hareneen schoonen glans te geven. De Flacon kost 75 Cents Dr. Beringuier's Aromatische Kronengeist een van de nieuwste producten der Scheikunde is een kostelijk opwekkend en versterkend Reuk- en Waschwater. De Flacon ƒl. Dr. Beringuier's Krauter-Wurzel ÖL tot onderhouding en verfraaijing van het Hoofd- en Baardhaar. Prijs per Flacon 60 Cents. VERKOOPHUIS te Amsterdam. Breda Henri Sprengers. I Leur L. van den Berg. » M. Janssen voorheen \Y'ede. ! Ooslerhout Gebr. Driessen J. Soomers. Rozendaal M. D. v. Leeuwen. Bergen-op-Zoom D. Ponwels. Steenbergen W. v. d. Kar. » P.F. Appelboom Apoth. Tilburg G. 11. Domhoff. Eindhoven A- Beguin. Waalwijk P. Reijnen voorheen Helmond  A. H. Martin. F. v. d. Klokken. 'sHeriogenbosch F.'JL. Welsch. » P. J. van Gils. F.n iv de audere Steden in de bekende Dépóts.,http://resolver.kb.nl/resolve?urn=ddd:010155786:mpeg21:a0016:ocr,4,ddd:010155786:mpeg21:p004,Bredasche courant,1187
2290944,1866/01/27 00:00:00,2983,ddd:010332725:mpeg21:a0005,http://imageviewer.kb.nl/ImagingService/imagingService?id=ddd:010332725:mpeg21:p004:image&x=48&y=1603&w=768&h=2983,ddd:010332725:mpeg21,816,4586,48,1603,4,"BEKENDMAKING. GOUVERNEMENTS SECRETARIE. Curacao den 19 January 1866. ""O Y Gouvernements besluit van den 15 dezer No. 16 zyn de militairen K. L. Haakman P. Leeuw en S. Wittcvberg tydelyk by de brigade maréchaussés alhier gedetacheerd. De Hoofd Commis belast met de functien vau den Gouvernements Secretaris W. B. MELLINK. KF.IiËNOMAKfNG. GOUVERNEMENTS SECRETARIE. Curacao den 19 January 1866. ¥5Y Gouvernements besluit van den 16 dezer No. 18 is aan den persoen van Eustaquio Abad vergund om den familienaam van de Pool te voeren. De Hoofd Commis belast met de functien van don Gouvernements Secretaris W. B. MELLINK. GOUVERNEMENTS SECRETARIE. Curacao den 19 January 1866. IC* Y Koninklyk Besluit van deu 5 December a p. No. 83 is de onderwyzer J- Rynenberg te Bcmmel benoemd tot laudsschoolonderwyzer op St. Eustatins. De Hoofd Commis belast met de. functien van den Gouvernements Secretaris W. B. MELLINK. ""I>E debiteuren wegens landsbelastingen enz. worden hierby opgeroepen en aangemaand om het verschuldigde tot en met ultimo December 1865 ten kantore van den ondergeteekendo te komen voldoen ; zullende na ultimo dezer maand de onbetaalde posten gercgtelyk worden ingevorderd. Curacao den 12 January 1866. De Koloniale Ontvanger P. I. BEAUJON. Publieke Ver kooping. ■~|E ondergeteekenden Weesmeesters der ""^^ Nederlandsch Portugeesch Israëlitische Gemeente alhier zullen op Maandag den 29 dezer des middags om 12 ure vóór het Weeskamersgebouw by publieke veiling doen yerkoopen : HET HUIS No. 149 gelegen in de Willemstad 3e. Wyk toebehoorende aan den boedel van wyle Mejufvrouw SARA VAN MOZES DE CASSERE3. Tevens zullen ook publiek verkocht worden EENIGE MEUBELEN en GOUDWERK. Curacao den 18 January 1866. M. A. CORREA Jr. Saml. DACOSTA GOMES Je* In lading naar Amsterdam de Nederlandsche Brik }£§£> AG A TH A $£¡!|i& Kapitein A. E. ZEYLINGA. Voor vracht vervoege men zich by J. E. VAN DER MEULEN. Curacao den 18 January 1866",http://resolver.kb.nl/resolve?urn=ddd:010332725:mpeg21:a0005:ocr,4,ddd:010332725:mpeg21:p004,De Curaçaosche courant,768
2285784,1866/05/12 00:00:00,2396,ddd:010529117:mpeg21:a0013,http://imageviewer.kb.nl/ImagingService/imagingService?id=ddd:010529117:mpeg21:p003:image&x=1033&y=2382&w=954&h=2396,ddd:010529117:mpeg21,1987,4778,1033,2382,6,"INSTITUUT TE NIJKERK. De ondergeteekende Dag- en Kostschoolhouder te*Nykerk neemt de vryheid zijne onlangs opengestelde I__- RICHTUV C 3 ouders en voogden aantebevelen. Hij stelt zich ten doel jongelieden opteleiden voor de Militaire Academie te Breda voor de Marine of den Handel. Prospectussen zj}n op franco aanvraag te bekomen. De Hoofd-onderwijzer D- van der HORST. Burgemeester en Wethouders van NIJKERK vinden zich gedrongen het INSTITUUT van den Heer van der HORST ruimschoots aantebevelen zoo uithoofde van de erkende kunde en bekwaamheid van den Onderwijzer als uithoofde van het uitmuntende locaal tot ontvangst van kostleerlingen terwijl de Centraal-spoorweg  behalve vele audere middelen van vervoer het meeste gemak voor het Instituut aanbiedt. Nijkerk 3 Mei 1866. Burgemeester en Wethouders voorn. As. MARC U S. De Secretaris J. FR E Z I E. *#* Te Wageningen wordt ten spoedigste gevraagd een HULP-ONDERWIJZER aan de openbare armenschool op eene jaarwedde van f 375. Zy  die boven de 23 jaar oud ""zijn zullen bij voorkeur in aanmerking komen. Men vervoege zich met vrachtvrije brieven onder overleggmg van stukken aan den Burgemeester aldaar. DRIE HULP-ONDERWIJZERS worden gevraagd te Hoogwoud. Salaris / 325 ieder. Adres  met franco brieven  doch liefst in persoon aan den Burgemeester. Aan een Instituut in de prov. Utrecht wordt tegen half Augustus e. k. gevraagd een SECONDANT van de P. G. geëxamineerd voor de wiskunde. Kennis der fransche taal zal tot aanbeveling strekken. Salaris naar bekwaamheid. Brieven franco onder lett. IJ. by den Boekhandelaar J. MADO te Utrecht. ïutTïïïaY Voor een JOSIC MENSCH van goeden huize  die eene vlugge en nette hand schrijft en voor het Notariaat wenscht opgeleid te worden bestaat gelegenheid als volontair werkzaam te zijn op een druk Notariskantoor in eene kleine stad. Leergeld wordt niet verlangd  doch voor huisvesting enz. geschikt verkrijgbaar moet op eigen kosten gezorgd worden. Brieven franco letter D. bij den Heer A. KNOOP Klein Heiligland te Haarlem.",http://resolver.kb.nl/resolve?urn=ddd:010529117:mpeg21:a0013:ocr,3,ddd:010529117:mpeg21:p003,Opregte Haarlemsche Courant,954
2628428,1866/08/11 00:00:00,2914,ddd:010261273:mpeg21:a0015,http://imageviewer.kb.nl/ImagingService/imagingService?id=ddd:010261273:mpeg21:p004:image&x=1931&y=51&w=902&h=2914,ddd:010261273:mpeg21,2833,2965,1931,51,4,"F. FALKENBURi \\{j te 's Gravenhage VHEEFT VERKRIJGBAAR GESTELD: ' COCOSZeep die de vuurproef van I 'wetenschappelijl. onderzoek schitterend doorstond- geeft eene aangename friscliheid aan de huid neemt de kleine huidvlekjts volkomen weg. Het deze Zeep gcwasschen fijn goed wordt schade i gereinigd daar bier alle soda-zelfstandigheden ontj| ? ken. De vervaardiger staat voor de deugdelijk dezer binnenlandsche Zeepsoort borg. Prijs per stuk t ! Gntta-Percha Sclioensmeej scheikundig vrij van alle nadeelige zuren bevon' i Het geeft aan het leder een zeer zwarttn glan3 . verlakt gelijk en houdt het leder zacht en waterd'r ' Veelvuldig gebruik heeft hel onvergelijkbaar he>e- Prijs per doos f 0.05. — Per 25 doozen f >' ïüaptlia waarmede de ergste Vetvla^J j worden iiitgewischt zonder zelfs de teedersie kle'ir' te schaden. Voor het wasschen van Glacé H*""1 schoenen verwierf liet reeds reputatie. De fiakon met. gebruiksaanwijzing f""' E<a Brillantïne ais poetspoeder iA alle Metalen hoogst aanbevelingswaard. De nadeed zelfstandigheden die andere poetspoeders zoo ver* felijk voor de Metalen maken ziju hierin niet sB wezig. Goud en zilver doet het zijn glans en gl° behouden. Per pakje fO.lO. — Per 25 pakjes f 2.— j Depot te 's Hertogenbosch bij den heer | VAN BA ER; te Eindhoven bij de heeren A-  VAN BON en J. H. GRUIJTERS; te Oosterl'o bij den lieer Jlis. ZWAGA Gzn. F. FAI.KEHBURG' tVOORTREFFELIJKE WERKING| (\fa VAN HET Tt f lllflillMiilWllll JL Op het Tandvleesch en de Tanden- f /fc> Door het eiiren gebruik van het AUotherfO*H}> VllODdwater (*) van den praktisercndeli^ *® Tandarts den heer Pr JT. G. POPP il! X Weenen heb ik mij van de VOOrtrelTC*(f (Plijke werking op het Tand'd) f vleesch en de Tanden overtuigdf zoodat ik mij om de lijdende mensclilieiil -''' tf Indienen aangespoord gevoel dit MOUdwatC*'!) (B iedereen om het meest aan te bevelen. % f Weenen /p *y Landgraaf tot Fürstenberg m/p. /\} & K. K. Generaal der Kavalerie enz. k (f (*) Verkrijgbaar bij den Heer JC. STRAAT* J ©MAM Apotheker in dc Vughterstraat te 's ller~\ J§ togenbosch Depöthouder. |' Tl Alleen franco aanvragen om een Depot te er-| | tjplangen alsook Consiiltatiën van het seëerd public""!) f kan men rigten ao.n den Heer Dr Jl C. POP» '*  praktiseerend Tandarts te Weenen. yj",http://resolver.kb.nl/resolve?urn=ddd:010261273:mpeg21:a0015:ocr,4,ddd:010261273:mpeg21:p004,De Noord-Brabanter : staat- en letterkundig dagblad,902
109074,1866/11/24 00:00:00,106,ddd:110536655:mpeg21:a0041,http://imageviewer.kb.nl/ImagingService/imagingService?id=ddd:110536655:mpeg21:p008:image&x=3215&y=3048&w=1029&h=106,ddd:110536655:mpeg21,4244,3154,3215,3048,8,_ . _ Snelpersiru.k W. OGILVIE Batavia.,http://resolver.kb.nl/resolve?urn=ddd:110536655:mpeg21:a0041:ocr,8,ddd:110536655:mpeg21:p008,Bataviaasch handelsblad,1029
1776735,1866/03/26 00:00:00,1845,ddd:010529078:mpeg21:a0034,http://imageviewer.kb.nl/ImagingService/imagingService?id=ddd:010529078:mpeg21:p006:image&x=2001&y=2878&w=963&h=1845,ddd:010529078:mpeg21,2964,4723,2001,2878,6,V Bij IPEttBUUR & VAN SELBAM tTA^ sterdam  is verschenen en alom verkrijgbaar gesteld : L'Unité du corps de Christ. Discours sur i Corinth. XII: 12 13 prononcé dans le temple wallon d'Amsterdam le 28 Janvier 1866 PAR F. H. GAGNEBIN l'un des pasteurs de I'Eglise Wallonne et publié a la demande du Comité Exécutif de l'AUiance Evangélique. ƒ-.10. EN Y. KINGMA Pzn. Inleiding tot de beoefening der Zweedsche taal; zijnde eene Handleiding voor Houtkoopers Kooplieden Cargadoors enz. methet Noorden connectie hebbende. Prijs ƒl. V BiJ «Ï.^AT JBÖÖÏT& ZÖÖN teM^ppd7^ilt heden het licht een herrduk van het voor eenigeda»-en geannonceerde werkje: GESCDENK AAN BEDROEFDEN; OF dc Raad van Christus aan eene bedrukte Moeder DEN DOOD VAN HAREN GELIEFDEN EN EENIGEN ZOON BEWEENENDE DOOR JOHAN FLAVEL Predikant te Dartmouth in Engeland. 8 vel Bvo8vo mediaan. Prijs 75 Cents. B^* De rijke bron van troost steunende op Sg^^Q^ waren godsdienstzin welke dit werkje bevat is juist geschikt om hen  die dierbare panden hebben' te betreuren een rijken troost aantebieden ; terwijl het voor degenen die eenige stichtelijke lektuur verlangen  mede bijzonder geschikt is. Alle solide Boekhandelaren nemen bestellingen aan. Een BOEKDRUKKER Ha&B*» zijn werk goed verstaande en tevens eeniggg^V zins bekend met het zetten van goede getuigschriften voorzien  kan bij bovengenoemde Drukkers dadelijk of met medio April geplaatst worden.,http://resolver.kb.nl/resolve?urn=ddd:010529078:mpeg21:a0034:ocr,6,ddd:010529078:mpeg21:p006,Opregte Haarlemsche Courant,963
973104,1866/03/08 00:00:00,627,ddd:010113759:mpeg21:a0028,http://imageviewer.kb.nl/ImagingService/imagingService?id=ddd:010113759:mpeg21:p005:image&x=875&y=4474&w=1552&h=627,ddd:010113759:mpeg21,2427,5101,875,4474,10,T¥__ SfMI SHIPPII illPlï. GIDEUESG-HI.BE DIENST f 38281 TUSSCHEN ROTTERDAM e_ NEWCASTLE. Het Stoomschip LORD RAGLAN Kapitein J. H. THOMPSOI. vertrekt van hier naar _EW-CASTLE Zaturdag IO dezer *?£'# -morgens vroeg PASSAGE- lste KAJUÏT * — _S/-. VOORKAJUIT _\ — .870. DEKPASSAGE i' - »/-. RETOURKAARTEN iy2 Vracht. Adres bij D. BURGER -_ ZOO_.,http://resolver.kb.nl/resolve?urn=ddd:010113759:mpeg21:a0028:ocr,5,ddd:010113759:mpeg21:p005,"Nieuwe Rotterdamsche courant : staats-, handels-, nieuws- en advertentieblad",1552
2773470,1866/11/14 00:00:00,2810,ddd:010484549:mpeg21:a0011,http://imageviewer.kb.nl/ImagingService/imagingService?id=ddd:010484549:mpeg21:p002:image&x=1082&y=3167&w=987&h=2810,ddd:010484549:mpeg21,2069,5977,1082,3167,6,Ontvangen: Delicieus ïïollandscb BIER per mand van 25 heele kruiken ƒ 15—. per mand van 50 halve dito „ I<s—. (6569) VAN DEN ABEELEN & Co. Weder ontvangen: een factuur Keukengereedschap als: TULBANDVORMEN met deksels  MESSEMANDEN VLIEG E-DEKSELS CASSEROLLES met deksels SCHUIMSPANEN VLEESCH VORKEN BOUILLONZEEPTEN BIEFSTUK-ROOSTERS VISCHKETELS MELKPANNEN IJZEREN POTTEN enz. (6689) WINSSER DE LANGE 8. Co. Ontvangen. Puik ROOK VLEESCH en Hollandsen ZULT in Azijn. (6576) VAN DEN ABEELEN & Co. Wederom ontvangen: ROOD BLADKOPER van 1 tot 4 Ned. strepen dik. (6636) E. TEN BRINCK k Co. Wederom voorradig : Nieuwe Palembangsche Rottingmatten van verschillende dimensiën. (6714) VAN DEN ABEELEN k Co._ Ontvangen per „ Joan' : SOO/3 flesschen ROB BOYVEAU LAFFEOTEÜR. (6570) L. PLATON. Ontvangen per IJ stroom: 100 Rollen witte en gekleurde Chinesche MATTEN. (6712) V. C..SSALETTE k Co. Ontvangen per Ternate-. — Opregte Westfaalsche Hammen PUIK 1100KVLEESC1I. GRASBOTER van d-r Leeuw. BERGSCIIE ANS.IOVISCII. (6716) VAN DEN ABEELEN k Co. Wederom ontvangen: Slriivc \\ A t E R bij (6563) WINSSER DE LANGE & Co. Bij G. Rol!F & Co. te Batavia thans verkrijgbaar: (6518) NEDERLAND3CII INDISCHE ZAKAGENDA voor 1867--in net linnen bandje ƒ 2—. Idem KANTOOR-ALMANAK 1867 opgeplakt „ I—. Te zamen franco per post  3—.,http://resolver.kb.nl/resolve?urn=ddd:010484549:mpeg21:a0011:ocr,2,ddd:010484549:mpeg21:p002,"Java-bode : nieuws, handels- en advertentieblad voor Nederlandsch-Indie",987
3188199,1866/10/11 00:00:00,3297,ddd:010529308:mpeg21:a0022,http://imageviewer.kb.nl/ImagingService/imagingService?id=ddd:010529308:mpeg21:p004:image&x=1054&y=2598&w=967&h=3297,ddd:010529308:mpeg21,2021,5895,1054,2598,4,"%* G. W. WESSELING 11. M. WESSELIXG eu F. 11. WESSELIXG zullen op Maandag den 15Jon October 1866  des namiddags ten half drie ure  te Amsterdam in de Witte Zwaan  op den Nieuwendijk  presenterente verkoopen : Eene extra mooije  nieuw aangevoerde partij Greenen en Vuren Dramache Fredrlkstadsche  Bybavensehe  Riga  Narva en Zweedsche Balken ; Wyburger Fretlilkliavensche «lacobstadsche Riga Zweedsche en Noordsche Deelen en Platen; Riga Sparren Battings Ellens Colters en andere HOUTWAREN. Liggende iv den Binnenkant en op den Wal. *.* Men is van meening om  op Woensdag den 24s'<'n October 1866 des voormiddags te 11 ure iv de lierberg 's Lands Welvaren  te Sohoorldam  gemeente Warmerhuizen in het openbaar te verkoopen : Onderscheidene stukken WEI-  BOUW- en BOSt lILAND en BOOMGAARD gelegen in de gemeente Schoorl ter gezamenlijke grootte \an 21 bunders 98 roeden  35 ellen. Te aanvaarden met Kerstijd 18GG. Welke percelen uitvoeriger omschreven en in teekening gebragt zijn in de alom verspreide billetten. Nadere informatien zijn te bekomen ten kantore van de Heeren \m LANGE eu de MORAAZ aan de Breestraat te Alkmaar  en ten kantore van den Makelaar CORNs. JOlIS. dk LANGE  aiin de Pastoorsteeg  aldaar. VERKOOPING. De Notaris VAN BOEKEREN te Stads-Kanaal is voornemens Zaturdag den 27st™ October a. s. des morgens ten tien ure in het logement van de Wed. J. 11. Kok te Stads-Kanaal ten verkoop aan te bieden : Eene BOERENPLAATS gelegen aan het Boerendiep te Stads- Kanaal gemeente Wildervank en wel achter de kapitale huizinge van den Heer Offers zijnde die plaats met de huizen ten verkoop aanbiedende groot 15 bunders op het schoonste gedeelte vau Stads-Kauaal gelegen en is door gemelden Notaris over 186 G publiek verhuurd voor bijna ƒ 900. Informatien bij genoemden Notaris en bij den Heer J. KLOEKERS te Assen. Inmiddels uit de hand te koop. Couditien van betaling >/g bij aanvaarding en 8/. in termijnen met 5 °/0. De Notaris Jl. HEPPENER te Borger provincie Drenthe is voornemens Dingsdag den 23stt'n October a. s. des morgens ten 10 ure ten huize van den Kastelein Lubbie te Borger publiek te veilen en te verkoopen : Het van ouds bekende zeer nette LOGEMENT staande te Borger met de daarbij behoorende LANDERIJEN gelegen 3 uren van de stad Assen en 2 uren van Stads- Kanaal. De omgeving van gehuchten en gemeenten geeft aan  dat een groothandel in granen en andere landbouwproducten met succes kan worden uitgeoefend. De betalings-conditien is '/s van den koopschat bij aanvaarding  2/; s in termijnen van 3 jaren met 5 °/a rente. Informatien bij genoemden Notaris en den eigenaar J. KLOEKERS te Assen. Inmiddels uit de hand te kooji. De Notaris J. T. KLFMMELL  te Westerberk is voornemens op Woensdag den 24""'™ October a. s. 's morgens ten twaalf ure ten huize van Mejufvrouw de Wed. van Tavei te Dalen  publiek te verkoopen : Een hechten sterken royaleu en beklanten KOREN-en PELMOLEN  staande te Dalen aan den straatweg en doende eene jaarlijksche huursom van f 450 ; in de onmiddelijke nabijheid is tevens ontworpen een kanaal naar de Schoonbeeker Veenen zoomede een DUBBEL HUIS met schuur mede aan dien straatweg zeer gelegen voor een Huisschilder of voor andere affaires» Informatien bij genoemden Notaris en bij 'deu Heer J. KLOEKERS te Assen. Inmiddels uit de hand te koop. Gonditien van betaling l';. bij de aanvaarding -/„ iv termijnen mei 5 UIT dk HAND tk KOOP een sterk DUBBEL HUIS  met annexe bakkerij en open plaats staande en gelegen in de Oudestraat te Assen mede zeer geschikt vooi^ andere affaires thans bewoond door den Heer Zeistra. Informatien bij den eigenaar J. KLOEKERS te Assen. Couditien van betaling '/j bij de aanvaarding  '-/. in termijnen met 5 % rente-",http://resolver.kb.nl/resolve?urn=ddd:010529308:mpeg21:a0022:ocr,4,ddd:010529308:mpeg21:p004,Opregte Haarlemsche Courant,967
1890444,1866/04/08 00:00:00,1578,ddd:010155809:mpeg21:a0017,http://imageviewer.kb.nl/ImagingService/imagingService?id=ddd:010155809:mpeg21:p004:image&x=80&y=90&w=1198&h=1578,ddd:010155809:mpeg21,1278,1668,80,90,4,i VAN BEDDEN DEKENS | EN paardenharen- springveren- en kapok- MATRASSEN. G. D. H. WINTJIÏS. Eindstraat A  24. De Majoor kommauderende de véreenigde Bataillons van het 3e Regement Infanterie in garnizoen te Breda zal onder nadere goedkeuring van den Kolonel  kommandant van gemeld Regement op Zaturdag den Een en twintigsten A-pril a. s.  des namiddags om één uur in het bureau der Adjudanten-Onderofficier binnen de Klooster-Kazerne AANBESTEDEN: Het LEVEREN van VLEESCH VET SPEK STEENKOLEN en KRUIDENIERSWAIIEN alsmede het VERPACHTEN van den PRIVAATMEST; alles van 1 Mei e. k. lot en met ultimo April 1867. De voorwaarden liggen ter lezing iv het bureau der Adjudanten-Onderofficier voornoemd. De billetten van inschrijving moeten verzegeld zijn (op ongezegeld papier) en de namen van twee borgen bevatten. Beeda den 4. April 1866. De Majoor voornoesnd TISSOT VAN PATOT.,http://resolver.kb.nl/resolve?urn=ddd:010155809:mpeg21:a0017:ocr,4,ddd:010155809:mpeg21:p004,Bredasche courant,1198
32340,1866/11/21 00:00:00,66,ddd:000010752:mpeg21:a0014,http://imageviewer.kb.nl/ImagingService/imagingService?id=ddd:000010752:mpeg21:p003:image&x=1382&y=591&w=490&h=66,ddd:000010752:mpeg21,1872,657,1382,591,10,ADVSETEOTIE-f.,http://resolver.kb.nl/resolve?urn=ddd:000010752:mpeg21:a0014:ocr,3,ddd:000010752:mpeg21:p003,Algemeen Handelsblad,490
63732,1866/11/15 00:00:00,94,ddd:010390014:mpeg21:a0044,http://imageviewer.kb.nl/ImagingService/imagingService?id=ddd:010390014:mpeg21:p004:image&x=1023&y=900&w=678&h=94,ddd:010390014:mpeg21,1701,994,1023,900,4,ADYEETENTIEN7,http://resolver.kb.nl/resolve?urn=ddd:010390014:mpeg21:a0044:ocr,4,ddd:010390014:mpeg21:p004,Rotterdamsche courant,678
574838,1866/08/15 00:00:00,374,ddd:010510022:mpeg21:a0028,http://imageviewer.kb.nl/ImagingService/imagingService?id=ddd:010510022:mpeg21:p004:image&x=257&y=4091&w=1537&h=374,ddd:010510022:mpeg21,1794,4465,257,4091,4,Een keurig assortiment Kukel en Dubbelloops RORVFJf tAUIinVFRK fsiißi.ermvE K4mMEiv PLATTE en BfEPE JTO«»J?JT «e&lepen JF-ATimGI^^kZACX  IAILkJiHGÏiAZEM,http://resolver.kb.nl/resolve?urn=ddd:010510022:mpeg21:a0028:ocr,4,ddd:010510022:mpeg21:p004,De West-Indiër : dagblad toegewĳd aan de belangen van Nederlandsch Guyana,1537
3959670,1866/05/27 00:00:00,5538,ddd:000024579:mpeg21:a0012,http://imageviewer.kb.nl/ImagingService/imagingService?id=ddd:000024579:mpeg21:p003:image&x=51&y=22&w=715&h=5538,ddd:000024579:mpeg21,766,5560,51,22,6,"m(LJi*£vr='K&e&A Ten overslaan van jPw^jy f!DDOfflf den te 's Gravenhage Pp*™'i« ¦¦«Mfc-iLresiderenden Notaria p VtVttiiing  zal in het Venduhuis der Parissen in de Nobelstraat aldaar op °ENSUAG den 30» Mei 1866 des voor- teu 10 ure  in het openbaar worden ""eild en op WOENSDAG den 6» Junij (""Wnvolgende mede des voormiddags ten 1 ""re finaal verkocht: No. 1-7. DE '.OUWMANSWONIHIr met HEEREN-OPTREK genaamd: .Groenhoven"" ers Stalling voor 34 Beesten Schuren 'üetihuis Paardenstal Hooiberg en verder lerte . BOOMGAARD OPRIJLAAN 7«N en BOSCH alsmede eeuige perceelen puntend WEILAND alles gelegen in den - Estcamppolder  onder de Ge- ISe«nte Loosduinen en Kadastraal bekend 8. Nos. 418 419 420360 445 ""» 442 446 377 378 379 409 tot en «Kt 412. M 8. Een BOUWMANSWONING met S""ALLING HOOIBERG en verder getim- Ne alsmede een perceel TUINLAND gesBn als voren Kadastraal bekend Sectie B V 416 en 417 zijnde thans ingerigt tot 6|eekerij. N». 9. Een perceel WEI-of HOOILANU in den West-Escamppolder den Leijweg onder de gemeente Loosdui"""">. kasdastraal bekend Sectie C No. 634. N"". 10. Een HUIS met ERVE en TUIN . liegen aan de Noordzijde van deu Loos'«Unschen Straatweg  onder de ge» Loosduinen Kadaster Sectie A N». 241 Meeltelijk.  N». U. Drie HUIZEN en ERVEN gelegen 'oren Kadaster Sectie A No. 242 455 456 geheel en 241 gedeeltelijk. . No. 12. Een HUIS en ERVE waarin sedert !*tti met goed gevolg de Timmermans-Affaire \ uitgeoefend gelegen als voren Kadaster A No. 463 geheel en 241 gedeeltelijk. . N°. 13. Een Perceel BOUWGROND met Vchter gelegen WARMOEZIERSTUIN fcjegen als voren Kadaster Sectie A No. 464 Scheel en 241 gedeeltelijk. N°. 14. Een TUINMANSWONING en uit""«ntende WARMOEZIERSTUIN gelegen **tt den Loosdulnschcn Straatweg ?Qder de gemeente Loosduinen in de Iflicnt. laster Sectie A Nos. 395 en 396. N°. 15. Het zeer gunstig en alleraangenaamst 'atl deu Loosdulnschcn Straatweg o«iler de gemeente Loosduinen gelegen Buitenverblijf „ONS GENOEGEN"" TUINMANSWONING MENAGERIE of volière koetshuis stalling l°°r 4 Paarden  KOESTAL met gemetseld j°urnuis en Bakoven Hooizoldcr Hooiberg *ai aangelegden en met exquise Vruchtboo?e» Heesters en ander plantsoen beplanten JÜIN  MOESTUIN en BOSCH  Kadaster Sectie A Nos. 370 375 en 374 bevuilde de Heerenhuizing tien zoo Boven- als  alle Behangen  sommige Ge- Wonnccrd en meerendeels vau Stookplaatsen *a*ironder met Marnieren Schoorsteenmantels v°orzien ; voorts Badkamer  Domestiekenka- Keuken Kelder en Zolder Bergplaatsen '°or provisie en brandstoffen vele vaste Kas'*l en alle verdere gemakken tot eene aanname voor Zomer- en Winterverblijf ingef'gte  woning vereischt wordende. De perceelen No. 1 2 3 en 6 zijn ver'lurd voor ƒllOO 'sjaars met uitzondering 'a>i het Hecrenoptrek dat afzonderlijk ver«Uurd is voor ƒ2OO 'sjaars de Lauden tot 1866 en de Woning en het Heeren°Ptrek tot 1 Mei 1867; No. 8 tot 1 Mei 1871 v°or ƒ230 'sjaars; No. 10 en 13 tot 1 Jan. 1870 de Tuin en lot 1 Mei 1870 de Huizing ** zamen voor ƒ4OO 'sjaars; No. 11 bij de *eek te zamen voor ƒ3; No. 12 tot 1 Mei 1867 voor ƒ225 iv het jaar en No. 14 tot 1 Februarij 1872 voor ƒ3OO 'sjaars; zijnde Je overige perceelen in eigen gebruik. Alles omschreveu in het Dagblad van Zuid- eu 's Gravenhage van Zondag 22 en Maan""*g 23 April 1866 en bij geafficheerde billetten. De bezigtiging der perceelen kan behalve en Zondags dagelijks plaatshebben «Oet uitzondering van perceel No. 15 hetwelk W worden bezigtigd des Dingsdags en Donderdags van des middags 12—2 ure op verton van een permissiebillet verkrijgbaar ten Wtorc van den Notaris van Waning 'oornoemd alwaar nadere onderrigt ing te bekomen is. (2995) . Ingevolge bekomen magtiging ffSSB^ van de Arrondissements- RegtïliL bank' te 's(JravenllaSe> za'.ten [ïfïMlfT^É overstaan van de te sGravcnjrt JLJ^B hage residerende Notarissen van ™—'——— den Bergh en Stoop  iv het Venduhuis der Notarissen  in de Nobelstraat aldaar in het openbaar op MAANDAG den lln Junij 1866  des namiddags 'eu vijf ure  worden geveild en op MAANDAG den 18» Junij 1866 des avonds ten 7 ure worden verkocht: Een HUIS ERF en TUIN staande en gelegeu aan de Zuidzijde van de Prinsen- Kracht  te 's Graveiihaee . No. 44 Kadaster Sectie K No. 223  groot 2 Roeden 27 Ellen; bevattende het Huis 2 Benedeukamers en suite en 3 Bovenkamers allen geplafonneerd en 4 van stookplaatsen voorzien ; een ruim Onderhuis met Mangelkamer  Keuken Kelder en Bergplaatsen en een grooten Kleederzolder met twee afcreschoten vertrekken. — Grondlasten over 1866 /'63.85. Gemeld perceel is te aanvaarden op den 1 September 1866 bij de betaling der Kooppenningen of welligt vroeger en te bezigtigen * Maandags en Donderdags van iedere week 's namiddags van 2 tot 4 ure mits zich daartoe vooraf aanmeldende ten Kantore van genoemde Notarissen. Nadere informatièn zijn te bekomen ten voorschreven Kantore. (3486)",http://resolver.kb.nl/resolve?urn=ddd:000024579:mpeg21:a0012:ocr,3,ddd:000024579:mpeg21:p003,Dagblad van Zuidholland en 's Gravenhage,715
2897217,1866/10/05 00:00:00,3617,ddd:010113513:mpeg21:a0045,http://imageviewer.kb.nl/ImagingService/imagingService?id=ddd:010113513:mpeg21:p004:image&x=1637&y=105&w=801&h=3617,ddd:010113513:mpeg21,2438,3722,1637,105,6,De OPENBARE YERKOOPING van het PAND  genaamd het Truweel aan de Nieuwe Haven te Delfshaven wijk D n°. 141 op Vrijdag den 28 September jl. ten overstaan van den Notaris U. LOURENSZ geveild en waarvan de Afslag voorloopig was bepaald op Vrijdag den 5 October 1866 wordt UITGESTELD tot nadere bekendmaking. (15752) JAVA TABAK. Veilingen teßotterdam op Donderdag den 18 October 18GO van onderstaande Partijen: (15770) BLITAR 558 Pakken BB I*B WATES 102 ICOTTA (in een zeshoek)... «ffi? H & A KEDIRIE 716 KS 281 HJ & A BLITAR 558 OPENBARE YERKOOPING Ten overstaan van den Notaris VAN DORSSER gevestigd te Dordrecht op Donderdag 11 October 1866 's voormiddags 10 ure in het Koffijhuis Koophandel en Zeevaart van VAN BEK HOEST te Dordrecht van: I°. Ruim 150 Bunders GRIENDGEWAS bestaande in 120 B. Eenjarig of JLot en 30 B. Tweejarige Einden. 2°. Het STEHDANR uitruim lOßunders. 3°. Ruim 14 Bunders RIETGEWAS. Alles te veld staande op de Krabbegronden de Noordbank de Zeehondenplaat den Kooipolder en de Gronden van het JKroondomein op het Eiland Rozenburg in de Maas tusschen Brielle en Maassluis. Alles in Perceelen. 4°. 1 Bunder eenjarig GRIENDGEWAS te veld staande op den Polder den Rondenhoek onder Sliedrecht. En s°. Het RIETGEWAB te veld staande om de Polders Kort- en Lang-Ambacht de Rondenhoek en de Molenplaat onder Sliedrecht en Hardinxveld. Aanwijzing dagelijks. Ndder onderrigt bij de Heeren A. VAN DRIEL te Puttershoek en Mr. C. W. O. VAN DORSSER te Dordrecht bij den Opzigter J. MOL op Rozenburg bij JP. BLOKLAND op den Heipolder en bij voorn. Notaris. (15400) HOUTVERKOOPING. De BURGEMEESTER van Loosduinen als hiertoe gemagtigd is voornemens op Woensdag den 10 October aanstaande des morgens ten 10 ure bij dc kom der Gemeente te doen verkoopen: Den Inventaris en Casco van het op den 16dcn September jl. gestrande Zweedsche Schoenerschip Sralmt  almede op authorisatie der Heeren H. en A. BICKER CAARTEN  als gevolmagtigden van het Comité der Assuradeuren te Parijs dc daaruit geborgene lading bestaande uit ruim 8500 GREINE DEELEN breed 18 en dik 3% Ned. duimen bij eene lengte van 2 tot 8 Ned. ellen of 7 tot 28 Amsterdamsche voeten. Nadere inlichtingen te bekomen ten Kantore van voornoemden Burgemeester. Zijnde een en ander dagelijks te bezigtigeD. (15736) Loosduinen den 4 October 1866. Verkooping op Regterljjk gezag op Woensdag den V)den October 1866 en zoo noodig volgende dagen des voormiddags 10 ure te Hillegersberg in en voor het Koffijhuis genaamd-Hef Wapen van Holland alwaar de Goederen zijn opgeslagen van: Zeer nette en goed Geconserveerde MEUBELEN hoofdzakelijk bestaande in: Mahoniehouten LINNENKAST dito CHIFFONNIÈRE dito BONHEUR DU JOUR dito KANAPÉ differente TAPELSenSTOELEN LEDEKANTEN VLOERKLEEDEN en KARPETTEN Domasten LEDEKANT en STATIE-GORDIJNEN goed rrevulde VEEREN BEDDEN met Toebehooren zeer zindelijk Linnen BEDDEGOED en dito ONDERKLEEDEREN differente TAFELLAKENS en SERVETTEN vele soorten van Laken JASSEN BROEKEN en VESTEN eenig GOUD en ZILVER; voorts onderscheidene JBOEKEN waaronder een groote Staten-Bijbel differente LUSTERS en Verlakte WERKEN voorts KOPER TIN BLIK IJZER PORCELEIN GLAS en een aantal andere GOEDEREN meer. Alle* ont Contante Betaling. (15750) J. C. LACH Deurw.,http://resolver.kb.nl/resolve?urn=ddd:010113513:mpeg21:a0045:ocr,4,ddd:010113513:mpeg21:p004,"Nieuwe Rotterdamsche courant : staats-, handels-, nieuws- en advertentieblad",801
1403262,1866/12/17 00:00:00,1813,ddd:010113586:mpeg21:a0040,http://imageviewer.kb.nl/ImagingService/imagingService?id=ddd:010113586:mpeg21:p004:image&x=3268&y=190&w=774&h=1813,ddd:010113586:mpeg21,4042,2003,3268,190,4,Laatstleden Zaturdag tusschen eten middag is VERMIST: „ Een Muiskleu-ig BAS-EWIKBHOWDJE BaSterdsoort aan het Gasfabriek Nieuwe Werk. Die hetzelve teregt brengt oi weet aan te wijzen zal genereus beloond worden. Adres aan het bureau dezer Courant. (20008) H. A. M. ROELANTS te Schiedam geeft uit: HET LEVEN EN DE UITGELEZEN ZANGEN EN DICHTEN VAN JACOBIÜS HEVIUS. Heruitgegeven en besproken door Dr. J. tan Vloten Prijs 30 Cents. GEDICHTEN VAN HIIIBEBT POOT. Gekozen en geschikt door Cd. Bijbeen Huet. Prijs 60 Cents. BLOEMLEZING uit de Gedichten van JOHANNES VOLLENHOVE. Met een I*.-vensberigt door A. L. Lestubgeon. Prijs 60 Cenh. HET LEVEN EN DE UITGELEZEN VERZEN VAN ELIZABETH WOLFF-BEKKER. Naar tijdsorde gerangschikt door Dr. 3 van Vioten Prijs 60 Cents- LOSSE PROZA-STUKKEN EN BRIEVEN VAN ELIZABETH WOLFF-BEKKËB- Verzameld door Dr. 3. van Vloten. Prijs 60 Cents. Bovenstaande Werken behooren tot de Serie van het Klassiek  Letterkundig Pantheon. — Eene volledige Lijst daarvan is in alle Boekwinkels verkrijgbaar. — Alle Deelen wordea afzonderlijk verkocht. (19992. VOOR HET LEGER. Bij GEBROEDERS MÜLLER ts 's Hertogenbosch is ter perse om binnen enkele dagen te verschijnen : (19996) OPMERKINGEN OP HET NIEUW REGLEMENT OP DE INWENDIGE DIENST DEB INFANTERIE. Prijs 26 Cents. Alle Boekhandelaren nemen Bestellingen aan.,http://resolver.kb.nl/resolve?urn=ddd:010113586:mpeg21:a0040:ocr,4,ddd:010113586:mpeg21:p004,"Nieuwe Rotterdamsche courant : staats-, handels-, nieuws- en advertentieblad",774
1620556,1866/02/06 00:00:00,868,ddd:010254256:mpeg21:a0021,http://imageviewer.kb.nl/ImagingService/imagingService?id=ddd:010254256:mpeg21:p004:image&x=1017&y=3102&w=1867&h=868,ddd:010254256:mpeg21,2884,3970,1017,3102,6,BOEKHNDEL: C. Li. VAN LANCENHUYSEjY. s Cingei hoek Beulingstraat. Verkrijgbaar bij de aanstaande Feestviering: DE ZALIGE PETRUS CANISIUS PRIESTER BER SOCIËTEIT V.W JESUS. EENE LEVENSSCHETS vermeerderd niet belangrijke ïainilic-Aanteekeningcn. 228 Pagina's . . . Prijs ƒ 0.75 Deze beknopte en klare voorstelling van het charakter en leven des roemrijken landgenoots van wi^' zaligverklaring onze eeuw getuige mag zijn is getrokken uit de grootere werken van Sacchini Raderus V rigny Boëro en uit oorspronklijke oorkonden. De eerste opsteller in het Hd. is ecu ordengenoot dcs ** ligen. Een ander zijner broeders heeft eeno uitmuntende bijdrage aan het werkjen toegevoegd : Een origineelen onuitgegeven brief van Canisius met Handteekening (in faksimilee.) Eene nog niet aldus uitgegevene genealogie van den geloofsheld. De goedkoope prijs verzekert de algemeenheid der verspreiding. Amsterdam bij'C.L. van Lasgbshovskn Drukker en Uitgever.,http://resolver.kb.nl/resolve?urn=ddd:010254256:mpeg21:a0021:ocr,4,ddd:010254256:mpeg21:p004,De Tĳd : godsdienstig-staatkundig dagblad,1867
2851848,1866/03/08 00:00:00,2934,ddd:010529179:mpeg21:a0019,http://imageviewer.kb.nl/ImagingService/imagingService?id=ddd:010529179:mpeg21:p004:image&x=57&y=1854&w=972&h=2934,ddd:010529179:mpeg21,1029,4788,57,1854,6,"CRUTTERIJ. Er wordt gevraagd tegen 1° Mei of eerder een bekwame GRUTTERS-KVECHT  ongehuwd P. G. en van goede getuigschriften voorzien. Adres met franco brieven onder lett. Z. bij den Boekhandelaar JOH. ROEM te Alkmaar. Depöthouders worden gevraagd in alle plaatsen van ons Rijk (uitgezonderd Amsterdam) voor den verkoop van Pure Engllsh Plppermlnth (doublé Strongness) en Glnger Plppermlnth (Gemberpepermunt.) Brieven franco aan WILLEMS en C°. te Amsterdam  Haarlemmerdijk n°. 219 bij de Oranjestraat. %* Op een buiten nabij Zutphen wordt tegen Mei of Augustus e. k. verlangd eene vertrouwde KEVBERMEIB of JUFVROUW van de P. G. geschikt en genegen  de verzorging vau zeer jonge kinderen op zich te nemen. Kennis van wollen- en linnennaaijen geeft de voorkeur. Alleen zij  die voldoende bewijzen van aanbeveling kunnen leveren zullen in aanmerking komen. Brieven franco onder letters A. Z. bij den Boek- en Kunsthandelaar J. A. WILLEMSEN te Zutphen. *** Op een dorp nabij Leiden verlangt men met Mei aanst. twee bekwame BIEVSTBOBEV liefst van buiten de stad van de R. C. Godsdienst; de eene goed kunnende koken en werken en de andere goed kunnende naaijen stoppen en met de wasch omgaan; beiden van goede getuigen voorzien. Adres met franco brieven  onder letter S. aan de Heeren P. M. en J. N. GEIJER Botermarkt te Leiden. ___   _—-—— ** Het Bestuur der Banne HENSBROEK is voornemens op Woensdag den 4den April 1866 des namiddags ten een ure ten Raadhuize der gemeente' bij inschrijving en opbod aantebesteden : Het bouwen van een nieuwen WATERMOLEV. De aanwijzing zal geschieden op den 3d""j April 1866  des voormiddags ten 11 ure. Inlichtingen ziju te bekomen hij den HeerJ. LEGUIT te Oudorp en de bestekken te«-en betaling van f 050 per exemplaar bij den Secretaris des Bestuurs te Hensbroek en bij de Boekhandelaars HERMs. COSTER & ZOON te Alkmaar. Hensbroek Het Bestuur voornoemd 6 Maart 18 66. D. OVERTWATER Voorzitter. MENSONIDES Secretaris. %* Burgemeester en Wethouders van OOSTZAAN ; Gezien de schriftelijke verklaring van J. HUFFNAGEL Provincialen Veearts van Noord-Holland  wonende te Haarlem  van heden  houdende  dat onder het Vee van KLAAS WIT Landman aldaar de ruuderpest heerschende is en dat hij  ter voorkoming van verdere besmetting het zeer dringend noodzakelijk acht dat al het vee van dien stal bestaande uit zeven KOEIJEV en twéé PIVKEV zoo spoedig mogelijk wordt onteigend afgemaakt en begraven. Gezien art. 69 en volgende der onteigeningswet; Besluiten: 1° Het bovenomschreven rundvee wordt onmiddelijk onteigend in beslag genomen afgemaakt na inkerving van de huid begraven ter plaatse daartoe door den Burgemeester aantewijzen en met kalk bestrooid ; 2° Dit besluit zal terstond aan Heeren Gedeputeerde Staten dezer Provincie medegedeeld op de gebruikelijke wijze ter openbare kennis gebragt en geplaatst worden in de Haarlemsche-Courant. Gedaan te Oostzaan den 2den Maart 1866. Burgemeester en Wethouder» voornoemd Jb. BRAT Pz. De Secretaris S. GELDERMAN.",http://resolver.kb.nl/resolve?urn=ddd:010529179:mpeg21:a0019:ocr,4,ddd:010529179:mpeg21:p004,Opregte Haarlemsche Courant,972
3917578,1866/12/28 00:00:00,4249,MMKB08:000087784:mpeg21:a0010,http://imageviewer.kb.nl/ImagingService/imagingService?id=MMKB08:000087784:mpeg21:p003:image&x=1765&y=51&w=922&h=4249,MMKB08:000087784:mpeg21,2687,4300,1765,51,4,"Advertentie vermist eene halfwassen gr ij 'e KAT  met een lederen halsband om. Die haar terug brengt aan het Bureau dezer C jurant kan op eene goede belooning rekenen. WORDT VERLANGD te Arnhem zoo spoedig mogelijk in een klein gezin eene KEUKENMEID OF NOODHULP voorzien van goe ie getuigschriften en van de P. G. Loon /""75 a ƒ80 naar bekwaamheid. Adre3 onder letter U bij den Boekhandelaar H. B. BREIJER alhier. WORDT GEVRAAGD op een Buiten in NoordBrabant eene keukenmeid - van da P. G. op zeer aannemelijke voorwaarden. Alleen zij die van goede getuigen zijn voorzien komen in aanmerking. Adres met franco brieven onder de letters K. P. ain de Boekhandelaars BROESE & COMP. te Breda. Op een Buiten in Noord-Brabant WORDEN GEVRAAGD een of twee Protestantsche AR3SIDEES voor TUIN- en BOSCHARBEID. De voorwaarden  die zeer gunstig zijn  nader te bepilen. Ook gehuwden komen in aanmerking. Adres met franco brieven onder de letters P. A. aan de Boekhandelaars BROESE & COMP. te Breda. Stoomfabriek vaa Plakwerken ARNHEM De ondergeteekenden bevelen zich aan tot den AANLEG van GAS en het LEVEREN van GASTOESTELLEN in openbare en particuliere Gebouwen. WULFBAIN GERRITZEN & RODENHUIS. COMPAGNON GEVRAAGD in eene Eabriekzaak  die in het rijk geene concurrentie heeft welk fabriekaat zeer gevraagd is  en goede winsten oplevert doch uitbreiding vereiseht. Adres franco brieven Lett. X bij W. J. JONGH Kantoor-boakverkooper Koningstraat vArnhem. F WIEGEL vroeger woonachtig te Amsterdam wordt in zijn belang OPGEROEPEN om zijne tegenwoordige verblijfplaats op te geven aan den Notaris Mr. W. P. A. VOORENDONK te Rotterdam. Tegen Januarij of Eebruarij aanstaande VRAAGT MEN als Hypotheek op zeer soliede Panden ƒ 12000 tegen behoorlijke rente en aflossing. Adres H. H. R. aan het Bureau dezer Courant. Brieven franco. Ten behoeve van het Fonds voor ongelukkig geworden Handwerkslieden zijn dezer dagen door de Commissie belast met het beheer van dat Eonds aan de Ingezetenen brieven ter inteekening verzonden  waarin verzocht wordt om de NIEUWJAARSGIFTEN aan Handweikslieden toegedacht aan de kas van bovengenoemd Eonds te willen schenken. In de laatste algemeene vergadering der Vereeniging „Handwerksbloei"" werd door Bestuurderen kennis gegeven dat bij hen van onderscheidene Ingezetenen klagten waren ingekomen dat niettegenstaande aan alle werklieden en leerlingen het nieuwjaarswenschen ten strengste verboden is zij telken jare daarmede worden lastig gevallen. Aan Bestuurderen is toen opgedragen oin langs dezen weg de Ingezetenen beleefd uit te noodigen aan zoodanige personen die tegen het verbod mogten handelen geene fooijen uit te reiken; terwijl het bovendien gebleken is  dat in de meeste gevallen dit misbruik wordt uitgeoefend door personen die hetzij vroeger of nimmer bij een of anderen Meester der Vereeniging gewerkt hebben. Namens Bestuurderen der Vereeniging Handwerksbloei J. van HEES 2 de Voorzitter. E. WANSINK 1 ste Secretaris. Die iets te vorderen hebben vnn-of verschuldigd zijn aan wijlen H. TAKKEN vervoegen zich bij J. van LAAR in de Ploeg te Oosterbeek.",http://resolver.kb.nl/resolve?urn=MMKB08:000087784:mpeg21:a0010:ocr,3,MMKB08:000087784:mpeg21:p003,Arnhemsche courant,922
1026954,1866/07/12 00:00:00,1062,ddd:010776545:mpeg21:a0003,http://imageviewer.kb.nl/ImagingService/imagingService?id=ddd:010776545:mpeg21:p003:image&x=2023&y=3755&w=967&h=1062,ddd:010776545:mpeg21,2990,4817,2023,3755,4,"Een jong mensch^ cene duidelijke hand schrijvende biedt ""zich aan als veste KI_EKK. Gading- makenden adresseren zich met franco brie**r"" ven ouder leller K- aan het BUREAU dezer Courant. Oproeping van Marklgenooten. ____ri»i»rS_S_fc' ne MARKTGENOüTEN van Schoon\\W _Mk lo worden ter vergadcrine opgeroepen °P ""'""..sdag den 17 Julij 1866 des ~ voormiddags 10 uur ten huize van de Weduwe PEEKS te Schoonloo. Namens de Marktgcnooten. A. W. VAN HOLTIIE TOT ECHTEN Notaris. Poor de benoeming van den Heer HILLINGA tot Leeraar van de Hooger '{jf*u'<-?!-* Burgerschool te Veendam staat de *asï KIJZOXKEKE SCHOOT roor meer tiitgebreïd Ijagei"" Or.dertcti* *« Wildc.-ranli vacant ie worden. SOLLICITANTEN naar die bc.rc_i._-ng worden verzocht zich aan te melden vóór den ISden Anj-ts» t.is e.k.  bij den President der Commissie. d Mr. 11. J. ENGELKENS.",http://resolver.kb.nl/resolve?urn=ddd:010776545:mpeg21:a0003:ocr,3,ddd:010776545:mpeg21:p003,Provinciale Drentsche en Asser courant,967
3064632,1866/11/15 00:00:00,1788,ddd:010079957:mpeg21:a0017,http://imageviewer.kb.nl/ImagingService/imagingService?id=ddd:010079957:mpeg21:p004:image&x=142&y=2343&w=1714&h=1788,ddd:010079957:mpeg21,1856,4131,142,2343,4,"BERGISCH-lIAERHISCHE EISEMH. In der Eichtung von Gladbach und Yiersen nach Yenlo. e ï. ui. i r^pin: £ \ ! - Stationen. Vormittags. Nachmittags. Mctn. TTT*^"" u- I M- _L^_M- v- I M©ladbach Afb. — — 1 18 — — — — i;o Viersen Ank. — — 1 33 — — — — Abf. 8 45 1 38 4 45 9 55 166 Duiken 8 59 1 51 4 59 10 7 230 Boislieim. 9 11 2 3 5 11 10 17 2„3 Brcyell. 9 20 2 12 5 20 10 25 334 Kalclenkirchen. 9 33 2 25 5 33 10 37 300 VenlO Ank. 91 40 2 32 5 40 j_lo__4s_ In der Eichtung von Yenlo nach Yiersen und G-ladftaoh. i ii. i iv. I vi^nT^l""7"" o Stationen. Vormittags. Nachmittags. Melen. TJ. j M. TJ. | M. IJ. | MJ_ÏÏ. | M. VeillO Abf. 6 50 9 55 2 40 7 5 056 Kaldenkireken 7 10 10 15 3 — 7 25 1„ Brcyell 7 22 10 27 3 12 7 36 160 Boisheim 7 31 10 36 3 25 7 44 2M Duiken 7 45 10 48 3 39 7 55 290 Viersen Ank. 7 55 10 58 3 50 8 5 Abf. — — 11 — — — — — 390 CylaflfoaCllAnk 11 |15 — — •— — Elberfeld 5 Nov. 1866. Die Königliche Direction.",http://resolver.kb.nl/resolve?urn=ddd:010079957:mpeg21:a0017:ocr,4,ddd:010079957:mpeg21:p004,De Noord-Brabanter : staat- en letterkundig dagblad,1714
1923852,1871/06/24 00:00:00,2476,ddd:010333253:mpeg21:a0004,http://imageviewer.kb.nl/ImagingService/imagingService?id=ddd:010333253:mpeg21:p002:image&x=1617&y=136&w=777&h=2476,ddd:010333253:mpeg21,2394,2612,1617,136,4,"Lyst van de ter Postery alhier liggende brieven drukwerken mousters en stalen aangebragt gedurende de laatste acht dagen. Brieven : Alberto Antommarchi 2 Fransisco A Antomraarchi Baetz Luksiba Borgia J. & 1. R Blanch Ueinrich Bruhn Juan J. Boggio & Co. S E. Curie! Felipe Calero Maria Bonificia Clement J. & M. Capriles David Mos. de Castro Saml. Da Costa Gomez Jr Pedro Ferreiro J. & F. Faneyte Jn Cme Fnncois Abigael S. L. Heuriqtiez A D Henriquez 2 Dewed. H. C Henriquez José Jesus Henriquez Daniël C. Henriquez & Son C E. lloeksma Eduard F. Harrison G. Joost L. V. Leyba. José Ignacio Pulido Domingo Peüs Guillermo Rnjer J>*é Aniceto Serrano Franc. Sorarra'S y Wilsou G. 11. Satnson D. Martin Vesra. Drukwerken enz.: J & J R. Blanch 3 Brandao Herms. G- Cook & Co. Mosé Curiel & Co. 2. E M. Curiel F. Calero hij o I). A. de Lima Albert L. Foulkers J. Faneyte. José Gomes Casseres 3 José H. Gonsalez Mordehay Henriquez Jolw W. Hassell 2. T. E. Harrison 7. J. C. Henriquez M. Lindo & Co Benjamin Penso Joscph Punso Alfred Rothe J.isé A. Serrauo2 Curacao den 23 Juny IS7I. Do Coinmis belast met de Post-directie J. F. K. VAN EPS. Collegium NeGrlanilicüm. A AN de Ouders en Voogden der leerlingen -™- wordt by dezen bericht dat de lessen aan deze Inrichting op ultimo dezer zullen gestaakt worden. DE DIRECTIE. 23 Juni 1871. Publieke Verkooping TE7""AN eene party Yzer-en Koperwaren op * Donderdag den 29 dezer des middags om twaalf uur voor het gebouw der Hy» pothcekbauk. Curacao den 21 Juny 1871. Publieke Verkoop.ng rf~ftP Woensdag den 19 Julv e. k voor het gebouw van de Hypotheekbank van : DE HUIZEN No. 86 en 89. gelegen aan ilc QvairzvHe dezer haven 2'lo Wyk on HET IÏUIS No. 179 gelegen in do Willemstad toebehoorende aan den Heer C. P. DE WINDT. Curacao den 23 Junv 1871. GENEUEÜX J. R. DÉ LIMA.",http://resolver.kb.nl/resolve?urn=ddd:010333253:mpeg21:a0004:ocr,2,ddd:010333253:mpeg21:p002,De Curaçaosche courant,777
1527195,1871/08/16 00:00:00,1695,ddd:011101585:mpeg21:a0009,http://imageviewer.kb.nl/ImagingService/imagingService?id=ddd:011101585:mpeg21:p002:image&x=52&y=51&w=901&h=1695,ddd:011101585:mpeg21,953,1746,52,51,4,"Verkoophuis Tanah-Kongsie. Firma CHATELIN. Verkrijgbaar en gros en en détail: EAU-DE-COLOGNE. (1075) ""Verkoophuis op Tanah-Kongsie. Firma CHATELIN'. H-ijnwijnen als: Llebfraumilch 4/1 11.; Stemberger Cabinet 122 11.; Deidesheimer 1/1 fl.; Nierstciner 1/1 fl. Vermouth op 1/1 cn 1/2 flesschen. . Löwenbier id. id. Hulsman Bitter*. Diversen als: Jams; Mixed Pickles; Haring; Pepermunt; Chinine; Eau des Carmes; Vinaigre de Toilet; div. Bouloirs; Corsetten; Operakijkers enz. enz. (85) Verkoophuis Tanah-Kongsie (firma CHATELIN.) Steeds voorzien vans Frovisiën Vleezen en Groenten in blikken en stopflesschen gedroogde Vruchten versche en geconfijte Vruchten op water en op brandewijn Suikerwerk in flesschen Pruimedanten Krenten Tafel- en Sultanerozijnen Amandelen ehz. enz. (150)",http://resolver.kb.nl/resolve?urn=ddd:011101585:mpeg21:a0009:ocr,2,ddd:011101585:mpeg21:p002,Sumatra-courant : nieuws- en advertentieblad,901
1342952,1871/07/08 00:00:00,1396,MMVEEN01:000078073:mpeg21:a0002,http://imageviewer.kb.nl/ImagingService/imagingService?id=MMVEEN01:000078073:mpeg21:p001:image&x=43&y=1573&w=962&h=1396,MMVEEN01:000078073:mpeg21,1005,2969,43,1573,4,Advertentie P II IIL1C A TIE % Reclames. Schutterij. BURGEMEESTER en WETHOUDERS der gemeente Wildervank  brengen ter kennis van de belanghebbenden  dat de commissie van onderzoek bedoeld bij art. 15 der wet op de schutterij zitting zal houden in het locaal der gemeente op donderdag- den £3 Julij aanstaand» des uademitldags te ie» uur tot het onderzoeken van- en beslissen omtrent de redenen van vrijstelling en uitsluiting wegens de dienst der schutterij. Wordende mitsdien al degenen die vermoeden redenen van vrijstelling te hebben ook die welke na de inlijving bij de schutterij mogten zijn ontstaan bij deze opgeroepen om op den^bovenbepaalden tijd en plaats voor de commissie te verschijnen  terwijl diegenen welke voor de commissie niet verschijnen  beschouwd zullen worden geene redenen tot vrijstelling te hebben en voor zooverre zij dienstpligtige nommers hebben bekomen of ambtshalve aan het hoofd der lotingslijst zijn geplaatst  voor de dienst der schutterij zullen worden aangewezen. W ildervank den 6 Julij 1871. Burqemeesler en Wethouders voornoemd: H. J. ENGELKENS. De Secretaris : H. A. YEENHOYEN.,http://resolver.kb.nl/resolve?urn=MMVEEN01:000078073:mpeg21:a0002:ocr,1,MMVEEN01:000078073:mpeg21:p001,Nieuwe Veendammer courant,962
4659732,1871/03/14 00:00:00,5412,ddd:010586089:mpeg21:a0008,http://imageviewer.kb.nl/ImagingService/imagingService?id=ddd:010586089:mpeg21:p004:image&x=2777&y=126&w=861&h=5412,ddd:010586089:mpeg21,3638,5538,2777,126,6,"Houthandel VAN T. ïï. Overuur k Zooi De Ondergi teekenden bobben de eer aan hum geachte Be • te berigten . dal hun lIOUTSTEK. Itij de Prins flrmlrilibriig te LrcuwarriVn Maandag 20 dezer zal worden geopend Onder dankbetuiging voor bel 1..1 hiertoe neten vertrouwen bfflven (ij rich v tduremï i.n v riendi lijk ie aanbevelen Schenkel !|ii Reeuw arden  8 ) .1. 'l' VV OVERMEER & ZOON. B.j HUGO SURINGAR Boekverkoop* Z*2 Relden te Leeuwarden en verder hij „n Boekv rkoopen in Prieeland i- ie bekomen 6 DE ACHTSTE DRUK VAN DE KLOPPARTIJ op de school van Mamsel Europa of hoe de Duitsche jongen don Fran schen jongen afranselde en do En "" gelsche jongen bleef toekijken P r ij s 10 Cents. eaÊttmnwsmÊtmmunmmtmsÊmÊmmmWÊÊÊmistmsitmmnnnummmm^m Bij H. A. M. ROBLANTB te Schiedamverschijnl - de Derde vermeerderde Uitgaaf (Mei de wijzigingen tol hei einde van u;i( V v\ AL DE REGLEMENTEN NEDSRLANDSCHE HERVORMDE KIIIK. Mei eed uitvoert"" Mf biblist! legfcter H. M. C. van Oosterzee. KI. 80. M 8 li '00 —j^Ba^ l' •■■""'i'-u Tweeden Druk i »ehej ■*p>^ oen . kn -u verbetering*  <tmsla-  door hun Bo kvt .ragen. ZAItWOORnKMtOEkÊrC die fIGSTB ui"" -t PRAC'J i ORRECTB en tevens GOEDKOOPST] worden «in: KRAMERS Nouveau Dictionnaire de Poche Francais- Neérlandaii 't Reérlan rancaie Spelling van de Vries en te Winkel sde belangrijk vermeerderde en verbeterde dr; deel en in een geprest linnen band f 1.70. JAEGER Nouveau Dictionnaire de Poche Francais'-Hol la n dais el Hol-landaïs - Fr an oai b. Sde veel verbeterde en vermei .derde druk. Tw é deel e g in ééti geprent linnen baad f 1.70. JAEGER Neues Taschen Wörterbuch I) .■ u t . i land isoh und Bollandiaèh• Deutseh. 2de veel verbeterde en vermeerderde druk. Tvv. il.-elett ineen -t linnen band f 1.70. JAEGER A. Now Pocket Dictionary of the Engliah-Dutch and Üutch- Kn;_'lis h I a n u u en vermeerderde druk. Twéé deelen ia """" ' linnen liand f 1.30. ÖOOB ala 10 et. ó 12 l/s et. per vreek I De Noord- en Zuid- Hollandsche Courant VI NT THAI DAGELIJKS behalve op . Abonj romen 'iv puit .lam. Bureau: N. Z. Voorburgwal H 261 te AmstordP __ 11. d DE ZELFBEWARING. ■ ' ddelen worden in ie-' - ein-iin - I bijden beeld i ' ' ■ I :0 ~l).g",http://resolver.kb.nl/resolve?urn=ddd:010586089:mpeg21:a0008:ocr,4,ddd:010586089:mpeg21:p004,Leeuwarder courant,861
2489728,1871/10/19 00:00:00,1468,MMKB04:000164836:mpeg21:a0017,http://imageviewer.kb.nl/ImagingService/imagingService?id=MMKB04:000164836:mpeg21:p004:image&x=2510&y=3958&w=1696&h=1468,MMKB04:000164836:mpeg21,4206,5426,2510,3958,4,LEVENS DER PAUSEN Uitgave van Wed. J. R VAN ROSSUM te Utrecht. li«JTESTS) UliR FAl'813W door J. CHANT&EL vr|j vertaald en bewerkt door J. :É3C_ •WENSI3STG Oud-Professor. Heden is verschenen: HET LEVEN van zijnde liet 20 e deel van liet g-eiieele werk. LIJSr DER WEBKEN. 13e deel. De Pausen der XlIIe eeuw. 1 e deel. De H. Petrus en de tijden der Apostelen. 2e ï De Pausen der Katakomben. De H. Silvester en het Arianisme. De H. Leo de Groote en de onbeschaafde volkeren. De h. Gregorius de Groote en zijn tijd. De Pausen en het Monotholismus. De II. Leo Ui en de pauselijke souvereiniteit. De II Nicolaas de Groote en zijne eeuw. Silvester II en de ijzeren eeuw. De II. Gregorius VII en de onafhankelijkheid der Kerk. De Pausen en de kruistogten. Innocentius III en zijn tijd. 3e 5e 6e 8e 9e 10e 11e 12e 14e » Bonifacius VIII en zijn tijd. 15e » De Pausen van Avignon en de groote kerkscheuring. 16e » De groote kerkscheuring van het Westen en de Pausen der XVe eeuw. 17e » Paus Alexander VI. 18e » De Pausen en het Protestantismus. 19e » Het levert van Adriaan VI. 20e » Het leven van Clemens VII. 21e » De Pausen en het Philosophisme. 22e » Pius VI en da revolutie. 23« » Plus Vil en Napoleon I. 24e » De pauselijke regeering van Pins IX. (2»39) De prijs van ieder deel is 60 Cents  afzonderlijke deelen worden niet verkocht.,http://resolver.kb.nl/resolve?urn=MMKB04:000164836:mpeg21:a0017:ocr,4,MMKB04:000164836:mpeg21:p004,De Maasbode,1696
980710,1871/11/02 00:00:00,1010,ddd:010099772:mpeg21:a0018,http://imageviewer.kb.nl/ImagingService/imagingService?id=ddd:010099772:mpeg21:p004:image&x=3009&y=63&w=971&h=1010,ddd:010099772:mpeg21,3980,1073,3009,63,4,"TE HUUR GEVRAAGD met primo Mei 1372. Eea HUIS of BOTEKHU3B vo-ar een groot Gezin niet te ver uit het milieu der Stad gelegen tegen eea Huur van ƒ 550 a ƒ 700. Aaabiajiagtin franco onder Lett. B. E. N. Bureau Handelsblad. (33102) ~ TE HUUR GEVRAMD. ïfgen I°. Mei 1872 of eerder: een BUIS of BOVENHUIS van ƒ2OO a ƒ250 'sjaars  voor een Gasin van Zeas Personen. Fraaco brievon onder N°. 200 Bureau Handelsblad. (33030) De ONDERGETEEKENDE zijne AFFAIRE ~ BOTER en KAAS beneveas VLEE3CHRÖOKERIJ OVE""»--n■■ fAS HEBBENÖE aan H. MAATMAN beiankt zigne üeeerde Begunstigers voor het hem steeds ge;chouken vertrouwen  en beveelt zijnen Opvolger minzaam aaa. W. V. SPAUEiMBEiaG. Mij recreërende am bovenstaande Aïmonce beveel ik de door Mij OVEB«ENO""HEÜV AEUAIIBE ia BOTEB en KAAS beaeveas VLEESCHKOOKEBIJ beleefdelijk aaa zullende ik_trachten Mö dat vertrouwen waardig te maken hetwelk mgn Voorganger ïoo ruimschoots heeft mogen onder~^~ _ H. IMAATMAIV. Ajisieebak 1 November 1871. (33015)",http://resolver.kb.nl/resolve?urn=ddd:010099772:mpeg21:a0018:ocr,4,ddd:010099772:mpeg21:p004,Algemeen Handelsblad,971
616946,1871/10/02 00:00:00,638,MMHCO01:000065369:mpeg21:a0019,http://imageviewer.kb.nl/ImagingService/imagingService?id=MMHCO01:000065369:mpeg21:p004:image&x=2446&y=3005&w=967&h=638,MMHCO01:000065369:mpeg21,3413,3643,2446,3005,4,Advertentie Die soms nog iets mogt versclml«liffd zijn aan- of te vorderen hebben van mejufvrouw G. J. W. LYCLAMA a NIJEHOLT den 8 dezer alhier overleden worden verzocht binnen veertien dagen na datum dezes zich aan te melden bij J. REVIUS executeur-testamentair buiten de Kamperpoort. Zwolle  30 September 1871. AGENTUUR. Een NEDERLANDSCHE VERZEKERINGSBANK (levensverzekering) vraagt AGENTEN die tevens als boden werkzaam kunnen zijn. Brieven franco onder letter B. aan den boekverkooper der MOUW.,http://resolver.kb.nl/resolve?urn=MMHCO01:000065369:mpeg21:a0019:ocr,4,MMHCO01:000065369:mpeg21:p004,Provinciale Overijsselsche en Zwolsche courant,967
2364262,1871/11/27 00:00:00,2369,ddd:010486015:mpeg21:a0006,http://imageviewer.kb.nl/ImagingService/imagingService?id=ddd:010486015:mpeg21:p001:image&x=2096&y=1241&w=998&h=2369,ddd:010486015:mpeg21,3094,3610,2096,1241,4,Vendutie op Woensdag 29 November 1871 op _Er*__sser Baroe PMDGOÏDE_tE\ afkomstig uit het PANDJESHUIS te Passer Baroe. (6680) LAUW TJBNGHOEIJ. Houtaankap-Blitar. Hout- Vendutie op Donderdag den 30 November 1871 van DJATTIEHOÜTEN BALKEN in alle dimensiën  pas aangebragt per het Ned. Ind. schip Bacht Masiora op liet plein tegenover Kampong Moeka door (6880) VAN VLEUTEN & COX. Groote Vendutie op Vrijdag den 1 December 1871 in het Vencl utielokaal van W. LOONEN & Co. voor rekening van de Heeren van Beek Reineke & Co. van diverse Koopmanschappen en eene groote hoeveelheid zeer mooi en degelijk Kinderspeelgoed in kleine koopjes gearrangeerd. Helm- en Stroohoeden Heeren Hemden en geaiaakte Kle er en eenig keurig PORCELEIN WERK enz.  enz. (6909),http://resolver.kb.nl/resolve?urn=ddd:010486015:mpeg21:a0006:ocr,1,ddd:010486015:mpeg21:p001,"Java-bode : nieuws, handels- en advertentieblad voor Nederlandsch-Indie",998
1841787,1871/07/10 00:00:00,1811,ddd:110533332:mpeg21:a0001,http://imageviewer.kb.nl/ImagingService/imagingService?id=ddd:110533332:mpeg21:p001:image&x=53&y=1036&w=1017&h=1811,ddd:110533332:mpeg21,1070,2847,53,1036,6,"Bij dit Blad behoort 1 Bijvoegsel. BATAVIAASCH HANDELSBLAD. ABONNEMENTEN en AÜVERTENTIEN WORDEN AANGENOMEN: Te Buitenzorg. J. W. BEIJNON. Samarang . VAN DORP en DE GROOT KOLFF & Co. v Soerabaija. THIEME & Co. G EBR. GIMBERG & Co. en Chs. KOCKEN. „ Tagal . . . VAN MUMMELEN & Co. „ „ . . .Weduwe DORT St ZONEN. Soerakarta. P. ZWAGER „ Padang . . L. N. H. A. CHATELIN. ""cXS PRIJZEN bij VOORUITBETALING. Brieven FRANCO. Intechcnlng. Per halfjaar voor geheel Nederlandsch-Indië . ƒ 15.— u jaar voor Nederland #55.— „ jaar voor de Mail-Editie franco in Nederland. „ 30.— Ad verten tien. Van 1 tot 5 woorden ƒ —40. Voor elke 5 woorden meer .... . . „ —40. Voor elke volgende plaatsing de helft. (Minder dan 5 woorden rekent voor 5). ZEGELGELDEN: Van 1—45 woorden. —30. „ 46—95 „ „ —.60. Boven da 95 „ . . » 120. Van dezelfde advertentie is slechts tent zegelgeld verschuldigd onverschillig hoe dikwerf zij geplaatst wordt. Geene advertentie wordt beneden / 1 geplaatst. De plaatsing geschiedt d kontant. Bij toezending van advertentien wordt beleefdelijk remise verzocht. OGILVIE & Co.",http://resolver.kb.nl/resolve?urn=ddd:110533332:mpeg21:a0001:ocr,1,ddd:110533332:mpeg21:p001,Bataviaasch handelsblad,1017
6847300,1871/07/16 00:00:00,4281,MMKB04:000164765:mpeg21:a0018,http://imageviewer.kb.nl/ImagingService/imagingService?id=MMKB04:000164765:mpeg21:p004:image&x=1746&y=1111&w=1622&h=4281,MMKB04:000164765:mpeg21,3368,5392,1746,1111,4,"Advertentie DE DE CATHOLIJKE VEREENIGING GRONDWET TE ROTTERDAM. De C atholijke V ereeniging DE GRONDWET heeft in hare Algemeene Vergadering gehouden den 12 Julij besloten zich van het stellen van Candidaten voor den Gemeenteraad te onthouden ten einde met het oog op de wijze waarop in andere Kiesvereenigingen de Candidaten gesteld zijn de politieke en godsdienstige hartstochten niet verder op te wekken; alleen wenscht zij als een protest tegen de wijze waarop men het aftredend Lid den Heer M"". J. 6.9E BRUYN bejegend heeft hem bijzonder aan te bevelen. (2407) jacq 8 . h. c. van der kun President. c. langelaan Secretaris. TURKIJE. HONGARIJE. OOSTENRIJK. 1 AÜGUSIliS THEKKM. Hoofdprijs f 600.000 60.000 20.000 6 000 3.000 1.000 400 . f3. - 1.75 . - 0.90 1 Prijs 2 » » 6 ï » 12 » » 28 » . ï 300 t> » Geheele certificaten Halve » Kwart » 15 AUGUSTUS TREKKING. Hoofdprijs f 250 000 1 Prijs » 25.000 1 » » 5.000 4 » » 1.000 13 » » 500 580 » j> 100 Geheele certificaten .. f 3.50 Halve » .. - 1.75 Kwart » .. - 0.90 1 september trekking. Hoofdprijs ƒ 200 000 1 Prijs 1 » » 1B » 1 » ï 2 » » 3 j> » 6 » » 15 » » 30 » » 74 » » Geheele certificaten Hajve » Kwart » 200000 50.000 15.000 10.000 5 000 2.000 1.000 500 400 170 ..ƒ4— - 2.— - 1.— Het publiek kan in Hollandsch lezen wat men koopt de origineele zijn hier te lande bij een der eerste bankiershuizen gedeponeerd en met mijn cachet verzegelt zoodat men niet bevreesd behoeft te zijn voor uitgeloote nummers te koopen. Ook neem ik geen tien procent zooals andere buitenlandsche huizen die dagelijksch anonceren en zijn mjfne certificaten goedkooper. Bij bestelling van 13 kwarten kan men 12 verschillende seriën krijgen en ontvangt men gratis een lot uit de Haarlemsche Paardenloterlj. Bij bestelling van ÏO gebeele loten ontvangt men gratis een Weerbaarheidslot  trekking 31 Julij. Boekverkoopers Postdirecteuren Makelaars en Commissionnairs in effecten ontvangen tien procent rabat en kunnen bij bewijzen van soliditeit loten in Commissie krijgen. U trecht  Choorstraat en Moreelsche laan. D. (2412) A. DU MOSGH Effecten en Loterijhandel. SPECIALITEIT VAN LOTEN. lEllEH BEPIIOEVE HET FORTtJI .1L Turkscho aandeden trekliing 1 Augustus. Hoofdprijs fr. 600.000. Yoor deze trekking geef ik geheele loten & f 3 halve a f 1.75 en kwart a f 0.90. HONGAARSCHE loten trekking 15 Augustus. Hoofdprijs Oost. fl. 250.000. Voor deze trekking geheele loten f 3.50 halve f 1.75 kwart f 0.90. OOSTENRIJRSCHE loten 1864 trekking 1 September. Hoofdprijs Oost. fl. 200.000. Voor deze trekking geheele loten f 4 halve f 2 kwart f 1. Bij bestelling van tien kwarten in eens ontvangt men een lot der HaarlemSCtlO of Tielsche paardenloterij gratis. Bij bestelling van 10 gebfiele ontvangt men gratis een ""WeerbaarlieidslOt trekking 31 Julij waarop f 75-000 kan getrokken worden of een Leeuwarder lot. U trecht  Moreelsche Laan en Choorstraat. O. DU MOSCH. NB. Het publiek wordt attent gemaakt dat zoowel van Hongaarsche Oostenrijksche als Turksche Loten de origineele hier te lande gedeponeerd zijn. (2334) PIUS IX. Katholiek Zondagsblad. INHOUD van N # . 51. ROME. — Toespraken en Feestrede gehouden te Rotterdam in de O. L. Vrouwe-Kerk bij gelegenheid der Pius-Feesten door C. J. Willems S. J. ( Wordt vervolgd.) Elke week verschijnt een No. van 16 pag. — Abonnementsprijs per half jaar f 125 franco per post f 150* — Afzonderlijke nummers 8 ContS. — Men abonneert zich bij alle Boekhandelaren en Postdirecteuren  en bij den Uitgever G. W. VAN BELLE te Rotterdam.",http://resolver.kb.nl/resolve?urn=MMKB04:000164765:mpeg21:a0018:ocr,4,MMKB04:000164765:mpeg21:p004,De Maasbode,1622
2734769,1871/11/25 00:00:00,4453,ddd:010333274:mpeg21:a0008,http://imageviewer.kb.nl/ImagingService/imagingService?id=ddd:010333274:mpeg21:p003:image&x=776&y=124&w=1542&h=4453,ddd:010333274:mpeg21,2318,4577,776,124,4,"vuiifimsi?. rjE oiidergeteekende maakt by deze het publiek bekend dat hy verhuisd is boven het pakhuis vau den lieer C. Sphock Cz. Ca)[Hcao den 22 November 1871. N. VAN MEETEREN Junior Horologiemaker. """"verhuisd"" ELI AS P. MORENO naar I'ietonnaai iiu.'s No. 104. Curacao 19 November 1871. Eenige kennisgeving. E>1T myn vertrek naar het moederland roep *^*ik myne vrienden en colega's een hartelyk vaarwel toe. Curacao den 24 November 1871. L. O WILLEMSE. Sergeant titulair der iufauterie. PIONEER HILL. "" T\E prys van MAISMEEL zal gedurende ■-'de volgende week zyn : WITTE aƒ 2. 50 en ZEMELEN a 30 et. per schepel. Curacao den 24 November 1871. ROODM AMiGLSPARItLW te bekomen by A. W. NEUMAN Fz. op Pietermaai. A PETICION DEL PUBLICO. ÜLTIMA FüNCION DE BESPEDIDA DEL PREST! DUIT A DOK 1.1. &t f wsM DE VARSOVIA para el Sdbado 25 de Noviembre de 1871. GRAIV TOMBOLA (SoRTEo HECHO POR DOS NINOS.) Nota.—Se suplica a las persouas tenedoras de billetes para la Gran Tombola qle so sirvau guardarlos hasU que ella se verifique. iMPORTANTisiMo.—Todo asistente recibira del botelero junto con la papeleta de entrada el billete con que se tendraopcion alospremios '»En caso de Uuvia la fuucion se diferira para el Martes. Hora i precios los de costumbre. Dienstbeurten by de Spaarbank. Zatardag den 25 November 1871. Bestuurder de Heer Salomon Senior. Commissarissen de Heeren C. Sprock Cz. en Pelix Vidal. o ""DE VKIIGENOEGING"" MaandblVKSchb Vergadering op Zaterdag den 25 November 1871. GODSDIENSTOEFENING by de Ver- Protestantscbe gemeente op Zondag deu 26 dezer des morgens ten 9 ure. j&i iffcVERLEDEN op den 23 dezer Jf^V ïti den ouderdom van ruim 23 jaren myn geliefde zoon WILLE?! DAVID. Curacao den 21 November IS7I. DAVIL) MEIJER. Kennisgeving aan familie eu vrienden.",http://resolver.kb.nl/resolve?urn=ddd:010333274:mpeg21:a0008:ocr,3,ddd:010333274:mpeg21:p003,De Curaçaosche courant,1542
3248964,1871/09/22 00:00:00,3718,MMKB08:000088936:mpeg21:a0014,http://imageviewer.kb.nl/ImagingService/imagingService?id=MMKB08:000088936:mpeg21:p004:image&x=907&y=1849&w=883&h=3718,MMKB08:000088936:mpeg21,1790,5567,907,1849,4,Advertentie Kantoor van Vaste Goederen Eloeh Vossenstraat en Rynkade H ISO ARNHEM. Dagelijks kunnen inlichtingen bekomen worden van TE KOOP of TE HUUR zijnde Buitenverblijven Villa's Heeren- en Winkelhuizen (om te aanvaarden den 1 sten November en later.) Ook van diverse BOUWTERREINEN in perceelen van verschillende grootte gelegen nabij het Stationsgebouw aan het Eusebius-Plein aan de Parkstraat Velper- Utrechtsche- enAmsterdamsche Straatwegen waaronder ook uitmuntend geschikt tot den aanleg van Buitenverblijven of Villa's. Voor belanghebbenden liggen mede ter inzage teekeningen en plattegrondverdeelingen van reeds voltooide van in aanbouw zijnde en van nog te bouwen Perceelen. Lastgevingen in publieke veilingen worden in vertrouwen en op solide wijze behandeld. VAN SOMEREN BRAND  Makelaar. Tegen HOOS LOOM WORDT GEVRAAGD een DAGMEISJE buiten den kost. Adres Lett. BB Bureau Arnli. Courant. Tegen 1 Nov. WORDT GEVRAAGD: eene KINDERMEID P G voorzien van goede getuigschriften. Loon naar bekwaamheid. Adres in persoon Wijk I N°. 401 of wel met franko brieven. RESPIRATORS. J. O. TH. MARIUS. Boekhorstenstraat. 6cf)ouu)lmrg te 2lrnf)em. Door het Tooneelgezelschap van BOAS en JUDELS onder Directie van VICTOR DR1ESSENS ZATURDAG  23 SEPTEMBER 1871 7 ure GEORGES en MAüRICE of de eer der Familie. Drama in 5 Bedrijven. Budget van Uitgaven of VROUWEN TOILETTEN. Blijspel in 1 Bedrijf. ZONDAG  24 SEPTEMBER 1871 7 ure  VOLKSVOORSTELLING. il'ÏI)\MMÏI TOB MIPffiiM of een pleizierreisje naar Spa. Tooneelspel in 4 Bedrijven. €oUeöie JHusis 6acrum. ZONDAG 24 September ten TWEE ure (hQste en Laatste Nommer van het 3de Collegiejaar) MATINEE MUSfCALE. door DE KAPEL DER INFANTERIE onder Directie van den Heer KNOLL. 'Entree voor Niet-Leden ƒ 0.29. ZONDAG 1 October CONCERT van do SAKSISCHE GARDE onder Directie van den Heer FRIEDRICH WAGNER. Den Leden beleefdelijk aangeboden dooide Ondernemers STERK & KAMPS.,http://resolver.kb.nl/resolve?urn=MMKB08:000088936:mpeg21:a0014:ocr,4,MMKB08:000088936:mpeg21:p004,Arnhemsche courant,883
2663040,1871/12/29 00:00:00,3040,ddd:010586213:mpeg21:a0038,http://imageviewer.kb.nl/ImagingService/imagingService?id=ddd:010586213:mpeg21:p007:image&x=1843&y=2550&w=876&h=3040,ddd:010586213:mpeg21,2719,5590,1843,2550,10,"DEZELFDE NOTARIS zal op Saturdag d. n 13 Januari 1872 's namiddags 4 uur in de herberg van .1. O. Boskma te Zwaagwesteinde  provisioneel verkoopen : 1. Een peroeel BOUWLAND bij het Kanaal t.- Zwaagwesteinde de 3 genaamd  gr...i 1-00-50. 2. Een perceel DITO ten zuiden van het vorige het Halfpondm. genaamd groot 17 are. 8. 0-84-40 HOOILAND aan de Groote Kolk onder Wouterswoude. t. 1-17-10 DITO. voorzien van Klijn benoorden de Valomstervaart aldaar. Alles eigen aan de Wed. en Erven Frans Minnes Venema en dadelijk na de linale toewijzing te aanvaarden. Bakkerij Franeker. De Notaria A. A. LAND te Franeker zal op Maandag den 15 Januari 1872 des avonds om 7 uur ten huize van deu Logementhouder Kuur-tra in het I'ostbuis te Franeker linaal ter verkoop \ ei len ■ BAKKERIJ mei WONING . inde Kerkstraat te Franeker sectie A no. 548  groot 90 centiare ; waarop geboden ƒ361. In huur bij F. Pietersma. Aanvaarding 12 Mei 1872. Verkooping te Franeker. DEZELFDE NOTARIS /.al op tijd en plaats linaal krachtens art. 1223 B. W.  ter verkoop veilen : Eene WINKELHUIZINGE ca Erve staande en gelegen aan het Noord te Franeker kadastraal bek.n.l .sectie A nos. 1084 groot 9] centiare en 1086 groot 30 centiare in huur bij de Wed. de Vries en andere!.. I veilen in 2 perceelen met regt van combinatie. Waarop geboden: peroeel l f9ta perceel -' /"" .;75.25. Aanvaarding 12 Mei 1872. STELPHUIZINGE. FRANEKER. Na bekomen regterlijke autorisatie zal eerstdaags publiek woe dd ; Eene STELPHUIZINGE en Srlll IK met STALLINO e. a.  .slaande in hel Kaal-v.dd te Franeker met hel regt van Op.lal op den Grond waarop de llni/inge c. a. is gebouwd .end gemeente Franeker. sectie C no. «58  groot •"". are lil) centiare  bewoond bij Li.-uwe Bonnema. Aanvaarding i_ Mei 1872. A. A. LAND Notaris. Herberg te Hitzum. De Netari \ \ LAND te Franeker aal op Dingsdag _ Januari LB7S  des oamiddai uur. bij dc Kastelein.\s de Wed. ..luienaai"" in lei Kaal veld Ie Iraneker prov isionee] ler verkoop veilen : Eene iv den laatsten tijd veel verbeterde HUIZINGE en Erve c. ii aan lui Waler en den Orindvve"" te Uil/. kad. bekend gemeente Tzum sectie t' no groot :; are :;n centiare waarin ihans herberg enz. doei. /eer geschikt voor Wagenmakerij. In <■; uik bij \. IL Bon Aanv",http://resolver.kb.nl/resolve?urn=ddd:010586213:mpeg21:a0038:ocr,7,ddd:010586213:mpeg21:p007,Leeuwarder courant,876
2252383,1871/06/19 00:00:00,2107,ddd:010983931:mpeg21:a0017,http://imageviewer.kb.nl/ImagingService/imagingService?id=ddd:010983931:mpeg21:p004:image&x=43&y=3823&w=1069&h=2107,ddd:010983931:mpeg21,1112,5930,43,3823,4,Petroleumlampen ia grooten voorraad. (1926) SOESMAN & Co. PUIK K VATWII N van Weduwe Reijers en Zonen Peytieu en DC  op fust en door ons afgetapt verkiijgbaar. (i 924) SOESMAN & Co. TOKO HUIJGENS. OP NIEUW ONTVANGEN: divers Speelgoed met en zonder Uurwerk en Muzyk. (17%) TOKO PLUNAKR Ontvangen: Eelite Linnen geborduurde zakdoeken lijn wit organdie 10/4 breed wit Zijden bnrège wit Satijn en moiré eff. nen moiré Ci-intunrlinten. (1804) De echte Schakellijm VEBKOOPEN: de Groot Kolff & Co. Zoowel per flaeon als per kisje van 12 flteebjes. In 't laatste geval met prijsvermindering. Voor 't lijmen van earton licnt en/. is deze lijm by zonder aan te bevelen. (1655) Allsops al e hier getapt. (1925) SOESMAN & Co. Steeds in voorraad: hoogst doelmatige Singapore Kurkenhoeden. (1916) REISIGER & Co.,http://resolver.kb.nl/resolve?urn=ddd:010983931:mpeg21:a0017:ocr,4,ddd:010983931:mpeg21:p004,De locomotief : Samarangsch handels- en advertentie-blad,1069
3378990,1871/09/11 00:00:00,1630,ddd:010983996:mpeg21:a0036,http://imageviewer.kb.nl/ImagingService/imagingService?id=ddd:010983996:mpeg21:p004:image&x=2098&y=43&w=2073&h=1630,ddd:010983996:mpeg21,4171,1673,2098,43,6,Nog eenige gr oo te achtkantige Amerikaansche klokken acht dagen en goed loopende MET UITMUNTEND SLAGWERK van een uitstekend fabricaat \i f 35.— (2724) Verkrijgbaar bij De Groot KoltT & Co. Goedloopende achtkantige Amerikaansche KLOKKEN met slagwerk; guarantie een jaar. Prijs / 20.— en hoog e r. (2877) J KLATT Jr. Parfumerie francaise et auglaise. CAI OU Grand clioix de Brosaes anglaiaes pour Kxtrait d'odeur suprafin et WH!■ U li les cueveux. Grand assortiment. pOUl' la Coupe des CheveilX. Chapeaux pour Lommes et enfanis. Ganterie et articles de fanlaisie. Kcrkstl'fliftt Spécialile' de la maisun Qotnell. Ponpée habillée riche et d'autres joncti MAUZAT Huile extrafine. vnriés. Coiffeur et (2915) Nettoyago de tête a I'eau athénienne Pommadepiur iVutrcticn de la cLevilure.,http://resolver.kb.nl/resolve?urn=ddd:010983996:mpeg21:a0036:ocr,4,ddd:010983996:mpeg21:p004,De locomotief : Samarangsch handels- en advertentie-blad,2073
4572354,1871/06/17 00:00:00,2346,ddd:010099558:mpeg21:a0017,http://imageviewer.kb.nl/ImagingService/imagingService?id=ddd:010099558:mpeg21:p004:image&x=2039&y=98&w=1949&h=2346,ddd:010099558:mpeg21,3988,2444,2039,98,4,"PAUSELIJKE LEENINGEN VAN 11860-1864 TEN LASTE VAN HET KONINGRIJK ITALIË. De ondergeteekende daartoe gemachtigd door de Heeren GEBRs. VAN ROTHSCHILD te PARIJS heeft de eer te berichten dat hem door deze Heeren is opgedragen de betaling der op I°. APRIL 1871 verschenen Coupons der Pauselijke Leeniiieen van 1860-1864 die thans ten laste van het Koningrijk Italië- zijn. DE DESBETREFFENDE BORDEREALK zg'n ten Kantore van den ondergeteekende verkrijgbaar. __^ 15 juni iB7i. D Z. GOLDSCHMIDT aan den Handel en van af Maandag1 19 Juni ook aan PARTICULIEREN WEGENS ONTBINDINGEN LIQUIDATIE DER FIRMA ISAACSON&HARTMANN 11136 Damrak bij de Vrouwenstee# Amsterdam VAN EENE RUIME KEUZE DER VELE VERSCHILLENDE ARTIKELEN EIGENAARDIG AAN EEN ENGELSCH MAGAZIJN zoo als: Kinderwagentjes in 20 diversiteiten Glaswerk Aardewerk Cilinder-Mangels van verschillende constructie en in alle grootten Barometers Thermometers Stormglazen Electriseermachines Lederwerk Schotsch Fantasleartikelen Kotters Reiszakken Wsschmachines Haverkneuzers Familieweegschalen Briefwegers Tafelbollen Tafelkleeden Tafelmessen Scheermessen etc. Machinezijde Heeren-Paletóts Heeren-Costumes Dassen in buitengewoon groote verscheidenheid etc. Handschoenen Dames-Artikelen Shaw3s Corsetten Broderies etc. Houtwerk Geldtrommels etc Geëlectroplateerde en Britannia Metaal Koiflo-en Theeserviesen Botervlootjes Bouißoires Zuurstellen Olie- en Azrjnstellen etc. etc. etc. Parian Beeldwerk Venetiaansch Glaswerk etc. (18029) DAMRAK H 136 AMSTERDAM Gisteren kwam bij mg' de Schipper en Koopman N. 8. die mij verhaalde dat zijne Eehtgenoote wel 5 jaren lang aan hevigen buikloop geleden heeft doch door het gebruik van 3 Bussen REVALENTA radicaal genezen is. Wam. F. T. POTMA. De volmaaktste gezondheid kracht en nieuwen levenslust hergeeft de REYALEMTA ARABIC Jl. Slechte spijsvertering diarrhaea maag- en onderbuikskwalen slijm zuur galziekten oprispingen spanning op de maag zinkings hoofdpgn en eene menigte andere ziekten geneest DU BARRT's REVALENTA spoedig en met weinig kosten. Als voeding voor kleine Kinderen is ze ook bijzonder aan te bevelen en verdient de voorkeur boven de voeding met melk. Zg verteert licht verzuurt niet geeft veel voedsel en gezonde sappen. Zieken kunnen geen beter dieet houden dan zich bg' de REVALENTA te bepalen dio op verschillende wg'ze zeer sinakelgk gereed kan gemaakt worden. Er zijn vele nagemaakte soorten. Echt. is de REVALENTA van de Heeren BARRY DU BARRY #• C°. aUeen te verkrggen in het VEUKOOPHUIS of zijne Depots in Bussen van «7V% Cents  ƒ2 3.50 ƒB ƒ 16. M«n lette er vooral op dat iedere bus tot waarborg der echtheid door #F. VON WINDHEIM f CO. VERKOOPHUIS"" geteekend is. (18348) VERKOOPIIÜIS en de bekende Depots.",http://resolver.kb.nl/resolve?urn=ddd:010099558:mpeg21:a0017:ocr,4,ddd:010099558:mpeg21:p004,Algemeen Handelsblad,1949
34599,1871/10/12 00:00:00,57,ddd:010263332:mpeg21:a0048,http://imageviewer.kb.nl/ImagingService/imagingService?id=ddd:010263332:mpeg21:p004:image&x=1618&y=476&w=607&h=57,ddd:010263332:mpeg21,2225,533,1618,476,4,ADVERTENTIËN.,http://resolver.kb.nl/resolve?urn=ddd:010263332:mpeg21:a0048:ocr,4,ddd:010263332:mpeg21:p004,De Tĳd : godsdienstig-staatkundig dagblad,607
4438332,1871/02/25 00:00:00,5084,MMSADB01:000004104:mpeg21:a0013,http://imageviewer.kb.nl/ImagingService/imagingService?id=MMSADB01:000004104:mpeg21:p003:image&x=1851&y=305&w=873&h=5084,MMSADB01:000004104:mpeg21,2724,5389,1851,305,6,"Advertentie I-MM te Ginneken bij Breda. De ondergeteekende blijft zich beleefdelijk aanbevelen tot het leveren van alle soorten van VERWHOUT bij uiterst billijke noteeringen  goede kwaliteit op elke verlangde wijze gemalen. A. H. SCHIPPERS. bij F. L. WELSCH Scliapenmarkt B. 30G. T.F.BASTET Scheermessen T.F.BASTET Scheerramen 1/40 bij F. L. WELSCH Schapeumarkt B. 306. ondergeteekende heeft wederom verkrijgbaar gesteld SIERLIJKE DOOSJES bevattende 20 pakjes met ZADEN van verschillende mild en schoonbloeijende ZOMERBLOEMEN met aanwijzing van de gemakkelijkste wijze van kweeking en behandeling. Voor echtheid en goede"" kieming dier Zaden wordt door hem ingestaan. Haarlem  voorjaar 1871. DAVID JACOBSON Zaadhandelaar. Prijscouranten van Groenten Bloemen Landbouwzaden enz. op franco aanvraag vrachtvrij. 1» Ct. a i%\ Ct. PER WEEK vrij aan huis en in eigendom. De Noord- en ZuidHollandsche Courant VERSCHIJNT THANS DAGELIJKS behalve op Zon- en Feestdagen. Abonnementsprijs per 3 maanden ƒ1.30 binnen ƒ1.60 buiten Amsterdam. BUREAU: N. Z. VOORBURGWAL H. 621 te Amsterdam. JOHANNITER-ORDEN. De Gedelegeerden van de Johanniter-Orden schreven aan den Heer JOHANN HOFF te Berlijn: /UEd. gelieve ten spoedigste ons wederom eene zending van uw voortreffelijk MALZEXTRACT te doen geworden welk praeparaat in ons lazareth van eene zoo zegenrijke werking is geweest. — Vrijheer VON ROSENBERG Gedelegeerde van de Johanniter-Orden bij het Keizer Frans-Kazernen-Lazareth 15 November 1870."" De Heilkracht uwer Malz-fabriekaten uit den oorlog 1866 uit ondervinding kennende verzoek ik u enz. — VON PFUEL Gedel. Johanniter bij het generaal-kommando van het 10e Armee-corps"". Verkrijgbaar te 's Bosch bij Th. J. JANSEN  Bazar A. 119; te Geertruidenberg bij J. BOON; te Oosterhout bij HOLLANDER-MOSSOU; te Oss bij DE LOUW; te Tilburg bij Ed. GIELIAM; te Waalwijk bij J. G. VERWIEL. machijsam BIEBBOÏTELiRU Kelders onder de Boterhal. Gewoon Gerste p r Literflesch ƒ-.08 Dubbel Gerste // u // Jong Oud n ii ii --09 Oud Gerste n u // —.10 Oud Bruin n h n -.1° Nieuwlicht n n u -.11 Amsterdamsch Beijersch u flesch u -.18 ld. id. ii '/j u n —.09 Spuitwater u Siphon u -.10 Alles & Comptant. Bestellingen binnen de Stad worden franco aan huis bezorgd. ANT. SMITS.",http://resolver.kb.nl/resolve?urn=MMSADB01:000004104:mpeg21:a0013:ocr,3,MMSADB01:000004104:mpeg21:p003,Provinciale Noordbrabantsche en 's Hertogenbossche courant,873
2513928,1871/09/09 00:00:00,2812,MMSADB01:000004394:mpeg21:a0010,http://imageviewer.kb.nl/ImagingService/imagingService?id=MMSADB01:000004394:mpeg21:p002:image&x=2094&y=2476&w=894&h=2812,MMSADB01:000004394:mpeg21,2988,5288,2094,2476,6,"Advertentie Nieuwe Geleijeo Confituren en AÏÏGÏÏHKE1T bij JOSEPHA. MARTIN te Eindhoven. Er is gelegenheid tot plaatsing van TWEE LEERLINGEN. TE KOOP aangeboden: EEN BIERWAGEN voor een of twee Paarden lang 3 Meter breed 1.50 Meter en hoog 0.90 Meter zonder Veeren. Een zoo goed als nieuwe GEILKUIP inhoudende p. m. 40 Hectoliters en dito ROERKUIP p. m. 20 Hectoliters. Brieven franco onder N"" 183 aan den Boekhandelaar P. J. KRAPT Spuistraat 's Hage. zal ten dienste van het 2e Regement Hussaren worden Aanbesteed voor den tijd van 15 dagen: De benoodigde Aardappelen. De voorwaarden liggen ter lezing op het bureau van het 4e Escadron des Regements. Het Gemeentebestuur van Bakel C. a. zal krachtens magtiging van Heeren Gedeputeerde Staten dezer Provincie provisioneel op Dingsdag den 19 September 1871 des voormiddags ten 9 ure op het Veld en finaal op Dingsdag den 3 October daaraanvolgende des namiddags ten twee ure ten huize van M. SPOOREN te Milheeze publiek VERKOOPEN: 61 Hectaren 48 Aren 70 Centiaren PUIK BESTE VEENGROND verdeeld in 106 perceelen uitmuntend geschikt voor Weiland het steken van Turf het maken van Bagger en het teelen van Boekweit behoorende aan en gelegen onder genoemde Gemeente ter plaatse genaamd de groote Peel tusschen de Schoutensche en Stipstalsche banen. De conditiën van verkoop en schetskaarten zullen te rekenen van af den 11 dezer van des voormiddags 9—11 ure uitgezonderd Zonen Feestdagen ten Raadhuize te Bakel ter inzage liggen. Bakel  7 September 1871. Het Gemeentebestuur voornoemd J. V. NEERVEN Voorz. De Secretaris SOEREWIJN.",http://resolver.kb.nl/resolve?urn=MMSADB01:000004394:mpeg21:a0010:ocr,2,MMSADB01:000004394:mpeg21:p002,Provinciale Noordbrabantsche en 's Hertogenbossche courant,894
1441047,1871/08/14 00:00:00,1633,MMKB08:000088889:mpeg21:a0024,http://imageviewer.kb.nl/ImagingService/imagingService?id=MMKB08:000088889:mpeg21:p004:image&x=996&y=3827&w=869&h=1633,MMKB08:000088889:mpeg21,1865,5460,996,3827,6,Advertentie OOGSPIEGELS J. C. TH. MARIUS. Boekhorstenstraat. DIENSTAANBIEDINGEN a 5 Cts. den regel voor de eerste plaats sing en k 3 Cts. voor de herhaling binnen 14 dagen. De betaling gescheidt CONTANT aan het Bureau. Eene Burgerdochter zag zich gaarne GEPLAATST als TWEEDE of DERDE goed kunnende Strijken en Naaijen en van beste getuigen voorzien. Brieven franko Lett. A. A. Bureau Arnhemscht Courant. EENE WASCHVROUW BIEDT ZICH AAN tot het wasschen aan huis van PIJN GOED en KINDER-WASCHJES belovende eene nette en vlugge bediening. Brieven franko Lett. B. B. Bureau dezer Courant TUINBAAS. ER BIEDT ZICH AAN : een ongehuwd Persoon  die de laatste 16 jaren in Zuid-Holland als TUINMAN is werkzaam geweest; door omstandigheden buiten betrekking zag hij zich tegen November of eerder gaarne GEPLAATST. Bewijzen van goed gedrag en bekwaamheid ontbreken niet. Adres met franko brieven onder Lett. F. P. Bureau dezer Courant.,http://resolver.kb.nl/resolve?urn=MMKB08:000088889:mpeg21:a0024:ocr,4,MMKB08:000088889:mpeg21:p004,Arnhemsche courant,869
1328631,1871/12/06 00:00:00,1951,ddd:000017783:mpeg21:a0024,http://imageviewer.kb.nl/ImagingService/imagingService?id=ddd:000017783:mpeg21:p004:image&x=2883&y=3052&w=681&h=1951,ddd:000017783:mpeg21,3564,5003,2883,3052,4,"ttr Piano. ~w ! Groote cadeaux van blijvend nut die weinig geld kosten. Beethoven gezamentlgke 36 Sonaten voor 2 handen in prachtband. . . ƒ3.15. Beethoven gezamentlijke 9 Symphoniën voor 2 handen lu prachtband . ƒ 3.90. Mozart Sonaten voor 2 handen ln prachtband ƒ4.50. Hetzelfde in nog goedkoopèr uitgave toch ook ln prachtband ƒ2.40. Beethoven gezamentlijke 9 Symphoniën voor 4 handen in pr acbt band . ƒ 4.80. Beethoven Sonates Rondo's en Variationen voor Piano en Viool ln2prachthanden partituui en stemmen. . ƒ 7.80. En even zoo van vele andere Komponisten in Solo's 4/ms. Trio's Qtiartetten enz. enz Catalogussen en Gelegenheldsliji-tii-S S'eed. gratis. SKI FF IKU TS Dluzlekhandel. AMSTERDAM. P. S. Geene particuliere bestelling (hoe spoedvereischend ook) wordt geëffectueerd waar het bedrag niet voor ontvangen is. utrechts* Striaenten-AliaiaT Het Feest-Comlté herinnert hierbij nogmaals dat de Reunie van HH. Oud Redacteuren zal plaats vinden op Dinsdag 18 December e. k. Verzameling tusschen 12 en 1 uren bg den Heer KLOKKE Keistraat te utrecht. Zij die verzuimd hebben kennis van hunne deelname aan de feesten te doen kunnen zich daartoe tot S December e. k. bij den ondergeteekende aanmelden. (7192) Namens het Feest-Comité: •*• C. KIVCTTEI Secretaris. Utrecht Woonplaats: Korte Nieuw-1 Dec. 1871. stral]ltj bjj Kejntjes. ALMANAK VOOR Hollandsclie Blïn..llon 18 7 2. l'""5* Met Plaatjes. Prijs 60 Cents. Uitgegeven en verzonden door S. E. VAN NOOTEN te Schoonhoven.",http://resolver.kb.nl/resolve?urn=ddd:000017783:mpeg21:a0024:ocr,4,ddd:000017783:mpeg21:p004,Het nieuws van den dag : kleine courant,681
1252120,1871/06/03 00:00:00,1361,ddd:011101564:mpeg21:a0002,http://imageviewer.kb.nl/ImagingService/imagingService?id=ddd:011101564:mpeg21:p001:image&x=50&y=3279&w=920&h=1361,ddd:011101564:mpeg21,970,4640,50,3279,4,(Voor hel land.) TWEEDE KOFFIJ-VEILING te PADANG. Op den eersten of tweeden dag pa aankomst aldaar van du Stoompakketboot welke in de tweede belft der maand Junij aanstaande van Batavia derwaarts zal terlrekken. (zie Jamsche-Couranl van 12c dezer No. 38) De Gouverneur van Sumatra's Westkust bij afwezen: De Secretaris (Hl) KROESEN. In opvolging van het bepaalde bij art. 850 van bet Wetboek van Koophandel wordt bekend gemaakt dat de door den Rpgter-Commissaris in bet faillissement vaa d<*n Chinees Tjoa Main opgemaakte rangregeling met de daarbij behoorende bewijzen ter Griffie van den Raad van Justitie alhier zijn nedergdegd om aldaar gedurende veertien dagen te verblijven ter inzage van een ieder. • r Namens de Weeskamtn '{ (110) De Secretaris . ' 'i • IIEEGER. . . den 31 Mei 1871. * . • i,http://resolver.kb.nl/resolve?urn=ddd:011101564:mpeg21:a0002:ocr,1,ddd:011101564:mpeg21:p001,Sumatra-courant : nieuws- en advertentieblad,920
912460,1871/09/01 00:00:00,1061,ddd:010586162:mpeg21:a0048,http://imageviewer.kb.nl/ImagingService/imagingService?id=ddd:010586162:mpeg21:p007:image&x=935&y=4512&w=860&h=1061,ddd:010586162:mpeg21,1795,5573,935,4512,8,Openbare Verkooping ie mi LOGEMENT Het Amsterdams he en Zwolsihe Veerliuis te ENKHUIZEN. I ithoofde van sterfgeval /uilen de Notarissen A. L. wx BLOGTEEEN en v L. NIJHOFF op Vrijdag den i:> September 1871 des avonds ten 7 ure  prc-enlercii te verkoopen ILi LOGEMENT hei Amsterdamsche en Ztcol sche Veerhuis. nut Hillnrd/aal ruimen Stal Hooi ■ . slaande  ~ |.| Dijk te Enkhuizén sectie V not ii lee grool 8 ae ~ eentiares waarin dil bedrijf gedur Ie meer ilau .* I jaren en DM heden wordl mi' loefend . aagelati d door Mej de vi d II .1 lop De verkoopiM minlen worden in v oorlioeinil | ~.. (~.||| Nadere 1 ■ 11. > i-11.. 11« -~ |~ |„| „„. ~. ~ ri. N;m bovenge -inde \ oonditiën en bewezen van ei| urende »ohl dagep vóór en op den verkoopi :■ tet leiing liggen.,http://resolver.kb.nl/resolve?urn=ddd:010586162:mpeg21:a0048:ocr,7,ddd:010586162:mpeg21:p007,Leeuwarder courant,860
1221772,1871/08/25 00:00:00,1308,MMKB08:000088910:mpeg21:a0014,http://imageviewer.kb.nl/ImagingService/imagingService?id=MMKB08:000088910:mpeg21:p003:image&x=2619&y=4169&w=919&h=1308,MMKB08:000088910:mpeg21,3538,5477,2619,4169,4,Advertentie Wijk H 555a. Een BRIK voor twee Paarden. Te bevragen bij G. WILLEMSEN Huis- en Rijtuigschilder Hommelstraat VOORHANDEN: F ii xs ss chs ar met HERMETISCHE AFSLUITING tegen zeer billijke prijzen. Ei es eca cc eël ^ Magazijn van Porselein  Kristal enz. o O. J. BOLT. ALLE SOORTEN VAN Rekeningen Wissels Assignatien Kwitantien Etiqoetten Plattegronden Teekeningen Plannen enz. enz. worden zeer spoedig en tegen billijke prijzen geleverd ter Steendrukkerij van G. J. THIEME te Arnhem.,http://resolver.kb.nl/resolve?urn=MMKB08:000088910:mpeg21:a0014:ocr,3,MMKB08:000088910:mpeg21:p003,Arnhemsche courant,919
1686234,1871/10/04 00:00:00,2643,MMVEEN01:000078097:mpeg21:a0022,http://imageviewer.kb.nl/ImagingService/imagingService?id=MMVEEN01:000078097:mpeg21:p004:image&x=2452&y=2889&w=638&h=2643,MMVEEN01:000078097:mpeg21,3090,5532,2452,2889,4,Advertentie HOTEL FRIESLAND A. VAN DER WAL Kleine Pelsterstraat. — Groningen W. .). HEGGE Middelste Verlaat WILDERVANK Wijnen Likeuren Gedistilleerd enz. in Manufacturen Beddegoederen etc. R. J. SCHUERSÏEEK Guldenstraat K. 7. Groningen. Ondernemer van publieke verkooplngen van boeken  platen  schilderijen munten enz. Dagelijks gelegenheid tot inzending. Guldenstraat K. 7. Groningen. algemeene boekhandelBOEKDRUKKERIJ. Hoofd-Depót van de Kantoorboeken van EDLER & KRISCHE te Hannover. L. FRANK Veendam. lieneden-Verlaat. Agent tan de Amsterdamsche Onderlinge Brandwaarborg-Maatschappij „Nederland Gr- OOSTEA. wildervank Handel in Binnen- en Buitenlands gefabriceerde Sigaren. h- k- van halteren Boekdrukkerij en Boekhandel STADS KANAAL. koffijhuis en S talling vlak tegenover het Station Zuidbroek. LOGEMENT: „SBet Hof van /Bolland van G. MONKHORST. J- II. W. ÏI5R VI:Ut Jr. Parapluie en Parasolmaker. BOYEN-OOSTERDIEP. WILDERVANK. J. H. LOOMAN te CAGLIARI (eil. SARDINIË) Scheepsmakelaar en Interprêter voor de Hollandache  Engelsche Duitsclie Fransche en Italiaan9ehe taal. B. VROOM WESTERDIEP. — VEENDAM. SPIEGELHANDEL  Vensterglas glazen Dakpannen enz.,http://resolver.kb.nl/resolve?urn=MMVEEN01:000078097:mpeg21:a0022:ocr,4,MMVEEN01:000078097:mpeg21:p004,Nieuwe Veendammer courant,638
732556,1871/06/11 00:00:00,1173,MMWFA01:000192047:mpeg21:a00024,http://imageviewer.kb.nl/ImagingService/imagingService?id=MMWFA01:000192047:mpeg21:p00005:image&x=2326&y=3551&w=1011&h=1173,MMWFA01:000192047:mpeg21:p,3337,4724,2326,3551,5,Advertentie NAGEKOMEN ADVERTENTIES LAPPENDAG. WOENSDAG 14 JUNIJ van 8 lot 12 uur opruiming [van lappen enz. tot zeer loge prijzen bij MOORIIAUS & CoI Wegens plaatsgebrek zijn wij genoodzaakt eenige Advertentiën tot een volgend nummer te laten liggen. Gedrukt bij P. J. PERSIJN te Hoorn.,http://resolver.kb.nl/resolve?urn=MMWFA01:000192047:mpeg21:a00024:ocr,5,MMWFA01:000192047:mpeg21:p00005,Hoornsche courant,1011
1606944,1871/11/11 00:00:00,1824,MMKB08:000089085:mpeg21:a0012,http://imageviewer.kb.nl/ImagingService/imagingService?id=MMKB08:000089085:mpeg21:p004:image&x=957&y=3046&w=881&h=1824,MMKB08:000089085:mpeg21,1838,4870,957,3046,4,Advertentie Slechts tot ZONDAG 12 NOVEMBER. In MUSIS SACRUM (Kleine Zaal) PARIJS en de ruïnen van Parijs en St.-Clond Dagelijks geopend van 's morgens 10 uur tot 's avonds 10 uur. Entrée 40 Cts. J. B. RÖTTGER. DIENSTAANBIEDINGEN a S Ct*. de regel voor de eerste plaatsing en è 3 Cts. voor de herhaling binnen 14 dagen. De betaling geschiedt CONTANT aan het Bureau. ER BIEDT ZICH AAN om dadelijk of met Februarij in dienst te treden als: Palfrenier of Huisknecht IEMAND van goede getuigen voorzien. Adres franko Letters U U Bureau dezer Courant. Een R.-K. KEUKENMEID oud 26 jaren die omtrent bekwaamheid en gedrag de beste getuigenissen kan overleggen ZOEKT tegen 1 Februarij e. k. eene BETREKKING. Adres met franko brieven onder Lett. A—Z aan het Hulppostkantoor  te Oosterbeek. ER BIEDT ZICH AAN tegen 1 Februirij a. s.. EENE BEKWAME TWEEDE- Of DERDEHEID P. G. oud 24 jaar van goede getuigen voorzien. Adres franko Lett. V V Bureau dezer Courant. ~,http://resolver.kb.nl/resolve?urn=MMKB08:000089085:mpeg21:a0012:ocr,4,MMKB08:000089085:mpeg21:p004,Arnhemsche courant,881
3475080,1871/12/24 00:00:00,3528,ddd:010099863:mpeg21:a0025,http://imageviewer.kb.nl/ImagingService/imagingService?id=ddd:010099863:mpeg21:p004:image&x=57&y=3373&w=985&h=3528,ddd:010099863:mpeg21,1042,6901,57,3373,4,"_*i J. H. HAMBURG cSP^BI—^^S d«l»evsteeid landmeeilei -xßliin* Tan z- M- DEN KONING fïS3§-iÉp_ ©-MSTHAAT (naast de Pasage <BS'*--~eS» WYNAND FOSKING). '"" Is dagelijks te consulteeren tot het „zetten vaa KUNST» TANDEN; welke geplaatst worden op ZUIGPLATEN die door eigen aonzuigiag vastzitten ook op Gond Caoutchouc enz.; alle deze tanden worden ingezet zonder de oude wortels te verwijderen en wordt geen betaling gevorderd vóór de gebruiker overtuigd is dat dezelve aan alle vereischten voldoes. Tandheelkundige operatiën worden verricht zonder piia aaar d« Bewerking vanDr.BICHAEDSON. (24341) HF* Ds van ouds gerenommeerde Punch vas Meertje is nog altoos verkrijgbaar bij H. B. DE BEEB Ho itgracht Q 332. Bestelliagëa per Briefkaart worden ook franco aaa huis bezorgd. (29442) ! """"""""""""^^ Winterhandea Zekere genezing -AIS en spoedige verzachting van E Voeten gemakkelijke behaadeliag. Dr. PLENCK. E DÉPURAïÏFDÏÏSANG. I ESSENCE TAN SALSAPAMI-LE geaeesmiddel § i voor srphilitische aoadeoaiagea dauwworm klierea © I huiduitslag ca scheurbuik. | «DB INJICTJES MEER. 1 De DBAGÉES van BLOT zija tegelportijd ver-§ sterkead ca hloedzuiveread ca zoader kwik een onfeil- « baar middel tegen aile geheime ziekten vaa beide ge- \\ slachtea hetzij in het begia hefcsij in chronische of gs verouderde gevallen in de ziekten der blaas het weg- 5 loopen of ophouden van het water ca in de huidziekten. \ Zfl vereischen noch ontberiag noch vastgestelde leef- \ wnze. ƒ 2.50 de doos. \ Te Botterdam: SNABILIE Groote Markt} te 's-Hage 3 ABILLt; te Amsterdam: DIiOTH Zeedijk. (28342) \ E 131 METROPOLITAN HEAT HAMET LONDEN October 1871. Mijn Heer. Wij zijn zoo vrij UÉd. ialiggead oas Adres en Befereacies te zendea. Mocht ÜEd. genegen zija oas in Uwe consignaties Tan GESLACHT VLEESCH te laten deelen zouden wij ïulks als eene groote gunst beschouwea. UEd. dw. Dienaren ARCHEB & MAL ÏHOUSE. Befereacies. ms. H. «EBHARDT London Cattle Market. (34147) Mn. KOEKOEK . . i LONDON JOINT STOCK. BANK S-UTHHELB. GEHEIME ZIEKTEN. SPECIALE BEHANDELING volgens aieuwe methode. Chirurgijn SB. VILANH. (33787) O. Z. Voorburgwal 3de Huia.van de PijUteeg Jl5B BeTM_EMMIM€2MIo Het Kantoor ter verkrijging vaa BETREKKINGEN  Keizersgracht bij de Huidenstraat HH 483 te Amsterdam is geopead alle Werkdagen von 10 tot 2 en van 6 tet 8 uren. fgm\ Inlichtingen worden gegeven en lastgeviagea kosteloos te rerkrijgea. (34903) HENRY SMET & C°. PT"" WIL OEN VOLKOMEN l genezen worden van Winterhaadea ca Voeten Buwe of Ge- Barstene Haaden Qespioteaa Lippen Koude ia Ooren of Wangen of welke woaden ook die door koude wordt verhinderd te genezen. men Jcoope zich voor Slechts 30 Cents t eene flacon van het alleen echte WnNTERHANBEN- . IHIDDEL verkrijgbaar te Amsterdam bij: J. W. ANNE- c GABN Leidschestraat bij de Heerengracht H. LENSING Jr. Damstraat Magazijn de Beijenkorf Nieuwendijk bij de Kolkateeg EIL & VAN OS Botterdam ISEBIEF „ ZONEN 's-Hogp enz. WpF' Het alleen echte is voorzien van dea naam des Hoofd- ] dêpothonders voor Nederland S. P. POSTMA Leeuwarden o •DeßotiafWTragsa franco (38023) t . i",http://resolver.kb.nl/resolve?urn=ddd:010099863:mpeg21:a0025:ocr,4,ddd:010099863:mpeg21:p004,Algemeen Handelsblad,985
4888728,1871/07/12 00:00:00,4976,MMWFA01:000192056:mpeg21:a00010,http://imageviewer.kb.nl/ImagingService/imagingService?id=MMWFA01:000192056:mpeg21:p00004:image&x=584&y=220&w=1010&h=4976,MMWFA01:000192056:mpeg21:p,1594,5196,584,220,4,Advertentie Bij de op I Juli ISTI te Weenen plaats gehad hebbende trekking der Loten van 1858 zijn op de navolgende Seriën en Nummers groote Prijzen gevallen : Serie 1212 N®. 45 f 200000 Serie «361 N°. 93 / 400 » 3279 » 27 > 40000 » «79« » 33 » 400 » 3062 » 95» 20000 » 4 84 4 » 56» 400 » 820 » « 3  5000 » 4 84 4 » 69» 400 » 4242 » 98» 5000 » «814 » 96 » 400 » 3062 » 57 . 2000 » «8)5 » 2 » 400 » 3062 » 99 » 2000 » 4845 » 29» 400 » 429 » 40 » «500 » «966 » «2 » 400 » 820 » 3 » «500 » «956 » «5 » 400 » 3*62 » 97 » «500 > «956 » 34» 400 » 429 » 74 » «000 » «956 » 65 » 400 » 504 » «8 » «000 » «956 » 79 » 400 » 504 » 74 » «000 » 300« » 39 » 400 » «361 .42» «000 • 3004 » 48 » 400 » 136« » 76» «000 > 300« » 49» 400 » 3062 >60» «000 > 3062 * 34 » 400 » 3729 » 30 » «000 » 3062 » 39» 400 » 4088 » 76 » «000 » 3062 » 70 » 400 » 429 » 25 » 400 > 3«62 » 30 » 400 » 429 » 36 . 400 » 3279 » 43 » 400 » 504 » 20 . 400 » 3729 » 34 » 400 » 820 » 83 » 400 » 4032 » 54 » 400 » «2)2 » 20» 400 » 4033 » 78» 400 » «212 » 37» 400 » 4032 » 82» 400 » «212 » 48 » 4001 » 4088 » 14 » 400 De verdere 2550 getrokken Prijzen zijn op de door de Heeren IDK.VriI lL & C°. te Amster«lam uitgegeven volledige Trekkingslijst na te zien. | Geluks-x4anbieding. 1 | *»Geluk en Zegen bij ColinT’ gi | Groote door den Staat Hamburg geguaran- I i deerde Geld-Loterij van meer dan 11 Millioen 410000 Thaler. i | In deze voordeelige Geld-Loterij  welke 7\ || 44700 Loten bevat worden in weinige Rh | Maanden in 6 Afdeelingen de volgende || Winsten zeker getrokken namelijk 1 winst Ijl eventueel 100000 Thaler speciëel Tlllr. % 60000 40000 30000 1600010000 f 2maal 8000 Sma'al 6000 3maal 4800 f lmaal 4400 2maal 4000 4maal 3200J Smaal 2400  llmaal 2000 2maal 1600 rl 27maa! 1200 lOSmaal 800 5maal 600  | 4maal 480  155maal 400 205maal 200 § 2maal 120 300maal 80 11610maal 44 40 10650 a 20 12 8 6 4 en 2 Thaler. [| De Winst-Trekking der tweede Afdeeling | is officieel op den 75 j*. 19 cn 30 Juli «1. J. 1 K vastgesteld en kost de prijs hiervan voor § ra 1 geheel Origineel-Lot 7 Gld. S K 1 half d°. 3 Gld. 50 Ct. | 1 vierde d°. 1 Gld. 75 „ || 1 achtste d°. 88 „ I d en zenfl ik deze Origilieel-Loten (niet van % H verhodene promessen of privaat-Loterijen) ra I tegen franco inzending van het bedrag 1 || zelfs naar de verst verwijderde oorden den J 2 geëerde lastgevers terstond toe. i I De officiëele Trekkingslijst en de |Verzending der Prijsgelden! | volgt terstond na de Trekking aan ieder jf I der bedeelden prompt en geheim 4 Mijne zaak is bekend als de Oudste en S Allergelukkigste daar ik bereids aan meer- f | dere bedeelden de grootste Hoofdwinsten f | van Thaler 100000  60000 50000 dik- § |wijls 40000 20000 zeer dikwijls 12000 <§ ^ Thaler 10000 Thaler etc etc. volgens ja | officiëele Trekkingslijsten uitbetaald heb. 1 S SÖ^De Bestelling kan men om de gemak- J | gf=kelijkheid eenvoudig op eene Postkaart ra I a^floen. I i LAZ. SAMS. COHN in Hamburg- 1 ra Hoofd-Kantoor Bank- en Wisselhandel. |j KEIZERLIJK OTTOIAHISCHË Premiën-Leening van 1870. Hoofdprijzen: Frcs. 60000060000 2 üt 20000 6 5 6000 J2 è 3000 28 è 1000 1 300 5 400 enz. welke den I Augustus d. J. getrokken worden. Voor deze. trekking verzend ik tegen franco inzending van hot bedrag GEIIEELE LOTEN è 3 Fl. halve Loten i» 1 Fl. 50 cents. vierde Loten è 1 Fl. Prospectussen gratis. Trekkingslijsten franco na afloop der Trekking. Bankiershuis Siegmuod Heckscher Amsterdam Warmoesstraat J. 539. |,http://resolver.kb.nl/resolve?urn=MMWFA01:000192056:mpeg21:a00010:ocr,4,MMWFA01:000192056:mpeg21:p00004,Hoornsche courant,1010
526400,1871/06/17 00:00:00,800,ddd:000017637:mpeg21:a0027,http://imageviewer.kb.nl/ImagingService/imagingService?id=ddd:000017637:mpeg21:p004:image&x=2151&y=4237&w=658&h=800,ddd:000017637:mpeg21,2809,5037,2151,4237,4,Begrafenis-Onderneming TAN H. F. HENNEN. Deze Onderneming belast zich met de zorg voor BEGRAFENISSEN en al wat daartoe behoort tegen vaste en billijke Prijzen .olgens Tarief te bekomen ten Kantore. (2205) Huidekoperstraat Z 762. IHet publiek wordt bijzonder op- I merkzaam gemaakt op de in de Cou- I rant van heden geplaatste advertentie I der firma 8. Sacks _. Co. in I Hamburg welke door hare prompte I en reële bediening tegenover hare I geïnterresseeraen het volste vertron- I wen in alle epzigten verdient. (3916) I,http://resolver.kb.nl/resolve?urn=ddd:000017637:mpeg21:a0027:ocr,4,ddd:000017637:mpeg21:p004,Het nieuws van den dag : kleine courant,658
3512652,1871/11/20 00:00:00,3588,ddd:010099803:mpeg21:a0017,http://imageviewer.kb.nl/ImagingService/imagingService?id=ddd:010099803:mpeg21:p003:image&x=2011&y=3317&w=979&h=3588,ddd:010099803:mpeg21,2990,6905,2011,3317,4,DE MAKELAARS SN DROGERIJEN TE AMSTERDAM zullen op Woensdag 29 November 1871 onraiddellgk na afloop der veiling van 614 kisten BORNEO-öüM COPAL enz. dei namiddags te halt Twee uren in de Brakke Grond in de Nes aldaar presenteoren te verkoopen; 56 Kisten BORNEO-GUM COPAL 451 M-ttes TIMOR-CASSIA »1 Vaatjes CUESACAO-SCSIILLEN 9 Kisten SCHILDPAD (TOBTLE SHELL). Alles directe aanvoer. Nader bü Notitie. (35023) A. J. B. VAN WATJENBURG. W. LEENDERTZ Cz. J. VALKENBUKG J. G. VAN GINKEL J. G. OTTERBEEK J. L WIJTMAN P. J.OOLGAARüT.W.F.WE-iTERMANN H. T. DDNNEWOLD A. VAN IJSENDIJK Es. H. KBOESE Jr. A. KAPPELHOPF Jr. J. STERK en H. F. SüLTH Makelaars zullen als lasthebbende vaa hnnne- Meesters op WOENSDAG 22 MIMBIR 1871 dei Avonds te 6V» Uren aan do raeestbiedenden presenteeren te Verkoopen: 9SS Kisten Goconfijte GEMBER en ______ 100 Matten Korten CRINEFSCHE KANEEL Liggende en te zien als nader bü Notitie zal worden aangewezen. (35040) DE üUWbIüJkE \ Füktlliri^ IN HET Oudezijds Heeren-Logement waarbü de INBOEDEL van wülen den Wei-Edel Genorem Heer D. BIRRIUS CAMPEN wordt deze week aldus veivolgd te weten: Maandag- 20 November. DES VOORMIDDAGS TE IOVs UUR PRECIES: Bedden ca Matrassen Pendules Candelabres Schoorsteenornementen Lichtkronen Pianino Serafineorgels en Piano's Tapgten. Karpetten e» Loopers. DES NAMIDDAGS TE SV» UUR PBECÏES: Koper- Kristal- Glas-en Lakwerk IMnsdag 21 November. VOORMIDDAG: Spiegels  Gasorneraenten .Lampen Barometers S-hilaergen en 6'ravares in Lijsten.. NAMIDDAG : Luiermandsgoed E.ts.r.iezen ca Porseleinen. Woensdag* 22 November. VOORMIDDAG: Diver.e Meubelen. NAMIDDAG: Koperwerk Dekens Gordüflcn en Behangselgoed. (35025) MAKFLAARS IN KRÜIDENIER3WAREN zullen DINSDA« 38 NO VERBOER 1871 des Avonds ten 6 nnr ia 'net Lokaaf de Brakke Grond in velling brengen EEN PARTIJ NIEUWE SIIMA-VIJGEN. De NOTITIEN zullen tgdig uitgegeven worden. (35013) Vereen!*.ng tot h«i»«-fc»vlaff van hel I.ll>erale ne_.i_.Bel ta de -Veder d. Herv. Gemeente te Imifeiilem. DERDE VOORDRACHT DINSDAG 21 NOVEMBER 1871 in Frascati Nes. TOEGANG* RAARTEN zün a 5 Cents te bekomen zoo als op de Biljetten staat vermeld. (35011) Het BEBTDUB der AMSTERDAMSCHE MEEL- en' BROODFABRIEK bericht aan belanghebbenden dat het Piaa voor eene te sluiten Geldleening verkrügbaar is aaa de Fabriek Zoutkeetsgracht. (35018) Tapen betaling der Advertentiekosten is terug te bekomen een ZAKJE waarin eenig GELD vooreenigen tüd gevonden. Nadere inlichtingen zün te bekomen bg dea Boekhandelaar 3. REDBERING Leidschestraat tusschen de Kerkstraat ca Keizersgracht CC 2. (35009) . SINT-NICOLAAS GESCHENKEN. * A. SOEDEROÜW W ïiIREGMRSBREESTRAATJiI Heeft ontvangen eene keurige collectie ZIJDEN en BANNELLA Dames- Heeren- en Kindor-PAREPLUIES 8 10 en 12 Baans. Bunn keuze ENTOUTCA* en REGENMANTEL-PARAPLUES w.iks artikelen door aan> staande VERPLAATSING van MAGAZIJN REGULIERS BREESTHAAT X 56 met GROOTE VERMINDERING DER PRIJZEN WORDEN OPGERUIMD. (34994),http://resolver.kb.nl/resolve?urn=ddd:010099803:mpeg21:a0017:ocr,3,ddd:010099803:mpeg21:p003,Algemeen Handelsblad,979
784035,1871/11/25 00:00:00,1179,ddd:010263369:mpeg21:a0055,http://imageviewer.kb.nl/ImagingService/imagingService?id=ddd:010263369:mpeg21:p004:image&x=3057&y=1126&w=665&h=1179,ddd:010263369:mpeg21,3722,2305,3057,1126,4,14 2 Hulponderwijzer worden gevraagd aan de R. Cath. ScM te Zwolle. Jaarwedde ƒ400.—. Brie* franco N°. 56 bij den Boekhandel» J. M. W. Waanders te Zwolle. (73--— -*1 Eene E. 0. Burgerjuf vroul zag zich gaarne tegen Februari) als Wi ïieMoefatea- om het even in *m vak geplaatst; zij is met dergelijke f trekking bekend. Brieven onder lettert aan het Bureau dezer Courant. (733 BockkandTvaQ A. M. m DIJK iëldij Verschenen: De VIJFDE DRUK van de Officïën en Gezangen on<f en na het Lof van het Aartsbroed< schap van het H. en Onbevlekt H» van Maria. Kerkelijk Goedgekeurd. Prijs 25 Cents. De Hollandsche Liederen afzonderÜ 8 Cents. (7346,http://resolver.kb.nl/resolve?urn=ddd:010263369:mpeg21:a0055:ocr,4,ddd:010263369:mpeg21:p004,De Tĳd : godsdienstig-staatkundig dagblad,665
31200,1871/06/21 00:00:00,52,ddd:010262780:mpeg21:a0036,http://imageviewer.kb.nl/ImagingService/imagingService?id=ddd:010262780:mpeg21:p003:image&x=2344&y=5087&w=600&h=52,ddd:010262780:mpeg21,2944,5139,2344,5087,4,ADVERTENTIËN.,http://resolver.kb.nl/resolve?urn=ddd:010262780:mpeg21:a0036:ocr,3,ddd:010262780:mpeg21:p003,De Tĳd : godsdienstig-staatkundig dagblad,600
3012184,1871/04/26 00:00:00,2888,ddd:110533270:mpeg21:a0012,http://imageviewer.kb.nl/ImagingService/imagingService?id=ddd:110533270:mpeg21:p002:image&x=1124&y=3337&w=1043&h=2888,ddd:110533270:mpeg21,2167,6225,1124,3337,4,"Ten behoeve van het Departe- ment vau Onderwijs Eeredienst **• en Nijverheid ter verstrekking aan Inlandsche scholen zijn benoodigd: Eenige .53eel> en Waterpas BeistrKßaisentess met «i Teckenbeijoeften. i Zij die op de levering dier voorwerpen reflecteren worden verwezen naar de ter zake ; ! geplaatste advertentie in de Javasche Courant van | I den 25 April 1871 no. 33. j Be Directeur van Onderwijs Eeredienst en Nijverheid L. J. W. DE WAAL. | Batavia 22 April 1871. (183 S) j ' K' re"" vnn den ondergeteekende | SSSjEr^ wordt op billijke voorwaarden j ter overname aangeboden zijne winstgevende ! Scheepsbouw en reparatiezaak j ! met daarbij behoorende twee KIELLIGTERS \ VLOTTEN' BOOTEN INVENTARIS etc j ; thans nos gedreven wordende onder de firma ! !J. LLOIJD & Co. Nadere inlichtingen te bekomen in de Ga tot| tan of aan de werf op de Kaliemaas bij den ! eigenaar D. H. KRAMER. Soerabaija April IS7I. (1S50) 0!» Bij cc""c DEFTIGE FAMILIE i"" de onmiddelijke nabijheid van een der eerste stwien van Zuid- Holland waar behalve voorbereidingscholen een ! gunstig bekende hoogeic burgerschool bestaat is I gelegenheid tot huisvesting van TWEE a DRIE jongelingen. Inlichtingen te bekomen bij (1735) Mr. HOEK. jpsF* SÏaicSsche"" €oüraßt BINTANG-BARAT Uitgevers ÜGILVIE & Co. Door verscheidene en degelijke lectuur dagelijks in lezers winnende beveelt zij zich door goedkoopheid ten zeerste aan tot het plaatsen van Advertentien die algemeen bekend moeten worden. (1829)",http://resolver.kb.nl/resolve?urn=ddd:110533270:mpeg21:a0012:ocr,2,ddd:110533270:mpeg21:p002,Bataviaasch handelsblad,1043
5881372,1871/10/06 00:00:00,3626,ddd:010873629:mpeg21:a0019,http://imageviewer.kb.nl/ImagingService/imagingService?id=ddd:010873629:mpeg21:p004:image&x=1667&y=76&w=1622&h=3626,ddd:010873629:mpeg21,3289,3702,1667,76,4,"Bij den Uitgever J. B. DE MESQUITA Muiderstraat V 260 en verder alom is verkrijgbaar gesteld eene Brochure getiteld: MODERNE THEOLOGIE IN NEDERLAND. DOOR Philip Elte. (210) ""^PKÏjri>'30 Ct Inhoud: lets betrcfiende »Een Joodsch Concilie"" en »Eene Zending onder Israël"" van B. Tideman Jz. Dr. Theol. en Predikant te Hoorn. INRICHTING voor Maatschappelijk en Godsdienst-Onderwijs. Bij den aanvang van den WIJSTERCIJRSUS maken ondergeteekenden Ouders en Voogden opmerkzaam dat met 16 OCTOBER e.k. wederom op hunne School gelegenheid bestaat tot het plaatsen van Scholieren. Voor kinderen welke de Burgerscholen bezoeken hebben zij reeds 1 April met goed succes eene gelegenheid geopend om GODSDIËXST-OXDERWLIS te kunnen genieten.. Voor dezen zijn de SCHOOLUREN op werkdagen van Hl tot 11 ure en 's namiddags van 4—51 ure; op Zon- en andere vacantiedagen van 9—5 ure. Dankbaar voor de tot nu genoten belangstelling bevelen zij zich in de protectie van Ouders en Voogden aan. (207) M. SCHORLESHEIM. Zwanenburgerstraat. £ 197. M. POLS Azn. |w I Kenlen | FILIALEN en | Königsliergen i/Pr. Coiiöilieiistrasse 25.g CEETRAAL-DEPOTS. prorMntoiistrasse 4/61 i .|j Onder alle Genees- en Voedingsmiddelen neemt het MALZ- § & EXTRACT van JOHANN HOEP te Behlijn zeker eene eerste |S? g -J—'£j plaats in. Bereid uit de beste van als „goed"" algemeen erkende B^m^ bestanddeelen onder bijvoeging van versterkende en verzachtende kruiden — wier zamenstelling een persoonlijk geheim van den Heer 3^.§.f ff Jgl Hoff is — beeft bet MALZ-EXTRACT van zijn beginne — voor § |f~ |] ff «=>g ruim 20 jaren —af zich een naam verworven die van dag tot &~ £ BajRS'iLÏÏ dag algemeener en al gunstiger bekend wordt. Voor het eerste Sts%ftss ff ee3js worden"" zijn bloote Advortentiën voldoende voor »gunstig"" Jpco <] ff -E bekend worden moeten daadzaken spreken en dit doen de dagelijks jês H te Beelijn' en aan de filialen ontvangen wordende dankschrijven Hatf-töiS aJË Ss* waarvan heden wederom eenige: cpS'slS HÜ-sS] Tegernsee. Mevrouw de Barones von Pechmann heeft [Igjll'ïï gij uw MALZ-EXTRACT voor hare vier jaar oude tweelingen die 33 B 6 éaff zeer zwa* waren met buitengewoon gunstig resultaat gebruikt 33 S ÜL __ J§ en is do districts-arts volkomen overtuigd dat het herstel der 3__ _»H 1| kinderen uitsluitend aan bet MALZ-EXTEACT te danken is. ~S I - 1 F- G' SCHMIDT. ga ff S f] Nog nimmer hebben heil- en geneesmiddelen zulk een a <=» $i |H Ê opgang gemaakt als de HOFF'sche MALZ-PRODUCTEN: »MALZ- ag* | f <= Ü EXTEACT-GEZONDHEIDSBIEE MALZ-CHOCOLADE MALZ- a | S""Ü m BONBONS"" enz. en geene voedingsmiddelen konden zoo algemeen ff S & ff p_i g gebruikt worden als deze fabriekaten. ff 5= % $ £< (203) Dr. J. HIESCHFELD Badarts te Ischl. | jj? - rffo<usa^B:ïi4Pïusa^^ il WGGÜËII C Amsterdam Smalle g PuFijS Ü ajp ë KartHner Rik 11. i 138 roe üg TEcliipiGr. l| ■* 1 öna^;jt|s%pa[iinïj[5^ C. ABERCROMBIE éa C ~ LEVERANCIERS VAN Z. M. DEN KONING DOELENSTRAAT B 70. (209) Orfèvrerie Ghristofle. Bronzen PENDULES CANDELABEES KAMEEKEOONEN HANG- en TAFELLAMPEN Porseleinen TAFEL- en THEESERVIEZEN KEISTALLEN benevens diverse LUXE-AETIKELEN.",http://resolver.kb.nl/resolve?urn=ddd:010873629:mpeg21:a0019:ocr,4,ddd:010873629:mpeg21:p004,Nieuw Israelietisch weekblad,1622
440776,1871/02/21 00:00:00,463,ddd:010099369:mpeg21:a0025,http://imageviewer.kb.nl/ImagingService/imagingService?id=ddd:010099369:mpeg21:p003:image&x=2027&y=6354&w=952&h=463,ddd:010099369:mpeg21,2979,6817,2027,6354,4,ZATERDAG 25 FEBRUARI 1.71; IERSTE BAL MASQUÉ onder directie vau den Heer JÜS. OLIVEIIIA. Fhtrêeprijs voor een Heer met of zonder Dame f \. 99 voor eene Dame ƒ 1. Aanvang 12 Ure. Dameekaarten zijn verkrijgbaar des MORGENS VAN 11 TOT 2 UREN aan het lokaal Frascati.,http://resolver.kb.nl/resolve?urn=ddd:010099369:mpeg21:a0025:ocr,3,ddd:010099369:mpeg21:p003,Algemeen Handelsblad,952
701080,1871/12/07 00:00:00,1031,ddd:000017784:mpeg21:a0025,http://imageviewer.kb.nl/ImagingService/imagingService?id=ddd:000017784:mpeg21:p004:image&x=2206&y=4035&w=680&h=1031,ddd:000017784:mpeg21,2886,5066,2206,4035,4,Die een praktische Almanak voor IM?2 wil hebben koope de Wetelijksclie_ScteiirMeDier. Bjj zeer duidelijke cijfers is op elk blad ruimte beschikbaar voor aanteekeningen hetzij Vergaderingen Verjaardagen als anderszins gedurende den loop der week. Men schtu.t alleen des Zondags een blaadje weg en vult het Memorandum ln. waardoor men de geheele week voor oogen h-eft wat te verrichten valt. Is in alle Boekwinkels aft Cts verkrijgbaar. (7473) ALMANAK Hollanflschß BliiEßßsticßii \ 18 72. (7175) Met Plaatjes. Prss «O Cents. Uitgegeven en verzonden door 8. E. VAN NOOTEN te Schoonhoven.,http://resolver.kb.nl/resolve?urn=ddd:000017784:mpeg21:a0025:ocr,4,ddd:000017784:mpeg21:p004,Het nieuws van den dag : kleine courant,680
2038810,1871/08/11 00:00:00,2278,ddd:010586153:mpeg21:a0009,http://imageviewer.kb.nl/ImagingService/imagingService?id=ddd:010586153:mpeg21:p003:image&x=1817&y=2063&w=895&h=2278,ddd:010586153:mpeg21,2712,4341,1817,2063,10,Harddraverij te Hallnm PRIJS 100 GULDEN in Geld op Dinsdag d Lugustus 1871 . door Kaarden die niet meer dan Drie gead\. I'rijzen onder den Man gewonnen hebben Aangifte bij S. 8. POLSTRA M 12 uur 's middags. HARDDRAVERIJ te Alphen aan den Rijn. Hij . id van de VolksfOOStOn te Alphen Aarlanderveen en Oudshoorn te vieren op den 19 en 23 A e. k  /uilen te Alphen op Dingsdag -houden worden 2 ÉAJIDDRAVERIJEN als: des voormiddag» om In uu van 1 'aaiden  die nimmer een I'rijs gewonnen hebben ; des namiddags om 2 ure van Paarden van /essen klaar. worden uitgeloofd \ i oormiddag- Rarddra PRIJS oen fraai VERGULDEN PENDULE als PREMIE eon POR CELEINEN LAMP. . Barddra. \an aeaaen klaar e. n I'KI.IS van f 250 en eene PREMIE van f5O beiden ... De Paarden moeten twee uur te voren ter Keuring aanwezig zijn op den Stal van de Wed. L. T r WIT te Aarlanderveen. Alphen . 7 Augustus 1871. Namens de Commissie J. II kim; KW 1.1 N J C \ huiii.Ki; Voorloopig Beril»!. HARDDRAVERIJ lij M 008TERH01 l te Ho/urn .on m Augustus a. s. om nader te bepalen PRIJS. De Ondergeteekende geeft luj de/e I»  delijk te kennen aan hare geëerde Begunstigers.dat /ij roornemei SMEDERIJ met behulp van een flinke- Moesterknocht aan te houden. Neemt daarum de vrijheid zich beleefdelijk aan te hevelen in alle- wal lot het Smidsvak behoort; alsmede wat hei Kagchelvak aanbelangt belovende in allee eene prompte en i-iv iele bediening Leeuwarden. Wed \ || ROGGENBURI Doctor DE LA FAILLE Eewal~ i- lot en nut Woonsdag 16 Augustus uit de stad.,http://resolver.kb.nl/resolve?urn=ddd:010586153:mpeg21:a0009:ocr,3,ddd:010586153:mpeg21:p003,Leeuwarder courant,895
661099,1871/09/29 00:00:00,661,MMHCO01:000065367:mpeg21:a0008,http://imageviewer.kb.nl/ImagingService/imagingService?id=MMHCO01:000065367:mpeg21:p003:image&x=1059&y=127&w=959&h=661,MMHCO01:000065367:mpeg21,2018,788,1059,127,4,OPROEPING. De BURGEMEESTER van GENEMUIDEN maakt bekend dat op de JAARMARKT aldaar invallende Dingsdag den 17 October aanstaande gfeene draaimolens kramen stalletjes straatmuziek en in het algemeen geene openbare spellen zullen worden toegelaten. Genemuiden  22 September 1871. OPROEPING. De bekende en onbekende schuldeischers van J. F. W. DAMAN vroeger grutter en winkelier te Lutten worden verzocht vóór den 1 November e. k. franco opgave te doen hunner schuldvorderingen aan den Heer Mr. MEESTERS Notaris te Dedemsvaart.,http://resolver.kb.nl/resolve?urn=MMHCO01:000065367:mpeg21:a0008:ocr,3,MMHCO01:000065367:mpeg21:p003,Provinciale Overijsselsche en Zwolsche courant,959
2611098,1871/05/28 00:00:00,2703,ddd:010099527:mpeg21:a0004,http://imageviewer.kb.nl/ImagingService/imagingService?id=ddd:010099527:mpeg21:p001:image&x=3973&y=1307&w=966&h=2703,ddd:010099527:mpeg21,4939,4010,3973,1307,4,1. HET SGHEILINGSPAKIET BEVAT: 50 vel goed Postpapier. 25 Gegomde Enveloppen. 1 sterken Pennenhouder. 6 beste Stalen Pennen. 2 Keurige Photografieplaatjes vanGOUPILfe C°. te Parij». 12 Quitantien in 12 Nota's. Alles te zamen slechts 30 Cents. Daar niet iedere m zaken doet zoo kan men ook in piaats van de Qnitantiën en Nota's daarvoor bekomen: zes groote Platen.Teekenstudiën naar Lavater. 3. ~~= HET GULDENSPAKKET. ; • - i- BEVAT: 100 vel best Postpapier. 100 Gegomde Enveloppen. 100 beste Stalen Pennen. 100 Quitantien. 100 Nota's en 1 Stel Wonderkaarten om lemands gedachte te raden Alles te zamen slechts 100 Cents. Daar niet iedereen zaken doet zoo kan men ook in plaats van de Quitantien en Nota's daarvoor bekomen: Een Atlas van 15 goed geteekende en gekleurde Landkaarten ontworpen onder toezicht van P. J. PRlk- SEN naar AROW en SMITH. a. HET RIJKSDAALDERSPAKKET. BEVAT: Eén pak Craemlaid Engelsch postpapier. (120 vel). Eén doos daarbg passende Enveloppes. (100 stuks). Eén gros uitmuntende Stalen pennen. (144 stuks). Eén Faber-potlood. Eén soliden Pennenhouder. Eén gelinieerd Notitie-Boekje. (96 pagina's). Eén fraai gebonden Zakboekje. Eén boek best velin Popatria-papier. Eén 0 0 ii ii met dwarslijnen. Eén pijp fijn rood Lak. Een en ander van de beste qualiteit kost te zamen. slechts JT 2.50. Om den verkoop van dit complete stel Schrijtgarnituur nog meer te bevorderen zullen wg niettegenstaande den lagen prgs van ƒ2.50 daaraan nog eene premie toevoegen en wel aan ieder die een stel koopt daarbij cadeau geven: een exemplaar van het Jaarboekje HOLLANS uitgegeven door mr. J. VAN LENNEP. Keur van proza en poëzie gebonden in sierlijken prachtbund verguld op snede en voorzien van prachtige staalplaten. De prijs van dit jaarboekje was bij de nitgave ƒ 3.90: thans CADEAU. Ot wel: een exemplaar AURORA. Jaarboekjeuitgegeven door S. J. van den Bergh. Keur van proza en poëzie; mede rijk geïllustreerd en buitengewoon prachtig gebonden. De prfjg van dit Jaarboekje was bg de uitgave ƒ 450; thans CADEAU. fflÊÊÊB*' Van beide Jaarboekjes die zooais algemeen bekend is de schoonste zijn welke de Nederlandsche indien een oianuerj__ _uv„_v„—»___.».. «„------ - voor een ander jaar. De verschillende jaren toch wedgveren met elkander in keur yan proza en poëzie in pracht van platen en in uiterlgken sier. .___„__. .at Nog iets. — HOLLAND loopt van 1849—66; van AURORA 1850—66. Beide Jaarboekjes zgn nog fonkelnieuw zien er frisch en onbesmet uit en zijn nog in de papieren couverts gesloten welke er bij de uitgave omgedaan zgn. Zeldzamer en waarlgk meer verrassend aanbod is nog nooitgedaan. B^em^an-TPakketten worden uitgegeven door en zj|n alleen te bekomen bij GEBROEDERS ÈÓ-TER Boekhandelaren Leliegracht RR 78 Amsterdam. .  NB. Voo? buiten Amsterdam zgn deze Pakketten door bemiddeling van iederen Boekverkooper te ontbieden. (16269),http://resolver.kb.nl/resolve?urn=ddd:010099527:mpeg21:a0004:ocr,1,ddd:010099527:mpeg21:p001,Algemeen Handelsblad,966
3249666,1871/12/18 00:00:00,3238,MMGASL01:000361075:mpeg21:a00014,http://imageviewer.kb.nl/ImagingService/imagingService?id=MMGASL01:000361075:mpeg21:p00003:image&x=2751&y=64&w=962&h=3238,MMGASL01:000361075:mpeg21:p,3713,3302,2751,64,4,"Advertentie De ondergeteekenden ontvdngen j&sfëBsÊIsp gelden a deposito in sommen van f to« en de veelvouden van dien met 14 dagen opzegging tot eene rente van 3Vü procent. Gelden op langer termijn worden tegen nadei overeen te komen rente aangenomen. Steenwijk. k*w bk. ih-ji & iwta. JRr rriPK n bj. h «u* MENSCHEN nog nooit beleefd!!! Zulke puik beste JJSEE die Marei Mede Borstelmaker in de Oosterstraat te Steenwijk voor de centen geeft. Verzoeke gunst en recommandatie. PUIK ISESTF IlD-iSCBMPVIl bet srhaapwet 3© Cts. liet Pond bij S. M. HjEEIJWW Oosterstraat Steenwijk. . Tot de levering van goed»  koope en beste KLOMPEN fn allerlei grootte beveelt zich minzaam aan de Wed. URI geb VAN EEKEN. Steenwijk 16 Dec. 1871. IWÊÊÊSP* Ter ""enczno van de meest ingewortelde Rhumatiek Rhumatisebe tand- bals- en hoofdpijn Rhumatische kramp en aandoeningen in den rug de zijde enz. door koude ontstaan bestaat er tot nog toe geen heilzamer en tevens goedkooper middel dan de krachtig werkende ABSHAUBBIN’S OF Anti-Rhumatische Watten. Ieder lijder zal de gewensebte uitkomst ondervinden van deze heilzame Watten wanneer hij slechts zorgt zich van de eebte Anti-Mhn* matische M^atten te bedienen die kenbaar zijn aan de witte kleur aan de fijne kwaliteit aan het formaat aan de stevige pakking en aan de onderteekening der blaauwe omslagen welke daarenboven nog met twee naamstempels zijn voorzien van den Bereider en Hoofd-Dépöthouder A. BREETVELT Az. te Delft die deze Watten o.a. verkrijgbaar heeft gesteld tegen den prijs van 30 cents bij : Wed. K.Timmerman Steenwijk J. K. Remmers Almelo. Mej. Gez. Weghuis Zwolle. H. J. v. d. Vecht Hasselt. J. Korthagen voorheen Mej. A. van Gelder lilokzijl. J. W. Sauer Deventer in Wed. .1. Pondmen voorheen de Bazar. _ Mej. A. J. ten Hagen Kampen. Wed. A. Stevens Enschedé. Th. Verhoeren Denekamp. D. Frijling Dalfsen. Publicatien.",http://resolver.kb.nl/resolve?urn=MMGASL01:000361075:mpeg21:a00014:ocr,3,MMGASL01:000361075:mpeg21:p00003,Opregte Steenwijker courant,962
1626821,1871/06/27 00:00:00,839,ddd:010099573:mpeg21:a0035,http://imageviewer.kb.nl/ImagingService/imagingService?id=ddd:010099573:mpeg21:p003:image&x=3026&y=5976&w=1939&h=839,ddd:010099573:mpeg21,4965,6815,3026,5976,4,Kiesvereeniging R WJR€ÏEItIM*MjI€ï _P_ Kiezers! Ten tweede mate wordt gg geroepen tot het doen uwer keuze voor het LIDMAATSCHAP VAN DE TWEEDE KAMER DER STATEN-GENERAAL. Gij zult te beslissen hebben of de partij van vooruitgang of wel die van stilstand versterkt moet worden. Van de eerste alleen kunt gij ontwikkeling uwer grondwettige rechten verwachten. Van de eerste alleen ongeschonden behoud der Neutrale School. Van de eerste alleen krachtigen weerstand tegen het veldwinnen der Kerkelijke Partijen. Komt dus DINSDAG »7 DEZER trouw ter Stembus en kiest den beslisten voorstander der liberale beginselen: •I. P. BE BOBDE.. AMSTERDAM _ Juni 1871. üe Commissie van Bestuur J. DOMELA NiEÜWENHDIS. R. C. D'ABLAIHG VA N GIESSEHBüKü. R. J. KELDERMAN. P* J- BASTIAANS. H. F. BODEMAN. J* A. LEVY. P. C. ANDRÉ DE LA PORTE. J. REGTDOORZEE. C. NOORDUYN. NB. De Kiezers worden opmerkzaam gemaakt dat overeenkomstig Art. 38 der Kieswet de Stembiljetten alleen kunnen worden ingeleverd aan het Bureau in den Oproei'ingsbnef vermeld. De Buteaux zgn geopend van 's Morgens 9 tot 's Namiddags 5 Uien. i 8?33),http://resolver.kb.nl/resolve?urn=ddd:010099573:mpeg21:a0035:ocr,3,ddd:010099573:mpeg21:p003,Algemeen Handelsblad,1939
947702,1871/01/06 00:00:00,973,ddd:010485741:mpeg21:a0006,http://imageviewer.kb.nl/ImagingService/imagingService?id=ddd:010485741:mpeg21:p001:image&x=1100&y=1238&w=974&h=973,ddd:010485741:mpeg21,2074,2211,1100,1238,4,Winsser de Lange & Go. Echte ARROWROOT (Marauta Arundinacea) in pakjes van 1/2 kilogram. (83) WINSSER DE LANGE & Co. Ontvingen: I>e volgende soorten BLOEMBOLLEN TULPEN. HYACINTHEN. NARCISSEN. CROCUS. ENGELSCHE IRIS. GLADIOLUS. LILIÜM RUBIFERUM. (84),http://resolver.kb.nl/resolve?urn=ddd:010485741:mpeg21:a0006:ocr,1,ddd:010485741:mpeg21:p001,"Java-bode : nieuws, handels- en advertentieblad voor Nederlandsch-Indie",974
1578009,1871/07/04 00:00:00,1507,MMHCO01:000065282:mpeg21:a0010,http://imageviewer.kb.nl/ImagingService/imagingService?id=MMHCO01:000065282:mpeg21:p003:image&x=2007&y=1393&w=1041&h=1507,MMHCO01:000065282:mpeg21,3048,2900,2007,1393,4,Advertentie Groote Societeit. MILITAIR CONCERT VAN HET lste regement infanterie in .den tuin voor heeren leden met hunne dames op Woensdag 5 Julij. Aanvang te 2 uur 's namiddags. DE OPENBARE EXAMENS volgens art.. 22 van het Kon. besluit van 30 Aug. 1864 Staatsblad No. 91 zullea aan de Kijks Hoojiere Burgerschool te Zwolle worden afgenomen van 10 tot 13 Juli a. s. telkens van 8—12 en van 1—4 uren. De Directeur H U B E K T S. NEB9EStLANDSCIIE HANDELMAATSCHAPPIJ. Aanbesteding 11 Julij 1871. Aan belanghebbenden wordt medegedeeld dat de termijn van levering der 16045 st. zwaar illaauw ba* toeil* begrepen in perceel 32 tot en met 47 wordt verlengd en zal loopen van af 1°. Januarij tot uit 0 . Mei 1872. Voor de vervanging van afgekeurde partijen wordt vijf maanden toegestaan.. A msterdam  27 Junij 1871.,http://resolver.kb.nl/resolve?urn=MMHCO01:000065282:mpeg21:a0010:ocr,3,MMHCO01:000065282:mpeg21:p003,Provinciale Overijsselsche en Zwolsche courant,1041
3277696,1871/03/17 00:00:00,3712,ddd:010586090:mpeg21:a0032,http://imageviewer.kb.nl/ImagingService/imagingService?id=ddd:010586090:mpeg21:p010:image&x=981&y=1932&w=883&h=3712,ddd:010586090:mpeg21,1864,5644,981,1932,10,Strand vonder ij. De BURGEMEESTER van WESTDONGERADEEL roept ter reclame op eigenaren of regthebbenden op de volgende uit Zee geborgen Goederen : a. Een vat met PALMOLIE gemerkt C L 163 Z R. b. Een PRAAM lang 7.50 meter en breed 2.10 meter gemerkt binnen boord aan de Steven T. B. 1863 D ZEELUST  waarin eenig TOUWWERK een ANKERTJE 4 GRIJPEN en een IJPEREN KRUK. Ternaard den 15 Maart 1871. De Burgemeester vooonoamd J. KLAASESZ. De Notaris H. DOUMA te Gorredijk zal op Donderdag den 23 Maart 1871 's nademiddags 4 uur bij D. I. Douma te Opeinde provisioneel verkoopen ■ Een stuk GREID- en BOUWLAND  gelegen op de Tieke onder Nijega groot 2-99-20  afkomstig van J. R. Jongsma in 4 perceelen. De Notarissen ATTEMA en DOUMA zullen op Vrijdag den 24 Maart 1871 's voordemiddags 10 uur  ten huize van de Wed. J. P. Boonstra te Siegerswoude bij boelgoed verkoopen : Een BOERENREEUW en BESLAG bestaande hoofdzakelijk in: 8 Koeijen 1 bruin Merriepaard  1 donkerbruin Ruinpaard 3 Schapen  dragtig Zwijn  3 Boerenwagens 2 Ploegen  2 Eggen  6000 pond best gewonnen Hooi 200 bos Rogstroo 200 bos Dekstroo een Mesthoop ongeveer 50 korf Aardappelen eene partij Baggelaar  Kam  Emmers enz. j MEUBELEN en HUISGERADEN als: 2 Bedden 2 Kasten Stoelen  Tafels enz. Finale toewijzing te Worknm. De Notaris TJEBBES zal op Vrijdag den 24 Maart 1871 des avonds 7 uur bij H. Boijing te Workum  finaal verkoopen : Eene WINKELHUIZINGE met Erf op een der beste standen nabij de Markt te Workum. In eigen gebruik bij Fo'ppe N. Wouda. Waarop geboden is ƒ1095. Te aanvaarden 12 Mei 1871. Boelgoed te Workum. !)e Notaris K. TJEBBES te Workum zal op Woensdag den 22 Maart 1871  des voormiddag om 9 uur. ten huize van de Wed. Sjoerd S. Postema te Workum bij boelgoed verkoopen- Eenige MEUBELEN en HUISGERADEN bestaande hoofdzakelijk in ! 1 eiken Kabinet 1 Bureau 1 Klok 2 Kagchels Bed met toebehooren Tafels Stoelen Spiegels Schilderijen Poreelein  Koper  Tin  IJzer  Glas en Aardewerk. Voorts: TUINGEREEDSCHAP eene partij POOT-AARDAPPELEN en hetgeen meer te voorschijn zal worden gebragt. Huizen en Wagenmakerij te Ternaard. R. FOCKEMA. Notaris te Anjum  zal op Zaturdag den 25 Maart 1871  des avonds te 5 ure en ten huize van den Kastelein Broekens te Ternaard provisioneel presenteren te verkoopen : Twee HUIZEN en WAGENMAKERIJ niet Erf en Grond e. a. staande en gelegen in d.' Buurt te Ternaard gemeente Ternaard sectie A nos. 1325  1326 en 1327  groot 4 are 70 centiare in 2 perceelen. Eigen aan de Erven Marten G. Broekens. TE KOOP: Een VEERSCHEP mei ftolledigen Inventaris groot 17 ton zich in een besten staat bei vindende -. Een SCHEEPSHOL in aanbouw oneeveer 22 il 23 ton. 8 Te bevragen bij S. J. HOEKSTRA Seheepstimmerbaas te Sloten.,http://resolver.kb.nl/resolve?urn=ddd:010586090:mpeg21:a0032:ocr,10,ddd:010586090:mpeg21:p010,Leeuwarder courant,883
5151783,1871/01/31 00:00:00,5859,ddd:010485762:mpeg21:a0014,http://imageviewer.kb.nl/ImagingService/imagingService?id=ddd:010485762:mpeg21:p002:image&x=1106&y=85&w=2004&h=5859,ddd:010485762:mpeg21,3110,5944,1106,85,4,"BATAVIA M-PMM-EL A.HCÏ. Regelmatige verzending met iedere Engfelsciie en Fransche IMail tot op den dag der sluiting van Raketten Monsters enz. naar Holland J_>uitscliland Frankrijk Engeland Amerika China Japan en Singapore. Voor de spoedige doorzending en aflevering aan geadresseerden wordt de meest mogelijke zorg gedragen tegen billijkst tarief de vrachten aanmerkelijk verminderd zijnde. Informatien en Verzendingen door tusschenkomst van Batavia. T. JACOMETTI. Correspondenten: Singapore: CRANE Bros. London: Geo W. WHEATLEY & Co. Marseille: Robt. GOWER & Co. Rotterdam: G. P. ITTMANN & ZOON. N.B. Laatstgenoemden belasten zich ook met de inontvangstneming en verzending van GOEDEREN REGALEN enz. per scheepsgelegenheid van Indie naar Nederlana verzonden. (398) The London & Lancashire Fire HSÜHAIGE GOMPAMY. (675) BURT MYRTLE & Co. Agenls. The China & Japan Marine lISII-AI-Ï COMPIII. (676) BURT MYRTLE k Co. Agents. ïet Wei! J. S. BTJRLINGHAM Chirurg-.—Dentist is tot nadere kennisgeving te spreken in het HOTEL DES INDES Bovenverdieping. Batavia 14 Januarij 1871. (652) .m^A- Een WEDUWE uit den deftigen stand 'MSê Hf woonachtig te Amsterdam zou zich gaarne <■» """" met de opvoeding- en moederlijke zorg van twee of drie OOST-INDISCHE KINDEREN bebelasteu tegen eene billijke tegemoetkoming. Reflecterenden gelieven zich met franco brieven te adresseren onder Letters «J. 0. bij den Heer VAN DORP. (653) Bataviasche Tramway. Abonnementskaarten voor Febrax-ij 1871 van af S 9 dezer te verkrijgen aan het Kantoor der Directie (Station BATAVIA). N.B. De nieuwe KAARTEN kunnen nog in deze maand gebruikt worden. (677) Oorlogs-Molest. tfMBËËÈ jëff4i___ De ondergetcekendci) daartoe door sB onderstaande Verzekering-Maatschappij SBSI gemagtigd zijn bereid om tegen eene premie van 1 pCt. RISICO'S TEGEN MOLEST aan te nemen mits per spoedig zeilende Britscle schepen en het bedrag van £ 7000 per Schip niet te boven gaande. De Agenten der „ Home fy Colonial Marine Insurance Company Limited"" gevestigd te London (8197) MACLAINE WATSON & Co. Doctor BECHTINGER vroeger practizerend geneesheer te WEENEN is dagelijks tusschen 11—12 bij de heeren John Pryce in de stad en anders op Noordwijk te spreken. Voor KEEL- en OORLIJDENDEN 's avonds tusschen 67—9 uur. (S 81) B Br voor mij verleden is de heer HERMAN LUBERTUS WIJNKES benoemd tot gevolmagtigde van den heer SIMON GIMBERG in privé en van zijne firma GEBROEDERS GIMBERG & Co. in likwidatie. H. CALICHER Notaris. Soekabaya den 23 Januarij 1871. (664) fg_|_____|___B-_a__. Een gehuwd persoon 28 H|| |jp jaar zonder kinderen in lief bezit van lil» eenig kapitaal bekend met MACHINERIËN CULTUUR en ADMINISTRATIE iv staat ONDERWIJS te geven ook in WIS- en NATUURKUNDE zoekt eene betrekking. Adres: JESSE Sapoeran Bagelen. (665) H____-__H__!^*fc ■Eenc etiuv. e met twee voi- ÉÉ3 Rp wassen Dochters waarvan eene gereg_j___f_r tigd tot het geven van onderwijs zou zich gaarne belasten met de verzorging en het aanvankelijk onderwijs van een paar jonge kinderen. Nadere informatien te vragen aan het Bureau van dit blad onder no. dezer advertentie. (655)",http://resolver.kb.nl/resolve?urn=ddd:010485762:mpeg21:a0014:ocr,2,ddd:010485762:mpeg21:p002,"Java-bode : nieuws, handels- en advertentieblad voor Nederlandsch-Indie",2004
1887114,1871/07/31 00:00:00,2571,ddd:010263270:mpeg21:a0044,http://imageviewer.kb.nl/ImagingService/imagingService?id=ddd:010263270:mpeg21:p003:image&x=3019&y=2819&w=734&h=2571,ddd:010263270:mpeg21,3753,5390,3019,2819,6,benevens vele andere prijzen als: /'SS.OOO fl]m> i a AOOO 13 a ƒ5OO bepaald getrokken worden. De kleinste prijs bedraagt ƒlOB. Ten einde een ii'der in de gelegenheid te stellen zich de kar.s te verschaffen een dier belangrijke prijzen te trekken stellen wij heele stukken verkrijgbaar waarop men op den boyengenoemden datum ƒ350000 /»5000 ƒlOOO enz.enz. gelijk boven opgegeven  kan winnen tegen den prijs ïan J _.— halve voor f% — en kwart stukken voor Wij mogen des te eerder eene zeer belangrijke deelneming verwachten daar wel zelden eene gelegenheid is aangeboden waai bij met zoo geringe kosten en bij eene enkele trekking zoo aanzienlijke Kapitalen kunnen gewonnen worden. Men gelieve de orders ten spoedigste in te zende?. daar de kleine voorraad van de nog in ons bc zit zij ade Stukken spoedig uitverkocht z&i zijn. De toezending van het bedrag geschiedt in kontanten ot postwissels en moet franco plaats hebben. Ongefrankeerde toezendingen worden geweigerd. Na afloop der trekking ontvangt ieder kooper ongevraagd eene volledige trekkingslijst franco en gratis. Van het winnen van groote Prijzen wordt per Telegraaf kennis gegeven. Bovendien wordt de uitslag der Trekking in alle Nederlandsche Dagbladen waarin de tegenwoordige Advertentie geplaatst is bekend gemaakt. (5076) ISENTHAL &C. Commissionairs in Effecten. AMSTERDAM ROTTERDAM (Filiaalhuis) Warmoesstraat Weste Wagenstraat J 574. Wijk 5 No. 681. PS. Men gelieve deze door den Staat geguarandeerde Leening niet te verwarren met de zoo dikwerf aangebodene Klassen-loterijen! Bij deze betaalt men slechts een enkelen keer en heeft er slechts ééne trekking plaats waarbij dadelijk alle boven opgegeven groote prijzen uitkomen. ■■■■■■■■■■HaBBH,http://resolver.kb.nl/resolve?urn=ddd:010263270:mpeg21:a0044:ocr,3,ddd:010263270:mpeg21:p003,De Tĳd : godsdienstig-staatkundig dagblad,734
2783598,1871/05/01 00:00:00,2631,ddd:110533274:mpeg21:a0004,http://imageviewer.kb.nl/ImagingService/imagingService?id=ddd:110533274:mpeg21:p001:image&x=3177&y=1004&w=1058&h=2631,ddd:110533274:mpeg21,4235,3635,3177,1004,4,Ontpakt: BRUIDSTOILETTEN. ZWARTE ZIJDE. BL4AUW en WIT SATIJN. Zwarte gewerkte TULLE Vn GRENADINE. KANTJES en ENTREDEUX. Echte APLIQÜK ZAKDOEKEN en KRAGEN. Zwarte Witte en Geklemde SATIJNEN LINTEN. Geel TA RL AT AN. Zwarte ZIJDEN en KATOENEN FLUWEEL. IIOROLOGIEKOORDJES. Eng. NAALDEN en SPELDEN. Zilveren en Vergulde KNOOPEN met W. (1914) H. A. BAIILMANN & Co. Ancieime liaison Scuffert Combet dfc? Oio. Viennent de recevoir par la malle Frangaise: Une factnrc DE CHAUSSÜRES DE PARIS. (1595) Pas gelosl en onlvangcn: Het Delicieus Sweden iilleonlijlv l>jj LOA POSENG (1916) Bazaar Baroe.,http://resolver.kb.nl/resolve?urn=ddd:110533274:mpeg21:a0004:ocr,1,ddd:110533274:mpeg21:p001,Bataviaasch handelsblad,1058
393875,1871/07/29 00:00:00,575,ddd:000017673:mpeg21:a0020,http://imageviewer.kb.nl/ImagingService/imagingService?id=ddd:000017673:mpeg21:p004:image&x=762&y=1891&w=685&h=575,ddd:000017673:mpeg21,1447,2466,762,1891,4,"Ï.¥.ïl-18f2 ( MET IlOM»E-._)E> PEATE\ ' ia PORTIiEriEV is voor don buitengewoon gjidko-.pen i Prijs van f aft» PER JAAR de Ifltdekeaing ii!o*i_ épengestelil. j l^flF*"" Geen blad levwl »eu ""«JPj I -ii!s-i'rijs zulk een n.r ¦*¦ ¦ jud """"ir en een ui*. ntrijke. ftrai (5; !7 Ard„. -^f /fgjjfi \",http://resolver.kb.nl/resolve?urn=ddd:000017673:mpeg21:a0020:ocr,4,ddd:000017673:mpeg21:p004,Het nieuws van den dag : kleine courant,685
1692889,1871/10/24 00:00:00,2297,ddd:010263342:mpeg21:a0049,http://imageviewer.kb.nl/ImagingService/imagingService?id=ddd:010263342:mpeg21:p004:image&x=1567&y=102&w=737&h=2297,ddd:010263342:mpeg21,2304,2399,1567,102,4,"Bisschoppelijk Seminarie HAGEVELD. De nieuwe Studie-Cursus zal aanstaanden Donderdag 26 October geopend worden. G. F. DRABBE Sem. Reg. Voorhout 19 Oct. 1871. (6735) GAIiAWT-ERIÊIf. Een R. C. jongmensch wenscht gaarne geplaatst te worden in een galanteriën of glas- en porcelein-winkel of in een andere dergelijke zaak. Er zal meer op een juiste behandeling dan op salaris gelet worden. Heeren belanghebbenden gelieven zich met franco brieven te adresseren onder het motto »Glas."" Bureau van de Tijd. (6766) Er worden gevraagd Hulponderwijzers en I4weel_-eiiiig-en aan de scholen van het R. C. Parochiaal Armbestuur te Rotterdam. Adres bij den Hoofdonderwijzer-Directeur den Heer H. H. B. BINNEWIERTZ Kerklaan aldaar. (6764) BUSBUM. Geregelde Pakschuitdienst voor • Goederen en Wasschen tussehen Amsterdam en Bussurn tegen verminderd vrachtloon door Schipper Hk BUS alle Dingsdagen en Donderdagen; ligplaats te Amsterdam Kloveniersburgwal voor de Doelenstraat. Van den Eersten Octo' ber 1871 tot Ultimo Februari] 1872 des namiddagsten 12} ure en van den Eersten Maart tot Ultimo September ten 1 uur • van Amsterdam en van Bussurn Maan[ dag en Woensdag. Bij gesloten water rijdteen Wagen. Bestellingen op dit Veer. De Besteller zal voorzien zijn van een - bestelboek waarin vracht- en bestelloon ; staat opgeteekend en moet hetzelve bij i ieder ontvanger vertoonen. . De Ontvangers worden beleefdelijk ver zocht daar achter hun naam door een • der huisgenooten te laten teekenen om - alle misbruiken te voor komen.  De ondergeteekende verzoekt beleefde lijk gunst en recommandatie. Met hoogachting ben ik UWEd. Dw. Dienaar (6623) Hk BUS.",http://resolver.kb.nl/resolve?urn=ddd:010263342:mpeg21:a0049:ocr,4,ddd:010263342:mpeg21:p004,De Tĳd : godsdienstig-staatkundig dagblad,737
1026720,1871/08/30 00:00:00,1035,ddd:010485938:mpeg21:a0004,http://imageviewer.kb.nl/ImagingService/imagingService?id=ddd:010485938:mpeg21:p001:image&x=99&y=4857&w=992&h=1035,ddd:010485938:mpeg21,1091,5892,99,4857,4,"Verkoop van een Schip. Op Donderdag den 31 Augustus 1871 ten ÏO ure zullen de ondergeteekenden aan den Kleinen üoom verkoopen: ei^i Het Nederlandsch Barksehip mDEN ELSHOUT j_£_____|fc^ meende 629 Tonnen gebouwd in 10.7^^^^^^ 1844 en nieuw gekoperd in December 1869 gevoerdggew-st door Kapt. K-. IC. TepfrwT^? mBt INVENÏARIB bestaande uit: DUBBEL vrDD ZLILEN> ANKERS KETTINGEN TROSSEN BOOT SLOEP en VLET alles in een koop. En verder: ir™ £^!l?JEUW TOUWWERK ZEILDOEK BLOKmw™»^' Een cH»ONOM.ETÈR Een BAROMETER Een SEXTANT Een LANGE KIJKER enz. enz. Het schip ""dagelijks te bezigtigen en informatien zijn te bekomen bv de Heeren J. DAENDELS & Co. en bij de ondergeteekenden ' J (4692) VAN VLEUTEN & COX.",http://resolver.kb.nl/resolve?urn=ddd:010485938:mpeg21:a0004:ocr,1,ddd:010485938:mpeg21:p001,"Java-bode : nieuws, handels- en advertentieblad voor Nederlandsch-Indie",992
2771178,1871/06/29 00:00:00,2967,ddd:010099575:mpeg21:a0035,http://imageviewer.kb.nl/ImagingService/imagingService?id=ddd:010099575:mpeg21:p004:image&x=3976&y=61&w=934&h=2967,ddd:010099575:mpeg21,4910,3028,3976,61,4,"mr S. STOKVIS *\„ Heiliaenweg D 240. Gemaakte-Hêerenkleedin - Heerenartikelen en Uitruk tingen voor O. en ""W. Indië. m__\*_iionE. In een stil ordelijk gezin vraagt men tegen Augustus een nappe burgerlijke DIENSTBODE van den P. G. als M _!_■ LLLEEN. De hierep reflecteerenden vervoegen zich onder de _tt. H. K. K. Bureau Handelsblad. (19469) Heden den 29sten Juni 1800 een en zeventig ten verzoek» 'an _. PETBONELLA VAN WIS zonder beroep wenend» e Helden Weduwe van JAN BOLLEN en B. van alle har» onderen als I°. ANDRIES MATHIS BOLLEN Molenaar t» lelden; 2°. MABIA ELISABETH BOLLEN Landbouwster ildaar Weduwevan HENDRIK JOOSTEN; 3°. ALDAGONDA JOLLEN Molenaar te Aldenrijck (België) Weduwe van JA:0B HOUBEN; 4*. PETRONELLA BOLLEN en haar ma» 3RISTIAAN EAEDEMAKERS Verver te Maeseyk (BelgiS) lic zfln Echtgenoote tevens bflstaat en machtigt; s°. JAN WILLEM BOLLEN Pastoor te Thora; 6°. JOSEPHINA BOLJEN Overste in het klooster te Heythuyzen en 7°. ANNA «ARIA BOLLEN Landbouwster te Helden Weduwe va» rAN COENDERS hebbende allen een en hetzelfde belang roor wie in rechten occupeert en zal voortvaren te occupeev •en Mr. CONSTANT GUILLON Procureur bfl de Arrondissenentsrechtbank te Roermond wonende te Roermond heb ik jndergeteekende CASPER HÜBERT SIVBÉ Deurwaarder b» le gemelde Bechtbank wonende en gepatenteerd te Boermona Mits deze uit kracht van een verlof door meergemelde Rechtbank bfl vonnis verleend de dato Vijftienden Jnni jl. behoorlijk op de daarvan uitgereikte grosse geregistreord _EM DERDENMALE GEDAGVAARD: GERARDBOLLEN laatst gewoond hebbende te Helden doch thans afwezend_e_ wel I°. door aanplakking van een afschrift dezer dagvaarding aan de voorname deur der vergaderplaats van genoemde Rechtbank en 2* aan het Hnis der Gemeente Helden binnen welk» ie gedaagde zijne laatste woonplaats gehad heeft beneven» ioor beteekening aan den Edel Achtbaren Heer Officier van Justitie bfl de Arrondissementsrechtbank te Roermond mfln exploot doende op zijn parket aldaar alwaar zijnde en sprekende tot Zfln Edel Achtbaren in persoon die mfln Origineel met gezien geteekend heeft; Alsmede door plaatsing van dusdanige afschriften in d« Kedtrlandtche Staatscourant en in het Algemeen Handelsblad van Amsterdam; — Om te verschonen op Donderdag den Vflfden October 1800 een on zeventig des voormiddags ten klokke tien uren voor de Arrondissementsrechtbank te Roermond zittende in hare gewone kerechtzittingszaalinhet Paleis van Justitie aldaar — TEM EINDE - _'■'-""'_■_ Aangezien de gedaagde is de respectieve Zoon Broeder en Behuwdbroeder der verzoekers; Aangezien hfl zflne laatste wooonplaats te Helden in het jaar 1800 twee en vflftig heeft verlaten en vandaar naar Amerika vertrokken is zonder volmacht tot het waarnemen zflner iaken gegeven of order op het beheer daarvan gesteld te nebben; Aangezien de laatste tflding door den gedaagde aan zflne voornoemde bloed- en aanverwanten in 1800 een en zestig is jegeven uit Jefferson Maréan County Feyas (Noord-Amerika) sn er sedert al dien tfld nu bijna tien jaren geleden geene Eekerheid bestaat omtrent zfln aanwezen of overlijden; Aangezien de requiranten na meerdere berichten van onder* icheidène zflden te hebben ingewonnen alle reden hebben te gelooven dat gemelde GERARD BOLLEN overleden is zoolat er allezins termen zfln om de verklaring van rechtsvermoeden van het overlflden des gedaagden te doen uitspreken. Mitsdien hetzij in persoon hetzij lemand van zflnentweg» te doen blijken dat hn Gedaagde nog in leven is; terwijl in geval van niet verschflning door de Verzoekers zal worden lisch gedaan dat het der Rechtbank moge behagen na verhoor ran het Openbaar Ministerie te willen verklaren dat er rechttrermoeden van Overlflden van voornoemden GERARD BOLLEN bestaat en wel sedert den eenfn dertigsten December 1800 Een en Zestig. Met Winst van Kosten. Waarvan Akte. De Kosten zfln enz. (get.) C. H. SIVRE Dr. Voor eensluidend Afschrift: (19692) C. H. SIVRÉ Dr. *•",http://resolver.kb.nl/resolve?urn=ddd:010099575:mpeg21:a0035:ocr,4,ddd:010099575:mpeg21:p004,Algemeen Handelsblad,934
5317060,1871/06/16 00:00:00,5368,ddd:010262774:mpeg21:a0042,http://imageviewer.kb.nl/ImagingService/imagingService?id=ddd:010262774:mpeg21:p003:image&x=73&y=90&w=3681&h=5368,ddd:010262774:mpeg21,3754,5458,73,90,6,"Waalwijk 14 Junij 1871. Heden overleed alhier den Heer .10--bEPHUS WALTHERUS PETRUS GAST: voorzien van de HH Sacramenten der btervenden m den ouderdom van ruim 37 Jaren- (4593) Hoofddorp in de Haarlemmermeer. Den 6"" Junij jl verloren ds Parochianen van den H. Joannes de Dooper plotseling hunnen beminden en onvergetelijken Herder den ZeerEerw. Heer JOANNES VROLIJK wiens stoffelijk overschot den 9"" daarna plegtig ter aarde werd besteld op het R. C. Kerkhof aldaar. De groote toevloed ""der geloovigen de meer dan 600 parochianen die voor ZijnEei w. tot de tafel des Heeren naderden de nette grafkelder met een schoonen steen gesloten aan zijne nagedachtenis gewijd en de groote droefheid bij de plegtigheid der begrafenis waren alle zoovele getuigen wat de ontslapene Herder in zijn leven was voor zijne dierbare Parochianen. Bovenal gevoelden de armen en ongelukkigen en niet het minst nog de kinderen wat zij verloren in den voor hen allen te vroeg ontslapenen Herder. Geen wonder dan ook dat de ZeerEerw. Heer Taverne Pastoor te Rotterdam de rouw een zoete rouw durfde noemen omdat zijne wenken hem volgden. De plegtige Uitvaartdienst werd opgedragen door den Hoogwaardigen Heer H. van Beek Vicaris-Generaal van den Bisschop van Haarlem bijgestaan door den Zeer Eerw. Heer C. L. Rijp Pastoor te Amsterdam  en den Zeer Eerw. Heer P. A. Claasen Deken en Pastoor te Ouderkerk terwijl de Zeer Eerw. Heer Taverne  gevolgd door eenet alrijke priesterschaar Familie en een grooten toevloed van geloovigen het lijk ter aarde bestelden. De Parochianen van den H. Joannes de Dooper. Eenige Gemeentenaren. 9 Junij 1871. (..596) Voor de vele bewijzen van belangstelling en deelneming zoowel hier als van buiten bij ons Huwelyk ondervonden betuigen wy bij deze onzen hartelijken dank. Amsterdam M. P. V. JANSSEN 15 Jung 1871. M. C. W. JANSKEN(4SBB) Brugman. De Ondergeteekenden betuigen hun hartelijken dank voor de vele blijken van belangstelling bij de voltrekking van hun Huwelijk ondervonden. F. A. J. KAAG. E. M. KAAG-Schermer. Hoorn 14 Juni 1871. (4569) (4587) Voor de vele bewijzen van deelneming betoond bij het overlijden van onze geliefde Moederen Behuwdmoeder Mejufvrouw de Weduwe MAAS geboren van Zul betuigen wij onzen hartelijken dank. Leiden Uit aller naam 14 Juni 1871. J. M. L. MAAS. Voor de R. K. school voor lager onderwijs te Nijkerk wordt gevraagd een Hoofdonderwijzer tevens bekwaam om het orgel in de parochiekerk aldaar te bespelen. Het salaris aan beide betrekkingen verbonden is ƒ 500 met vrije woning terwijl het vooruitzigt bestaat dat het salaris mettertijd zal verbeterd worden. Candidaten voor deze betrekking genegen worden verzocht zich ten spoedigste per brief te wenden tot den ondergeteekende H. F. J. TER SCHOUW. (4511) Pastoor aldaar. (4579) Voor een sedert jaren ge vestio-d Sigaren-Fabriek wordt tegen goed loon gevraagd: lemand met de werkzaamheden van het vak bekend en tevens geschikt voor Binnenlandsche Reizen  liefst tusschen 20 en 30 jaren. Kennis van de Duitsche en Fransehe taal kan tot aanbeveling strekken. Opgave van informatien onder Lett. A. B. aan het Bureau dezer Courant. _(4595) Er biedt zich aan eene R K~ DIEIBTBODE voor Mefd aiïeen' hetzij m of buiten de stad tegen Augus-' tus oud 25 jaar. Men adrelseererich Pius-Feest-Sigaren O- Z- Voorburgwal hoek St. Jansstraat J. 234. (4593) R. VAN DEN BERG. C'FFÊ Dl (MPO Dl FIOM vroeger gevestigd te Rome thans in de Warmoesstraat tusschen de St. Annastraat en Wijdekerks eeg J. 31 te A-fISTERDAHI. Beveelt zich met de Piusfeesten in de gunst van alle belangstellenden aan. (4540) t_______M_H_-_^_a-B------M-----------l Het publiek wordt bijzonder opmerkzaam gemaakt op de in het Courant van heden geplaatste advertentie der firma S. Sacks & Co. in Uamburg welke door hunne prompte & reële bediening tegenover hun geënterresseerden het volste vertrouwen in alle opzigten verdient. (4064) PIUS-CONGERT in het Paleis voor Volksvlijt op Dinqsdaq 20 Juni 1871. TEKSTBOEKJES voor dit Concert zijn met vergunning te bekomen a 15 Cents bij den Boek- en Muziekhandelaar H. A. ZWEERS Kalverstraat bij de Munt D 152 alhier en UI I E ir op den avond van het Concert in het Paleis voor Volksvlijt. Zij zullen echter tevens verkrijgbaar zijn op Vrijdag en Zaturdag 16 en 17 Junij in het Locaal y>De Keizerskroon"" Singel bij de Vijzelstraat bij het bekomen van Toegangskaarten en het bespreken der Plaatsen aldaar  van 's morgens tien tot 's middags vier uur. (4582) ZOUAVEN-BROEDERSCHAP „FIDËI ET VIRTÜTI"" te Amsterdam. De plechtige Hoogmis voor Z. H. Pius IX ter bijwoning waarvan deOud-Zouaven van buiten de stad worden uitgenoodigd en waaronder de Generale Communie van bovengenoemde Broederschap zal plaats hebben zal opgedragen worden in de Kerk van den H. Franciscus van Assisië (De Boom) Kalverstraat bij de Munt ten lialf elf ure. Namens het Bestuur W. H. LEURS Voorzitter. J- J. A. LEMAIRE Selcretaris. Amsterdam 15 Junij 1871. . (4592)",http://resolver.kb.nl/resolve?urn=ddd:010262774:mpeg21:a0042:ocr,3,ddd:010262774:mpeg21:p003,De Tĳd : godsdienstig-staatkundig dagblad,3681
3084867,1871/03/15 00:00:00,2913,ddd:110533235:mpeg21:a0007,http://imageviewer.kb.nl/ImagingService/imagingService?id=ddd:110533235:mpeg21:p001:image&x=2152&y=3298&w=1059&h=2913,ddd:110533235:mpeg21,3211,6211,2152,3298,4,Op Zalurdag den _ssten Maart 1871 des voormiddags te 10 uren zal in het Lokaal van het VcrrriiiEittürtoïftE* tic ES;i(avi;i openbaar verkoclit worden: Een ERF bebouwd met STEEN EN WOONHUIS met pannen gedekt  en dito bijgebouwen staande en gelegen aan de Zuidzijde van het Koningsplein blok M deel sectie 111 verpondingsnurmner BSSI taxatie /' 22000.—; thans bewoond door den WelEdel Gestr. Heer 11. J. VAN DER PLAS; huurprijs ƒ2O o—-'s maands. De gemachtigde der eigenaren en der henejiciaire Erfgenamen van vrouwe P. Ingram geb. Ungerer (1197) I. H. J. HOEK. Wogen!?; >'ortrek zal ondergclcckondc op ZaTURDAG den _5 dezer in het Veiuhilokmil alhier publiek verkoopen: Het KUIS en ERF staande en gelegen aan het Koningsplein Ihans bewoond door den Heer Mr. U. F. LAST. Batavia 14 Maart IS7I. (1209) W. VAN DER VALK. Billiton-Maatschappij. In de eerste helft der maanden JUNI AUGUSTUS OCTOBER en DECEMBER 1871 zoomede van FEBRUARI en APRIL 1872 zullen te BATAVIA in veiling worden aangeboden door het HOOFD-AGENTSCHAP DER NEDERLANDSCH-INDISCIIE HAND ELS BA N K aldaar: telkens p. iv. 7800 pikols BILLITON-TIN. t in kavelingen van 100 blokken wegende ruim 50 pikols. Het TIN is voor af te bezichtigen indien men daartoe zijn verlangen te kennen geeft aan het Hoofd-Agentschap voornoemd. De Billiton-Maatschappij DE GROOT. Manga- 2 Maart Wil (1091),http://resolver.kb.nl/resolve?urn=ddd:110533235:mpeg21:a0007:ocr,1,ddd:110533235:mpeg21:p001,Bataviaasch handelsblad,1059
2718426,1871/11/18 00:00:00,2713,ddd:110533428:mpeg21:a0008,http://imageviewer.kb.nl/ImagingService/imagingService?id=ddd:110533428:mpeg21:p001:image&x=2093&y=1033&w=1002&h=2713,ddd:110533428:mpeg21,3095,3746,2093,1033,5,■ ; Vendu tic op I)IlN/]SüA(. den'2l November a. s. op het I-Teeiiirnxlenplein i van diverse pas aangebragte D.JATTIE BALKEN van verschillende afmetingen door (5291.) JOHN PRYCE & Co. Let wel!!! VENDUTIE op VVroeii}S<lti«>- clou 23öten VOOR HET COMMSSIEIIUIS VAN W. Loonen & Co. Van een partijtje keurig SPEELGOED Parfümeriön en Surprises KINDERSCIIOMMELS en MANOENW AGENS GALANTERIEN Dames-Artikelen en meer anderen zeer geschikt voor CADEAUX alles in knopjes gearrangeerd. Heeren Zadels met compleet HARNACILEMENT Provisien Dx*aiiken enz. enz. Badhanddoeken Heeren hemden SERVET- en TAFELLAKEiNGOEI) Gemaakte HEEREN KLEEDEREN en HOEDEN ÉÉN en DUBBELLOOPS JAGTG KWKR L;l>. (5253),http://resolver.kb.nl/resolve?urn=ddd:110533428:mpeg21:a0008:ocr,1,ddd:110533428:mpeg21:p001,Bataviaasch handelsblad,1002
2926195,1871/12/06 00:00:00,2935,ddd:010486023:mpeg21:a0019,http://imageviewer.kb.nl/ImagingService/imagingService?id=ddd:010486023:mpeg21:p002:image&x=2125&y=510&w=997&h=2935,ddd:010486023:mpeg21,3122,3445,2125,510,6,Mme. Bailly St. Laurent. Par Malle Frangaise: Couronnes Eventails Gants Voiles et Souliers pour Mariées. Fleurs Organdie Tarlatane rosé et jaune COI SETS de Paris. MANCHETTKS pour Dames. Faux-cols Manchettes et Üants pour Hommes etc. etc. (7123) Encadreinents Dorures. Réparations' Enseignes en tous genres. Adresse: (7124) TOKO BAILLY St. LAUEENT. Wederom ontvangen : C. M. BAUERNPEIND Elemente der Vermessungskunde. Dritte Auflage mit 603 Holzschniiten und 22 Tafeln. Franco p. post ƒ 13. (7126) G. KOLFE & Co. Bij de ondergeteekenden verkrijgbaar ; Flowers PALE ALE in vaatjes en afgetapt. ROODE WIJN RHIJNWIJNEN COGNAC enz. (7127) VAN SLOOTEN MOEGAN & Co. Echt LINNEN DRILL Fijn Zwarte ALPACA WATERPROOF TRICOT Engelsche HEMDEN en BOORDJES Zwarte en Witte DASJES ZIJDEN PARAPLUIJEN HELMHOEDEN enz. (7128; VAN SLOOTEN MOEGAN & Co. Australisch Jarra-Hout SINGAPORE PLANKEN Gegalvaniseerd DAK-IJZER en GOTEN. PORTLAND CEMENT. Granieten Steenen. (7129) VAN SLOOTEN MOEGAN & Co.,http://resolver.kb.nl/resolve?urn=ddd:010486023:mpeg21:a0019:ocr,2,ddd:010486023:mpeg21:p002,"Java-bode : nieuws, handels- en advertentieblad voor Nederlandsch-Indie",997
512644,1871/05/11 00:00:00,764,ddd:000017605:mpeg21:a0022,http://imageviewer.kb.nl/ImagingService/imagingService?id=ddd:000017605:mpeg21:p004:image&x=1457&y=2575&w=671&h=764,ddd:000017605:mpeg21,2128,3339,1457,2575,4,Begrafenisonderneming TAN C. F. H E IJ N E N. Deze Onderneming belast zich met de zorg voor BEGRAFENISSEN en al wat daartoe behoort tegen vaste en billijke Prijzen volgens Tarief te bekomen ten Kantore. (2265) Huidekoperstraat Z 762. Uitvallen van het Haar. Het bij ondervinding zeker werkende middel om het uitvallen te beletten en den groei der Hoofdharen te bevorderen is op franco aanvrage verkrijgbaar bij C.J. SCHULD Apotheker te Bameveld a 50 ets. de halve en 90 ets. de heele Pot. (2970),http://resolver.kb.nl/resolve?urn=ddd:000017605:mpeg21:a0022:ocr,4,ddd:000017605:mpeg21:p004,Het nieuws van den dag : kleine courant,671
2426994,1871/05/15 00:00:00,2474,ddd:010485849:mpeg21:a0007,http://imageviewer.kb.nl/ImagingService/imagingService?id=ddd:010485849:mpeg21:p001:image&x=2062&y=3376&w=981&h=2474,ddd:010485849:mpeg21,3043,5850,2062,3376,4,Heden per Mail ontvangen: Neerlands Vloot en Reederijen door H. Sweijs. (2981) G. KOLFF & Co. Batavia. Verkrijgbaar bij H. M. VAN DORP Batavia : Goedkoop en sterk MISrWRTJKI. (2913) in 't groot en in 't klein. ~ ATELIER WOODBURY & PAGE. Geopend dagelijks van 7 tot 11 nre. PORTRETTEN in elke grootte gekleurd en ongekleurd. CARTES DE VISITE per 1 Doz. ƒ 15 volgende ƒ 10. GABÏNET PORTRETTEN per le afdruk/ 15 volgende ƒ 2 MIDDELSOORT id. 1 „20 „ 3 EERSTE id. 1 „30 „ 5 DIRECTE VERGROOTING van „50 tot „ 100 VERGROOTE REPRODUCTIE  „50 „ „ 300 Deze laatsten kunnen gemaakt worden naar alle mogelijke soorten van Portretten. AFNEMEN VAN HUIZEN le afdruk ƒ 50 volgende / 3— GEZIGTEN en LANDSCHAPPEN groote soort pr. st.„ 250 ld. KLEINE soort en TYPEN per Doz. - 4— LIJSTEN voor Portretten van elke grootte. (4256) SUIKER RAFFINADERIJ LEttOUX & Co. Sniker in mandjes van 30 & netto f 9— idem 15 „ „ „ 450 in brooden per stnk „ 2— 9) Photographiscii Atelier Dagelijks geopend van 7-10 uur.,http://resolver.kb.nl/resolve?urn=ddd:010485849:mpeg21:a0007:ocr,1,ddd:010485849:mpeg21:p001,"Java-bode : nieuws, handels- en advertentieblad voor Nederlandsch-Indie",981
378950,1871/09/23 00:00:00,550,ddd:000017719:mpeg21:a0022,http://imageviewer.kb.nl/ImagingService/imagingService?id=ddd:000017719:mpeg21:p004:image&x=2167&y=1989&w=689&h=550,ddd:000017719:mpeg21,2856,2539,2167,1989,4,148884 | Egmonds Knipprenten.! Deze fraaije ln verscheidene kleuren ge- i drukte PEAJiPKEXTEU zijn in 24 | soorten a IO Ct. en ln 24 soorten (Kleinere a 0 Ct. brj eiken Boekhandelaar voorhanden. (6042) J. VLIEGER UMI,http://resolver.kb.nl/resolve?urn=ddd:000017719:mpeg21:a0022:ocr,4,ddd:000017719:mpeg21:p004,Het nieuws van den dag : kleine courant,689
115236,1871/10/21 00:00:00,132,MMSADB01:000004431:mpeg21:a0004,http://imageviewer.kb.nl/ImagingService/imagingService?id=MMSADB01:000004431:mpeg21:p002:image&x=324&y=908&w=873&h=132,MMSADB01:000004431:mpeg21,1197,1040,324,908,6,Advertentie Vervolg der Berigten en Advertentiën zie Bijvoegsel.,http://resolver.kb.nl/resolve?urn=MMSADB01:000004431:mpeg21:a0004:ocr,2,MMSADB01:000004431:mpeg21:p002,Provinciale Noordbrabantsche en 's Hertogenbossche courant,873
3564356,1871/07/15 00:00:00,1802,ddd:010983954:mpeg21:a0009,http://imageviewer.kb.nl/ImagingService/imagingService?id=ddd:010983954:mpeg21:p004:image&x=2154&y=67&w=1978&h=1802,ddd:010983954:mpeg21,4132,1869,2154,67,4,flft Nedcrlandsch-lndischc Stoomvaart Maalschappij jrj Dienstregeling over het jaar 1871. Van Batavia naar Singapore vi& Muntok en Riouw. Januari den lSden en 27sten. Juli den 9den en 28sten. Februari „ lOden „ 24sten. Augustus „ 6den „ 20sten. Maart „ lOden „ 24sten. September „ Sden „ 17den. April „7 21 sten „ SOsten. October „ lsten „ 20sten. Mei - „ 14den „ 28sten. November „ 2 17 „ Juni „ Uden „ 25sten. December „ 1 15 „ 28sten. NOOKÜKUBT VAN JATA. „y j)e BOOT die den Ben. en löen van Batavia naar Soerabaia vertrekt kan op aanvraag Cher\bo*i Tagal en Pekalongan aandoen. Van Samarang naar Batavia 5 11 17 23 en 29 van elke maand. M „ „ Soerabaia 6 12 18 24 en 30 „ „ jjo-. De BOOÏ die den sen 17 naar Batavia vertrekt kan op aanvraag Pekalongan Tagal •' (Jheribon aandoen. MOLUKKEN. Van Samarang via Makassar naar de Molukken en Timor op den 12den van elke maand. Naar de Molukken via Menado in de maanden Januari Maart Mei Juli September en November Timor-Koepang in de maanden Februari April Juni Augustus Octo ber en December. BANDJEBMASBING. Van Samarang via Bawean naar Bandjermmsing op den 24sten van elke maand. LIJN 11 AC ABB AR —SINGAPORE Yice- Versa. Vau Samarang eens in de maand. Vertrekdagen zullen geannonceerd worden. De Agenten (NSS2) Mc. XEILL & Co. I ii • il ii ■ in ■ n •■ i,http://resolver.kb.nl/resolve?urn=ddd:010983954:mpeg21:a0009:ocr,4,ddd:010983954:mpeg21:p004,De locomotief : Samarangsch handels- en advertentie-blad,1978
4166666,1871/06/26 00:00:00,2009,ddd:110533320:mpeg21:a0008,http://imageviewer.kb.nl/ImagingService/imagingService?id=ddd:110533320:mpeg21:p002:image&x=1082&y=4201&w=2074&h=2009,ddd:110533320:mpeg21,3156,6210,1082,4201,4,1 ! gpf >L Nederiaiidscii Indische Siooiuvaart slaalsdiappij.!; I Regeling van de diensten der Stoomschepen \ over de maand Julii 1871. I' ■- / 3 Julij Batavia van Batavia naar Soerabaya via Kustpl. en Samarang.  3 „ Koningin Sophia „ Soerabaya „ Batavia „ Samarang en Kustpl. 3 „ Baron Bentinck „ „ Macasser. j 1 7 „ Singapore „ Batavia „ Singkawang via Billiton en Pontia- i nak en terug. t 9 „ Konino Willem 111 .... „ „ „ Samarang Soerabaya de Molukken! e en Gorontalo. j a 9 h Koningin Sophia // „ „ Singapore via Muntok en Riouw. e i 9 „ Vice President Prins . . . „ Soerabaya „ Batavia „ Samarang. 10 „ Minister Fransen v. d. Putte. „ Batavia „ Padang via Telokßetong en Benkoelen i t en terug via Benkoelen en Telok Be-< g tong. i 10 Minister v. Staat Rochussen. „ Soerabaya „ Bali Beliling via Pasaroean Probo- 1 lingoBezoekiBanjoe\vangie enterug. c 14 / Koningin der Nederlanden . „ Batavia „ Singapore. 1 15 / Vice President Prins . . . „ „ „ Soerabaya via Kustpl. en Samarang. I 15 „ Batavia . . Soerabaya „ Batavia n Samarang en Kustpl. ( 15 „■■ W. Cores de Veies ..../ Batavia ~ Tjilatjap „ Anjer. j i 17 i Baron Bentinck „ Samarang „ Singapore. i |21 n Hatavia „ Batavia „ Soerabaya „ Samarang. i 21 „ Baron Si.oet van de Beele . u Soerabaya „ Batavia nu I s 23 // Singapore // Batavia „ Palembang „ Muntok. |-i 23 „ Koningin Sophia n „ „ Singapore / „ en Riouw. 11 25 u Minister Fransen v. d. Putte. ;/ „ „ Padang via Kroë Engano en Ben- ; < koelen en terug via Benkoelen en Kroë. j i 27 // W. Cores de Vries. . . . „ „ „ Soerabaya via Samarang. it 27 „ Vice President Prins . .. „ Soerabaja „ Batavia „ Samarang. < 28 „ Minister v. Staat Rochussen. „ f Bandjcrmassing via Bawean. ! ( 28 h Koningin der Nederlanden . „ Batavia „ Singapore. i > De Marine Super-Intendent der Ned. Ind. Stoomv. Maatschappij |c S. VAN HULSTIJN. ' i \ 11 Vracht en Passage te bespreken: te Samarang bij de Heeren McNEILL & Co. t (2725) „ Soerabaya „ „ w FRASER EATON & Co. c i,http://resolver.kb.nl/resolve?urn=ddd:110533320:mpeg21:a0008:ocr,2,ddd:110533320:mpeg21:p002,Bataviaasch handelsblad,2074
3190188,1871/06/15 00:00:00,3203,ddd:110533311:mpeg21:a0008,http://imageviewer.kb.nl/ImagingService/imagingService?id=ddd:110533311:mpeg21:p002:image&x=67&y=70&w=996&h=3203,ddd:110533311:mpeg21,1063,3273,67,70,4,Met toestemming van tt;n Resident van Batavia. Groot Amerikaansch Cirque. Onveranderlijk de laatste Drie Voorstellingen Dingsdag Donderdag en Zaturdag. Elke avond volgens een nieuw Programma. ZATURDAG den 17den Junij 1871 eerste en eenige VOORSTELLING BIJ DAG. KINDEREN betalen Ijair geld terwijl voor SCHOLEN en andere inrigtingen overeenkomsten kunnen gesloten worden bij Mr. POLLOCK Java lUtel. Het Bureau is geopend ten © uur. Aanvang der Voorstelling ten 41/» uur. der plaatsen: Eerste Rang (besproken) . ..ƒ4. Tweede „ ■....„ 2. Derde „ 1. PLAATSEN kunnen besproken worden op den dag der voorstelling. Het Bureau voor de Avond-Voorstelling-en is geopend ten 8 uur. Aau vans te Sl/» uur. De Rijtuigen kunnen te 11 uur weder besteld worden. De Agent (2589) Mr. F. H. POLLOCK. Met toestemming van den Heer Resident. Vrijdag 16 Junij 1871 geheel nieuw PROGRAMMA bestaande uit 12 Nummers. De Groote VereenigdeTroupe TYCOON JAPANEZEN en KUB ffilffll |in het Komediegebouw. F. PAGE Manager. F. STEBBING Direkteur. (2594),http://resolver.kb.nl/resolve?urn=ddd:110533311:mpeg21:a0008:ocr,2,ddd:110533311:mpeg21:p002,Bataviaasch handelsblad,996
2135059,1871/05/07 00:00:00,2503,ddd:010586112:mpeg21:a0013,http://imageviewer.kb.nl/ImagingService/imagingService?id=ddd:010586112:mpeg21:p004:image&x=2804&y=85&w=853&h=2503,ddd:010586112:mpeg21,3657,2588,2804,85,6,"BOELGOED Van 1 Meubelen en Huishoudelijke Goe&W /.oomede SCHOENMAKERS-ARTIKETp^ Maandag 8 Mei 1871 oamiddae n '°P •2 uur ten huize van F. Boekelrnan ■** Groote Hoogstraat te Leeuwarden ' ln de L- HARMEN2OB boelgoed. A. VOET te Leeuwarden zal ten  van A. G. ORIE qq. op Woensdag den?n°?ke 1871 des voormiddags 9 uur ten lmi ' O. Kuipers in de Groote Kerkstraat aldaf V&a gen dadelijke betaling verkoopen- Mw\^' EEN en HUISGERADEN als: Mal c'hiffn' eikenh. Kabinet 2 dito Secretaires mft' p fels Spiegels Stoelen Kagchels Koper nT I en Aardewerk  Bedden met toebehooren ' Bakkers en Winkelgeroedschapr.erocrts Zuurketel Builmolen Troggen Platen T nen  Trompen  Winkelkast Toonbank ' |>| * ken en hetgeen meer zal worden aan«ebori Te bezigtigen daags bevorens des""voor!?; dags van 9 tot 12 uur. 00rm«l. BOEIiGOEB. A. G. ORIE te Leeuwarden zal on Dnnri dag den 11 Mei 1871 des namiddag 2 u ten sterfhuize van Mejufvrouw IJtie van d»1 Meer in het Sint Anthony Gasthuis aldaar koopen: Eikh. Kabinet dito Kastje Tafef"" Stoelen  Spiegel Schilderijen  Kagchel' Kon Glas en Aardewerk Bed met toebehoore eenige Lij fd ragt enz. n> Te bezigtigen des voormiddags van H tot 12 uur. Voorloopige Aankondiging 480 hektaren buitengewoon best BOUWLAND in den Oost- Einder-Poelpolder onder Aalsmeer en Nieuwer! Amstel waarvan vóór twee jaren het Koolzaad werd verkocht en Het GEWAS van 67 hektaren Rogge 10 hektaren Tarwe en 284 hektaren Haver zullen op nader aan te kondigen dag en plaats in de eerste helft der maand Julij a. s. worden geveild. Te huur met 12 Mei door toevallige omstandigheden: Een roijaal INTREK met vrijen Opgang een aangenaam uitzigt hebbende en van vele gemakken voorzien zijnde. Te bevragen letter D no. 59  Naauw  Leeuwarden.",http://resolver.kb.nl/resolve?urn=ddd:010586112:mpeg21:a0013:ocr,4,ddd:010586112:mpeg21:p004,Leeuwarder courant,853
4775832,1871/11/20 00:00:00,4696,ddd:010984056:mpeg21:a0025,http://imageviewer.kb.nl/ImagingService/imagingService?id=ddd:010984056:mpeg21:p004:image&x=1098&y=78&w=1017&h=4696,ddd:010984056:mpeg21,2115,4774,1098,78,6,Pas ontvangen: Echt Maastrichter POMPLEDER verkrijgbaar per pond en per vel (3640) bij de Weduwe GOTTSCHALK. F. MARIOTAT & Co. In voorraad: Heeren verlakt- was- en witlederen Schoenen. NB. Alle bestellingen worden met spoed en accuratesse geëffectueerd. '2588) Loten in de loterij Maatschappij van Toonkunst a vijftien gulden by A. J. DE BORDES Batavia. (3611) ZADELMAKERIJ. MOBCH & Co. 6am urans. Steeds rnlm voorzien van alle artikelen hun vak betreffende als: Heeren- en Dameszadels Hoofdstellen Buiksingels Stjjg. beugel- en Staartriemen Vilten Schabrakken Zweepen en Karwatsen Tly- en Wagenstangen Stijgbeugels etc etc. te veel om op te noemen. Bestellingen op Wagentuigen als andorzins worden met spoed en accuratesse geëffectueerd. Alles tot minstens even lage prijzen als eigens elders te bekomen. (2710) Liqueur du Père Kermann-.Absinth- Fransche Pruimen Hui Ie d'Olives Olives Farcies- Marasquino- Vruchten op Water van Teyssonnean DIVERSE FRANSCHE PATÉS. (3651 By REIBIGER & Co. PETROLEUM^ wordt by Chs BOYBR goedkooper verkocht dan ergens anders. (2969) Per ARIA en BETST heb ik ontvangen: NAAIMACHINES van Oei ff er die zoowel met de handen als met de voeten bewerkt kunnen worden; Garen Band Fransche zwarte Naaiiijde zoo ook in alle kleuren : Zijden Finweel en Taf; Lint per el; fijne Odeurs EAU DE COLOGNE Vinaigre de toilet een lederen Koffer; Haakpennen Rijgpennen enz BLAKANG KEBON. (8125) DE VRIES. ATELIER CAMERIK Photoqbatis poetbetten gekleurd op ongekleurd in iedere grootte zoomede groepen en gebouwen. Portretten in Olieverf & Pastel. Dagehjks geopend van half 8 tot 10 uur 's morgen». Samarang (8083) TAWANG C. 236. Toko Huygens. fj| Ruim voorzien: ÊL luL voor et c°^aas feest» Rfv'^fc^/\ van ai'e soorten van Spelen; als pracli- tige Poppen ook met volledige Garderobes Kinder- en Poppenwagens van mandewerk Stoelen en T»fels withouten Loopwagens goed geacheveerde Kinderwagens Zandkarren Sabels Geweren Trompetten Waltherens Chacots Hobbelpaarden Gummi-ballen Zweepen Hoepels Toverlantaarns. enz. tevens heerlijk St. Nicolaas gebak in groene trommels. Verkrijgbaar tegen 5 December: yersche BANKETLETTER. IV. Es. De Toko zal van den lsten tot den 6den December iederen avond geopend zijn. (8648') F. MARIOTAT 4 CO. PAS ONTVANGEN: EEN GROOTE VOORRAAD ENtiELSCHE WAGEN VEEREN in verschalende dimensiën benevens ecu factuurtje WIELEN van Europceech fabricaat. (3667),http://resolver.kb.nl/resolve?urn=ddd:010984056:mpeg21:a0025:ocr,4,ddd:010984056:mpeg21:p004,De locomotief : Samarangsch handels- en advertentie-blad,1017
6252099,1871/06/26 00:00:00,4703,MMHCO01:000065275:mpeg21:a0016,http://imageviewer.kb.nl/ImagingService/imagingService?id=MMHCO01:000065275:mpeg21:p004:image&x=157&y=33&w=1327&h=4703,MMHCO01:000065275:mpeg21,1484,4736,157,33,4,Advertentie KIESCOLLEGIE! In het waar belang onzer Nederduitsch-Hervormde Gemeente wenschen wij dat al hare belangstellende stemgerechtigde leden met ons zullen stemmen VOOl' een feiescollegie. Zwolle  24 Juni 1871. Het Bestuur der Vereeniging voor C7iristelyfce belangen te Zwolle In zijn naam J. B. ter MEULEN. TE K.ÖOP een fraaije BÜ14* met net WAGESTJE en TUIG. Brieven franco  letter B bij den boekhandelaar B. BERGHUIJS te Kampen. PRIMA KWALITEIT PORTLANÜSCHE CEMENT TOT ZEEK BILLIJKEN PRIJS bij II© FM. AM» Zwolle. De verkoop van Obligatiën der Oostenrijksche Staats-Prcmie-leeningcn is in alle landen geoorloofd. Eene enkele Trekking. 3 2 3 S 32 l.s.3 O Maal fl. 5.000 // // 2.000 // // 1.5 00 // // 1.000 n H 400 // // 180 II. 20CMÏ00 // 40000 // 30000 // BOOÖ© // 4©€5© // 4.5SÏO // §.OfïO // 13SOO // zijn te winnen bij de op 1 JULIJ 1371 plaatsvindende Trekking der 00STEMIJKSUHE PREMIE-LEENING VAN 18 5 8. Uitgegeven na vergunning en gegarandeerd door de Iieiz. Ivon. Oostenr. Monarchie volgens allerhoogst besluit van 1 Febr. 1858. Wij verkoopen stukken in bovenstaar.de leening geheel of ten deele waarmede men op 1 Julij 1871 een der bovengenoemde groote prijzen of een deel daarvan winnen kan. Volgens de door ons voor dezen verkoop af te geven ce rtificaten heeft men voor geheele stukken slechts / 8.— // // halve // n n 4.— // // kwart n n n Sg.— // // achtste n u u fl.— te betalen. Wij mogen des te meer taïs*ijlie bestelltn» gen te gemoet zien  daar slechts zelfleai de gelegenheid is aangeboden  met geringe kosten reeds bij eene enkele trekking zoo groote prijzen te kunnen winnen. Sedert 1 .juli SS5S . zijn de trekkingen dezer leening begonnen en er hebben reeds .32 trekkingen plaats gehad met dezelfde groote prijzen als bij de trekking op 1 Jiiii IS71 daardoor hebben zich de voorhanden zijnde Seriën zoo zeer verminderd <. dat de nog in de gelukskans overblijvende wegens hun gering auntal e«n groote kasss op winst aanbieden. Tegen inzending van het bedrag in geld of postwissels (geene postzegels) worden bestellingen prompt naar alle oorden uitgevoerd. Ongefrankeerde brieven worden niet aangenomen. Na afloop der trekking ontvangt ieder kooper zonder voorafgaande aanvraag eene uitvoerige trekkingslijst franco en gratis. Buitendien wordt de uitslag der trekking in de voornaamste dagbladen aangekondigd. Groote prijzen worden per Telegraaf medegedeeld. Jsenthal & C. Commissionairs in Effecten. AMSTERDAM WARMOESSTRAAT  J 574.,http://resolver.kb.nl/resolve?urn=MMHCO01:000065275:mpeg21:a0016:ocr,4,MMHCO01:000065275:mpeg21:p004,Provinciale Overijsselsche en Zwolsche courant,1327
3133060,1871/05/19 00:00:00,1610,ddd:010485852:mpeg21:a0011,http://imageviewer.kb.nl/ImagingService/imagingService?id=ddd:010485852:mpeg21:p002:image&x=73&y=28&w=1946&h=1610,ddd:010485852:mpeg21,2019,1638,73,28,4,"VAN DEN ABEELEN & Co. Stadhuisplein. PALEMBANGSCHE ROTTINGMATTEN. ■_?«*_« „„ rUwïi™'™ Wiinnn leksteenen met stelling. ïpc en Ordinaire Wijnen. MEUBELEN. CHAMPAGNE. jaTaSe SSlen. po™™ - ™E*A- ziTdetsels' Engelsch en Hollandsen Bier. MAILROFFERS ' £S™ °HE STOELEN""NT A A TM A PTTTNTPQ VERLAKT LEDER. iNüüimüOnilNJliÖ. REGENJASSEN met Kappen. PESra™uMLAMPEN. Pleet- Verlakt en Koperwerk. PETROLEUM. „.. . . Berlijnsch Tafelzilver. ™ZU S r m EET- en THEESERVIEZEN. MUURFONTETNTJES. AMERIKAANSCHE WIELEN. Koperen- en tinnen KAMERPOTTEN. do. EMMERS. ZEEMLEDEREN LAPPEN. WATERCRACKERS. KANTOORDRAAISTOELEN. BOTER. PAREUMERIEN. HAM. Baptisten ZAKDOEKEN. KAAS. Diverse Provisien. FrailSCh Speelgoed. * ¥ «n^II €1 14 mm SI "" ll* IMITATIELEDER Eerste kwaliteit. Amerikaansche en Schwartzwalder a™Sra^Ls. KLOKKEN. PAINKILLER. (3024)",http://resolver.kb.nl/resolve?urn=ddd:010485852:mpeg21:a0011:ocr,2,ddd:010485852:mpeg21:p002,"Java-bode : nieuws, handels- en advertentieblad voor Nederlandsch-Indie",1946
2622459,1871/10/31 00:00:00,2657,ddd:010485992:mpeg21:a0006,http://imageviewer.kb.nl/ImagingService/imagingService?id=ddd:010485992:mpeg21:p001:image&x=2135&y=1243&w=987&h=2657,ddd:010485992:mpeg21,3122,3900,2135,1243,4,Vendutie op Maandag den 6 November 1871 weg-ons vertrek  ten huize van den WelEdelGestr. Heer ]*_-¥. O. J. ü. Straeter in de Gang. Patjenongan door VAN VLEUTEN & COX van eenen goed onderhouden INBOEDEL. als: SPIEGELS SCHILDERIJEN ROTTINGMEUBELS CONSOLES en TAFELS met Marmeren bladen Een fraaije ÉTAGE HE KAST HOEK-ÉTAGÈ RE-KASTJES JAPANSCHE GOEDEREN MAHONIEHOUTEN KASTEN TOILET PSYCHE. Een voor dit klimaat vervaardigde IPI^JNIINO (van E_R__k.M>). Een en twee persoons en kinder IJzeren LEDEKANTEN Een van Ambonhout twee persoons LEDEKANT in Europa vervaardigd GLAZEN KASTEN een groote EETTAFEL BUFFET met Marmeren blad SCHRIJFTAFEL enz. enz. PALEMBANGSCHE ROTTIXGMATTEN fraai PLEETWERK EETSERVIES CRIóT.VL- en GLASWERK JAPANSCHE MARTEVANEN. Voorts : Alles wat tot eene goedgeordende huishouding behoort: Een fraaije collectie BLOEMEN van ruim Ï000 potten. Diverse ROZEN en ZELDZAME PLANTEN. Voorts: 1 CALÈCHE van Oudarl. 1 HANDWAGEN met lossen bok. 1 span goede Overwalsche PAARDEN. TUIGEN enz. enz. Geene goederen kunnen worden bijgebragt. Op Zondag den sden ie bezigligen. (64-07) Vendutie op Dingsdag den 7 November 1871 voor het Commissiehuis van W. LOONEN & Co. Eene keurige partij Kinderspeelgoed iii kleine koopjes. Eene kist ODEURS en ZEEP die bij kleine kavelingen opgeveild worden zeer geschikt voor Cadeaux. GLAS- cnPORCELEINWERK. enz. enz. (6403),http://resolver.kb.nl/resolve?urn=ddd:010485992:mpeg21:a0006:ocr,1,ddd:010485992:mpeg21:p001,"Java-bode : nieuws, handels- en advertentieblad voor Nederlandsch-Indie",987
2459235,1871/06/29 00:00:00,2447,ddd:010485885:mpeg21:a0007,http://imageviewer.kb.nl/ImagingService/imagingService?id=ddd:010485885:mpeg21:p001:image&x=2124&y=2988&w=1005&h=2447,ddd:010485885:mpeg21,3129,5435,2124,2988,4,"Vendutie op Vrijdag den 7 Julij 1871 voor het Commissiehuis van W. LOONEN & Co. s van diverse Koopmaiisgoedcrcn LIJNWADEN GLASWERK DRANKEN IJZERWERK f31?66) enz. enz. """"publieke verkoop van Onroerend Cfoed. Zaturdag den vijftienden Juli 1871 zal door den Ondergeteekende ten overstaan \en ten Kantore van het Vendudepartement alhier des morgens ten tien ure publiek worden verkocht Be navolgende Perceelen | gelegen in de stad Batavia buurt Amanus-grachl allen I ten name van SITIE MARIAM BINTIE SECH ACHMAD SAI: - Een stuk GROND verp.'No. 2647 getaxeerd ƒ 480.— » » id. „ „• 2fi46 id. „ 240.— » » id. „ „ 1838 id. „ 750.— „ ERF bebouwd met ecu vervallen HUIS met pannen gedekt verp. No. 6711 getaxeerd „ 2000.— (3609) HEIJNING qq. ""PUBLIEKE verrooping. Op Zaturdag den twee en twintigsten Julij 1800 een en zeventig des morgens ten tien uren zal door den ondergeteekende in het Lokaal van het Vendu-Departement alhier door diens tussehenkomst publiek worden verkocht: Een .ïS*""f bebouwd met een STEENEN HUIS en dito blokken BIJGEBOUWEN allen met pannen gedekt gelegen in de Residentie Batavia buurt of wijk Tana- Abang verponding No. 8792. Deze verkoop geschiedt ten laste van de gezamenlijke erfgenamen van J J. VAN DER BIESEN en ten behoeve van het Weduwen- en Weezoufonds van Burgerlijke Ambtenaren in Nederlandsch-Indie krachtens Raadschuldkennis dd. 10 September 1862 no. 216. De Officier van Justitie bij den Raad \ van Justitie te Batavia (3764) R. VAN GOENS.",http://resolver.kb.nl/resolve?urn=ddd:010485885:mpeg21:a0007:ocr,1,ddd:010485885:mpeg21:p001,"Java-bode : nieuws, handels- en advertentieblad voor Nederlandsch-Indie",1005
2433512,1871/07/01 00:00:00,1324,ddd:011101572:mpeg21:a0014,http://imageviewer.kb.nl/ImagingService/imagingService?id=ddd:011101572:mpeg21:p002:image&x=1891&y=3335&w=1838&h=1324,ddd:011101572:mpeg21,3729,4659,1891,3335,4,"INSPUITING CADET. 7 Boulevard Deuain. — PARUS. Oe Inspuiting Cadet* weler samenstelling gebaseerd is op de ob- |||gjgl servatie en naauwbeurige kennis der ge- ✓ cito-urine orgagnea vult ecne tot heden - bestaande leemte op in de behandeling der kwalen de*er jrganea hel publiek eenvoudig aangeboden zonder J hil de minste pretentie er heefl geen over®""U3flSfi""i""Sa drijving tan prjjs vorm of grootte der [CERTAINEetINFAIIUBLEI fasschen plaats welke laatste zooveel '• hbaHßaaaHMlßll vloeistof bevatten'is verscheidene ande- ■■■■■WSWWW ' [lUlil*! re *an deielfde beschrijving welker ui- Bj|i{t]KflllJH»Kl I Ph-B.Denain7 J Perjlakoo met gifcrqiksaanwjiiin^/3—. Op frmko uavran verkrijgbaar: • - 1 .y.t.iAt&'.'ki -M ■'• •' : ■ \ •""' ••• . . - Generaal Depót;«'""J; Boulevard D«nain„ Pöts*. (856) : i.-» r. i.'l Hoofd-Dcpót-iitr.Samiirtï CHATEUN Padam.",http://resolver.kb.nl/resolve?urn=ddd:011101572:mpeg21:a0014:ocr,2,ddd:011101572:mpeg21:p002,Sumatra-courant : nieuws- en advertentieblad,1838
3351532,1871/08/28 00:00:00,3780,MMGASL01:000361060:mpeg21:a00003,http://imageviewer.kb.nl/ImagingService/imagingService?id=MMGASL01:000361060:mpeg21:p00001:image&x=1021&y=1493&w=992&h=3780,MMGASL01:000361060:mpeg21:p,2013,5273,1021,1493,4,Advertentie De Notaris* «W* ft* MMp FSïM ’szal tember 187!  des namid dags om 2 uur ten huize van KLAAS KU KMANS te Steenwijk ten verzoeke van Mej.ftc Wed. T. 15. IlIJKMANS aldaar publiek verknopen: liet Grasgewas van een stuk land  gelegen bij het Verlaat groot p. m. 2'h Dagtnad. gsosa De Notaris *1. G. BB. VVT TE SB IIOB’^T  zal op ttL. Donderdag den 7 September EurVO 1871 des voormiddags om 10 uur te sterfhuize van Mej.de Wed. IIARM RIJKMANSTz. buiten de Woldpoort te Steenmijk publiek verkoopen: Een NETTE IMBOEBEE. ïfta».ae in: 1 mahpnijhotjtenLinnenkast 1 dito Lintfonière dito Bureau Kagchels Stoelen Tafels Spiegels Schilderijen Porcelein- bias- Aardewerk 4 Bedden met toebehooren eemge Mannen- en Vrouwen-kleederen. Voorts gouden- en zilveren Voorwerpen als: 1 gouden Hoofdijzer dito Knoppen Ketting Ringen enz. 1 zilveren Tabaks loos dito Room- Thee- en Suikerlepeltjes. Eindelijk een Kapchai» en hetgeen meer zal worden te voorschijn gebragt. De Goederen zijn te bezien op Woensdag den 6 September des namiddags van 2 tot G uur. He- Notaris S®. II. I • VAN MARLE zal op I 871 des namiddags om drie uren ten huize an JAN NIJK. te Steenwijk namens de Wed. 3ERNs. GREVEN publiek verburen: Een Boeren W oonhuis met §ehunr Erf en Grond staande en gelegen te Steenwijk in de Wheemstraat door nu wijlen BEKNs. GREATEN bewoond geweest. (920) jb De Notaris B®. BB. 1®. VAS my-y MARGE zal op Maandag den 28 gplsl?' Augustus 1871 des avonds om 7 uur] en volgende avonden ten huize van J- KARSTEN te Oldemarkt namens de Koopman KiJAöUUür publiek verknopen: Eene a a n z i e n 1 ij k e partij GalanterieffOcdci*Cll ^ bestaande lioofdzakenjk m • Spiegels Schilderijen verlakte Goederen van Trommen Presenteerbladen ^ Schenkketels en Theestoven Porcelein Kristal en verder Glaswerk Messen Vorken en Lepels mahonvhouten Tabak- en Lepeldoosjes Pij pestandaars eene groote partij Kantoorbehoeften verschillende soorten van Zeep en heteeen verder te voorschijn zal worden o-ebra'R de goederen zullen zijn te bezien op iederen verschijndag van des voormiddags van 10 tot 12 en van des namiddags 2 tot 1:1 (921) De Notaris 1®. Bi. !*• VAM IjBags MARGE zad °P Woensdag den dmmËÈ 30 Augustus 1871 des voormiddags om 10 uren ten huize van Bk. PRINS te Oldemarkt namens H. M. DE. BOER . bij boclgoed verkoopco: 1 Een Kabinet een Bureau een Secretaire 3 Bedden met toebehooren Spiegels en . Schilderij Tafels Stoelen Koper- Tin- : Blik- Porcelein- Glas- en Aardwerk. ’ Voorts onderscheidene KtuKtiCrsiJCI vc(lschappen als Builmolen  Baktrog  Bak-,http://resolver.kb.nl/resolve?urn=MMGASL01:000361060:mpeg21:a00003:ocr,1,MMGASL01:000361060:mpeg21:p00001,Opregte Steenwijker courant,992
1918880,1871/11/04 00:00:00,2864,ddd:000017755:mpeg21:a0020,http://imageviewer.kb.nl/ImagingService/imagingService?id=ddd:000017755:mpeg21:p004:image&x=2861&y=96&w=670&h=2864,ddd:000017755:mpeg21,3531,2960,2861,96,4,"7mAA\M****\\\*+m**** De «iKerae™» »«"""" ;HH Bh^^ dacht wordt gevestigd op M^^^ MISS H\t H de I *¦¦ Arme Blinde welk nieuwste verhaal van WILKIE COLLINS thans verschgut in de kolommen van de Olijftak voormalig Geïll. Sïutvers-magazijn. Uitgaven vau I. DE HAAN ta Haarlem: I. A. CRDTS OEFENINGEN OVER DE Nederlandsche Taal voor kweekelingen voor inrichtingen van middelbaar onderwijs eu voor Gynmasiën. Prijs 35 Cts. Dr. H. HERK HANDLEIDING BIJ HET Onderwijs ier Neierlanische Taal. 2 stukken. 5e druk. / 1.80. J. A. ll\ DI.IH. Nederlandsche Spraakkunst voor inrichtingen van middelbaar en lager ondeiwgs. 2e druk. ƒ O 35 Cts. J. A. VAN DIJK. Beknopte Neflerlandsche Spraakkunst voor lagere scholen. 2e druk. 12 Cts. T. LAGERWEY Theoretisch en Praktisch Leerboek DER ALGEBRA OF STELKUNST. Derde druk op nieuw herzien door Dr. T. Knottenbelt. 2 deelen. ƒ 3.60. Heden alom verzonden: Dr. J. VAS VLOTEN Zielkundig-Historische Inleiding TER ALGEMEENE EN NEDERLANDSCHE TAALKENNIS. Uitgave van I. DE HAAN te Haailem. Prgs \t- f I.SO. Bij VAN HOOGSTRATEN & GORTER te Zwolle ziet heden het licht: Geschiedenis VAN HET TWEEDE FRANSCIIK KEIZERRIJK van Ham tot Wilhelmshöhe. Naar den vierden diuk nit liet Fransch VAN EMILE LECLERCQ door (6686) .1. B. RIETSTAP. Een (raal groot B°. boekdeel Prijs ƒ 1.80. In eiken Boekwinkel voorhanden.",http://resolver.kb.nl/resolve?urn=ddd:000017755:mpeg21:a0020:ocr,4,ddd:000017755:mpeg21:p004,Het nieuws van den dag : kleine courant,670
2265128,1871/03/04 00:00:00,1070,MMHCO01:000065181:mpeg21:a0016,http://imageviewer.kb.nl/ImagingService/imagingService?id=MMHCO01:000065181:mpeg21:p004:image&x=1155&y=155&w=1964&h=1070,MMHCO01:000065181:mpeg21,3119,1225,1155,155,4,Advertentie RHEINISCH-WESTFALISCHEN LLOYD transport-verzekeringsmaatschappij teffl. Gladbach. Voor bovengenoemde maatschappij worden verzekeringen afgesloten door ZWOLLE 3 Maart 1871. DAMMA1I & VAM BIJLGVELT. STOLLWERGK'sche BORST-BONBONS. MET PREMIEN BEGIFTIGD OP ALLE TENTOONSTELLINGEN. Eene zamenvoeging van Suiker en zulke Kruiden-Extracten wier weldadige werkingen op de Ademhalings-organen door de geneeskundige faculteit is vastgesteld. Depóts dezer Borst-Bonbons zijn in Zwolle bij Zwolle G. Eleveld & Zoon en K. du Pré Bazar. Almelo H. Smale. Blokzijl D. de Ruiter. Dedemsvaart apoth. Eckma. Delden A. B. Gerritsen. Enschede apoth. Baurichter. Enter  H. J. Plaggemars. Epe  S. O verbosch. Genemuiden Erven D. Rigterink. Goor A. J. Hoek. Harderwijk  E. J. Fijn van Draat. Iïengelo C. A. J. Hooft. Kampen J. van Beverwijk. Koevorden apoth. G. K. F. Marchand. Meppel apoth. K. de Vries. Nijkerk apoth. de Roock. Raalte J. H. Schrader. Steenwijk Schurink en ten Brink. Wijle B. G. Elfrink.,http://resolver.kb.nl/resolve?urn=MMHCO01:000065181:mpeg21:a0016:ocr,4,MMHCO01:000065181:mpeg21:p004,Provinciale Overijsselsche en Zwolsche courant,1964
5179496,1871/05/05 00:00:00,5068,ddd:010983895:mpeg21:a0027,http://imageviewer.kb.nl/ImagingService/imagingService?id=ddd:010983895:mpeg21:p004:image&x=1101&y=839&w=1022&h=5068,ddd:010983895:mpeg21,2123,5907,1101,839,4,Goede Lectuur! NIEUWE UITGAAF! Voor leesgezelschappen bibliotheken enz. enz.! de Groot Kolff & Co. hebben ontvangen: Miniatuur Bibliotheek (formaat van de Guldens-editie) BEVATTENDE ONDER ANDEREN: Toussaint Graaf Pepoli; Brieven en Uitboezemingen van den Ouden Heer Smits; Brunings de Gouverneur; Dr. ten Brink Oost-Indische Dames en Heereu; Apostelen en Profeten (Gedichten van Beets ter Haar ten Kate van Lennep enz.) van Zeggelen Keur van scherts en Luim; Lod. Mulder Jean Faessen; Gerard Keiler Een Zomer in het Noorden enz. enz. Te zamen 55 deelen tegen / 60 slechts. (1036) Wederom ontvangen: Lofodinsche Levertraan van S. Braisma van Valkenburg te Leeuwarden. (1481) SOESMAN & Co. MEQBEL-MAGAZIJN BOUMA Ta wang. Steeds voorzien van ijzeren ledikanten bultzakken klamboes. (144 f) Deensche BOTER in blik. (1483) SOESMAN & Co. Toko «X van Gent. 0 | MODEWAREN f 5 EN [2964] g § ProviHÏëu en Dranken. s s I 5 SIGAKEN. i§ o ag neerenstraat. Pas ontvangen: Groote keus van medaillons voor 1 tot vijf portretten gouden ringen manchetknoopen rammelaars zilveren kurken en kinderbelletjes. (1256) PLIJNAER. J. H. SCHMIDT Marclmnd-Tailleur SAMABAN6 .Ruim voorzien van Lakens Tricots soorten Hoeden versierjelen Borduursels voor civiele Ambtenaren en Militairen enz. enz. Bestellingen vf orden spoedig en billijk uitgevoerd. (1248) Pas ontvangen: vVit en gekleurd Tarlatan breed Satijn Schotsch ceintuurlint dito effen zijde ceintuurlint Fluweelen ceintuurlint Emal gekleurd fluweel lint voor Chignons echte en valsebe Chignons echte Haarvlechten prachtige keus gekleurde alpaka's dito dito gekleurd linnen zeer geschikt voorwandelcostnmes effen gekleurde stofjes als: perl-grijs feuter en bruin Zijden popeline's Barège en Mousseline wit en zwart Nit.yu gekleurd en gestreept Satijn wit Moiré wit zijden Bayadère voor Bruidsjaponnen echte geborduurde Zakdoeken echte kanten Zakdoeken Batisten Zakdoeken zwarte en bruine Stroohoeden witte en zwarte paardenharen Hoeden Fluweelen Dames- en Kinderboeden zwart Fluweel Fluweelen en zijden Jakken gekleurd Mousseline Jakjes witte fijne Blousen zwarte Blonsen wit Organdie 10-4 breed zwart en grijs Tricot zeer geschikt voor amazone Japonnen en Kinderpakjes fijn wit piqué Klamboegoed franjes eu kant voor gordijnen Heeren- en Kindersokken Dameskousen en Heerendassen. (1384) PLIJNAEB. IT CA RL LANG. E -2 _. j M  Lithograaph |L i Ü EN £§ M STEENDRUKKER f «= Vervaardigt ook -~~- 4 NAAMPLATEA'enGRAFZERKEN W S op g=> g MAKMER I 3 (1952) en % ■% andere Steensoorten. Konijnenatraat O&lllïiriinjJ Arsenaal. g • — TOKO HUIJGENS ontvangen: NIHJ U W ö PJW tóLGO JE D als : prachtige TOOVEIt-LANTAARNS Chineesche SCHIMMEN GEZONDHEIDsPIJPEN fijne TOILET-ZEEPEN [DAM-en SCHAAKBORDEN met SCHIJVEN en STUKKEN Engelsoh METALEN THEEKOMFOORTJES enz. (500),http://resolver.kb.nl/resolve?urn=ddd:010983895:mpeg21:a0027:ocr,4,ddd:010983895:mpeg21:p004,De locomotief : Samarangsch handels- en advertentie-blad,1022
4439374,1871/03/09 00:00:00,5062,MMSADB01:000004115:mpeg21:a0014,http://imageviewer.kb.nl/ImagingService/imagingService?id=MMSADB01:000004115:mpeg21:p002:image&x=2865&y=287&w=877&h=5062,MMSADB01:000004115:mpeg21,3742,5349,2865,287,6,Advertentie Burgeraeesler^cWethouders van Vlijmen maken bekend dat er eene ten laste dier gemeente zal plaats hebben van f11500. tegen eene rente van 4V 2 ten honderd per jaar. De aandeelen zijn groot f 500. — en worden naar verkiezing der inschrijvers op naam of aan toonder afgegeven. De inschrijvingsbiljetten in voormelde Leening moeten vóór of uiterlijk op 1 April e. k. bij Burgemeester en Wethouders zijn ingekomen. Inschrijvingen beneden pari worden niet aangenomen. Vlijmen 3 Maart 1871. Burgemeester en Wethouders voorn. J. A. CORMAN. De Secretaris J. NIEUWENHUIJZEN. Door den Notaris te Helmond wordt in het openbaar GEVEILD: Op Dingsdag den 14 Maart 1871 bij inzet ter Herberg van de Wed. THEODORUS DREESEN te Helmond en op Dingsdag den 28 dier maand bij toeslag ter Herberg van den Heer J. P. H. VAN DER LINDEN aldaar telkens des avonds om 6 ure. Onder Helmond. a. Van CORNELIS ADRIAANS. Een Huis Erf en Tuin kadaster Sectie C. Nos 673 1682 1684 en 1932 ter grootte van 8 Aren en 9 Centiaren. b. Van W. VAN DER VELDEN. Een Huis en Erf kadaster Sectie D. N° 290 groot 1 Are 38 Centiaren. Onder Mierlo. Een perceel Hakhout op Medevoort kadaster Sectie A. N° 822 groot 17 Aren 90 Centiaren. Inlichtingen ten Kantore van den Notaris DIJKHOFF. DOOR DEN NOTARIS mmm dijkhqff te Helmond wordt in het openbaar Geveild en VERKO CHT: Onder .A.arle-Ifcixtel. Ten verzoeke van de Erven van wijlen Mejufvrouw MARIA PETRONELLA BOTS. HET OUD-ADELLIJK KASTEEL van RIXTEL genaamd het Guldenhuis omgeven met Grachten en Cingels  zeer vruchtbare Tuinen en Boomgaarden beplant met extra fijne Fruitboomen. Het geheel wordt omstroomd door de rivier de Aa en de Zuid-Willemsvaart en is alleraangenaamst gelegen aan gemelde Vaart in de onmiddellijke nabijheid van den Provincialen Kunstweg op slechts 'U uurs afstand van de belangrijke Fabriekplaats Helmond en het Staatsspoorwegstation aldaar; voorts met het daarbij behoorend in Zilver gesneden Adelijk Wapen van de voormalige Grondheeren van Rixtel Cijnsboek en verdere Ap- en Dependentiën. Eindelijk de aan de omgeving van het Kasteel belendende Bouwhoeve met vruchtbare BoUWen Weilanden. Het Kasteel met de Gronden die het omgeven heeft eene oppervlakte van 5 Hectaren 56 Aren 10 Centiaren en het daarbij gelegen Bouwmansbedrijf eene oppervlakte van 7 Hectaren 22 Aren 55 Centiaren zamen 12 Hectaren 78 Aren en 65 Centiaren. De Goederen zullen worden geveild in perceelen in verschillende massa's en eindelijk in eene generale massa. Aanvaarding: de Gebouwen en Erven Pinksteren 1871 Tuinen Boomgaarden Weiland Cingels en Dreven terstond en het Bouwland Oogst aan de Stoppelen in 1871. Betaling der kooppenningen 1 Julij 1871. Deze Verkooping zal geschieden bij inzet op Donderdag den 16 Maart 1871 en bij toeslag op Donderdag den 30 Maart 1871 telkens ten Herberge van G. VRIENS te Aarle-Rixtel des namiddags om 2 uur precies. Inlichting te bekomen ten kantore van den Notaris DIJKHOFF voornoemd.,http://resolver.kb.nl/resolve?urn=MMSADB01:000004115:mpeg21:a0014:ocr,2,MMSADB01:000004115:mpeg21:p002,Provinciale Noordbrabantsche en 's Hertogenbossche courant,877
3356342,1871/06/12 00:00:00,5002,ddd:000017632:mpeg21:a0019,http://imageviewer.kb.nl/ImagingService/imagingService?id=ddd:000017632:mpeg21:p004:image&x=41&y=146&w=671&h=5002,ddd:000017632:mpeg21,712,5148,41,146,4,"KIEZERSVEREENIGING I „AMSTEuDAM."" | ag 13 Junij ¦ 11 door de Vei uuvDeetfsch ' kis: ¦ Ka: .1 ii (wit slem'riejje.) H. L l__|.GER V. E. H. -JACOB V. 6. C. J. VAN „.BIN en voor het Lidmaatschap der Provinciale Staten van Noor-d-Holland (rood stembriefje) li. 11. J. HEi\'DRIfiHS. Het Bestuur A. r.RKIMANS Yoorziller. E. 1. DE (.KEU. 11. C. CRUYS. A. V.. I'.KCkKRLMiJi. 1). RAHUSEN Secretaris. (4030) .EREKNIGING BURGÜKPLIGT. De hiezcis worden met aandrang uitgei op Dinsdag 13 dezer trouw ter stembus op te komen en hunne stem ven aan de Candidaten der Vereeni¦ijude Voor de Tweede Kamer der Staten- Generaal : J. P. DE BORDES Mr. C. FOCK Mr. A. S. VAN NIEROP. ir de Provlnelale Staten van Ni ii!-llolland: (rood Stembriefje) Mr. H. J. KIST iVrastcrdain 6 Juni 1871. De Commissie van Bestuur: OMELA NIEUWENHUIS. R. J. KELDERMAN. H. F. BODEMAN. ANDEE 1)1'. LA PORtE. C. NOORDUYN. ¦ D'ABLAING VAN QIESSEN(4O7S) BURG. P. 3. BASTIAANS. ¦T. A. LEVY. J. REGTDOORZEE. Kiezers! Zoo go door een eerlijk en kundig man le Tweede Kamer wenscht verte¦ordigil te worden komt dan allen op lag 13 Juni ter stembus en brengt met ons uw stem uit op den Heer Mr. C. FOCK. Als burgemeester é_ van Haariem en van idam èu als Minister van Binneiilie Zaken heeft hij zich doen kennen ai degelijk onafhankelijk man die pal voor zijne overtuiging. Handel en nijd heeft hij aan zicli verplicht door de ftog der Octrooien; door zijn onwrikvasthouden aan onze openbare volks- N'i'derland aan hem dank huldigd. Ook aan de Zaanstreek heeft ''ij onberekenbare diensten bewjzen want 'ijn toedoen kwam de Spoorwegver 'S mei Amsterdam tot -.tant. i*iiKt dus allen op Dinsdng 13 Juni uwen burgerplicht en stemt evenals wij <i""U Kooi Mr. C. FOCK. J. ZWAARDEMAKERD*. kZaandam. •I. C. VAN VTESSEM  „ RT SMIT G_.  • D. 11. ZWAARDÊMAKEE * 0 W. VAN HOORN .  •'OH. EBMEIJEB  „ VERKADE / H. ZWAARDEMAKEB  „ fi. TERWEE  „ «OLENAAR „ ? ¦¦'¦ DEKKER. A- I. G. AVIS „ ? L ZWAARDEMAKER Hz . . 3MIT Gz.  . D.J. VAN DER GOOT// „ JAC. DUIJVIS fTz. JACOBUS HONIG „ „ A-». HOUTTUIJN „ Zaandük JAC. VIB Pz. » taanaijh a. C HONIGH „ "" ''. iPr XSv 11 Wormen*. \a. LAAN l. PIEPER ' "" D-^AN P W. PEEREBOOM „ ? ¦'• A. DEKKER  „ &OEKEBAKKER „ „ t. vis Mbz.  ; ; PH.KAARB^BIJPEBTEIJI//iVom»»m._0m»»m._ I'EKKEH Jz. „ Weg/zou» E. DEKKEB •'Westzaan 8. DEKKEB „ „ 11. BRAT (r.014) „ Oostzaan",http://resolver.kb.nl/resolve?urn=ddd:000017632:mpeg21:a0019:ocr,4,ddd:000017632:mpeg21:p004,Het nieuws van den dag : kleine courant,671
2965968,1871/01/11 00:00:00,2874,MMHCO01:000065136:mpeg21:a0010,http://imageviewer.kb.nl/ImagingService/imagingService?id=MMHCO01:000065136:mpeg21:p004:image&x=153&y=2079&w=1032&h=2874,MMHCO01:000065136:mpeg21,1185,4953,153,2079,4,Advertentie Concertzaal Odeon. VOORDR1GT va.n D«. A. KUENEN Hoogleeraar te Leiden o|i Woensdag- If Januarij 1S71 des avonds te S 11 / ure. Aan de openbare school voor gewoon lager onderwijs te Lutte  gemeente Losser  provincie Overijssel wordt verlangd een hulponderwijzer op eene jaarwedde van ƒ 250. Sollicitanten worden uitgenoodigd hunne stukken vóór den 18 Januarij e. k. in te zenden aan den burgemeester van Losser. Het BESTUUR der S TADS-ARMENINRIGTING te ZWOLLE overtuigd van de noodzakelijkheid om bij de veelvuldig bestaande behoefte en met het oog op den gezondheidstoestand aan de behoeftigen der verschillende godsdienstige gezindten van Zwolle en Zwollerkerspel warme voedzame spijs en indien zulks noodig mogt zijn brandstoffen uit te reiken is voornemens tot dat doel eene inschrijving te openen en zal te dien einde op de gewone wijze inschrijvingsbilletten doen rondbrengen niet twijfelende of zijne pogingen in deze zullen op prijs gesteld en door ruime bijdragen zijner medeburgers ondersteund worden terwijl het bestuur kan mededeelen dat de daarstelling der nieuwe inrigting zooverre is gevorderd dat met de uitdeeling op aanstaanden Maandag kan worden begonnen. Zwolle  10 Januarij 1871. Het Bestuur voornoemd I). DODER Hz. Voorzitter. J.. GR AT AM A Secretaris. De COMMISSIE tot de SPIJSUITDEELING uit het Bestuur der Armeninrigting te Zwolle is voornemens op Zaturdag den 14 Januarij des namiddags te 5 uren in een der bovenlocalen van het Stadhuis aan te besteden de leverantie van de benoodigde hoeveelheden spek vleeseli? groene erwten geparelde gort en zulks op de voorwaarden die van af heden ter lezing liggen bij den bode der Armeninrigting. Verzegelde monsters en inschrijvingsbilletten worden ingewacht: van de erwten en gort vóór of op Donderdag den 12 aan de Armeninrigting van het overige vóór of op Zaturdag den 14 Januarij op het Stadhuis beide des namiddags te vijf uren. Zwolle 11 Januarij 1871. De Commissie voornoemd D. DOIJER Hz. Voorzitter. HENDk . MAAS Hz. Secret. Horologiemakers. Op een der beste standen TE HUUR een S iofo S ogiemafeers -affaire. De voorhanden pendules en horologiën worden tegen billijken prijs ter overneming aangeboden. Adres franco onder No. 1263 bij DE ERVEN J. J. TIJL te Zwolle.,http://resolver.kb.nl/resolve?urn=MMHCO01:000065136:mpeg21:a0010:ocr,4,MMHCO01:000065136:mpeg21:p004,Provinciale Overijsselsche en Zwolsche courant,1032
2847996,1871/01/24 00:00:00,2779,MMHCO01:000065147:mpeg21:a0016,http://imageviewer.kb.nl/ImagingService/imagingService?id=MMHCO01:000065147:mpeg21:p004:image&x=1188&y=624&w=968&h=2779,MMHCO01:000065147:mpeg21,2156,3403,1188,624,4,"Advertentie Op nieuw ontvangen prachtige in goud gezet cclit granaten broches oorbellen medaillons kruizen bracelets manchetknoopen ringen etc. Bazar Roggenst/aat. R. du I'ré. AGENTSCHAP. Een JONG MENSCII te Londen die zich uitsluitend aan het commissievak wijdt wensclit goede en soliede ageiitsehapgteit van fabrieken of handelshuizen te bekomen. Uitstekende referten staan ter beschikking. Adres met franco brieven onder No. 1291 bij DE ERVEN J. J. ITJL te Zicolle. Met 1 Mei e.k. wordt verlangd een ongehuwd KOETSIER-HUISKNECHT P. G. bekwaam om met 2 paarden te rijden en die te verzorgen. Bewijzen van bekwaamheid eerlijkheid en goed gedrag zijn vereischten. Adres letter A bij den boekhandelaar W. E. J. TJEENK WILLINK te Zwolie. Slijm- en M&agpillen. Deze Pillen die sints vele jaren met liet beste gevolg tegen de SLIJM en als MAAGVERSTERKEND gebruikt worden door hare zachte 7 werking de SPIJSVERTERING zeer bevorderen bijzonder goed tegen de GAL en zeer ZACHT LAXEREND zijn zijn tegen 32J Cent het Doosje met berigt van het gebruik verkrijgbaar bij de Heeren Arnhem gebr. v. d. Heuvel Assen E. Lambers. Almelo A. O. Boom. Blokzijl D. de Ruiter. Borne J. H. Spekreis. Dedemsvaart H. Woudman. Deventer Gebr.Timan in de korte Bisschopstraat. Enschede J. H. van Westendorp. Enter H. J. Plaggemars. llardeuberg Z. Koeslag. Hasselt L. van der Vecht. Hengelo H. ten Hove. LET lloogeveen H. Radijs. Kampen J. van Beverwijk. Ivoevorden G. Marchant. Lemele E van Tongeren. .Meppel J. G. Lambers. Oldemarkt C. van der Wenden. Ootmarsum  J. W. Volkers. Raalte J. J. Buijs. Steenwijk II. Spanjaard. Wijhe ; B. G. Elferink. Zwartsluis  li. Buisman. Zwolle jJ.J.BrandtJloggenstraat. W E li! Deze SLIJM- en MAAGPILLEN reeds zoo vele jaren met roem bekend en in algemeen gebruik zijn te Zwolle alléén en uitsluitend verkrijgbaar gesteld bij den Heer J. J. BRANDT Roggeustraat. WAARSCHUWING. gjp"" Om elk Doosje der echte en sints onheugelijke jaren gebruikte Slijm- en Maagpillcn is een billet voorzien met de Haudteekening (welke zich ook bevindt op het Zegellak) van den vervaardiger. J. J. SCHREüDER. Chocoladefabriek van Franz fstollwerck en Zonen te Keulen a. d. Rijn. Het belangrijkste etablissement in den Pruissischen Staat. Premie ontvangen voor echtheid en deugdelijkheid. Vertegenwoordigt in alle steden van het vasteland van Europa. Men gelieve te letten op zegel en fabriekmerk.",http://resolver.kb.nl/resolve?urn=MMHCO01:000065147:mpeg21:a0016:ocr,4,MMHCO01:000065147:mpeg21:p004,Provinciale Overijsselsche en Zwolsche courant,968
109354,1871/06/27 00:00:00,107,ddd:110533321:mpeg21:a0009,http://imageviewer.kb.nl/ImagingService/imagingService?id=ddd:110533321:mpeg21:p004:image&x=3099&y=6104&w=1022&h=107,ddd:110533321:mpeg21,4121,6211,3099,6104,6,j Snelpersdrukkerij OGILVIE & Co. — Batavia.,http://resolver.kb.nl/resolve?urn=ddd:110533321:mpeg21:a0009:ocr,4,ddd:110533321:mpeg21:p004,Bataviaasch handelsblad,1022
2656500,1871/12/04 00:00:00,2750,ddd:010486021:mpeg21:a0022,http://imageviewer.kb.nl/ImagingService/imagingService?id=ddd:010486021:mpeg21:p002:image&x=3155&y=3209&w=966&h=2750,ddd:010486021:mpeg21,4121,5959,3155,3209,8,PHOTOGRAPHISCH ATEL# WOODBURY & PA(# op JE£ijs>vijlr geopend dagelijks van 7 tot 10 t^J] Plano-Hand^' van O. J. BEKBKHSÏfc Noordtcijk j# serkoopt ruilt verhuurt stemt en repareert alle .^ van Piano's. }^s Photographisch AteP van HL. JEC. OLLAND Jr'%) op rVoordwijli. .. Dagelijks geopend vanl—lo_^ Ned.-Ind. Bscompto-MaatschapPj Met intrekking van de advertentie van 10 ® hM$ voorkomende in de Bataviasche dagbladen W°r<* gesteld dat door de Maatschappij voorloopig alleen den in deposito worden genomen tot cc» van 4 pCt. met wederzijdsche opzegging van maand. da»v'' Voor eerste storting wordt geen kleiner bedrag f 500.— aangenomen. Namens het Algemeen Bestuur- TIEDEMAN & VAN KERCfl*^' Directeuren Batavia 7 December 1868. iX Let Wel! JPartieuliere JPosterÜ TUSSCHBN 1 BATAVIA en BIHTMZöR^ Solide Engelsche REISWAGENS ter beschikking der Reizigers. $ tungfelscne Iteiswagren 4pa»r f3O . Adres: op Weltevreden naast het Postkantoor. vertrekt eiken WOENSDAG morgen 6 uren van BATAVIA. ZATURDAG „ 6 „ M id. DONDERDAG morgen 6 uren van BUITENZO - 6 - ■ MAD^BEN^',http://resolver.kb.nl/resolve?urn=ddd:010486021:mpeg21:a0022:ocr,2,ddd:010486021:mpeg21:p002,"Java-bode : nieuws, handels- en advertentieblad voor Nederlandsch-Indie",966
1544299,1871/08/19 00:00:00,1597,ddd:010485930:mpeg21:a0013,http://imageviewer.kb.nl/ImagingService/imagingService?id=ddd:010485930:mpeg21:p001:image&x=3124&y=2773&w=967&h=1597,ddd:010485930:mpeg21,4091,4370,3124,2773,4,Boent' de ff ambour^ Iloeul Pressé Galantine Tniffée Sancisson de Paris bij porties. (4791) _^^ LEROUX & Co. Ontvangen per Mnsulinde: Een factuur Fransche PROHSIEN merk Teyssonneau als: FRUITS AU JUS. Id. a L'EAU DE VIE. Id. CANDIS SIROPS ASSORTIS. PRUNES d'ENTES. PATji DE FOIE d'OIE TRUKFÉ. SARDINES. MOUTARDE NATURELLE. MARONS. CIPRES. CELERI AU JUS. OLIVES AMELLEAU. TRUFFES. CHAMPIGNONS. TOMATES. HUILE d'OLIVE. VINAIGRE PUR ET _ I'ESTRAGON. (4710; CAVADINO & Co.,http://resolver.kb.nl/resolve?urn=ddd:010485930:mpeg21:a0013:ocr,1,ddd:010485930:mpeg21:p001,"Java-bode : nieuws, handels- en advertentieblad voor Nederlandsch-Indie",967
4562009,1871/03/30 00:00:00,4203,MMHCO01:000065202:mpeg21:a0009,http://imageviewer.kb.nl/ImagingService/imagingService?id=MMHCO01:000065202:mpeg21:p004:image&x=221&y=679&w=979&h=4203,MMHCO01:000065202:mpeg21,1200,4882,221,679,4,"Advertentie Landgenooten! In de maand Mei des vorigen jaars had een onzer ingezetenen J. W. BOUMAN een braaf en oppassend man en vader van zes nog onverzorgde kinderen het ongeluk om boven van den steenoven te vallen op de steenfabriek van den Heer de KRUIJN te Zwolle. Hij werd door dien val zóózeer gekneusd en verlamd  dat hij nooit reder in staat zal zijn het brood voor de zijnen te verdienen. Tot hiertoe werden de leden van dit gezin door de liefdadigheid voor den hongerdood bewaard. Maar hun toestand blijft nog steeds de zelfde en daarom is het doel dezer oproeping liefdegiften te vragen ten einde daardoor in staat te worden gesteld voor hen eene kleine nering of wat men liet best voor hen zal oordeelen tot stand te brengen opdat ze weder in hun eigen onderhoud zullen kunnen voorzien. In een land waar zooveel voor vreemde verminkten werd gedaan zal men mij wel geen kleinigheid weigeren voor dezen invalide. Hattem  Maart 1871. M. H. MOS —PRINS. Nog ontvangen: Kleine gift voor J. W. Bonman per bode Mensing / 5; Zwolle mej. S. ƒ1; Kampen S. F. 2 coup. f 1.23'/j. ADVER TENTIEN. Bevallen van een Zoon Mevrouw A. A. van ENGELEN  echtgenoot van Zwolle  28 Maart 1871. Mr. J. H. van ROIJEN. Eenige en algemeene kennisgeving. De familie van wijlen Mevrouw de weduwe van KETWICH — ZERINDEN betuigt bij dezen haar dank voor de vele bewijzen van deelneming ondervonden bij het door haar geleden verlies. t i *r k. jes isr OVERTREKSELS DEKENS ENZ in ruime keus en tot billijken prijs voorhanden bij J. (er Wtele Huisman. LEESINRIGTING van BINNEN- EN IÏUITENL4NDSCIIE DAGBLADEN. Prijs per kwartaal. Provinciale Overijsselsche en Zwolsche Courant j 0.75. Amsterdamsch Handelsblad "" 1.75. Haarlemmer Courant //1.50. Nieuwe Rotterdammer Courant //1.25. Het Vaderland // 1.50. Dagblad van Zuidholland en 's Gravenhage . . /. 2.00. Indépendance // 2.50. Kölnische Zeitung // 2.75. Ons Streven • . // 0.40. Onze Roeping .  . 0.30. De Wed . HERINGA — van DORP Voorstraat * naast Mej. de Wed. NELLENSTEIJN. *ijn een voortreffelijk middel tegen de trage werking der spijsverteringswerktuigen moeijelijken stoelgang bleekzucht bloedarmoede hamorriioïden en neiging tot jicht en klierziekte. De flacon pastilles waarin de zouten uit een liter Rakoczi aanwezig zijn kost 30 Kreutzer 8'/j Silbergroschen. Alleen echt te verkrijgen te Zwolle bij TL. DU PItÉ Bazar. Koninkl. Beijersche Mineraalwater-verzending.",http://resolver.kb.nl/resolve?urn=MMHCO01:000065202:mpeg21:a0009:ocr,4,MMHCO01:000065202:mpeg21:p004,Provinciale Overijsselsche en Zwolsche courant,979
474720,1871/10/14 00:00:00,480,ddd:010099741:mpeg21:a0011,http://imageviewer.kb.nl/ImagingService/imagingService?id=ddd:010099741:mpeg21:p002:image&x=3987&y=97&w=989&h=480,ddd:010099741:mpeg21,4976,577,3987,97,4,Jttgc-.nbcu isUb-bc*ltng-tt VA_ 1 TOT 5 REGELS a ƒ -.50 BOVEN 5 REGELS _ 50 Cts. DE REGEL»^ M. WISTIRMAN _ ZOOSS Viotjet Stempelinkt Zonder Vetdeelen a ƒ 1 de Flacon. COMPLETE STEMPELDOOZEN _ ƒ4.50.,http://resolver.kb.nl/resolve?urn=ddd:010099741:mpeg21:a0011:ocr,2,ddd:010099741:mpeg21:p002,Algemeen Handelsblad,989
325832,1871/11/01 00:00:00,169,MMVEEN01:000078105:mpeg21:a0030,http://imageviewer.kb.nl/ImagingService/imagingService?id=MMVEEN01:000078105:mpeg21:p004:image&x=1066&y=5306&w=1928&h=169,MMVEEN01:000078105:mpeg21,2994,5475,1066,5306,4,Advertentie Belanghebbenden die hun adres in bovenstaande lijst ééns in de week wenschen opgenomen te zien betalen daarvoor van 1—5 regels gedurende één jaar slechts / 2.50.,http://resolver.kb.nl/resolve?urn=MMVEEN01:000078105:mpeg21:a0030:ocr,4,MMVEEN01:000078105:mpeg21:p004,Nieuwe Veendammer courant,1928
534492,1871/10/21 00:00:00,588,MMSADB01:000004431:mpeg21:a0022,http://imageviewer.kb.nl/ImagingService/imagingService?id=MMSADB01:000004431:mpeg21:p004:image&x=4591&y=294&w=909&h=588,MMSADB01:000004431:mpeg21,5500,882,4591,294,6,Advertentie Voor Vrouwen en Meisjes. Vier verschillende Breiboekjes elk met 8 patroonplaten per stuk f 0.30. Vijf verschillende Haakboekjes elk met 8 patroonplaten per stuk f 0.30. Twee verschillende Knoopboekjes  elk met 12 patroonplaten per stuk f 0.30. Deze degelijke en goedkoope Boekjes zijn te bekomen bij den Boekhandelaar D. BOLLE te Rotterdam en verder in alle Boekwinkels.,http://resolver.kb.nl/resolve?urn=MMSADB01:000004431:mpeg21:a0022:ocr,4,MMSADB01:000004431:mpeg21:p004,Provinciale Noordbrabantsche en 's Hertogenbossche courant,909
1152549,1871/08/14 00:00:00,1581,ddd:010263284:mpeg21:a0031,http://imageviewer.kb.nl/ImagingService/imagingService?id=ddd:010263284:mpeg21:p003:image&x=2269&y=93&w=729&h=1581,ddd:010263284:mpeg21,2998,1674,2269,93,6,ROTTERDAM-HUIL Dienst voor Passagiers Goederen en \'ee met de Stoomschepen: . MCmth Kapt. W. READ. Albert » J. H. HENDRY. Van Rotterdam iederen Woensdag en Zaturdag des avonds. Van HuU iederen Maandag en Donderdag des middags. (5590) Adres SEEUWEN & O. De Notaris J. MAARSCHALK te Boskoop  zal op Woensdag den 30 Augustus 1871 des morgens ten 11 ure in het Gemeentehuis aldaar publiek veilen en verkoopen: Eene sedert weinige jaren nieuw gebouwde BODWffIANSWONING MET WEI- EN HOOILANDEN staande en gelegen langs de oostzyde van de rivier de Gouwe aan den Groeneweg in den Rijneveld chen polder binnen de gemeente Alphen te zamen groot 16 Bunders 82 roeden 18 ellen. Arngeslagen in de grondbelasting over 1871 met ƒ96.59. Te aanvaarden 2 October a. s. Te veilen in 9 perceelen eerst afzonderlijk vervolgens in combinatiën en in massa. Inmiddels uit de hand te Koop. Nader onderricht te bekomen ten Kantore van gemelden Notaris. (5581),http://resolver.kb.nl/resolve?urn=ddd:010263284:mpeg21:a0031:ocr,3,ddd:010263284:mpeg21:p003,De Tĳd : godsdienstig-staatkundig dagblad,729
1052733,1871/08/18 00:00:00,1311,ddd:010873622:mpeg21:a0016,http://imageviewer.kb.nl/ImagingService/imagingService?id=ddd:010873622:mpeg21:p004:image&x=869&y=52&w=803&h=1311,ddd:010873622:mpeg21,1672,1363,869,52,4,Veiling van eene aanzienlijke partij goed geconserveerde Hebreeuwsche Boeken benevens een partijtje GEWIJDE KLEEDEKEN geheel en alleen nagelaten door wijlen den WelEd. Heer SIMON SALOMON STIJER Jr. welke verkocht zullen worden op Maandag' 21 Augustus 1871 en volgende dagen des namiddagsten 5 ure ten overstaan van den Deurwaarder D. B. GOMPERTZ ten huize van de HH. Gebs. LEVISSON Zwanenburgerstraat P 198 Amsterdam alwaar de Catalogus a 40 Cents voor de Armen alsmede bij den Heer JOACHIMSTHAL Boekhandelaar Joden Breêstraat te verkrijgen is. De Goederen zullen Zondag den 20sien ' van 10 tot 3 ure publiek te bezigtigen zijn. (70),http://resolver.kb.nl/resolve?urn=ddd:010873622:mpeg21:a0016:ocr,4,ddd:010873622:mpeg21:p004,Nieuw Israelietisch weekblad,803
3645983,1871/12/11 00:00:00,3763,MMGASL01:000361074:mpeg21:a00004,http://imageviewer.kb.nl/ImagingService/imagingService?id=MMGASL01:000361074:mpeg21:p00001:image&x=973&y=1436&w=956&h=3763,MMGASL01:000361074:mpeg21:p,1929,5199,973,1436,4,Advertentie 48 Ee&C-SS- en andere Roomeil. staande op gemeld Boerenerf en Keutcrij. In perceelen zoo als is uitgehaakt. (1170) &.-p De Notaris EB. FABHJS zal °P Maandag 18 December a *. «Wjj. | s 71  des avonds ten 7 uren ten huize van du Wed. RIJKKBOKS te Steenwijk publiek doen inzetten en Woensdag 27 December 1871 finaal verkoopen: Een Woonhui» en Erf te Zuidveen op de Sloot kad. Sectie J No. 1569 groot 290 Ceutiares toebehoovende aan- en bewoond door EG BERT VAN EK. Voor den lieer W. LAMPE. Een Mannen Zitplaats in de Groote Hervormde Kerk te Steenwijk zijnde de tweede achter het Oostvak der stoelen tusschen de pilaren. Een Vrouwen Zitplaats in gemelde Kerk achter het Oostvak der stoelen voor den pilaar. Een Vrouwen uitplaats in de Kleine Hervormde Kerk zijnde de eerste achter het r Zuidvak der stoelen ongesloten. Voor den lieer Js. KROP. Een Vrouwen Uitplaats in de Groote H. Kerk ongesloten achter liet derde vak < der stoelen. Iuformatien te bekomen bij den Notaris. i gepresenteerd bij G E S L O T E N BRIEFJES in te leveren voor 15 December 1871 ten Kantore van Notaris FA BIUS te Steen wijk voor den tijd van 6 jaren ingaande 1 Vlei 1872. 12 dagmat weideland 8 dagm. hooiland ' en 60 schepel heideveld in het Erve PRIKKEN te Calleukote toebelioorende aan de Erven van den lieer A. LAMPE. Voorts een op het weideland te stichten boerenwoning. Aanwijzer MEINE DE BOER te Calleukote Iuformatien te bekomen en teekeiiiug der woning te zien bij bij den Notaris. (1172) . A De Notaris E®. SE. S®. VAN»’ M.4MEE zal namens I WfeK**fc*Ü* je heer Mr J. CORK KLISSEN en Echtgenoot op Maandag den 11 December 1871 cles avonds om 6 uren ten huize van J. NIJK te Steenwijk doen inzetten: 1. Een hecht en sterk betimmerd Bouwhuis met iiitincnsaing naar de publieke straat op de oostkant daarvan voorts ruime &clmiir tot stalling voor Vee en Paarden en berging voor Mooi en lioorn verders grooten Tuin daarachter voorzien van eenige jonge Vrucht hoornen alles staande en gelegen in de Korte Woldstraat te Steenwijk en thans bewoond en gebruikt wordende door DE VOS. 2. Een mannen zitplaats in de Groote Hervormde Kerk te Steenwijk tegenover [ den predikstoel door nu wijlen den heer H. W OLFFEN bezeten geweest. Voor den heer M. R. MEESTERS. 3. Een vrouwen zitplaats in voorschreven Kerk zijnde op een bank voor de zoogenaamde Princessenbank. Voor den Heer A. H. VOETELIN.K. 4. Een mannen-zltplaats in dezelfde Vprlr in bank 'No. 33. aan de noordziide,http://resolver.kb.nl/resolve?urn=MMGASL01:000361074:mpeg21:a00004:ocr,1,MMGASL01:000361074:mpeg21:p00001,Opregte Steenwijker courant,956
2068800,1871/03/27 00:00:00,2155,ddd:010099423:mpeg21:a0029,http://imageviewer.kb.nl/ImagingService/imagingService?id=ddd:010099423:mpeg21:p003:image&x=3967&y=3100&w=960&h=2155,ddd:010099423:mpeg21,4927,5255,3967,3100,4,"N.B. WAARSCHUWING. N.B. De Ondergeteekende verzoekt geene gelden af te geven dan IHTSJ.I7I TEN» op zijne EIGEIV handteekening. Kalverstraat E 27. (8851) T. KOITWENAAH. mmm mmummni GEVESTIGD TE AMSTERDAM. Het Bestuur geeft kennis aan HH. Aandeelhouders dat de JIAARLI.I_-Sl.-tE ALGEMEENE VERGADERING zal gehouden worden DONDERDAG 13 APRIL 1871  des Namiddags te één uur in het Gebouw de Eensgezindheid op het Spui E 349 . alhier en dat de BALANS over 1870 inmiddels ter visie ligt ten Kantore der Maatschappij Binnenkant  U 107 alhier. Amsterdam 25 Maart 1871. (8824) De Heeren H. VAN LEEUWEN #■ C°. te Amsterdam zullen Din?dag 28 Maart 1871 van af 1 uur des namiddag* ONDERHANDELEN over: VSS 168 PAKKEN JAVA TABAK directe aanvoer per% NESTOR. Monsters te bezichti gen op Maandag en Dinsdag 27 en 28 Maart in de Brakke Grond in de Nes. (8862) ZATURDAG 18 DEZER gaande van de Heerenstraat naar wand inde Koolteerstokerii. heeft men VERLOREN eene PORTEFEUILLE  waarin ƒ35 aan Papi«rgeld. Die dezelve terugbezorgt bij den Boekhandelaar D. R. HINSE Leidschestraat X 723 _al zonder verdere .navraag eene doeae üelooning ontvangen. (S-*"" l WMlfEIt "" b PRENTENBOEKEN voor verminderde prijzen. ZaM*©el_-i«s E*oriefeuëlëes. blt H. G. KOSTER H.GZN. Sleawendyk hoek Ondebrafsteeg (20537) AIUTKBBA-f. ?&& IVaa7~SURIi\AM-Ë \ ligt alhier in lading met SPOEDIGE EXPEDITIE W-88-ö* het Nederlandsch -nelzeileud SCIIOONER BRIKSCHIP ASTO-IA HENDRIKA CAÜOLINA Kapt. M. HOEDEMAKER. Uitmuntend ingericht voor Passagiers. Adres bij den Car gadoer D. HEIJDEMAN Ju. J (8819)",http://resolver.kb.nl/resolve?urn=ddd:010099423:mpeg21:a0029:ocr,3,ddd:010099423:mpeg21:p003,Algemeen Handelsblad,960
3569301,1871/10/25 00:00:00,3609,ddd:010485987:mpeg21:a0022,http://imageviewer.kb.nl/ImagingService/imagingService?id=ddd:010485987:mpeg21:p003:image&x=2105&y=78&w=989&h=3609,ddd:010485987:mpeg21,3094,3687,2105,78,6,Te koop of te huur: Twee HUIZEN selegen op (joeiioeii^-Sah&rie. Adres LANDS-DRUKKBRIJ. (3875) Te huur tegen 1 November a. s.: Het TOKOLOKAAL in de Binnen Nieuw poortstraat hoek Hospitaalstraat geoccupeerd door den Heer PADDINGEE. Te bevragen bij (6242) H. M. VAN DORP & Co. Te Huur dadelijk: Een ruim HUIS hoek Patjenongan—Sawabesaar laatst bewoond door den Heer VAN OUDTSHOORN. Informatiën bij (6243) p. THIEM. Te Huur met 1 November a.s. te aanvaarden: Een -BLnis in GANG HALKEMA huurprijs ƒ 75 's maands. Een Huis in GANG CORNELIUS huurprijs ƒBO 's maands. Twee JE-luizen in GANG SECRETARIE achter den Heer WOODBURT huurprijs ƒ 135 en ƒlOO maands. Te bevragen bij (.6267) TIEDEMAN & VAN KERCHEM. Kennisgeving. *%^k Het vertrek der PADANGJÉÈÊwÈÈï: BOOT *s een uitgesteld en tg&sëMgÊ* dus bepaald op 26 dezer. Instede van de Vioe-£*r*esiclent Prins gaat de Baron Bentinek. De Marine-Super-Intendent der Ned.-Ind. Sloomvaarl-Maatschappij (6265) S. VAN HÜLSTIJN. Passage naar Nederland /L wordt aangeboden met het gunstig bekende JÉH^ MEDEA Kapitein J. ANKRINGA vermoedelijk tegen het einde van October a. s. van hier vertrekkende. Informatiën te bekomen bij (5453) REIJNST & VIN JU. ~~ZjL BEZOEKIËT /JfMÊÈuËk Kapitein RECKERS •^^^Rj^. vertrekt 2& dezer naar FALMOUTH. -ïsS&IË&knW Heeft nog £5 hutten disponibel. (6272) REIJNST & VINJU. Passage naar Nederland /l wordt aa. aehoden met het snelzeilend £j»V&\ Nerleri. Clipper Fregatschip am ijt« ücht  mLWËËÊLWËLW* 3000 Tons Kapitein J. W. MóLLER. Dit zoo bijzonder gunstig bekende Schip zal waarschijnlijk in den loop der maand October van hier vertrekken. Nadere informatiën en plannen bij de Agenten -. G. SUERMONDT & Co. Batavia en Soerabaya. INT. CRED.- & HAND.-VERKENIGING (4567) ROTTERDAM Samarang.,http://resolver.kb.nl/resolve?urn=ddd:010485987:mpeg21:a0022:ocr,3,ddd:010485987:mpeg21:p003,"Java-bode : nieuws, handels- en advertentieblad voor Nederlandsch-Indie",989
2367362,1871/01/01 00:00:00,1394,MMGARO01:000167438:mpeg21:a0016,http://imageviewer.kb.nl/ImagingService/imagingService?id=MMGARO01:000167438:mpeg21:p004:image&x=1028&y=141&w=1634&h=1394,MMGARO01:000167438:mpeg21,2662,1535,1028,141,4,"Advertentie Iets voor La mpen. Heden ontvangen eene groote sortering PETROLEUM-lAMPfN van de minste tot de fraaiste kwaliteit; herkomstig uit de voornaamste fabrieken. Winkeliers in dit artikel genieten een flink rabat en door de lage prijzen worden zij in staat gesteld te kunnen concurreren zoowel tegen Binnen- als Buitenlandsche Huizen. (5) G. J. TIEROLFF Molenstraat — R osendaal. ""TT.- rStollwerck'sche Borst-Bonbons. Met premiën begiftigd op alle tentoonstellingen. Eene zamenvoegiug van suiker en zulke kruidenextracten wier weldadige werkingen op de ademhalingsorganen door de geneeskundige fakulteit is vastgesteld. Dépots «lezer Borst-Bonbon zjjn: Te Rosendaal bij M. D. van Leeuwen; te Bergenop-Zoom bij P. F. Appelboom; te TJiolen bij de Wed. van Rijssel & Zn.; te Zevenbergen bij P. J. Bartels; te Fijnaart bij G. Malipaard; te Terheijden bij G. Peters; te Willemstad bij H. Nederhorn; te Axel bij A. Smies. (18)",http://resolver.kb.nl/resolve?urn=MMGARO01:000167438:mpeg21:a0016:ocr,4,MMGARO01:000167438:mpeg21:p004,De grondwet,1634
1961792,1871/09/06 00:00:00,2114,ddd:011101591:mpeg21:a0002,http://imageviewer.kb.nl/ImagingService/imagingService?id=ddd:011101591:mpeg21:p001:image&x=44&y=2532&w=928&h=2114,ddd:011101591:mpeg21,972,4646,44,2532,4,"(Voor het land) DERDE KOFFIJ VEILING TE PADANG. Op den eersten of twee* sMßttare den dag: na : aankomst aldaar ■ m je stoompakketboot welke in de tweede helft der maand September a. s. fan Batavia derwaarts zal vertrekken. (Zie Javatche Courant van 18 dezer No 66.) De Gouverneur van Sumatra't Westkust (391) E. NETSCHER. (Voor het land.) BEKENDMAKING. Uitbesteding van de exploitatie der ""Vogelnest Klippen ia de Residentie Preanger 'Regentschappen. (Zi) Javatche Courant van 18 Augustus 1871 No. 66.) De Coitvernew van S. IV. K. (390) E. NETSCHER. (Voor het land.) INSCHRIJVING der Acten van Eigendom en Eigendomsovergang van Vastigheden gelegen te Padang. (Ordonnantie van 18 Julg 1870 Stbl. No. 84.' De Griffier bij den Raad van Justitie te Padang maakt ingevolge art. 9 van genoemde Ordonnantie en met verwijting naar art 13 en 15 eodem bekend dat de inschrijving der hierna te melden perceelen in het daartoe bestemde nienwe register van eigendom . enz. zal plaats hebben op Dinsdag- den 12 Spember a. s. des morgen ten 9 are in bet raadsgebonw en roept derhalve de eigenaren dier perceelen op om daarbij tegenwoordig te zijn en des geraden oordeelende hunne bedenkingen tegen die inschrijving mede te deelen te weten:",http://resolver.kb.nl/resolve?urn=ddd:011101591:mpeg21:a0002:ocr,1,ddd:011101591:mpeg21:p001,Sumatra-courant : nieuws- en advertentieblad,928
502860,1871/03/11 00:00:00,578,MMSADB01:000004117:mpeg21:a0016,http://imageviewer.kb.nl/ImagingService/imagingService?id=MMSADB01:000004117:mpeg21:p004:image&x=1116&y=879&w=870&h=578,MMSADB01:000004117:mpeg21,1986,1457,1116,879,6,"Advertentie J. KANEN Jr. te Valkenswaard berigt dat bij hem te verkrijgen is beste HOUT- FABRIEK"" ^ f mIUUUUi ' ~ ft ft ftfiVii ) i/l van af 30 tot 60 ets het halve Kilo franco aanvrage aan de Fabriek. en",http://resolver.kb.nl/resolve?urn=MMSADB01:000004117:mpeg21:a0016:ocr,4,MMSADB01:000004117:mpeg21:p004,Provinciale Noordbrabantsche en 's Hertogenbossche courant,870
3090729,1871/04/21 00:00:00,2969,ddd:110533266:mpeg21:a0005,http://imageviewer.kb.nl/ImagingService/imagingService?id=ddd:110533266:mpeg21:p001:image&x=1076&y=3198&w=1041&h=2969,ddd:110533266:mpeg21,2117,6167,1076,3198,4,"Vendutie MAANDAG 24 April 1871  voor een huis op PIN ANGSIA door van Siooien Morgan & Co. van  Diverse Europesche en Chinesche Paarden en Rij tuigen^ JUWEELEIN Goud- en Zilverwerken ETC. (1743) Bureau-Handel. - ügilvië k Co. Van de pers gekomen: Schets eener lIANDLE I D I N G voor de KINA-K ULTUUR door Si. W. YAi\ Prijs / 2.— Franco per post. „ 2.50 (1764) Holloway's Pillen en Zalf. Deze beroemde Pillen zijn bijzonder dienstig om het bloed te zuiveren <-u de man» te reinigen dc nieren zucht prikkelende rn nis een zacht purgeermiddel werkende. Eeuige doses de/er zuiverende Pillen brengen de vuilste maag weder iv orde verwijderen alle ""alaandoeningen versterken dm bloedsomloop geven kracht aan de spieren eu kalmte aau de hersenen en zenuwen. De Pillen zijn zoo onschadelijk rlat zij door personen in den zvvaksten gezond luids toestand un wondervol »-oed gevolg kunnen ingenomen worden. AN het ""estel door bovenmatig toegeven aan lusten ontzenuwd of door het gebruik van kwikzilver bereidingen uitgeput is zijn deze Pillen uitmuntende geneesmiddelen0; zij drijven het vergif uit en verrijken het bloed. Doosjes Pillen a ƒ I— ƒ 'd— tll f 5>__ Potjes Zalf a ƒ I— ƒ 3— eu f 5—. (1739)",http://resolver.kb.nl/resolve?urn=ddd:110533266:mpeg21:a0005:ocr,1,ddd:110533266:mpeg21:p001,Bataviaasch handelsblad,1041
4886484,1871/01/15 00:00:00,4516,KBDDD02:000214059:mpeg21:a0013,http://imageviewer.kb.nl/ImagingService/imagingService?id=KBDDD02:000214059:mpeg21:p004:image&x=2251&y=453&w=1074&h=4516,KBDDD02:000214059:mpeg21,3325,4969,2251,453,4,Advertentie Alsmede ? 0 kisten ItOZ! J\E\ (beschadigd) aangebragt per 't sch^p Albrecht Frederik kapt. Bakker  voor rekening van wien het mogt aangaan. Om verkooprekening te sluiten : Ankers Ifioll. GROENTEN PROVISIES MANUFACTUREN Een prachtig duivenhok van bruinliart hout met Waue beslagen en een vlug* duiven van 30 paar enz. enz. Uit de hand te koop: 100000 oude steencn t Pannen Tigchels ijzeren en koperen Ketels Sisser  koperen Waterpomp  Sehuimvaten Houtwaren  een Rivierpont een vierriems Tent Corjaal enz. RIPjTTOPPEN  afkomstig van plantage Groot Marseille. Onderhandsche Verkoop : Ter vermijding der hooge Vendureglen. MANUFACTUREN Dranken enz. In de Bakkerij van F. IV. DE TERMAN Jr„ Ulevellen. Krenten enz. enz. (1535) Verkrijgbaar bij E. MEHTENS. T er pent ij n in pullen en in fless. k f 125Levertraan „ „ „ „ „ „ 125 GROENE ZEEP in vaatjes £i ƒ 15.— Eene groote hoeveelheid versche 23C10C2JLOlj XXOXX in kleine verpakkingen. Zoethout e» gepoederde dito School- en Kantoorbehoeften Wit en Blaauw grof— schrijf— en Vloeipapier E-NYE-LOPPKS * K ramer's WOORDENBOEKEN in prachtbanden Zak dito de Raadsman Bloemenspraak en Nieuw Feestvreugde Staicnpeiioea i» dozen  Kisten VZiFÖ-EilNr en 12 Stoelen  2 Fauteuil en 1 Kanapé in soorten onder anderen WijneTrabucos. [i53t>} (1561) Tegen zeer moderate prijzen bij den ondergetoekende a C&tllUiil verkrijgbaar Versche I/ollandschc waaronder een partijtje beste Zeeuwsche TABAK  ©HM® C1 ' tfgarttt* El. F. MEURS. Waterkant  6 Januarij 1871. Bij zonder goede kwaliteit li II Ut » per puncheon en per gallon te bekomen bij JP. C. Wesenhagen Knuffelsgracht. (1562),http://resolver.kb.nl/resolve?urn=KBDDD02:000214059:mpeg21:a0013:ocr,4,KBDDD02:000214059:mpeg21:p004,Suriname,1074
3404685,1871/03/27 00:00:00,3215,ddd:110533245:mpeg21:a0006,http://imageviewer.kb.nl/ImagingService/imagingService?id=ddd:110533245:mpeg21:p001:image&x=2152&y=2970&w=1059&h=3215,ddd:110533245:mpeg21,3211,6185,2152,2970,4,"Op de Vendutie vun M \AN I) \(; 3 April j zullen nog worden verkocht: I G kisten a 50 ps. j WITTE SIïUITING1 S. 5n kistjes a l doz. OLf) TOM GEN EVER. 11 vaatjes AUSTRALISCHE BOTER ü 15 <«.' enz. enz. (1371) \V. H. HALL fr Co. Op Zalurdiigf_9 April eerstkomende voormiddags 10 uur zullen door de ondergeteekeuden als gemagügoc.i van da eigenaren tot scheiding en deeling van den gemeenen in het te Batavia openbaar vrij van alle hypotheken wer ■eu verkoeld : 1 Ysv. TUIN- en BOUWLAND wip; Boekiet Doer-i.! e*> A poetiv verponding C99G. Lev TÏJIM ANP wijk Twige/ong verponding ""'AI '■>. ir ' ZA/.!- c.i 'Ai ILAND wijk Babakan vcryouci u : 1 i. 4. l.er. ZAAI- er. WEILAND wijk Tjikohol vei-' onc'ing 7U7'.>. 5. Ke-i ZAAI- en \v I£IL\ND wijk Pondok e.o'/»•' v*vpof"".'*'ii« Ss7*>. 8 Een 'riT.-.-. .VET- en ZAAILAND wijk veipci.ding 7 lel. ? Een TUIN- Wïï en ZAAILAND wijk Amnle'n-er- verpand mg UOö. S. Ecu TUIN- ZAAI-«ii WEILAND wijk Ponder />/'-/>■'■:/ verponding 73tf5. fi :'cu LAN;* Wijk Pa.ia> Tav ge rang verponding nu. '180' L 10 Ecu ZAAL en verponding 5553. 11. Een TUIN- WEL ZAAI- en BOSCHLAND wijk Poris verponding 5131. 12 Een TUIL WEI- ZAAI- en BOUWLAND wijk 'Tiga liuksa verponding b2V?>. Allen gelegen iv het If'c-ilerreld'oï Jf'eitérktoartier der Üulaviascht Ommelanden. Nadere inlichtingen bij 'le ondertcekenden i. VAN GENNEP. !]?'>■■) F. H. GERRITZEN. >lnrin«^r s£«lt van Marmer. TcM'slïiajiicle „ „ „on Steen. Te verkrijgen bij (1243) OGILVIE & Co",http://resolver.kb.nl/resolve?urn=ddd:110533245:mpeg21:a0006:ocr,1,ddd:110533245:mpeg21:p001,Bataviaasch handelsblad,1059
3719051,1871/03/05 00:00:00,3596,MMKB08:000115724:mpeg21:a0017,http://imageviewer.kb.nl/ImagingService/imagingService?id=MMKB08:000115724:mpeg21:p004:image&x=1161&y=113&w=1026&h=3596,MMKB08:000115724:mpeg21,2187,3709,1161,113,4,Advertentie j Ter BOEKDRUKKERIJ DEZER COURANT kan EEN JONGEN geplaatst worden. Tegen half Maart wordt te Delft verlangd: eene Keukenmeid voorzien van goede getuigen die tevens goed huiswerk kan verrichten. Die daartoe in aanmerking wil komen gelieve zich te adresseeren met franco brieven letter P of in persoon bij den Boekhandelaar W. BE ETS te Delft. Met 1°. Mei verlangt men in een stil Gezin te 'sHage  voor Tweede-Meid een fatsoenlijk BURGERMEISJE van 16 è 20 jaar en van de P. G.; loon / 40 benevens verval. Adres bij den Boekhandelaar HENN EVELD. Met 1 Mei a. s. wordt gevraagd: EENE DIENSTBODE voor MEID-ALLEEN van goede getuigen voor-^ zien. Loon naar bekwaamheden. Adres Hypolitusbuurt Wijk 5 N°. 477. Men verlangt tegen Mei : eene bek wame W erkm eid die goed strijken en netjes werken kan. Adres bij den Boekhandelaar HENNEVELD. Er wordt om dadelijk in dienst te treden een Dienstmeisje gevraagd niet beneden de 16 jaar om eenig huiswerk te verrigten en rnet Kinderen om te gaan liefst van de P. G. Adres Bureau dezer Courant. De ondergeteekende heeft bij den Heer Jacob E. KOUWENHOVEN Jr. Choorstraat Wijk 5 voor Delft en omstreken verkrijgbaar gesteld: SIERLIJKE DOOSJES bevattende 20 pakjes met Zaden van verschillende MILD en schoonbloeijende Zomerbloemen met aanwijzing van de gemakkelijkste wijze van kweeking en behandeling. Voor echtheid en goede kieming dier zaden wordt door hem ingestaan. Haari.su  voorjaar 1871. DAVID JACOBSON Zaadhandelaar. De ondergeteekende maakt bij deze bekend dat de Affaire in GOUDEN EN ZILVEREN WEBKEN etc. door wijlen haren Echtgenoot uitgeoefend door haar voorloopig op denzelfden voet wordt voortgezet en zij zich dus tot de levering van alles dit Vak betreffende beleefdelijk aanbeveelt. Delft  28 Februarij 1871. W ed . C. E. JEDELOO — van K a PEI . Er worden gevraagd: Twee Metselaarsknechts die met Boerenwerk bekend zijn. Adres bij M. ROOZENBURG te Schipluiden. Een Bakkersknecht bekwaam voor zijn werk kan dadelijk geplaatst worden. Adres Bureau dezer Courant. Brieven franco letter H.,http://resolver.kb.nl/resolve?urn=MMKB08:000115724:mpeg21:a0017:ocr,4,MMKB08:000115724:mpeg21:p004,Delftsche courant,1026
2519244,1871/04/01 00:00:00,3276,ddd:010333241:mpeg21:a0003,http://imageviewer.kb.nl/ImagingService/imagingService?id=ddd:010333241:mpeg21:p003:image&x=834&y=165&w=769&h=3276,ddd:010333241:mpeg21,1603,3441,834,165,4,"THUBLIEKE VERKOOPING op Dings■* dag den 18n. April 1871 's voormiddags te elf ure in het gebouw der Spaar- en Beleenbank van de panden beleend van 1°- January tot en met ultimo Juny 1869 onder N°. 9516 G. tot en met Nü- 1616 H waarvan de verschuldigde interesten niet vóór dien dag zyn aangezuiverd. De panden zullen acht dagen vóór den verkoop ter bezigtiging liggen. Curaeao den 31 Maart 1871. Namens den Voorzitter De Secretaris A. J. PYPERS. ~BEKKND_HAKING. IWÏET voorkennis van het Bestuur dezer •""• kolonie wordt hierby bekend gemaakt dat de trekking van de Curacaosche Ljtery zal plaats hebben op WOENSDAG DEN sa. APRIL des voormiddags ten 11 ure in het Raadhuis ten overstaan van de daartoe aangewezen autoriteiten Nog zyn er tot den dag der trekking Loten te verkrygen en wel by de Heeren David OSORIO & Plkts LüPEZ in de Willemstad en aan de Overzyde by den Heer S. de Liu\. Ook by den ondergeteekende zyn nog enkele voorhaudeu.— Curapao 28 Maart IS7I. ISAAC OSORIO Jr. WAAIScSüWING. J^hE ondergeteekendeo waarschuwen by *-^deze een ieder om aan niemand hoege naamd eenig crediet op hare namen te verleenen zonder een door haar onderteekend bewys. Curaeao den 31 Maart 1871. Dbw. j. a. quast Di;w. C. M. NU BOER. CIKUJ ANO DENTISTA ofreee sus «ervicios profesionales Prinsen Straat junto al almaceu de los Sres. Jeudah Senior é hijo. Curazio 30 de Marzo 1871. Uit de hand te koop 4&& ¥T|E HKKItEXHUIZEN' onder ■ '»«. MJWSo. 247 en 247 4op Pieterma.ii gezamenlyk of nfzonderlyk. Voor iuformaticn vervoege men zich by C. H. TILLERMAN. Curaeao den 29 Maart ÜS'7l. Dienstbeurtcn by de Spaarbank Zaterdag den 1 April 1871. Bestuurder de Heer J. J. Naar. Commissarissen de Heeren J Kraanwinkel en Jacob Lanffer. Verafte Protsst: peeste. GODSDIENSTOEFENING opaanstaan- deu Zondag 2 April des avonds ten half 7 uur. (Bevestiging van nieuwe leden en Voorbereiding.) GODSDIENSTOEFENING op Goeden Vrydag 7 April: des morgens ten half 9 uur. (Bediening van het 11. Avondmaal ) de» avonds ten half 7 uur. (Dankzegging.)",http://resolver.kb.nl/resolve?urn=ddd:010333241:mpeg21:a0003:ocr,3,ddd:010333241:mpeg21:p003,De Curaçaosche courant,769
4965476,1871/05/26 00:00:00,4898,MMKB08:000115900:mpeg21:a0013,http://imageviewer.kb.nl/ImagingService/imagingService?id=MMKB08:000115900:mpeg21:p004:image&x=29&y=20&w=1012&h=4898,MMKB08:000115900:mpeg21,1041,4918,29,20,6,"Advertentie KOST en INWONING. Voor een of twee Jongelieden bestaat gelegenheid in een fatsoenlijk Gezin voor Kost Inwoning en Bewassching met gebruik van een vrije Boven-Voorkamer  op het schoonste en drukste gedeelte der Stad. Adres met franco Brieven onder lett. A R aan het Bureau dezer Courant. Men is van meening ten overstaan van den Deurwaarder C11R1STIAAN PFEIFFER morgen Zaturdag 27 Mei 1871 des middags ten 12 ure aan de Brabandsche Turfmarkt vóór de branderij «de verkeerde wereld "" te Delft  publiek en om contant geld teveikoopen: Bindten Brandhout enz. Men is van meening ten overstaan van den Deurwaarder 0HR1STIAA.N PFEIFFER a. s. Dingsdag 30 Mei 1871 des namiddags ten 2 ure vóór of in het huis aan de Groote Markt wijk 4 n°. 363  te Delft  publiek en om contant geld te verkoopen: eenige Meubilaire Goederen Toonbank. Winkelkast Gasleiding Scheurpapier  Brandhout  enz. TE ZIEN op den Yerkoopdag voormiddags van 10 tot 12 ure. VERHUISD van het Oude Delft naar de Jaeob Gerritstraat C M. VAN DER MEE in Verfwaren Venster- Spiegelglas Droogerijen Specerijen enz. Wordt aldaar tevens een LOOPJONGEN gevraagd. Dat ik mijne STALHOUDERIJ zoude hebben verkocht of overgedaan is mij geheel onbekend en beveel mij in de sedert dertig jaren genoten gunst mijner Stadgenooten bij vernieuwing aan. P. A. HESSE Noordeinde. De ondergeteekende berigt dat hij heeft geopend de handel in alle soorten van Binnen- en Buitenlandsche Biereu op flesschen en kruiken getapt waartoe hij dooreen frisschei; kelder aan zijn huis bijzondere gelegenheid heeft. Hij beveelt zich beleefd aan bij zijne geëerde Stadgenooten eene prompte en nette bediening belovende Tevens verzoekt hij beleefdelijk de bestclÜngviï anti Ij li hui o to croon  en clc gunst van alle weidenkenden terwijl hij zal trachten zich ieders vertrouwen waardig te maken. P. VAN DER STUIJT Markt 4—359. PARIJS. PARIJS. HEDEN ONTVANGEN per Grande Vitesse. Eene groote bezending van het Huis PINAUD uit Parijs van het beroemde Extrait Végétal supra fijne Odeurs  Cosmétiques Poudre de Riz Tandpoeders Toilet- en Scheerzeepen Crème en pate d'Amandes Pomades Vinaigre de Rouges enz. Van de Huizen J. v. BULLY & PELLERAY te Parijs echte Vinaigre Aromatique en Eau Berger bruin en zwart. Ook van het Huis POPP uit Weenen eene nieuwe bezending Anatherin Mondwater waarvan net eenig Dépot voor Delft bij mij gevestigd en dus alleen echt te verkrijgen is. D elft 22 Mei 1871. A. J. VAN RIJN Coiffeur. ""MAGAZIJN van Fournuizen Ledikanten enz. van J. M. AHSMANN VOORSTRAAT. Met deze berigt ik mijne geëerde Begunstigers dat mijn Magazijn ruim voorzien is van alle soorten van Fournuizen Ledikanten en andere Artikelen tot het vak behoorende. EEN BEKWAAM SMIDSKNECHT (Plaatwerker) en twee JONGENS kunnen bij mij vast werk bekomen. Eerste schroefstoombootdienst tusschen Delft en Rotterdam. C. TIMMERMANS is ontslagen als Commissaris en in zijne plaats aangesteld: de Heer K. C. VAN DER WAAI Bestelhuis Oude Delft schuins over het RijksMagazijn  bij den Heer M. Berkel. Op lsten en 2den Pinksterdag zal eene Boot 's avonds te 9 uur zoo van Delft als van Rotterdam raren.",http://resolver.kb.nl/resolve?urn=MMKB08:000115900:mpeg21:a0013:ocr,4,MMKB08:000115900:mpeg21:p004,Delftsche courant,1012
2075309,1871/03/13 00:00:00,2839,ddd:010262698:mpeg21:a0036,http://imageviewer.kb.nl/ImagingService/imagingService?id=ddd:010262698:mpeg21:p004:image&x=1564&y=2621&w=731&h=2839,ddd:010262698:mpeg21,2295,5460,1564,2621,4,"Bij Gebr. J. & H. VAN LANGENHUYSEN te 's Gravenhage is verschenen: HANDBOEKJE voor de Zaken der Roomsch Katholieke Eeredienst. Vijf en twintigste Jaargang. —1871. — ƒ3.25 Door de groote uitgebreidheid is voor dit jaar de prijs eenigzins moeten worden verhoogd. Door toevallige omstandigheden zijn nog een paar compleete jaargangen te bekomen. (-2670) De Amsterdamsche BANKETBAKKER OF «E 11 Al 4. K EEI Jf 34 E VRAAG IS AA tl voor KOEK- en BANKETBAKKERS CONFITURIERS RESTAURATEURS KOKS en KEUKENMEIDEN. Bevattend» de beste voorschriften ter bereiding van allerlei Gebak Confituren verschillende soorten van Us Likeuren Siroopen enz. Prijs 3© CT. Bij €k. THEOD. MS 011 Kalverstraat E 10 Amsterdam en op bestelling alom te bekomen. (2723) Zakwoordenboeken  die algemeen als de BESTE VOLLEDIGSTE meest PRACTISCHE meest CORRECTE en tevens GOEDKOOPSTE erkend worden zijn ItCSI VI ¦.-{*. ""loiiveau Dii-lion¦mire ite Poche Francais-Neêrlandais et Neêrlandais- Francais Spelling vande Vries «HteWiakel Sde belangrijk vermeerd. en verbet. druk. Twéé Deelen in één geprest linnen band ƒl7©» JAEKEB Nouveau JUictionnaire ile Poche Francais-Hollandais et Hollandais- Francais 3de veel verbeterde en vermeerderde druk. Twéé Deelen in één geprest linnen band ƒllO. JTIEGER Heiies Tasclien Worterb-icli. Deutsch-Hollandisch und Hollandisch- Deutsch. Ide veel verbeterde en vermeerderde druk. Twéé Deelen in één geprest linnen band ƒl7©. JAEGER 1 -Vew PtocUet Uictionary of the English-Dutch and Dutch-English languages. 2de veel verbeterde en vermeerderde druk. Twéé Deelen in één geprest linnen band ƒl.3©. Allen uitgegeven door G. B. van GOOR te Gouda. (2725)",http://resolver.kb.nl/resolve?urn=ddd:010262698:mpeg21:a0036:ocr,4,ddd:010262698:mpeg21:p004,De Tĳd : godsdienstig-staatkundig dagblad,731
3095633,1871/05/29 00:00:00,3237,MMGASL01:000361047:mpeg21:a00004,http://imageviewer.kb.nl/ImagingService/imagingService?id=MMGASL01:000361047:mpeg21:p00001:image&x=1954&y=1931&w=928&h=3237,MMGASL01:000361047:mpeg21:p,2882,5168,1954,1931,4,Advertentie tdSMM Ue Notaris M' **• ‘ MAIILE zal op Donderdag eaöMSslÊ den 8 «Hunij 1871 des voormiddags om 10 uren ten huize eu verzoeke van IIARM JACOBS PEN aau de Wetering gemeente Steenwijkerwold bij boelgoed verkoopeu: 12 afgekalfde Koeijen 1 jarige Stier 4 Pinken 5 Kalveren 2 Schapen en 2 Varkens 4 koperen Melkketels 1 Karn met koperen hoep. Voorts Melktonnen en Vaten en hetgeen verder te voorschijn zal worden gebragt. Voorts nog 2 14spande Turfhokken. Zullende dadelijk 11a afloop van dezen Verkoop worden verhuurd: Onderscheidene perceelen WFeislc- en Hooiland gelegen aan de Wetering gemeld bij den Verhuurder in gebruik geweest en door dezen aan te wijzen waartoe de gegadigden 55' zich op Donderdag den 1 en Vrijdag den 2 j-. Junij ten zijnen huize kunnen vervoegen. De Notaris B*. BB. JP. VAM MA RUU zal op Zaturdag den 10 Junij 1871 des namiddags om 3 uren ten huize van B. GROEN te Oldemarkt namens de heeren H. PAUW H. SMIT Mej. H. M. TELLENERS en de Familie GROSKAMP en verdere eigenaren publiek verpachten: Het Ga*asgewas van onderscheidene perceelen Hooiland gelegen onder de gemeente Oldemarkt hoofdzakelijk op de verschillende Broeken de Maten en Krabmans velden alles gelijk de verpachting daarvan jaarlijks geschiedt. (744) > Aio® De Notaris Ji. G. II. TTI<1 BS HORST zal op Donderdeg den I MStÉSssaam 1 Junij 1871 des middags om 12 uur teil huize van HEIN HAVERKAMP kastelein te Oldemarkt publiek verhuren: Onderscheidene perceelen Mooi®» en Stlci- ! land' gelegen onder Kalen berg zoo als die jaarlijks worden verhuurd. (745) i . De Notaris JU G. II. ffa M TER MORST zal op Donderdag den 1 Junij V 1871 des namiddags om 2 uur ten huize van HEIN HAVERKAMP Kastelein te Oldemarkt ten verzoeke van Mevr. de Wed. RIDDER de Heeren H. SPITZEN J. SPITZEN Jzn. T. GROENESTEGE den Pastoor der R. C. gemeente van Steenwijkerwold J. A. DE VRIES H. N. OSSE R. A. GRAS J. K. en II. HAVERKAMP en anderen publiek verkoopeu: Het GRASGEWAS van ruim 40 per- I ceelen Hooiland gelegen op de verschillende Broeken onder Oldemarkt en te Paaslo. (746) -ft a „ « De Notaris Jf. G. M. % TER MORST zal °P Donderdag den 1 Junij 1871 des namiddags om 4 uur ten huize van HEIN HAVERKAMP,http://resolver.kb.nl/resolve?urn=MMGASL01:000361047:mpeg21:a00004:ocr,1,MMGASL01:000361047:mpeg21:p00001,Opregte Steenwijker courant,928
2741503,1871/01/08 00:00:00,3307,ddd:010938025:mpeg21:a0011,http://imageviewer.kb.nl/ImagingService/imagingService?id=ddd:010938025:mpeg21:p003:image&x=2583&y=1393&w=829&h=3307,ddd:010938025:mpeg21,3412,4700,2583,1393,4,"•——— » Attentie !! Dé heeft de. öei"" het ge-acht publiek en zijne geëerde Begunstiger 5... te cerichtcn' dat hij per. het-schip ■Amalicc kaptein Rakker heeft ontvangen eh urtgepakt: Eene. groote keurige sorteering ginder bijzonder geschikt voor CADEAUX welke door late arivcmcnt voor inkoopprijs zullen verkocht worden Galanteriën Garen èn Band Mode Artikelen lèantooT- Schrijf- en Schoolbehooften alles bijzonder goedkoop. jbtg&rrii in soorten ■ ' r ' ' '* ... Komt; Ziet en óver tuigt U ! NB. Ontvangen iÖOO pond zeter geschikt voor huisgebfuïk. NICÖLA'is GOHÈN ""vVoonplaast: hoek Waterkant Knvffehgracht ""allernaast Mevrouw de Wed. SAM SON. [652.] .",http://resolver.kb.nl/resolve?urn=ddd:010938025:mpeg21:a0011:ocr,3,ddd:010938025:mpeg21:p003,De kolonist : dagblad toegewyd aan de belangen van Suriname,829
6820358,1871/03/01 00:00:00,3478,ddd:010099380:mpeg21:a0038,http://imageviewer.kb.nl/ImagingService/imagingService?id=ddd:010099380:mpeg21:p004:image&x=1041&y=3343&w=1961&h=3478,ddd:010099380:mpeg21,3002,6821,1041,3343,4,"Revue des -Deux Moedes. Uit nadere mededeelingen heden rechtstreeks van de Administratie der REVUE ontvangen blijkt dat de Directie in de buitengewone omstandigheden die Parijs vijf maanden lang heeft doorleefd op haar post gebleven is. Zij heeft met groote krachtsinspanning en buitengewone opofferingen vooral ook tengevolge van schaarschte van papier de_ velerlei bezwaren  aan den teestand verbonden weten te boven te komen. Dank ook de medewerking van specialiteiten die de vraagstukken behandelden die nit de geheel exceptioneele omstandigheden^voortsproten zullen de afleveringen die tijdens het beleg het licht zagen  een blijvend geschiedkundig gewicht opleveren. Het getal exemplaren ten behoeve der abonnés in Nederland is kunnen worden gedrukt en zoodra de gemeenschap voor goed hersteld is zullen die herwaarts worden afgezonden. De prijs van het vierde kwartaal 1870 zal geenerlei verhooging ondergaan niettegenstaande de buitengewone uitgaven van de Directie alleraanzienlijkst zijn geweest. Door de overmacht der gebeurtenissen gedwongen is het haar echter onmogelijk geweest den ANNUAIRE die over de jaren 1868 en 1869 loopen moest thans reeds in gereedheid te hebben. De Directie zou echter meenen den geest van billijkheid van _ het Nederlandsch publiek te miskennen indien zij een oogenblik twijfelde ""of de Inteekenaren hier te Lande deze vertraging — louter en alleen het gevolg der tijdsomstandigheden — haar euvel duiden zouden. Bovendien zullen zij daar niets bij verliezen daar de Directie alle krachten inspannen zal om de geschiedenis der zoo gewichtige jaren 1868 69 en 70 in één Annuaire samen te vatten; het belangrijke en de uitgebreidheid van het boekdeel zal dus HH. Abonnés ruimschoots schadeloos stellen voor de onwillekeurige vertraging die zg in de ontvangst van de toegezegde Premie ondervinden. Wat den prgs van de REVUE DES DEUX MONDE» voor 1871 betreft deze zal met of zonder Annuaire voor Nederland bedragen 23 Gulden. De inhoud van dit tijdschrift  waaraan Franksrijks beroemdste staatslieden geleerden en letterkundigen hunne meewerking verleenen belooft van nog meer gewicht te zullen zijn dan ooit te voren daar het zich voorstelt de vraagstukken  met het tegenwoordig tijdsgewricht in het algemeen en Frankrijks toestand in het bijzonder in verband staande met evenveel waardigheid als vrijmoedigheid te behandelen. 's-Grave-HAGe  22 Februari 1871. De Uitgevers van de Revue voor Nederland -. ■ GEBROEDERS BELINFANTE. GROOT INTERNATIONAAL CONCOURS HET DEN H-tNDBOÖG DOOR DEN -OORD- EN ZUID-HOLLAKHEf. BOND (AFDEELING AMSTERDAM) onder bescherming van 'L. _*__. den KO__j_i___G. Het Comité brengt ter kennis dat het CONCOURS zal plaats hebben ZATERDAG ZONDAG en MAANDAG' SA »5 en 96 JUNI 1871 in het Paleis voor Volksvlijt te Amsterdam waarbij verschillende Amsterdamsche LIEDERTAFELS hunne medewerking hebben toegezegd. Het PROGRAMMA der feestregeling zal nader worden bekend gemaakt. Amsterdam 27 Februari 1871. Namens het Comité: J' 0""1*' i Secretarissen L. RH HARD > gOT"" Hoeren Redacteurs der onderscheidene dagbladen worden beleefdelijk uitgenoodigd deze kennisgeving zooveel mogelgk mede te deelen. (5673) imekhnndei ran €.'_£.'F__f_V i^-V^^iv'Wl'ïil¥_v7 S ngel  hoek .. Oii gstraat te Amsterdam. Alom verkrijgbaar: Een schoone pliotographische voorstelling van De Kapitulatie vmn Parijs. Zinrnk en dieptreffend is deze schoone teekening. PARIJS tot het uiterste gebracht gilt in wanhoop tot den modernen Attila die  tusschen MOLTKE en BISMARCK  het schouwspel aanstaart: „ROEPT DE DOGGEN TERUG I!"" Die doggen zijn: Vuur Zwaard en Honger. Prijs ƒ0.40. (5783) AFLEGGEN VAN GELOOFSBELIJDENIS. Voor deze gelegenheid zijn ten allen tijde voorhanden of worden spoedig gereedgemaakt KERKBOEKEN voor alle PROTESTANTSCHE GEZINDTEN van af de eenvoudigste tot de fijnste en élégantste soorten met en zonder GOUDEN en STALEN KNIPPEN. OUDE BOEKEN worden opnieuw ingebonden of in ruil aangenomen en hij de meeste formaten kunnen de VERVOLGGEZANGEN bij ingebonden worden. Op franco aanvraag en bijvoeging van Postwissel worden KERKBOEK EN in FOUDRAALS naar alle OORDEN des LANDS verzonden  door den Bijbelbinder en Handelaar A. VAN ROSSUM Jb. Singel bij de Gasthuismolensteeg G 341 en 42 te Amsterdam. (5747) OILieBITIA. MaHyer^aai. -_J-__-_LDAe' den 3den MAART 1871 des avonds ten 7 ure ""VERGADERING en TENTOONSTELLING VAN VOORWERPEN ten behoeve der ZEEVAART NIJVERHEID KUNST en KOOPHANDEL. Toegangsprijs . A CENTS den P.*_oon. (1709) Men leze voot het overige de BILJ ETTEN allcrwege aangeplakt. C._J. MITGOTT. m CORK STEAM-SHIP-COMPANY. ÉfH ROTTERDAM EM IjIVEftPOOL. HET SCIIROEFSTOOMSCHIP MJGRMST* 1000 Tons Kapitein F. R. Reynolds Vertrekt \-_n Rott-. lam naar Liverpool VRIJDAG 3 MAART. (5740) Adres bij Ph. VAN OMMEREN.",http://resolver.kb.nl/resolve?urn=ddd:010099380:mpeg21:a0038:ocr,4,ddd:010099380:mpeg21:p004,Algemeen Handelsblad,1961
10405452,1871/08/16 00:00:00,6746,ddd:010099649:mpeg21:a0006,http://imageviewer.kb.nl/ImagingService/imagingService?id=ddd:010099649:mpeg21:p001:image&x=93&y=132&w=4852&h=6746,ddd:010099649:mpeg21,4945,6878,93,132,2,"HEBREEÜWSCHE TAAL. JLemans en 8. J. Mulder Hebveeo.w__.e_h en HVedevdnMieli Handwoordenboek £met Spraakkunstige Handleiding en een dubbel register der Eigennamen prijs ƒ 7.50. tttTDinfillTJ^ of gronden der Eiebreeaweche Taal. 3de druk prijs ƒ 1. In het BOEKEN-MAGAZIJN vanH. 6. BOM Warmoesstraat bij de St. Olofspoort M 463. (244791 — . ! — _tgr Op een HANDELS- en EXPEDITIEKANTOOR wordt gevraagd grondig ervaren in de Duitsche dn Engelsche Talen tevens in staat de BIJBOEKEN te houden. Adres franco brieven onder lett. E. 8. aan het Advertentie-Bnreau van NIJGH & VAN DI'IMAR Eotterdam. (24478) Voor het LOOPWEKK en do opleiding in eene fijne MANUPACTDOKZAAK verlangt men ten spoedigste een fatsoenlijken en'netten JONGEN. Salaris naar bekwaamheid. Franco briefjes onder lett. A. B. 814 Bureau Handelsblad. (24527) Eene JUFVROUW van den P. G. 25 jaren oud wenschte gaarne tegen half September of November GEPLAITSTte worden in eene WIft&ELZAAK en tevens tot adsistentie in de Huishouding; de beste getuigenissen staan ten dienste. Adres franco brieven onder lett. Z. bg den Boekhandelaar A. C. P. VAN PADDENBDRG Lgnbaansteeg. (24532) ~~ BEDIENDE GEVRAAGD van eerlijk gedrag tegen goed Loon bekend met het KOMENIASVAH-. Adres franco onder lett. _. P. A. Bureau Handelsblad. (24514) Li eene drukke Kruidenierszaak wordt gevraagd een TWEEDE BEDIENDE tegen genot van Kost Inwoning en Salaris bewijzen van sóliditeit en bekwaamheid kunnende overleggen; tevens bestaat er gelegenheid tot plaatsing van een LEERLING tegen matige vergoeding voor Kost en Inwoning. Brieven franco lett. F. aan de Boekhandelaars SCHELTEMA & HOLKEMA Beurssteeg. (24507) Een JONG PERSOON biedt zich aan ah PAKHUIS- KANTOOHKNEfUT of ANDERSZINS kunnende zeer goede informatiên bekomen. Beflecteerenden gelieven zich per franco brieven te adresseeren onder letter G. 8. Bureau Handelsblad. (24508; Te Huur v voor eene DAME uit den fatsoenlijken stand in eene der netste en levendigste gedeelten van de stad eene BOVEN VOOR' en ACHTERKAMER. Adres letter W. Firma R. C. MEIJER Kalverstr. E 246. (24510) lEMAND van middelbaren leeftgd die een fatsoenlijke Betrekking bekleedt wenscht in kennis te kernen met eene Weduwe of Burger Doohter van denzelfden leeftgd teneinde na kennismaking een WETTIG HUWELIJK aan te gaan. Fraueo Brieven letter 8.. bij de Boekh. NIKNDIECü & EUKN Molsteefr G 186. (2«W Al degenen die iets te vorderen hebben van verschuldigd zgn aan of onder honne berusting hebben betreff nde de nalatenschap van den Zeer Eerwaarden Heer PETHUS HUBERTL'S VAN DIJK R. K. P. rustend Pastoor gewoond hebbende te Ilpendam en aldaar op den 28den Juni 1871 overleden worden verzocht daarvan opgave'of betaling te doen vóór of op den lsten September e. k. ten kantore van Notaris T. H. P. M. VAN VEERSEN te Nieuwendam. (24103) Die iets te vorderen hebben van of verschuldigd zjjn aan den Boedel van den fleer EVERT WINDHOUWER in leven Cargadoor gewoond hebbende en onlangs op de Brouwersgracht alhier overleden warden verzocht daarvan vóór den 15den Augustus aanstaande opgaaf te doen ten kantore van den Notaris J. L. KABEL op de Oude Schans bij de Dpstraat alhier. (24099) TWEEDE VËKIFICATÏÊ^ welke in het Faillissement van EVERT JAN VAN APELDOORN te Heerde zal plaats hebben op Zaterdag 26 Augustus 1871 des voormiddags te half elf uren ia de Raadzaal van de Arrondissements-Bechtbank te Arnhem in bet Paleis van Justitie aldaar waartoe de schuldeischers in die massa ook zij die bevoorrecht zijn of pand hebben worden opgeroepen door den te Apeldoorn wonenden Curator in dat Faillissement (24460) P. LEENDERTZ Hzn. Bg Vonnis van de Arrondissementsrechtbank te Amsterdam Eerste Kamer op den 83ten Mei 1871 gewezen zijnde gerefistreerd: Is het Huwelijk tusschen GESINA BOSCH zonder eroep wonende te Amsterdam en HENDRIK ARIE TE MIJTELAAR thans weonachtig te Leipzig op den 18den Augustus 1859 te Amsterdam voltrokken door ECHTSCHEIDING ontbonden met alle de gevolgen daaraan door de Wet gehecht. Voor UITTREKSEL deugdelijk verklaard door den ondergeteekende Procureur voor de Eischeresse GESINA BOSCH hebbende geoccupeerd. H. P. LOGGERE. (21506) Procureur. BEKENDMAKING. De BURGEMEESTER en WETHOUDERS der Gemeente Nijmegen brengen hiermede ter algemeene kennis: Dat de gewone JAARMARKT of KERMIS dit jaar biunen deze gemeente aanvang zal nemen Maandag den 2den Ootober en voortduren tot en met Maandag den 9den October daaraanvolgende. Tot bekoming vaa standplaatsen voor Kramen en Spellen nullen de belanghebbenden zich met yraehtvrge brieven behooren aantemeïden bij den Heer Marktmeester W. VAN DER HAM vóór den 20sten September aanstaande. Nijmegen  De Burgemeester en Wethouders 12 Augustus 1871. voornoemd  F. P. BIJLEVELD. De Secretaris (24466) R. O. B. VERHEIJEN. STADS-GYMNASIUM. De ondergeteekende maakt bekend dat het TWEEDE TOELATINGS-EXAMEN zal plaats hebben op Woensdag 16 Augustus e. k. 's nam. te één nur in het Gymnasium (Singel D 198). Belanghebbenden gelieven zich aan te geven bg den Boekhandelaar S. VAN HELDEN (Warmoesstraat over St. Jansstraat J 600). Amsterdam Juli 1871. N. J. B. KAPPEYNE v. ». COPPELLO (21385) Gymn. Rector. J. W. TE BENSEL M. J. CLIESSEN.H.OVEBEEM. G. S. NOUT en C. ABBINK Makelaars zullen op Maandag den 28sten Augustus in het Lokaal de Brakke Grond des avonds te Zes Uren in veiling brengen ten overstaan van den Notaris D. VAN OSENBKUGGEN. N°. 1 Een HUM TUIS en ERV staande aan den Overtoom gemeente Nieuwer-Amstel nabij de Gebiedpaal Wijk J N°. 81 breeder bö bijletten omschreven. N°. 2. TWEE HOZEN onder één Dak met een Houten LOODS staande aan het Korte Bleekerspad gemeente Amsterdam Buurt XX 354 en 355 op Stadsgrond; groot 11 Aren en 4 Centiaren. Ook breeder bij Biljetten omschreven. Te zien Maandag en Woensdag van 1 tet 3 uren. De VeilconditiSn zullen vier dagen TÓor en op den Verkoopdag liggen ten Kantore van den Notaris D. VAN OSENBRUGGEN aan den Overtoom Gemeente Nienwer-Amstel Wijk J N"". 79. (24145) De Notaris DE POORTER te Oldenzaal maakt bekend dat de STOOMWEVERIJ onder Ootmarssum met annexe Gebouwen Weiland Arbeiderswoningen Tuin benevens Stoommachine Ketel Hoofd- en Drijfassen en Verwarmingßbuizen 160 verschillende Looms Hydraulische Pers Boom- Meet- en Boormachine bij vroegere couranten en biljetten breeder omschreven bij inzet en verhooging is gebracht ep de zeer geringe som van ƒ 15400. De definitieve Verkooping blgft bepaald op Dinsdag 22 Augustus 1871 des voormiddags elf nur ten huize van den Logementhouder KIP te Ootmarssum. (24340) Infermatiën te bekomen bij genoemden Notaris DE POORTER. ÜIT DE HAND TE KOOP en dadelijk te aanvaarden: Een BOERENHOFSTEDE SCHUUR TUIN goed bemest en bewerkt BOUW. en WEILAND in de gemeente Anna Paulowna (alwaar zich eene Protestantsche- en Roomsch Katholieke Kerk en goede Scholen bevinden) groot 29 hectaren (bunders) aan den spoorweg. De HELFT der koopsom kan op de perceelen gevestigd blijven. De verschillende Veldgewassen en Inventaris kunnen tegen taxati worden overgenomen. Te i» evragen ten kantore van den Notaris SMIT te Helder Dpstraat H 384. (23599) Bij FREDERIK MULLER te Amsterdam verschijnt: F"". VON HELLWALD MER COLONIËN nnd über die hollandischen Niederlassungen in Ostindien insbesondere. Ein Beitrag zur ' niederland. Colonialirage. B°. ƒ 0.60. (24164) DBSIffFfiCTIB. Privaatkuilen worden door ons spoedig zonder stank of aanslag gezuiverd en na de ruiming gedesinfecteerd. Nachtwerkers-Kantoor van KOK & COMP. (24504) Brouwersgracht SS 533. HUM. Tegen November of December e. k. wordt TE HUUR gevraagd een HUIS op een fatsoenlijken stand met minstens 5 kamers en van de vereischte gemakken voorzien. Huurprijs ƒ 500 a 700. Aanbiedingen worden franco ingewacht onder het motto: HUIS bg de Boekhandelaars M. WESTERMAN 6 ZOON.^Kalverstraat E 50 te Amsterdam. (22410) WIJNEN-LIKEÜREN. Een geroutineerd REIZIGER in Wijnen en Buitenl. Gedistilleerd  vele relatiën kunnende aanbrengen zoude zich gaarne tegen primo November a. s. aan een Huis verbinden waarvoor druk gereisd wordt de Huizen in verband met Binnenl. Gedist. en Likeuren zoude hem wel het aangenaamst zijn de beste informatiën staan hem ten dienste. Adres franco brieven lett. B. M. Bureau Handelsblad. (24408) ATTENTIE S. V. P. Een JONGMENSCH 26 jaar oud. elf achtereenvolgende jaren op een der Gasfabrieken als KOPERDRAAIER en ORNEMENTMARER gewerkt hebbende ook eenigszins met Gaefitten bekend wenschte op een Fabriek of Magazijn geplaatst te worden. Franco brieven worden verzocht bg den Boekhandelaar B. H. DE RONDEN Utrechtschestraat onder letter G. (24352) 1 November TE HUUR voor een klein gezin een onderst BOVENHUIS in de nabijheid der Utrechtschestraat. Huurprijs ƒ 140 per jaar. Franoo te bevragen onder lett. B. A. bi} den Boekh. B. H. DE RONDEN Utrechtschestr. (24353) Een fatsoenlijk Man van den P. G. zag zich geplaatst in eene betrekking van ZET-KASTELEIN in eene Sociëteit onverschillig in welk gedeelte des lands getuigschriften kunnen overgelegd worden. Adres franco onder letter S. bij den Boekh. A. M. SLOTHOUWER te Amersfoort. (24350) 3s; TEGEN HOOG SALARIS wordt op eene voorname HANDELSDHUKKEHIJT als CHEF OF EERSTE MEESTERKNECHT gevraagd: iemand toegerust met volledige kennis van het ZETTERS- en DRUKKERS VAK zooowel wat Boek-als Kantoor of Handelswérk betreft. Keflecteerenden gelieven zich met opgave bij wien inlichtinfen te bekomen te adresseeren onder het motto Chef aan het .dvertentiebureau van NIJGH & VAN DITMAR te Rotterdam. (23775) BÜÊMWAMLÈ TIMMERLIEDEN METSELAARS en andere AMBACHTSLIEDEN zoomede (24348) FLINKE AARDWERKERS worden «EVBiiCD voor den Spoorweg van Boxtel naar Wesel om tegen goed loon dadelijk In dienst te treden. Adres aan het Bureau van de Aannemers te Gennep (Limburg). DI NIEUWSTE CONSTRUCTIE van DRAAIBANKEN zoowel voor ovaal of wellend als rond te draaien voor Smeden Forceurs Ivoor- of Houtwerkers- alsmede PERSEN en alle andere WERKIUIGEN of GEREEDSCHAPPEN voor Typo- en Lithographie worden vervaardigd tegen veel verminderde prijzen bg die van het buitenland in de Werkplaats van Stoom- en andere Werktuigen van Jl MOES O. Z. Voorburgwal bij de St. Annastraat 361. (24448) Eene ROER- en BANKETBAKRERSACTAIRE wordt ter overname aangeboden wegens verandering. Brieven franco onder lett. A. 8. bg den Boekh. A. VAN DEN HOEVEN Wijde Lombardsteeg te Amsterdam. (24361) MOTEL Men vraagt terstond of tegen November een Jongmensch als 9de KELLNER van goede getuigenissen voorzien met opgaaf der laatste betrekking. Brieven franco  onder lett. G.L. bij den Boekhandelaar E. E. VON MÜNCHEN Groote Houtstraat te Haarlem. (24407) ~Tfl HUUR GEVRAAGD met 1 September a. s. of later voor een Burgergezin een HUIS of BOVENHUIS tot den Huurprijs van ƒ2OO a ƒ3OO. Aanbiedingen vau stand en inrichting met franco brieven onder lett. G. A. B bij de Boekhandelaars LOMAN & VERSTER Kalverstr. E 221 (24371) Eene OUDEHLOOZE JUFVROUW van den P. G .middelbaren leeftgd eene goede opvoeding genoten hebbende wenschte zich gaarne geplaatst te zien als HUISHOUDSTER  ook niet ongenegen zijnde DEELGENOOTE te worden in een Zaak zooals LOGEMENT of iets dergelijks alle geschiktheid en bekwaamheid daarvoor bezittende. Hierop reflecteerenden gelieven zich te adresseeren met franco brieven onder Lett. D. aan den Boekhandelaar J. MEURS Veenestraat N°. 42 te 's-Gravenhage. (24421) In een druk HUISHOUDEN VERLANGT men van 9 tot 5 Uren een LOOPMEISJE P. G. tusschen de 14 en 18 jaren oud kunnende Lezen Schrijven en eenigszins Rekenen om Boodsohappen te doen en eenig huiswerk te verrichten tegen een wekeljjksche Belooning van ƒl. Alleen zij ie ia staat zijn voldoende Getuigenissen te verkrijgen knnletLv a *ndK«aTre? Ps* eI29D geschreven briefje» on.?*!- Verhit ?hbiQ d^ V 65""5* P- G. VAN 1.6 M. KatnmiM hy de OUftikgehsteegi N"". 33 (844ÖÖ)",http://resolver.kb.nl/resolve?urn=ddd:010099649:mpeg21:a0006:ocr,1,ddd:010099649:mpeg21:p001,Algemeen Handelsblad,4852
17936,1871/03/08 00:00:00,38,ddd:011101539:mpeg21:a0010,http://imageviewer.kb.nl/ImagingService/imagingService?id=ddd:011101539:mpeg21:p004:image&x=3035&y=4543&w=472&h=38,ddd:011101539:mpeg21,3507,4581,3035,4543,4,DriiUrq CHATELIN li Padang.,http://resolver.kb.nl/resolve?urn=ddd:011101539:mpeg21:a0010:ocr,4,ddd:011101539:mpeg21:p004,Sumatra-courant : nieuws- en advertentieblad,472
5187723,1871/03/08 00:00:00,5315,MMVEEN01:000078022:mpeg21:a0024,http://imageviewer.kb.nl/ImagingService/imagingService?id=MMVEEN01:000078022:mpeg21:p004:image&x=2107&y=207&w=978&h=5315,MMVEEN01:000078022:mpeg21,3085,5522,2107,207,4,Advertentie Harlinger en Zuiderzee DAGELIJKSCHE DIEÏST. Van AMSTERDAM 's morgens EO uur. Van BS AKEIft'KE® 's morg. 8© uur 15 min. in directe verbinding met ket Staatsspoor van HARLINGEN naar LEED WAR üEN HliliRENVEEN GRONINGEN NIEUWE SCHANS enz. en in correspondentie met de IIOLLANDSCHE en RIJNSPOOllTREINEN. GcS>EDïlKE!41 worden vervoerd volgens het TARIEF vaetgesteld 1 Januarij 1871. mMm im» voor de Invaliden cn nagelaten betrekkingeu van de gesneuvelden der Saksische legers.. i Met goedkeuring van het Koninklijk Ministerie berichten wij de belanghebbenden  dat de TREKKING der LOTERIJ vasi den 27 Februari tot den 20 iflnart e.k wegens groote tot'bej'eidselen is UITGESTES^D. Dresden en Leipzig  24 Febr. 1871. De Saksische Militaire Hilfs- Vertin  Dr. F. SCHWARZE. BERNHARD KEIL. Van deze LOTERIJ zijn nog maar eenige loten a ff 1.35 te verkrijgen die daarom van deze gelegenheid profiteren wil haaste zich. Van de PREMlE-EEElIllie der Stad Mi Saan  waarvan de trekking den M» Maart zal plaats hebben  zijn nog steeds geheele Aandeelen a 60 Cents en halve Aandeelen a 40 Cents te verkrijgen. In deze LOTERIJ worden Preiniën getrokken van 50000  1000 500  100  50 20 en 10 francs I(. TE VELDE te Wildervank Agent van Builenlandsche Loterijen. e o tö t- 1 > t—1 lz! PARIJS. BEAUVAIS. HAVRE. D. & M. GROOTES Gebrs. WESTZAAN HOTLEVERASCIEES. CACAO EN CHOCOLADE. Zes medailles. Vijf eerv. vermeldingen. Het Concept-Reglement voor het waterschap !» ' 4i }» ter inzage in het Logement van Gr. II. HLOOB< * van af heden tot den 8 April e k.; gedurendedien termijn kunnen bezwaren en aanmerkingen bij het VOORLOOPIG BESTUUR worden ingediend. Veendam  7 Maart 1871. liet voorloopig Bestuur IV. M. IllIZIÏG  Voorzitter. Tnrksche Poot-Aardappelen bij IIARM WOLDKRllI» . Boven-Westerdiep te Veendam. EEN TAPKAST MET TOEBEHOOREN n.1. ELESSCIIESi ea GLAÏE» enz. bij B. DE ROOSZ Brood- en Koekbakker le Stads-Kanaal. GR0MNGER Straatvuilnis en Ier. PUBLIEKE YERKOOPIICr HEDEN Woensdag 8 Maart 1871 ten huize van J. R. EERKES te Veendam,http://resolver.kb.nl/resolve?urn=MMVEEN01:000078022:mpeg21:a0024:ocr,4,MMVEEN01:000078022:mpeg21:p004,Nieuwe Veendammer courant,978
1525138,1871/01/12 00:00:00,1447,ddd:010485746:mpeg21:a0021,http://imageviewer.kb.nl/ImagingService/imagingService?id=ddd:010485746:mpeg21:p002:image&x=3106&y=99&w=1054&h=1447,ddd:010485746:mpeg21,4160,1546,3106,99,6,"Gevraagd : Eene Grouvernante 9 die tevens zich met de"""" "" leiding der huishouding belast. Het geven van onderwijs op de PIANO is een vereischte. Adres franco JAVA-BODE Lt. O. K. (175) jmg_fii3Bte» Een WEDUWE uit den deftigen stand wfßgs&P woonachtig te Amsterdam zou zich gaarne ü» met de opvoeding- en moederlijke zorg van twee of drie OOST-INDISCHE KINDEREN beheksten tegen eene billijke tegemoetkoming. Reflecterenden gelieven zich met franco brieven te adresseren onder Let-ters J. .O-  :hjj -den l^eer VAN DORP. fc269) Te Koop d f 300 contant: Een span WAGENPAARDEN (Isabellen). Te bezigtigen bij f 1 Mevr. de Wed. RANT ** (276) Gang Patjenongan. Te Koop: West-Hartley Steenkolen zeilend per SUNDA bij (29) G. SÜERMONDT & Co. Te Koop gevraagd: Een span WAGEN PAARDEN. Adres Bureau JAVA-BODE. (231)",http://resolver.kb.nl/resolve?urn=ddd:010485746:mpeg21:a0021:ocr,2,ddd:010485746:mpeg21:p002,"Java-bode : nieuws, handels- en advertentieblad voor Nederlandsch-Indie",1054
349656,1871/07/27 00:00:00,408,MMSADB01:000004237:mpeg21:a0020,http://imageviewer.kb.nl/ImagingService/imagingService?id=MMSADB01:000004237:mpeg21:p003:image&x=1924&y=4879&w=857&h=408,MMSADB01:000004237:mpeg21,2781,5287,1924,4879,4,Advertentie Voor de bewijzen van deelneming bij ons Huwelijk ontvangen betuigen wij mede namens onze wederzijdsche betrekkingen onzen opregten dank. J. JURGENS. E. H. JURGENS van Waardenburg. Tiel 25 Julij 1871.,http://resolver.kb.nl/resolve?urn=MMSADB01:000004237:mpeg21:a0020:ocr,3,MMSADB01:000004237:mpeg21:p003,Provinciale Noordbrabantsche en 's Hertogenbossche courant,857
1095342,1871/04/28 00:00:00,1174,ddd:010873606:mpeg21:a0021,http://imageviewer.kb.nl/ImagingService/imagingService?id=ddd:010873606:mpeg21:p004:image&x=1010&y=3905&w=933&h=1174,ddd:010873606:mpeg21,1943,5079,1010,3905,4,Centraal Israël. Weeshuis IN NEDERLAND Zij die genegen zijn tegen 1 Augustus a.s. de betrekking van Godsdienst-Onderwijzer in bovengenoemd Gesticht te aanvaarden worden uitgenoodigd zich vóór of op 14 Mei a.s. daartoe bij een der ondergeteekenden aan te melden. Om in aanmerking te komen wordt o. a. vereischt dat de Sollicitant zij ongehuwd van een onbesproken gedrag in het genot van eene goede gezondheid en in het bezit van eene acte van minstens tweeden rang waarvan de bewijzen met opgave van ouderdom en tegenwoordige betrekking uiterlijk 3 dagen te voren bij den 2deu ondergeteekende ingewacht worden. Behalve vrije inwoning) kost enz. is aan deze betrekking een salaris van ƒ 200 verbonden. Het voorloopig Bestuur van de Stichting voornoemd Mr. S. M. A. DU MOSCH (816) Voorzitter. L. VAN LIER Secretaris. Utrecht 25 April 187 L,http://resolver.kb.nl/resolve?urn=ddd:010873606:mpeg21:a0021:ocr,4,ddd:010873606:mpeg21:p004,Nieuw Israelietisch weekblad,933
3971762,1871/12/30 00:00:00,3881,MMSAVL02:000422219:mpeg21:a00024,http://imageviewer.kb.nl/ImagingService/imagingService?id=MMSAVL02:000422219:mpeg21:p00004:image&x=1777&y=1123&w=1028&h=3881,MMSAVL02:000422219:mpeg21:p,2805,5004,1777,1123,4,Advertentie De ondergeteekenden wenschen bij den aanvang des jaars ’s Hemels besten zegen toe aan hun geachten stadgenooten. J. BRONKHORST en Echlgenoote. De ondergeteekenden brengen aan hunne begunstigers vrienden en bekenden het compliment van den dag. VAN DER GON & DE LIGT. Heilgroet aan familie begunstigers en vrienden. A. ZONNE. K. A. WIMMËRS wenscht zijn geachte Burgers bij den aanvang van het jaar veel heil en zegen toe; dankbaar voor het vertrouwen hem in ’t afgeloopen jaar geschonken beveelt hij zich weder opnieuw in ieders gunst aan. Bij den aanvang van het Nieuwejaar wenscht de ondergeteekende zijnen vrienden en begunstigers Gods besten zegen toe. J. H. MEIJER. De ondergeteekende wenscht zijne vrienden bekenden en begunstigers zoowel binnen als buiten deze plaats veel geluk in het aangevangen jaar. ____ L. HAKBIJL. Het Compliment van den dag aan mijn geëerde begunstigers vrienden en bekenden ANTH. DROP. De ondergeteekende wenscht zijne stadgenooten veel heil en zegen in het Nieuwejaar. J. A. VAN PINXTEBEN. Heil en zegen aan al mijne begunstigers vrienden en bekenden. C. J. VAN LEEUWEN Pz. De ondergeteekende wenscht hare begunstigers Gods besten zegen bij den aanvang van het Nieuwejaar En brengt tevens ter kennis dat de Verwersen Glazenmakerszaak door baar op denzelfden voet met behulp van baren zoon zal worden voortgezet. Zich bij voortduring in UEds. gunst aanbevelende. Uw dw. dienares Wed. C. DROP. Mijn Nieuwjaarsgelukwensch aan begunstigers vrienden en bekenden. J. F. C. BRUCKWILDER. Ondergeteekende zijne stadgenooten bij de intrede van het Nieuwejaar alle heil en zegen toewenschende maakt tevens bekend dat hij van af heden zich voor eigen rekening heeft gevestigd als VERWER m GLAZENMAKER in bet Huis aan het Westnieuwland Wijk L No. 152; bevelende hij zich met bescheidenheid in ieders gunst aan. Met achting UEd. Dw. Dienaar P. VAN DEN BERG Czn. Agentuur van Assurantiën tegen BRAM- RIVIER- EN ZEEGEVAAR. P. VAN DAM. V00RL00PIG BERICHT. Bij den ondergeteekende is op heden ingekomen van een man uit het volk een uitvoerig antwoerd op de in de Vlaardingsche Courant van 19 April 1871 gëdanè vraag: „Welk VOLKSFEEST kan voor de KERMIS in de plaats gesteld worden?” Vlaardingen  28 Dec. 1871. J. F. C. BRÜCKWILDER.,http://resolver.kb.nl/resolve?urn=MMSAVL02:000422219:mpeg21:a00024:ocr,4,MMSAVL02:000422219:mpeg21:p00004,Vlaardingsche courant,1028
1572020,1871/12/10 00:00:00,1894,ddd:010509645:mpeg21:a0012,http://imageviewer.kb.nl/ImagingService/imagingService?id=ddd:010509645:mpeg21:p002:image&x=2609&y=2756&w=830&h=1894,ddd:010509645:mpeg21,3439,4650,2609,2756,4,"! Gezonde zware Banannen PLANTSOENEN af te leveren aan de rivier-zijde van een nabij de stad gelegen plantage ;. worden tegen zeer billijken prijs te koop aangeboden. Adres ter dezer Drukkerij. (17659) ~""*"" "" ' ■ ' ' -Tl Te Huur; Het koopmanshuis aan de Knuffelsgracht La. A No. 229 laatst bewoond door den Wel Edel Heer P. C. WESEiVHAGEN. J. IM. WOLFF. (15660) Te koop: Eenige sterke gedresseerde Muilezels en in vaten Adres ter dezer DRUKKERIJ. (17661) -■ 1",http://resolver.kb.nl/resolve?urn=ddd:010509645:mpeg21:a0012:ocr,2,ddd:010509645:mpeg21:p002,De West-Indiër : dagblad toegewĳd aan de belangen van Nederlandsch Guyana,830
1885680,1871/08/15 00:00:00,2160,ddd:010586155:mpeg21:a0030,http://imageviewer.kb.nl/ImagingService/imagingService?id=ddd:010586155:mpeg21:p006:image&x=1858&y=98&w=873&h=2160,ddd:010586155:mpeg21,2731,2258,1858,98,6,"BOELGOED en verkoop van een SNIK.SCHIP. |~ iikuiM' _ h . Heiiivvaanl. i te Holwerd  ~..1 óp Don.ler.ae den I  AugllHtU """"l | ... L 2 uur . I.n huize \au lleune A i ' itl""  n Klaas II ' - • 'I"" ::rVv "" ''""'"" ' I | |~e 'l  . eoiitani  verkoopen : a. MKUKKIKN i-ii HUiSt. KHAAL) als i Kabinetten Kastje lloekspintle  Ta. el S len Staartßliikkb.k  Spiegel en Schil derijen . voorts Kope eu 11 d  i.las  l'oiveleii en Aardewerk . ijaereu Balansen met Schalen  eeniac Juffers en Kallen voorts Mannen en Vrouwen Lijfdragt. ... K.-n SNIKBCHIP liggende in de Vaarl te Wieruin. de Jongt Sanne genaamd . .„t g |~ll  met Luiken . Ma-t . (Hek  Zeil. Kok  Zwaarden en verder toe- en aanochooien ; v _S 84 I; raair/.nkken eu | l-een meer ler verkoop .al worden aan geboden. TE SNEEK UIT DE HAND TE KOOP: gene groote r ie en in den laai iten tijd verbouwde eu veel v crlieter.le \V IHI N 11 1' I/ I N OE mei Tuin en roim Erf alsmede een erool en sterk PAKHUIS met SCHITK -n Erf samen groot ongeveer 18 roede slaande en gelegen even builen de v melige OosterpooH aldaar aan de Trekvaart naar I.eeuw arden li/■ Panden sijn zeer gunstig gelegen tol bet Oprigten .ener fabriek/aal. .I; root handel of Boerderij. Dagelijks te beaigtteen en te ""bevragen lij den en bewoner S. iv\ fri WKKI TE KOOP bij Harlingen: K.l|(. terke BI RGERHUIZING . roeger Bakkerij) met Tuin of tlink- Grond aan de trekvaart. bij 8. AAN KMA Ie Harlingen. Duur \f ra ii ilt'ring vüii Wtt»UlU uit de hand TE KOOP: Ken voor twee jaren geheel nieuw vertimmerde WINKKKHi UZINGEmei groote*TuinStl bij de Markt kC Workum te aanvaarden II Kei . of eerder Te bei rag d bij den i igeaaai .1 POLDEfi te Workum.",http://resolver.kb.nl/resolve?urn=ddd:010586155:mpeg21:a0030:ocr,6,ddd:010586155:mpeg21:p006,Leeuwarder courant,873
733041,1871/05/31 00:00:00,711,ddd:110533298:mpeg21:a0002,http://imageviewer.kb.nl/ImagingService/imagingService?id=ddd:110533298:mpeg21:p001:image&x=1078&y=1029&w=1031&h=711,ddd:110533298:mpeg21,2109,1740,1078,1029,4,"V c ii d 12 f i c n. DONDERDAG 1 Junij. Ten huize van Majoor de Graaf door Janssen en van Wijl: en Voor een huis te Meesier Cornelis door van Slooten Morgan §- Co. en Voor de toko van van den Aleelen §"" Co. VRIJDAG 2 Junij. Ten huize van Mevrouw Calmer door ff. Loonen §' Co. en Ten huize van den heer Busken Iluet door van Vleuten §• Cox. en Voor de toko van van Slooten Morgan Co. ZATüRÜAG 3 Junij. In 't Vendu-Locaal. ADVERTENTIE N.",http://resolver.kb.nl/resolve?urn=ddd:110533298:mpeg21:a0002:ocr,1,ddd:110533298:mpeg21:p001,Bataviaasch handelsblad,1031
1015200,1871/01/04 00:00:00,752,ddd:000017495:mpeg21:a0025,http://imageviewer.kb.nl/ImagingService/imagingService?id=ddd:000017495:mpeg21:p004:image&x=2167&y=4427&w=1350&h=752,ddd:000017495:mpeg21,3517,5179,2167,4427,4,A. lIAMIVIËR De Pctiï Bourgogne Maconnais Thorins ?an uitstekende qualiteit is nog steeds voorradig. Pi ijs ƒ36 per anker met inbegrip van accijns. Pioefflesschen k f 0.90. Voorts alle andere soorten van fijne en ordinaire WIJNEN waaronder de alom gereputeerde BORDEAUX a ƒ 24 per anker en J O.CO per flesch. Fijn Binnen- en Buitenlandsch GEDISTILLEERD en LIKEUREN volgens Prijscourant. (176..) Generaal Depot: Oude Turfmarkt B 63 Amsterdam.,http://resolver.kb.nl/resolve?urn=ddd:000017495:mpeg21:a0025:ocr,4,ddd:000017495:mpeg21:p004,Het nieuws van den dag : kleine courant,1350
3460896,1871/11/25 00:00:00,3546,ddd:010099813:mpeg21:a0009,http://imageviewer.kb.nl/ImagingService/imagingService?id=ddd:010099813:mpeg21:p002:image&x=3953&y=97&w=976&h=3546,ddd:010099813:mpeg21,4929,3643,3953,97,2,"Al^eraaeeiae 'Wergadering' van Stemsrerechti^de Deelgenooten in de COMiHERCIE'* COMPAGNIE te Middelburg te beiden in het gebouw der Compagnie op Dinsdag dea 28iten November e. k. desnamiddajrs te een uur. Ter visie legging v»n stukken van af 14 November n. s. tot don dag der Vergadering ten Kantore van den Boe_h< >nd<_r der Compagnie. (33335) UOTJE--L M^MEIE-El^ lISTEIBAI. TABLE B'HOTE des Zondags te Vijl uren —de overiga dsgea der week Half Vqf — 28976) C_.ave.rt me. «/SB a. TSSRja ƒ 2.35.  KIEUWË cfLIIfEEAMSOCiËTEIT/ te 's-€Srave_aliase. COMMISSARISSEN mak n N-kend dat ter Aflossing der Geldieeniug van 1869 ad ƒ 250.000 op den Uden November 1871 zijn C9TGELOOT de Nommers 56 65 158 1 9 207 226 243 en 244 welke ObligatiSn den lsten Februari 1872 aan bet Societeitsgebouw aïsm.de te Amsterdam bij de Hoeion NACHENIDS & ZOON en te Rotterdam bq de Heeren A. J. & M. MILDERS betaalbaar zqn gesteld; zullende na di.n tqd geene renten meer op dia Obligatien nitb-taald worden. (35462Q 01ER-OPZKBTER WËBIHUB.- Tegen 1 Januari e. k. wordt ta Wcrmerveer voor hat Werkhuis een ONDEROPZICIITEft gevraagd. Soliicitantea kunnen met franco brieven zich vóór 1 December e. k aanmelden bq den laatst-ondergeteekei..!?. i R. LAAN Voorzitter. 1 (35471) W. DE MEIJïER Secretaris. I-HTVÖRDT GEVRAAGD voor eeao fatsoetfqk JUFVROUW eene BETRESLSLÜW6 als WISK_.ELDOCI_.TER het:s in Manufacturen of in een Garen- en Band winkel; zij verstaat alle vrouwelijke Handwerken; er zal in den begiune meer eekt worden op aene goede behandeling dan op groot salaris. Rriefj_s worden franco ingewacht onder de lett. P. H. O Bureau Handelsbl. (35419); BETREEEIIG GSfRAAGB. lEMAND oud 25 jsren P. G. bekend rcie_ de moderne talen en Admisistratie z.afet eene BETREKKIATG die hem een burgerlijk bestaan oplevert. Brieven franco onder lett. A. P Bureau Handelsblad. (35437) Eene WEDUWE 40 jaren oud uit den fatsoenlijken stand! zonder kinderen P. G zig zich gaarne ten spoedigste GE"" PLAATST als H_7}gH_Jf7DSÏER. Er zal meer op goede behandeling dan op groot salaris gelet worden. Hierop'reflscteereacïeu gelieven zich te adresseeren o»der lett. R. by den Boekhandelaar H. C. SUSAN CHz te's-Gravenbage. (35432) Pen fatsoenlijk JONGMSNSCH van den P. G niet onder (.e 16 jaar en sretuige*. van eerlökhoid kunnende producoeren kan in een SIGAREKMAGAZMtf geplaatst worden tegen genot van Salmi**. A-irea in ptrsooa Kalverstraat E 234. tegenover het Fransche Koffiehuis. (35582) JSBeII Een gebruikte houten BISVEM-lü een ex'ra JÊËR?' «ware MOLENKRIJfii 4 stuks PELSTEEftEtf «Swfflfc en verdere Moleawwken. Met franco brieven to bevragen en to bcrichtigen bq den Molenmaker T. PEPPINIC bq de Raambarrière te Amsterdam. (35489) WIJIIC h Gevrasgd een flinke BURGER JORGELING niet beneden de 16 ji.ren goed kunnende leze!. schrqven en tot werken genegen; loon voorloopig / 3 met verhooei**g nasr vordiecste. Franco eigenhandig geschreven brieven oneler lett M. U. in den Kantoorboel.winktil vanH.H.FELDERHOFFJb. Oude Teertuinen bq den Zeedijk. (35.92) Eeno fatjoenlqko JUFVROUW don;- sterfgeval buitea Betrekkicg zap zich gaarne welrr GEPLAATST ter eezelsdhvp cf ter bestieriDg van het Huishou ten van a-n oude HHES of DAME of kleine Huishouding. Daar zq alleen is heeft zy gaarne werkzaamheid en een aangenaams omgang. Brieven franco ond«r lett. H. W. A. Bureau Handelsblad. (35496) Hst Bestuur der Liedertafel OEFENING B *ART KUNST geeft bö deze kennis dat door haar een ZANGCURSUS voor _84j.%'GELKE__S_S_%' bovea de' 16 jaren geopend is. Aanvragen tot deelne:!*iß& gelieve men hq den Heer J. COHEN (Nes A 2) alhier in to leveren bq wien ook naders inlichti!»gea te bekomen _ga. (35C00)",http://resolver.kb.nl/resolve?urn=ddd:010099813:mpeg21:a0009:ocr,2,ddd:010099813:mpeg21:p002,Algemeen Handelsblad,976
1304752,1871/02/12 00:00:00,4547,ddd:010509559:mpeg21:a0015,http://imageviewer.kb.nl/ImagingService/imagingService?id=ddd:010509559:mpeg21:p003:image&x=98&y=69&w=3313&h=4547,ddd:010509559:mpeg21,3411,4616,98,69,4,"Rij Koninklijk Besluit dd. 3 Jannarij |1 Ko 24 is o. a. .___lo. de .Heer L G. Broei ondei t^OKbelui £ing eervol ontheven van de opdrag! hot yaarneminp der zaken bet departement van koloniën betreffende; 2o. ri. 1 in_.i'.i_ van den 4 der pemelde mnand. tot Minister van Koloniën benoemd de Heer Mr P. P. van Bosse laatsjtèlij» Minister van Financien. P. Koit-rijk heelt vei_oeh< dat aan be i in pacht worde _._. _ié_ii. het erf _an .«? Nieuw.-straat hij net Molenpad  thans benend onder La. 1' .No 382. Tijd van Terzet drie wekeu gerekend van den 6 Februarij. Bij Gouvernemefrus Resolutie dd. 10 Fehru» arij No. 1 is tot 2u. Commies ter Gouveroè. meuts Secretarie benoemd de Heor 11 W""jü_g_. ©e Notaris J. W. J. Papc zal op Olngsdaj den \>\ dezer des voormiddags ien 'J nie ter: verzoeke van dun Heer Konunandant var Z M Zeoiiiact in de kolonie Surina.i e. aar '.-i Lands .Marine Mai.'u/.ijiieii [iv litst openbaar a f. o n I u n t vrrkoo^ien : lo vaten (.011. 4 do. Groene Erwten 3 do. Gr.' ;iuwe Erwten en eene kUi-ie loot-veelheid Koas. Weke poederen op ilnnndag den 1-3 deieei van des voormiddaas aclu tot elf ure  le bezigtiget) zijn in 's Lands Musovijnon.",http://resolver.kb.nl/resolve?urn=ddd:010509559:mpeg21:a0015:ocr,3,ddd:010509559:mpeg21:p003,De West-Indiër : dagblad toegewĳd aan de belangen van Nederlandsch Guyana,3313
1601908,1871/10/31 00:00:00,2156,ddd:010263348:mpeg21:a0043,http://imageviewer.kb.nl/ImagingService/imagingService?id=ddd:010263348:mpeg21:p004:image&x=1565&y=3240&w=743&h=2156,ddd:010263348:mpeg21,2308,5396,1565,3240,4,"KÉOMUÉM. De ondergeteekende legt gaarne de verklaring af dat de drie nieuwe door de 'Heeren PETIT & FRITSEN te Aarle- Rixtel ten behoeve van het Seminarie van Roldtjc gegoten Torenklokken die 1666—845 en 484 halve kilo's wegen zoowel wat den sierlijken vorm als wat den vollen zuiveren klank en het akkoord betreft aan de strengste eischen beantwoorden en den vervaardigers alle eer aandoen. De grootste dier Klokken is een geschenk van den Wel Edelen Heer en Mevrouw J. VAN WEEDE—VAN WAAS uit Alkmaar die door deze edelmoedige gift de herinnering aan hun alhier overleden eenig Zooritje hebben vereeuwigd. Twee eerbiedwaardige Heeren Pastoors uit het naburige Duitschland waarvan de eene reeds overleden is en de andere onbekend wenscht te blijven hebben de beide andere geschonken. Wij wenschen hiermede openlijk onze diepgevoelde erkentelijkheid te betuigen. W. _ËV_ËHT§ Directeur van het R. K. Seminarie en der Hoogere Burgerschool (6901) van Rolduc. AANBESTEDING. De Vrouwelijke Vereeniging onder de zinspreuk: »Genootschap tot liefdadig onderwijs te Bergen op Zoom"" is voornemens op Maandag den 13. November 1871 des middass ten twaalfure bij den Heer A. VERLINDEN in het Koffij huis St. Antoine te Bergen op Zoom bij enkele inschrijving aan te besteden: het bouwen van een i__J__.loo.__ter met BS.apel en twaalf' SSehoollofealen met bijlevering der materialen. De teekeningen en het bestek liggen ter inzage in bovengenoemd Lokaal. De aanwijzing zal plaats hebben op Zaturdag den 4° November a. s. des morgens om tien ure. Inlichtingen zijn te bekomen bij den Architect C. P. VAN GENK te Bergen op Zoom. (6904)",http://resolver.kb.nl/resolve?urn=ddd:010263348:mpeg21:a0043:ocr,4,ddd:010263348:mpeg21:p004,De Tĳd : godsdienstig-staatkundig dagblad,743
6389225,1871/01/09 00:00:00,2541,MMHCO01:000065134:mpeg21:a0013,http://imageviewer.kb.nl/ImagingService/imagingService?id=MMHCO01:000065134:mpeg21:p004:image&x=1186&y=107&w=1955&h=2541,MMHCO01:000065134:mpeg21,3141,2648,1186,107,4,"Advertentie SIGARENMAGAZIJN Groote-Kerkplein 2 de huis van de Stadswaag. Door Kwitering van zalmen finale uitverkoop tot veel verminderde prijzen. ZWOLLE 24 December 1870. H. DE FLUITER. Groenten- bloem- gras- bosch- en landbouwzaden e nz. in beste kwaliteiten volgens prijscouranten verkrijgbaar bij DAVID JACOBSON Haarlem. Een EIO0FDAGEMT voor deze provincie wordt gezocht. Voor het eerst in Zwolle gearriveerd OSCAR RE BEK met dL© nieuwst© ©n interressantst© TOOVER-APPAEATEN. De gezamenlijke APPARATEMf zijn zeer verrassend en ieder aan te bevelen bijzonder voor familiën en gezelseliaps-kraitsen  om zich gedurende de LANGE WINTERAVONDEN den tijd te verdrijven en genoegelijk te amuseren ook voor kinderen en voor ieder welke zich iets nieuws wil koopen of liefhebbers ten geschenke geven wil. Ieder die een toestel koopt» bekomt eene duidelijke aanwijzing-en verklaring-. O"" PRIJSCOURANTEN gratis verkrijgbaar. Voor korten tijd alhier geëtaleerd in het Eüötel de Keizerskroon Kamperstraat.",http://resolver.kb.nl/resolve?urn=MMHCO01:000065134:mpeg21:a0013:ocr,4,MMHCO01:000065134:mpeg21:p004,Provinciale Overijsselsche en Zwolsche courant,1955
3716971,1871/05/31 00:00:00,3541,MMDA03:000095259:mpeg21:a0010,http://imageviewer.kb.nl/ImagingService/imagingService?id=MMDA03:000095259:mpeg21:p004:image&x=80&y=1616&w=991&h=3541,MMDA03:000095259:mpeg21,1071,5157,80,1616,4,"Advertentie Zendingszaak. VEBGABÜBI1VO van de AFDEELLNG KOEVORDEN van het SrderlandRrh Zendeling fieüootüchnp te Rotterdam op Zondag den 4den Juoji a s. te Daleu. Des namiddags ten 3 ure zal de O H* W Si M. «i. IIV G S -11K I> K  in da kerk te Dalen aebonde"" worden door tien Wel E rw. Zeergel. Heer ROESSINGH Pred. te Eromeri. Daarna Vergadering van LEDEN e« BEGUNSTIGERS ten huize van de erven VAN TAREL. De COLLKCTK zal gehouden worden bij het einde der godsdienstoefening. Dalen 26 Mei 187!. G. W. VAN EERDE President. » H. VAN INGEN Secretaris. van 99 „d e Eefiadraclit 9 Drentsche Yereeniging voor VOLKSVERMAKELIJKHEDEN TE ASSEN oj» ^onderda; den Bstcn Juni; 1871 's avonds te 8 uur ten huize van dm fleer SOMER. ?unt van behandeling: Plan voor het vieren van een Zomerfeest. Namens het Bestuur I. ROESSINGH Pres. H. W. SANDERS Secr. BURGEMEESTER en WETHOUDERS van WESTERBORK brengen ter kenni3 van belanghebbenden dat de TABEL DER WEGEN en daartoe betrekkelijke voorwerpen i;i deze gemeente door den Raad iu zijne vergadering van 20 dezer voorloopig is vastgesteld eti gedurende 14 dagen van af 1 tot 15 Junij e.k. ter Secretarie voor een ieder ter inzage is xsedergelegd ; kunnende belanghebbenden gedurende dat tijdvak hunne bezwaren bjj Heer-en Gedeputeerde Staten L brengen. Westerbork 28 M j i 1871. Burgemeester én Wethouders voorn. H. v. d . W1JCK Burgemeester. J. T. KIJMMELlr Secretaris. Op Vrijdag den 3den Juni) aal te WESTESUasOJtiU. voor hot eerst worden gehouden. AANBESTEDING. BURGEMEESTER en WETHOUDERS van ONSTWEDDE zijn voornemens op Woensdag den 21 Junij e.k. des nademiddags om 2 uur in het GEMEENTEHUIS te Stadskanaal bij enkele inschrijving te zaaien of afzonderlijk AAS TE BE* 8TBDE1Ï: Sïet bouwen van een SCHOOLCiSüSBOUVir en ©ar»EBWU31EÜSWO!ÏI]lie te Musselknnaal met Bijlevering van alle daartoe benoodigde materialen. BESTEKKEN en TEEKENINGEN zullen van af den 3den Junij e.k. ter inzage liggen in bet Gemeentehuis. Alsdan zij u op franco aan/rage BESTEKKEN verkrijgbaar gesteld tegen betaling van ƒ 0.50 het exemplaar. Inlevering der billetten rcinsteas 24 uren vóór de aanbesteding. >  Stadskanaal 27 Mei 1871. Burgemeester en Wethouders voornoemd REIJNDERS. De Wethouder. B. F. HARDING.",http://resolver.kb.nl/resolve?urn=MMDA03:000095259:mpeg21:a0010:ocr,4,MMDA03:000095259:mpeg21:p004,Provinciale Drentsche en Asser courant,991
77778,1871/02/01 00:00:00,87,ddd:011101529:mpeg21:a0013,http://imageviewer.kb.nl/ImagingService/imagingService?id=ddd:011101529:mpeg21:p004:image&x=2820&y=4599&w=894&h=87,ddd:011101529:mpeg21,3714,4686,2820,4599,4,Drukksrjj CHATELIN U Paddna. v. :•,http://resolver.kb.nl/resolve?urn=ddd:011101529:mpeg21:a0013:ocr,4,ddd:011101529:mpeg21:p004,Sumatra-courant : nieuws- en advertentieblad,894
5123458,1871/05/08 00:00:00,5446,MMKB08:000089023:mpeg21:a0020,http://imageviewer.kb.nl/ImagingService/imagingService?id=MMKB08:000089023:mpeg21:p003:image&x=2615&y=75&w=937&h=5446,MMKB08:000089023:mpeg21,3552,5521,2615,75,6,"Advertentie De Kiezersvereeniging „ARNHEM"" heeft in hare VERGADERING op Dingsdag den 18den April 11. tot Kandidaten voor het lidmaatschap der Provinciale Staten gekozen Mr. C. P. HENNY aftredend lid en Mr. G. J. VAN HASSELT Secretaris der gemeente Rheden. De Heer HENNY heeft |in de jaren die hij zitting had bewezen een nuttig lid der Staten te zijn die de hem toevertrouwde bolangen met ijver en kennis behartigde en op wiens voorlichting groote prijs werd gesteld door zijne medeleden. De Heer g. j. van hasselt is zoowel in Arnhem als in het onder-kiesdistrict bekend als een regtschapen bekwaam vrijzinnig man. Door zijne betrekking van Secretaris eener bloeijende en uitgebreide gemeente is hij vertrouwd zoowel met de Provinciale- en Gemeente-zaken in het algemeen als inzonderheid met die van het district waarin thans de keuze op hem is gevestigd. Overtuigd dat ook zijne kéuze  zoo zij gedeeld wordt door de meerderheid der kiezers in ons district in het algemeen belang zal strekken beveelt de Kiezersvereeniging „ARNHEM» bij de aanstaande verkiezingen op Dingsdag den 9 den Mei als kandidaten aan Mr. C. P. HENNY (aftredend lid) en Mr. Gr. J. YAN HASSELT Secretaris der gemeente Rheden. Het Bestuur der Kiezersvereeniging: B. F. Baron VAN VERSCHUER Voorzitter. G. KELLER Secretaris. PROVINCIALE STATEF De aftredende Leden der Provinciale Staten zijn: Mr. C. P. Henny EN C.W.Graafv. Limburg Stirum. die beiden op Dingsdag 9 dezer TEN ZEERSTE ter HERKIEZING worden aanbevolen. Kiesdistrict EDE. Aan de KIEZERS in het Kiesdistrict ED B worden bij de verkiezing van twee Leden voor de PROVINCIALE STATEN welke op 9 Mei aanstaande zal plaats hebben aanbevolen: Joukli. A.W.vau Borssele aftredend Lid en H. P. van Heyst Notaris te Barneveld. Laatstgenoemde uit aanmerking van zijne bekendheid met de belangen der Gemeenten Barneveld en Wageningen in welke hij zestien jaar lang heeft gewoond en gewerkt zoo mede omdat het billijk schijnt dat een aftredend lid dat Barneveld vertegenwoordigde door een Barnevelds ingezeten wordt vervangen. J. H. Baron VAN ZUYLEN VAN NIEVELT. Jhr. J. LAUTA VAN AYSMA. G. VERLOOP. P. ANDREiE MENGER. J. W. VAN VLOTEN. G. J. KAPTEIJN. J. R. VAN MAANEN. W. SCHUT. G. VAN VOLLENHOVEN. G. J. LAARBERG. J. BONTING. B. A. NIEUWSTAD. C. HOPSTER. E. MARCUS. J. TEN HAM. J. A. RADEMAKER. Kiesdistrict Ede Aan de Kiezers in het Kiesdistrict Ede worden bij de verkiezing van TWEE LEDEN voor de PROVINCIALE STATEN welke op den 9den Mei a. s. zal plaats hebben aanbevolen: Jonkheer A. W. YAN BORSSELE. Aftredend Lid. Ph.F.A. J. BaronVAN BRAKELLDOORWERTH. Burgemeester van Doorwerth. De herkiezing van den bekwamen en wakkeren Burgemeester van Ede den Heer VAN BORSSELE staat zoo niet bij alle toch zeer zeker bij de meeste Kiezers vast en de kandidatuur van den Heer VAN BRAKELL-DOORWERTH die in 1865 reeds 135 stemmen op zich zag uitbrengen moet gebillijkt worden als men bedenkt dat Wageningen Ede en Barneveld reeds een lid ter Provinciale Vergadering hebben afgevaardigd; terwijl tot nog toe de onderkiesdistricten Renkum en Doorwerth dat voorregt missen. Er kunnen in de gewestelijke vergadering vraagstukken ter sprake komen waarbij deze schoone streek het hoogste belang heeft dat hare belangen door iemand uit haar midden worden voorgestaan. Eenige Kiezers.",http://resolver.kb.nl/resolve?urn=MMKB08:000089023:mpeg21:a0020:ocr,3,MMKB08:000089023:mpeg21:p003,Arnhemsche courant,937
4310000,1871/03/04 00:00:00,5000,MMSADB01:000004110:mpeg21:a0009,http://imageviewer.kb.nl/ImagingService/imagingService?id=MMSADB01:000004110:mpeg21:p002:image&x=1962&y=285&w=862&h=5000,MMSADB01:000004110:mpeg21,2824,5285,1962,285,4,Advertentie HOOFDONDERWIJZERS. Die verlangen te dingen naar de betrekking van HOOFDONDERWIJZER der Openbare School te Borkel en Schaft waaraan is verbonden eene jaarwedde van f500.  met genot vau vrije Woning en Tuin worden uitgenoodigd zich vóór 26 April e. k. onder overlegging der vereischte stukken in persoon of met vrachtvrije brieven aan te melden bij den Burgemeester der Gemeente. KOPER- enBLIKSLAGER Wordt gevraagd een bekwaam vlug KOPER- en BLIKSLAGER  Hamer goed meester en juist naar model of teekening fijn glad werk kunnende drijven. Salaris naar bekwaamheid. Adres met franco Brieven onder lett. S. D. J.  bij den Boekhandelaar J. J. VAN BREDERODE te Haarlem. Eene groote partij BESTE LUIKSCHE KAGCHEL- Machine- cd Suicêkulcn ook echte en vette SCHAALKOLEN ENGALLETTEN aan de meest concurrerende prijzen. Levert ook direct per Waggon en per Schip bovenstaande soorten alsmede GAZ- en NUTSKOLEN en COKES voor Gieterijen en Suikerfabrieken. Kantoor Park 's Bosch. SNIJDERS VAN GEFFEN. È te geven door de QUARTET-VHREHNIGING de Gebroeders B0UMAN op Donderdag 16 Maart 1871 in de SCBOtlWBKUAL DER SOCIETEIT ÜSINO Aanvang Th ure. ENTREE 99 CENTS. AANBESTEDING J. A. COHMAÏÏ Bierbrouwer te Vlijmen  is voornemens op Maandag 13 Maart e. k. des namiddags ten 5 ure ten huize van W. VAN FALIER aldaar AAN TE BESTEDEN: Het bouwen van twee Bierkelders eene Mouterij Achtergebouw  Graanzolders enz. waarvan het bestek bij genoemde VAN FALIER van af 8 dezer ter i»zage zal liggen. De aanwijzing in loco zal plaats hebben op den dag der Aanbesteding des namiddags ten 2 ure. AANBESTEDING. BEKENDMAKING. BURGEMEESTER en WETHOUDERS van Tilburg zullen op Woensdag den 22 Maart 1871 des voormiddags ten 11 uur in het openbaar AANBESTEDEN: Het leggen van Trottoirs Riolering en Verstrating van de Markt Noorder- en Zuider Kerkstraat en een gedeelte van den Nieuwendijk. De bestekken liggen van af den 1 Maart aanstaande ten Gemeentehuize ter lezing en zijn bij de Boekdrukkers A. VAN DER VOORT & Zn. te Tilburg voor 50 Cents per exemplaar te verkrijgen. De aanwijzing van dat werk zal plaats hebben op Zaterdag den 18 bevorens des voormiddags ten 10 uur. Tilburg 25 Februari 1871. Burgemeester en Wethouders voorn. JANSEN  Burgemeester. Q. BEL JAARS Secretaris.,http://resolver.kb.nl/resolve?urn=MMSADB01:000004110:mpeg21:a0009:ocr,2,MMSADB01:000004110:mpeg21:p002,Provinciale Noordbrabantsche en 's Hertogenbossche courant,862
3726342,1871/06/07 00:00:00,2577,ddd:010262767:mpeg21:a0050,http://imageviewer.kb.nl/ImagingService/imagingService?id=ddd:010262767:mpeg21:p004:image&x=2307&y=389&w=1446&h=2577,ddd:010262767:mpeg21,3753,2966,2307,389,4,"NATIONALE-"" LEVENSVERZEKERING!-RANC GOEDGEKEURD DOOR Z. M. DEN KONING gevestigd te Rotterdam Zuidblaak No. 36. YOLTEEKEND WAARBORG-JCAPITAAL : EJETV MILLIOEN GULDEIV. Verzeßerd bedrag op ultimo December 1870: ƒ 8.175.146— Reserve voor loopende Kontrakten enz. op ultimo December 1870: ƒ760.51551. WINST over de jaren 1863—67: j 3754357 waarvan een vierdegedeelte (25°/9) onder de daarop rechthebbende Verzekerden is verdeeld bedragende voor ieder 3.77% van het door hem tot ultimo December 1867 'betaald* premiebedrag. COIfIItIISSA RISSEÏI: D. BLANKENHEYM JOOST VAN VOLLENHOVEN R. H. NIERSTRASZ R. MEES Mr. T. M. C. ASSER Mr. J. B. L. WENTHOLT Jonkhr. Mr. F. J. J. VAN EYSINGA Mr. J. U. DE KEMPENAER. DIRECTIE: Mr. W. S. VAN REESEMA Directeur. S.VAN DER HELD Wz. Administrateur- A. S. VAN REESEMA Adj.-Directeur. Levensverzekeringen voor het ge-i Tij d e lij k e-verzekeringen ; heele leven; Op voedings- en onderhouds-vef"" P e n s i o e n-verzekeringen; zekeringen; Kapitaal s-verzekeringen; Studiekoste n-verzekeringen; Gemengde levens- en kapitaals-verze- Lijfrenten-contracten zoo 'dadeljjk6 keringen; als toekomstige. (4361) Dadelijk ingaand recht op 25 percent aandeel in de winst* Inlichtingen en Memorandums te verkrijgen by de Directie en de Agenten. KOIILIJKE HONGAARSCHE LOTiIÏ7C met buitengewone hooge prijzen 15 Augustus* p^f> vuftibi pusTüs mum. -^g Voor de Trekking van IS Mnguxtu* lever ik Geheele Loten a f 3.50» Halve a f 1.75 Kwart a 90 Cents. NB. Onder dankbetuiging aan mijne geachte Landgenooten voor de ve'e bijvalsbetuigingen welke mij dagelijks toestroomen over mijne prompte bediening dient dat men bij bovenst Loten bg mij niet zocals bij sommigen °P een prijs tien procent missen moet; ook zijn mijne Loten niet in opgesmuk' verblindend Duitsch (dat velen niet lezen kunnen) maar in onze moede'"" taal gedrukt. Voorts zijn de Origineele .Loten gedeponneeid bij eefie dt'r eea'Ste Rai.kïerM-.uizen hier ie lande waarvan ieder begunstigd' tot zijne overtuiging opgaaf kan krijgen en raad ik ieder dit bij wien hij koop* te onderzoeken niet of een enkel nummer aanwezig is maar juist het nuU1' mer dat men koopt. .'. n. „ D- A. KU ItIOSCH in Effecten. Utrecht Lnoorstraat en Moreelsche Laan. Alle Buiienlandsclie Loten en Effecten door anderen geannonceerd zijn ül' jranco aanvrage-tegen remise steeds bij mij verkrijgbaar. (4370)",http://resolver.kb.nl/resolve?urn=ddd:010262767:mpeg21:a0050:ocr,4,ddd:010262767:mpeg21:p004,De Tĳd : godsdienstig-staatkundig dagblad,1446
22806,1871/02/24 00:00:00,63,ddd:000017539:mpeg21:a0026,http://imageviewer.kb.nl/ImagingService/imagingService?id=ddd:000017539:mpeg21:p004:image&x=3091&y=97&w=362&h=63,ddd:000017539:mpeg21,3453,160,3091,97,4,*8 Cents per regel,http://resolver.kb.nl/resolve?urn=ddd:000017539:mpeg21:a0026:ocr,4,ddd:000017539:mpeg21:p004,Het nieuws van den dag : kleine courant,362
4840065,1871/03/17 00:00:00,5469,ddd:010586090:mpeg21:a0025,http://imageviewer.kb.nl/ImagingService/imagingService?id=ddd:010586090:mpeg21:p008:image&x=74&y=125&w=885&h=5469,ddd:010586090:mpeg21,959,5594,74,125,10,Buigerhuis Veestalling Hooischuur en Tuingrond te Joure. De Notarii MUNNIK te Joure /al. mede ten ver. n den Heer G POSTHUMUS op mdag 20 Maarl 1871 - 's/a. Turen bij ff. van il verkooi BURGERHUIZINGE e a. op hei breedi i van de Midi traat te Joure mei di achter aanwezige VEESTALLING mei llooi-BCHUUR en Tuin in 8 onderdeden : a. Huis en Veestalling Hierop is gebod ƒ 8400. />. Hooischuur en Erf Staat op ./' 900. - Tuingi ond < leboden ./' 8 10. Hel Huis laatst bewoond door h-. Tutteners Huis en Tuingrond dadelijk en de Veestalling en Hooischuur I:' M>■ i LB7l te aam aarden. VERKOOP VAN KLIJNLAND op de Haskermaden in den Hasker-Veenpolder. D Notaris (4UNNIK te J -ê aal op D dag don :'. I Maarl 1871 . 8./ m. ' ui.-n  hij ii sebiar  in hel Kosthuis le lleerenveen linaal verkoopen i 25-20 beal KLIJNLAND aan deGeenw in 2 perceelen. Ti en II der boekjes.) Ingezel op: I ./' 1000 II ƒ 1600. 2. 6-58-90 beat KLIJNLAND aan de Geeuw in 4 perceelen. (111 IV. \ en VI der boekjes.) [ngezel op: 111 /' 700 IV ƒ7OO V 686 en \ I ./' 18 3. 18-04-50 beal KLIJNLAND aan deHorngtermeer . in 8 perceelen. i VII . VIII IX X XI en XII der boekjes.) Ingezet op : Vil f 1285 Vlll f 1870 l\ f 1800 . X ƒ 1860 XI ./' 1150 -XII ./' 10KO. N.B. Scileri den (hm der veiling zijn verhoogd : Perc. 111 ƒl2O [V ƒBO VI t 100 Xl./ '140 XII ; Aanvaarding dadelijk. Zathe en Landen te INDIJK nabij WOUDSEND. De Notaria I'OT.MA te Balk ia voornemena ten verzoeke van de 11.11. P. C POPPES te Kalk en A. HERINGA ti I op Maandag den 80 Maarl I s 7' '-' ure . ten huize van den Logementhouder S. Il te Woudeend . linaal te verkoopen : 'bare ZATHE en LANDEN aan elk mzende staande en liggende ten deele onder Indijk en ten deele onder ! m. VN'ij in bril- rail-cl . bij 't kad. bekend gem. Woudsend sectie \ nos. 77  78 84 85 86 87 38 89 en 96 te zamen grool 19 hectaren 48 aren 50 centiaren hebbende .-en belastbaar inkomen van ƒ6l ms ongel) eigend. i-n van f 36. eigend. Zathe en Landen zijn in eigen gebruik hij It. //. Huisman en zal behoudens 't regl van samenvoeging in 9 p eild worden. Geboden : perc. I voor 1871 II per 36 3/ [j -<K.fh-n fBO7 Hl id f_9o IV id. ƒBll V id. 777 VI id. VU id. ƒ717 VIII id. ƒ769 IX id./781. 't' Aanvaarding: Huizinge en Hieminge 18 Mei en de Landen B dagen na Bnale toewijzing. Huizen te Sloten. I»»- finale toewijzing van de HUIZEN te  bewoond door I tegen 16 l-Vbmarij 1871 doch tengevolge van het overlijden van twee .h-r Verkoopen tol nadere bekendmaking uitgesteld is nu bepaald op Woensdag den 22 Maart 1871 's avonds 7 uur ten huize van den menthouder U. I. de Jong te Sloten. ~~ VASTIGHEDEN TE OOSTERZEE. De Notari. I. BCHAAFBMA te Lemmer zal op Woensdag don 88 Maart 1871 des namid_ urn- bij den Kastelein Peereboom ie i iV.ce pK. ISJOneel veilen : Al de VASTIGHEDEN behoorende aan den Heer 11. J. Akkerman te Zetten bestaande in 3 \\'<><>N ÏH'IZEN te Ooetertee en ongeveer 26 hectare WEID- llooii.AND n Water aldaar te veilen in il perceelen nader omschreven bij verkoopboefaea die verkrijgbaar zijn ten kantore van den Notaris. LEMMER. Te wordt TE KOOP gevraagd: Eene flinke WOONHUIZINGE .taande op eenen gunstigen Btand. Opgeven worden verzocht ten kantore van den Notan BI ii.VAFSMA te Lemmer. tk IRNSUM— De Nota- V ris P. BOLTJEB te Gronw zul op Maandag den 27 Maart 1871 des namiddags 2 uur ten huize van ih' Weduwe 11. |). Koopmans Ka-Irleinsclic (e Irnsiini publiek onder uitloviug vau strijk- en verl ggeld  provisioneel verkoopen■ I. Eene uitmuntende sterke en wel onderhouden BütGERHÜIZaNGE mei Erve Bleek <-. a.. slaand- e legen Ln hei Gebuurte te [rnaum gem Rauwerd sectie C nos. 548 en 545 grool I vierkante roede 14 vierkante ellen  bij 11. 'I. »lc Wies in eigen gebruik ; I»- aanvaarden 8 da na de finale ___i ij/mg. 11. Eene uitmuntende voor korte jaren nieuw Üchte BURGERHUIZJNGE en Erf tik -I daaraan \ efboiiihn BUIT] 11 IS waarin Stalling voor § Koeijen  Turfhok  twee Blooken o a . staande en gelegen bij het murtc I»- rm-uni  bij D. J. »h- (irool in eigen gebruik ; 't.- aanvaarden 12 Mei 1871 Belde peroeelen breeder bij biljetten omachre\.-1 welke mei inlichting aangaande de verkoop voorwaarden ityn te bekomen ten kantore vau M -inilen Notaris. Hel eerste perceel ia Inmiddels ook uit do hand TE KOOP an tn dien einde te bevragen la.j den Eigenaar voormeld,http://resolver.kb.nl/resolve?urn=ddd:010586090:mpeg21:a0025:ocr,8,ddd:010586090:mpeg21:p008,Leeuwarder courant,885
546140,1871/09/10 00:00:00,658,MMKB04:000164811:mpeg21:a0016,http://imageviewer.kb.nl/ImagingService/imagingService?id=MMKB04:000164811:mpeg21:p003:image&x=879&y=4846&w=830&h=658,MMKB04:000164811:mpeg21,1709,5504,879,4846,4,CURSUS De Omleigeteekemle Oiitii *S' van de St. Antoniu^-kei k allner voornemens zijnde met 1 OCTObEd een cunmUS te 8® i'J ^ *0 ^ vuor Jongelieden niet beneden de 12 jiren tut opieidin^ van da zang der Katholieks lierkon beveelt zich minzaam aan. Inclinerenden worden verzocht zich te adresseren in den Opperti Wijk 6 No. 26. (2697) J. A. VAN DIJK. •— : ittmü,http://resolver.kb.nl/resolve?urn=MMKB04:000164811:mpeg21:a0016:ocr,3,MMKB04:000164811:mpeg21:p003,De Maasbode,830
1365988,1871/09/12 00:00:00,1417,ddd:010485950:mpeg21:a0008,http://imageviewer.kb.nl/ImagingService/imagingService?id=ddd:010485950:mpeg21:p001:image&x=2106&y=3058&w=964&h=1417,ddd:010485950:mpeg21,3070,4475,2106,3058,4,"toko o. SÏRUNCK Hoek Passer Senin en Parapattan. Ontving: NIEUWE Mwm per E*rins van Oranje. (5266) TOKO C. STRUNCK."" Wederom ontvanaen: DE OPAL PETROL. LIMFHrVI welke door HH. doctoren zeer aanbevolen worden als gevende zeer zacht licht. (5267) O. STRUNCK CONFISEUR-PATISSIER. IDagrelijlcsss: VERSCHE Boterbiesjes en Janhagel. (5268)",http://resolver.kb.nl/resolve?urn=ddd:010485950:mpeg21:a0008:ocr,1,ddd:010485950:mpeg21:p001,"Java-bode : nieuws, handels- en advertentieblad voor Nederlandsch-Indie",964
826632,1871/05/03 00:00:00,774,MMKB08:000115817:mpeg21:a0009,http://imageviewer.kb.nl/ImagingService/imagingService?id=MMKB08:000115817:mpeg21:p003:image&x=2079&y=1810&w=1068&h=774,MMKB08:000115817:mpeg21,3147,2584,2079,1810,4,Advertentie Men is van meening ten overstaan van den Deurwaarder CHRISTIAAN PFEIFFER op Vrijdag 5 Mei 1871  des voormiddags ten 9 ure aan de woning van W. VAN DEN BOSCH aan de Gasthuislaan nabij de Oostpoort te Delft publiek en om contant geld te verkoopen: 5 Kalfkoeijen 7 Vaarkoeijen 1 fraai 7 jarig Merriepaard (mak in tuig) 2 Varkens 2 Boerenwagens met Spoelingkisten enz. 1 Speelwagen 1 Kapwagen 1 Stortkar 2 Spoelingscïiouwen 1 Melkschuitje. 1 Ploeg en toebehooren ; voorts: Spoelingpompen Gooten Kuipen Paardentuigen Zeeften koperen Melkketel en Kannen Jukken Emmers Kruiwagens 1 Hondenmolen  2 Kaarnen en hetgeen meerder of anders ter verkoop zal worden aangeboden. Te Zien op den dag en vóór den aanvang der verkooping.,http://resolver.kb.nl/resolve?urn=MMKB08:000115817:mpeg21:a0009:ocr,3,MMKB08:000115817:mpeg21:p003,Delftsche courant,1068
1325553,1871/02/27 00:00:00,1337,MMDA03:000094675:mpeg21:a0018,http://imageviewer.kb.nl/ImagingService/imagingService?id=MMDA03:000094675:mpeg21:p004:image&x=1098&y=2247&w=953&h=1337,MMDA03:000094675:mpeg21,2051,3584,1098,2247,6,"Advertentie r ""~ir tt VERKOOPING op 3 maand ©redf et. Woensdag aer. 29sten Februari) e.k. 's namiddags een uur uilen aan de Markt bij de Vaart te Assen publiek worden verkocht: p Eene grooto partij Huislioude^ lijke en Winkelgoedcren bestaande o. a. in Tapkast Toonbank Haten Gewigten Winkelgereedacliappen voorts SSeddejjoed JSÜ Koper- Tin- en Klikwerk Kabinet Stoelen. Tafels Glas- en Aardewerk Kleedingstukken eeu best Wagenkleed en Wagenhoepen. In 't be;an der maand Maart zullen te NieuwAmsterdam gemeente Emmen publiek worden verkocht: 37 dagwerken HI j AU WK en ZWABTH TURF aan het water staande op de — plaatsen Nos. 815 en 316 Westervc-en benevens eenige dagwerken GBAAUWB T U Sï F.",http://resolver.kb.nl/resolve?urn=MMDA03:000094675:mpeg21:a0018:ocr,4,MMDA03:000094675:mpeg21:p004,Provinciale Drentsche en Asser courant,953
3356666,1871/02/26 00:00:00,3394,ddd:010099377:mpeg21:a0013,http://imageviewer.kb.nl/ImagingService/imagingService?id=ddd:010099377:mpeg21:p002:image&x=3984&y=94&w=989&h=3394,ddd:010099377:mpeg21,4973,3488,3984,94,2,"M. J. G. DE MEIJERE HUIDKI-ITRAAT bij ile I.i:»-RK\_1U('H'' Rechtstreeks van LYON ontvangen: deugdzame zwarte Zijden tot zeer voordeelige prijzen. (4785) NIEUWE «MI-MI!! PATEHT PLAK-LETTERS. G. L. G. VOSKUIL (4572) REGULIERSBREESTRAAT. Bij JOHs. NOMAN en ZOON te Zalt-Bommel"" ziet het licht: (4197) _______¥ BLIK OP DEN TOESTAND DEB Kolonie Suriname. g»oor 1..1N1-. JT. lAXCHEI «_-. «o/O.KO. ! \\\ OUDERS E_ VOOGDEN. In een deftig burger gezin te Arasterdam biedt men aau< tegen billijke vergoeding KOST INWONING en HUISELIJK VERKEER voor een of -twee Jongelieden dio aan een der hier bestaande Inrichtingen van Onderwij' hunne studiën wenschen voort te zetten. Brieven franco onder letters Q. Q. bij de Boekh. M. WESTERMAN & ZOO& Kalverstraat E 60 te Amsterdam. (5181) BRILLEN PINCE-NEZ LORGNETTEN EN TOUS GENRES J. A. J. SCHOKKING Mechaniker en Opticus Spui F 270 te Amsterdam. (14963) „MALZ-PRAEPARATE"" en hunne werking. Brochure GRATIS verkrijgbaar te Amsterdam JOHANH i HOFF'soh Centraal-Depot Bloemmarkt bij de Stilsteeg 154 en in de bekende Depots. (2467) «ZU DOOR HET M_(____M WM0BB*» Duizende lijders aan verschillende ziekten of kwft* %3** W len zijn door het MAGNETISME hersteld. J. J. WEIELINQ A«. Magnetiseur 0.-Z. Voorburgwal K 586 over de Oude Keric te A_tTKUD.IH §seft dagelijks gelegenheid z.n HELDERZIENDE 10-INAMBULE van 10 tot 4 ure te consulteeren. Brieven en Pakjes van Lijders die de Somnambule niet p«f soonlijk kunnen bezoeken franco. OtT"" Prospectussen gratis verkrijgbaar. (37679) DE MAGNETISEUR F. J. HULSHOF£ (O. Z. Voorburgwal J 502 tussche» de St. Annastraat en het Oudekerksplein) bericht dathninet zijne Somnambule Mej. de Wed. WORCH—v. d. GOORBERG» (wier Clairvoyance genoeg bekend is) dagelijks  nitgenome* Zondags van 10—3 ure te consulteeren is. Brieven en Pak* jes franco. (23) LIEBIG'S VLEESGHEXTRAGT VAN DE Eilebltr*a Kxlruct o_ Heat Company llmlted te Londen beroid in hare fabriek te FRAY BENTOS I (Zuid-Amerika) (■etieraal Oepof te Antwerpen. Bij elke Tentoonstelling met den eersten prijs bekroond. Als bewijs van echtheid is iedere pot voorzien van onderstaande handteekeningen van Professor Baron J. VON LIEBW3 en Professor MAK VON PETTENKOFER. C. M. e.TIITB te Haarlem. (27501) Eenig Agent voor Nederland",http://resolver.kb.nl/resolve?urn=ddd:010099377:mpeg21:a0013:ocr,2,ddd:010099377:mpeg21:p002,Algemeen Handelsblad,989
745557,1871/02/21 00:00:00,771,ddd:010485779:mpeg21:a0004,http://imageviewer.kb.nl/ImagingService/imagingService?id=ddd:010485779:mpeg21:p001:image&x=91&y=5140&w=967&h=771,ddd:010485779:mpeg21,1058,5911,91,5140,4,Vendutie WOra«S^?oaB VeHroortl 1871 vooi het Commisßiehuiß van J ' Van Slooten Morgan & Co. mn diverse Lijnwaden TAFELSTOLPEN PETROL^MLAMp > 4o rolleu MATTE*. urrp**' 10 M 1096. S 2 kisten 6/4 Oalieo ts. I mißi % batn lirill^'of meer beschadigd aangebragt ex Triton. (1134) !36 za^en AustraUsche Zemelen,http://resolver.kb.nl/resolve?urn=ddd:010485779:mpeg21:a0004:ocr,1,ddd:010485779:mpeg21:p001,"Java-bode : nieuws, handels- en advertentieblad voor Nederlandsch-Indie",967
1142656,1871/10/30 00:00:00,1264,MMKB08:000089059:mpeg21:a0022,http://imageviewer.kb.nl/ImagingService/imagingService?id=MMKB08:000089059:mpeg21:p003:image&x=138&y=4143&w=904&h=1264,MMKB08:000089059:mpeg21,1042,5407,138,4143,6,Advertentie COMMISSIE-KANTOOR VOOR Onroerende Goederen^ Assurantiën en Hypotheken van 33. AEIJELTS Roodenburgstraat bij de Weerdjesstraat A. 218^ ti? 2lrnl)cm. Aan genoemd Kantoor zijn steeds inlichtingen te bekomen omtrent te Koop en te Huur zijnde BUITENPLAATSEN VILLA'S HEERENHUIZEN  uitmuntend ingerigte WINKELHUIZEN gelegen op de beste standen BOUWTERREINEN enz.; een en ander staande en gelegen in en om Arnhem alsmede in andere schoone streken van Gelderland. Daaronder komen voor: drie zeer uitgestrekte prachtige LANDGOEDEREN  verscheidene groote en kleinere ZOMER- en WINTERVERBLIJVEN HEERENHUIZEN in Zevenaar Weslervoort Nijmegen  Zalt-Bornmel Amersfoort- BOUWTERREINEN in do gemeente Arnhem en omstreken en onder Wageningen ^gelegen. Ook worden door genoemd Kantoor inlichtingen gegeven omtrent het AANLEGGEN van Tuinen en Buitenplaatsen met bijlevering van al het daartoe benoodigde.,http://resolver.kb.nl/resolve?urn=MMKB08:000089059:mpeg21:a0022:ocr,3,MMKB08:000089059:mpeg21:p003,Arnhemsche courant,904
1308450,1871/09/22 00:00:00,1525,ddd:010586171:mpeg21:a0053,http://imageviewer.kb.nl/ImagingService/imagingService?id=ddd:010586171:mpeg21:p009:image&x=2747&y=2532&w=858&h=1525,ddd:010586171:mpeg21,3605,4057,2747,2532,12,KEREN <'i >(; I >K;N va idt fl t« Bi dezen o Stemgeregtigdc Floreenpligti| Gemeente om te vergaderen op W den 11 o 1871  ten iv uur vonnnidiia. Boschlust aldaar : 1. om te benoemen een Kerkvoogd in plaats \ M dea alt redende ; 2. \ ■ tellen de 3. op te nemen 4. te behandelen zood Lr tafel zullen worden gel.ragt. KERKVOOGDEN i ent» te BeetstiTzu-iutg. Bed» en Otttri hij dezen op de Stemgeregtigde Floreenpli van die drie Dorpen . on I Woensdag deu 11 October 1871 'smidda 12 uur. in het logement 8 zwaag: 1. om te beraadslagen en te besluite trent de al of niet loetreding tol de . ling v.-rvat in bet roorl ment van 81 -lulij 1871 Het rooTstel daartoe betrekkelijk ligt intage bij A. Andreie Administrerend Kerkvoogd te Beetsterzwa vn t>- benoemen eene vaste üe van helieer over de I'a-tn- I in plaat- raa Kerkvoogden van K -iag daarmede lijdelijk belast en 8. om mededeeling te ontvangen van deu stand der zaak van de Pastorie-inkoa en OMB. i|ii... ilaarninlrenl ecu beslll nemen -itigen wordt» uitgenoodigd om ter vergadering mede te brengen den Staat hunner Floreenen i'/nlat de stemming g- .nne geschieden.,http://resolver.kb.nl/resolve?urn=ddd:010586171:mpeg21:a0053:ocr,9,ddd:010586171:mpeg21:p009,Leeuwarder courant,858
1106387,1871/09/01 00:00:00,1291,ddd:010586162:mpeg21:a0008,http://imageviewer.kb.nl/ImagingService/imagingService?id=ddd:010586162:mpeg21:p002:image&x=2738&y=50&w=857&h=1291,ddd:010586162:mpeg21,3595,1341,2738,50,8,"876 171 e 177 grool U roedeBs el n wordende de Molen bemalcn en de ~.  Kamer beweend door (' \ lluwalda '.""' de andere hamer bewoond door K Mo]"" naar t„t dea tl Hei 187Ï komende da voor- en nadeelmi van den \||ci ~ jjj \i November IS7I voorden kooper ■ ~ "" boden ftm ' e*"" Te be/.ichtign i.p den zitlag van II > Ul||. wat het 1 en ! perceel betref! . op vertoon Vi|.' toenai den /ilLe; bij dm Notarl te bekomen Voorwaard i • vernemen en billetten te iH.. komen Ly 'lei. Notaris voornoemd Verkoop te Dricsum. De Sotarii W i m RIEBEB te Dantumawoude zal . ten v m zijnen Ambtgenoot '/. s Dl II \AN te Leen rarden qq . ■ >■ Zaterdag dcii 2 Se] lein' de namiddags t uur k:- Kcimp.' T '!'• Loer Lu telein ie Driesurn provisioneel verkoopen Bern ni< mwde WOONHUIZINGE met ruim Voorl ge-chikl tot Winkel Woon. A-v/-.  Erl' met Bergplaats gunstig staande e te Drie urn sectie A ao 1057 . •'!"" ' '' 15 d G Lij t;. \) Agema in gebruik en den i' November 1871 te aanvaarden \ oom aarden \- vernemen Lij de Notarissen voornoemd.",http://resolver.kb.nl/resolve?urn=ddd:010586162:mpeg21:a0008:ocr,2,ddd:010586162:mpeg21:p002,Leeuwarder courant,857
5134855,1871/07/30 00:00:00,5245,ddd:010099624:mpeg21:a0028,http://imageviewer.kb.nl/ImagingService/imagingService?id=ddd:010099624:mpeg21:p004:image&x=1033&y=457&w=979&h=5245,ddd:010099624:mpeg21,2012,5702,1033,457,4,"Ondergeteekenden gevoelen zioh verplicht bekend te maken dat zq geen HONGAARSCHE LOTEN debiteeren voor I den Heer D. A. DU MOSCH te Utrecht zooals door Z.Ed. : geannonceerd wordt — maar die uitsluitend ontvangen van de Heeren ISENTHAL & CO. Commissionairs in Effecten te Amsterdam. EDELMAN & A&KERINGA* Leew__KDE_i Juli 1871. (22909) H. G. SCHELTEMA A. LANGÉRHüIZEN M. H. BOAS en J. A. NIEUWENHUTS Makelaars zullen op Maandag 11 September 1871 des avonds na zes uren in het Lokaal de Brakke Grond ten overstaan van den Notaris W. F. OVERHOFF Jk. in veiling brengen : N°. 1. Hat kapitale hechte sterke en weldoortimmerdo HEERENHUIS. open Plaats Tuin en Erve staande en gelegen in da Plantage Far&laan Buurt V N°. 124 c kad Sectie H N"". 6031 groot 1 are 66 cent. — K°. 2. Het kapitale hechte sterke en weldoortimmerde HEERENHUIS open Plaats Tuin en Erve in de Plantage Parklaan bfl do Fransche Laan Buurt V N°. 124 i kad! Sectie H I N 5. 6037 groot 1 are 22 cent. — N°. 3. Het extra kapitale hpchte sterke en weldoortimmerde HEERENHUIS open | Plaats en Erve staande en gelagen in de Plantage 'Fransche liaan Buurt V N"". 124 m. kad. Sectie H N°. 6040 groot 1 are 27 cent. Allen breeder bij biljetten omschreven en te bezichtigen N°. 1 en 2 des Dinsdags en Donderdags en N°. 3 des Dinsdags en Vrq'dags alsmede op den verkoopdag van 1 tot 3 ure op vertoon van een toegangbiljet door een der bovengenoemde Makelaars onderteekend. De bewijzen van eigendom en cle veilconditiën zullen vier dagen vóór alsmede op den verkoopdag des voormiddags ter lazing liggen ten Kantore van den Notaris W. F. OVERHOFF Jk. op den N. Z. Voorburgwal bq de Wüde Steeg. (22990) IRKOÖPLOKAAL ""DE MERMR"". j___fl_-T__-»_CM-l»_- 182 3- HSSITJOniH E-SKKSÜTS JfeMl. MAKELAAE. zal op DINSDAG DEN Isten AUGUSTUS 1871 des Voormiddags te 10 uren Aan het LOKAAL VOOK WEKELIJKSCHE VEBKOOPINGEN hoek m._b. im.rimr-wal en Sa il_er ImkJke.«.'ee;sj H 589 ten overstaan van den Deurwaarder W. F. ICHEISKEH. VERKOOPEN: MAHONIE- GLADHOUTEN EN GESCHILDERDE Spiegels Schildergen Porcelein Aard- Lak- en Glaswerk wairouder voorkomt een exquise partij LAMPEN Boyenstellen LampenvoeteD. Petroleumperen van 4]/2 5 öl/» duim Lampenkappen en Reflecteurs. GOUD- EN ZILVERWERK Welgevulde Bedden Matrassen Dekens ""Vloerkleeden en Karfetten Lqnwaden Mans- en Vrouwe -kliederen Koper Tin Jzer- en Blikwerk. en verderen lemand nader onderricht begeerende adresseere zich ten Kantore van bovengemelden Makelaar. Al hetwelk te voren voor een ieder ter bezichtiging zal zün twee dsgen Zondag en Maandag des voormiddags van 10 tot namiddags 3 uren. (22887) MAISON C. ABÜOMBIE & C°. FÖÖEIMWDSS.I.LEEÖI. Doelenstraat^ ]B VO. (22921) Orfèvrerie CJirlaiofle _k Paris. Criataux de ISaecarat h _P.__i.is. Forcelaines de Eiimogen» lSronsea de I3i_r3>edtexine _Pavl» Hoofdprijs Fr. 600.000. HEELE AANDEELEN ff 3 HALTE ƒ1.50 VIJFDE /0.T5. Daar de voorraad nog maar klein is verzoeken wü spoedige toezending der Bestellingen en wel franco met büvoeging van het bedrag in Geld of Postwissel. Warmoesstraat'J 66. B. L-PAERL VV C. (22663) Commisßioaairs in Effecten. WEERBAARHEIDSLOTEN. voor ff 3.45 in plaats van ff 2.50 en een allerliefst Boekwerkje hü elk Lot CADEAU bü GEBROEDERS KOSTER Leliegracht. Eerste Trekking; 31 Juli aanstaande dus thans de laatste week van aanbieding. HOOFDPRIJS Op 31 JULI ff 7 5000. (22301) Hoogste Prijs f 80000. ƒ5.45 AANDEELEN WEERBAARHEID ƒ9.45 ff 2.45 Trekking 31 Juli e. k. f 2.45 ƒ2.45 Te bekomen bq Jl. VLIEGER ƒ2.45 ƒ 2.45 Halvemaansteeg IJ 520 ƒ 2.45 ƒ2.45 Huidenstraat XX 271. ƒ2.45 Een NIET heeft toch altüd ƒ2.50 waarde. (21995) De Commissie heiast met de regeling1 der opvolgende trekkingen der WEERBAARHEIDS LOTERIJ-LEEK geeft toij deze kennis dat de WitgeTers J-. !_. MEIJBIUS en J. WAJSB B9EKHO¥EI te Utrecht belast zijn met de uitgave der OFFICIEELS TAK-Hin. Mameas de Commissie ww ME. F. A. VAN HALL. ■: "" - -:-'- v^r..-.-- ::;-:;■.. -. - ■ ■~ ____M___________________R.V'' . _■■■ '^m_______________________________i",http://resolver.kb.nl/resolve?urn=ddd:010099624:mpeg21:a0028:ocr,4,ddd:010099624:mpeg21:p004,Algemeen Handelsblad,979
2991972,1871/09/23 00:00:00,2986,ddd:110533380:mpeg21:a0013,http://imageviewer.kb.nl/ImagingService/imagingService?id=ddd:110533380:mpeg21:p002:image&x=2102&y=99&w=1002&h=2986,ddd:110533380:mpeg21,3104,3085,2102,99,4,Ontvangen per laatste Mail: Eerste l£>v»liteil Vioolsnaren a Contant verkrijgbaar bij (4304) O. I. BEKKER NoordtvijL A.ul stralisclie PROVISIÊN. Per de Barentin heden ontvangen: ISO kisten inhoudende 7-432 blikjes Australische PROVISIE t. \V.: in blikken van MOCK TURTLE SOUP (SCHILDPAD SOEP) 2 'te. KIDNEY SOUP (NIERSOEP) . . .2 „ OX-TAIL „ (OSSE3TAARTENSOEP) 2 „ OX CHEEK WITH VEGETABLES (OSSEN KINNEBAKKEN). . . .2 „ RABBITS WITH ONIONS (KONIJNEN MET UIJEN) 2 „ RABBITS WITH BACON (KONIJNEN MET SPEK) 2 „ RABBITS BOILED (KONIJNEN GEKOOKT) 2 „ CORNED BEEF (LIGT GEZOUTEN OSSENVLEESCH 2 „ en 4 <ffi. ROAST BEEF (GEBRADEN OSSENVLEESCH) 2 „ „ 4 „ SPICED BEEF (GEKRUID OSSENVLEESCH 2 „ „ 4 „ BOILED MUTTON (GEKOOKT SCHAPENVLEESCH) 2 „ „ 4 „ ROAST MUTTON (GEBRADEN SCHAPENVLEESCH) 2„ OX-TONGÜES (OSSEN TONGEN) 2„4 SHEEPS DO. (SCHAPEN DO. ) .2 „ STEWED KIDNEYS (GESTOOFDE NIEREN) 2 „ IRISH STEW (lERSCHE HUTSPOT) 2 „ „ 4 „ \\ 11. HALL &L Co. Men wordt beleefd verzocht bij eene bestelling van minder dan 6 blikjes het geld er bij te voegen. f1224Ï,http://resolver.kb.nl/resolve?urn=ddd:110533380:mpeg21:a0013:ocr,2,ddd:110533380:mpeg21:p002,Bataviaasch handelsblad,1002
1264320,1871/01/20 00:00:00,1440,ddd:010586066:mpeg21:a0045,http://imageviewer.kb.nl/ImagingService/imagingService?id=ddd:010586066:mpeg21:p009:image&x=953&y=795&w=878&h=1440,ddd:010586066:mpeg21,1831,2235,953,795,10,Het DIJKSBESTUUR van Wonseradeels Zuider Zeedijken zal bij enkele insehiijving aanbesteden : De levering van 12S0 kilogrammen RONGEN  te weten : 000 stuks van 6 liectogrammeu  800 stuks a 5 bei logrammen en 1200 stuks van 4 hectogrammen. Het bestek ligt voor gegadigden ter inzage in DE PRINS te Makkum en bij den STRANDMEESTER te Gaast. De briefjes franco in te leveren ten Gemeentehuize van Wonseradeel te Bolsward vóór den 26 Januarij 1871. Bolsward 14 Januarij 1871. Het Dijksbestuur voornoemd S. LIJCKLAMA ii NIJEHOLT De Secretaris J. BINKES. UITLOTIÏVG. De COMMISSIE van Beheer van den Kunstweg over Bergum enz. naar Heerenveen berigt door dezen  dat op den 7 Februarij 1871 's namiddags om twee uur ten huize van S. S. Bijlsma te Beetsterzwaag  in eene voor de Deelhebbers in de Geldleening opene Vergadering zal worden overgegaan tot de uitloting van minstens vier Aandeelen in de Geldleening ten laste van genoemden Kunstweg aangegaan. < Beetsterzwaag den 16 Januarij 1871. De Voorzitter der Commissie van Beheer  Dr.. J. LUNSINGH TONCKENS. De Secretaris  J. PRAKKEN.,http://resolver.kb.nl/resolve?urn=ddd:010586066:mpeg21:a0045:ocr,9,ddd:010586066:mpeg21:p009,Leeuwarder courant,878
4229834,1871/01/28 00:00:00,4907,MMSADB01:000003968:mpeg21:a0013,http://imageviewer.kb.nl/ImagingService/imagingService?id=MMSADB01:000003968:mpeg21:p003:image&x=1905&y=298&w=862&h=4907,MMSADB01:000003968:mpeg21,2767,5205,1905,298,6,Advertentie &3HIecrai Molenaars! Worden verzocht Naam en Woonplaats in te zenden aan den ondergeteekende hun verzoekende wel te willen letten op het ingezonden stuk voorkomende in deze Courant van 26 Januarij 1871. L. MANDERS te Waalwijk. s^Een H C. » oud 24 jaren eene duidelijke hand schrijvende zoekt eene betrekking als HUISKNECHT WINKELBEDIENDE of in dier voege op een Kantoor. Reflecterenden gelieven zich franco te adresseren  onder de letters P. P.  aan het Bureau dezer Courant. n het Landbouwwerktuig-Magazijn van de Wed. J. C. MASSEE & ZOON te Goes zijn voorradig keuze (12 stuks) van ZAAIMAOHINES van verschillende grootte en verschillend sijsteem. Oprechte Welgemeende Een jong menscli in een welvarend dorp woonachtig R. C. Godsdienst wiens drukke zaak niet toelaat zich naar elders te begeven om eene gezellin des levens te zoeken zoekt langs deze meer gebruikelijken weg in kennis te geraken met een Burgermeisje van dezelfde Godsdienst in staat de stand zijner zaak te blijven bevorderen ten einde met wederzijds goedvinden een gewenscht Huwelijk aan te gaan. Gegadigden worden verzocht met franco brieven liefst met bijvoeging van Portret zich te adresseren onder de letters V» M.  aan het Bureau der Courant. Stipste geheimhouding wordt beloofd en verzocht. Kiezers van het DISTRICT TIliURG Bij de aanstaande herstemming voor een lid der Provinciale Staten op Dingsdag 31 Januarij  kan dunkt ons onze keuze niet twijfelachtig zijn. De Heer JANSEN toch Burgemeester van Tilburg is de aangewezen persoon. Wel voert men tegen diens verkiezing aan dat Tilburg genoeg representanten heeft in de Provinciale Staten en dat thans een buitenlid behoort gekozen te worden  doch dit motief kan niet in ernst worden volgehouden en schijnt slechts pour le besoin de la cause te worden opgeworpen. Tilburg toch staat met de buitengemeenten op eene lijn ten aanzien van landbouw en veeteelt de landbouw gaat daar krachtig naast handel en nijverheid; zooals in andere districten geldt daar niet het onderscheid tusschen stedeling en dorpeling; deze laatste alleen bestaat in het district Tilburg. Maar daarenboven niet de plaats waar men woont doch de hoedanigheden die men bezit beslissen over de vraag of men een goed buitenlid zijn zal; de plaats maakt den man niet; de Heer JANSEN nu is van nabij en door ondervinding op de hoogte van de behoeften van landbouw en alles wat den landbouwer zoo dierbaar is daaronder niet te vergeten de waterschapsbelangen die zoo hoog worden gewaardeerd. En wat meer is kiezers nooit te voren vroegen wij ons af waar een Kandidaat woonachtig was zelfs al was dit buiten ons district; leden buiten ons district hebben wij tot vertegenwoordigers. Of zal dit motief dan inderdaad  nu en in de toekomst bij elke keuze gaan gelden? Ook als Voorzitter van de Vereeniging van Burgemeesters en Secretarissen in NooYdbrabant heeft de Heer JANSEN betrekkingen welke hem in staat stellen van zeer nabij met uwe belangen te worden bekend gemaakt. En ten slotte als opregt Katholiek mag ook de Heer JANSEN dringend worden aanbevolen. Waar daden spreken zijn woorden overtollig. En men veroordeele niet alvorens zich op de hoogte van zaken te hebben gesteld. Men onderzoeke daar waar men bevoegd is te oordeelen  maar ook eerst dan beslisse men. Wij bevelen alzoo uit overtuiging aan DEN HEER J. F. JANSEN Burgemeester te Tilburg. . Eenige Kiezer» uit het district Tilburg.,http://resolver.kb.nl/resolve?urn=MMSADB01:000003968:mpeg21:a0013:ocr,3,MMSADB01:000003968:mpeg21:p003,Provinciale Noordbrabantsche en 's Hertogenbossche courant,862
930463,1871/11/02 00:00:00,1049,MMGARO01:000167626:mpeg21:a0025,http://imageviewer.kb.nl/ImagingService/imagingService?id=MMGARO01:000167626:mpeg21:p004:image&x=2583&y=121&w=887&h=1049,MMGARO01:000167626:mpeg21,3470,1170,2583,121,4,BRONWATER Geneeskrachtig BRONWATER dis: Vichijwater Ernser water Akenerwater Badnerwater Egererwater Selterswater te bekomen bij J. METZ Apotheker Rosendaal. (1279),http://resolver.kb.nl/resolve?urn=MMGARO01:000167626:mpeg21:a0025:ocr,4,MMGARO01:000167626:mpeg21:p004,De grondwet,887
2033374,1871/06/23 00:00:00,2381,ddd:010586132:mpeg21:a0010,http://imageviewer.kb.nl/ImagingService/imagingService?id=ddd:010586132:mpeg21:p003:image&x=2751&y=980&w=854&h=2381,ddd:010586132:mpeg21,3605,3361,2751,980,8,"Badkuipen met en zonder Vorwarmingstoostol STORTBADEN. ZITI3ADEN. TUINSPIEGELS. TUINSTOELEN en TAFELS. TUINBANKEN. TUINSP UITEN. KINDERWAGENS. Ontvangen in hel Magazijn Uzerwaren. I .warden. Th. RÉIJNDERS. Logeneil „k Plioenk."" Ondergeteekende eigenaar en bewooer geworden van bel Logement en Koll'ijhuis />/■: PHOENIA alhier neeml - I zich door deae soowel bij de Ing zetenen deaer plaats -\\> bij hel reizend publiek . minzaam aan ie bevelen. Tol bel houi \ ERKOO- I'IM.I-.N of VERGADERINGEN der verschillende Vereenigineen alhier _yn iteeds alb-zins doelmatige Localen be B trouwt iv staal te zijn aun de lullij van hei publiek te kunnen voldoen en belooft van zijn kant al In-i mogel enden om zijne begunstigers eene nette en soliede be b a ndeling te »eraekeren Dragten . den L 9 Juni l s7l. L ROSEMA HAYINGAs Onderlinge Bnidwurborgnaatschappij NEDERLAND gevestigd te AMSTERDAM. irissen : II J. HODDERM \N te __uterd-m. Mr I uv s. HULDER te Amsterdam. G HARKEHA te Amsterdam. J. i.\ BOMMEL te I Dirertrur- Deze M . Brandschade: GEBOUWEN. KOOP ORDEREN . INI OEDEL VJ Ditkoop tegen billijk. Agent i BIBS bij uit-u nadere informatiën te bekomen zijn.",http://resolver.kb.nl/resolve?urn=ddd:010586132:mpeg21:a0010:ocr,3,ddd:010586132:mpeg21:p003,Leeuwarder courant,854
1337217,1871/07/22 00:00:00,1721,ddd:010333257:mpeg21:a0017,http://imageviewer.kb.nl/ImagingService/imagingService?id=ddd:010333257:mpeg21:p004:image&x=1612&y=2696&w=777&h=1721,ddd:010333257:mpeg21,2389,4417,1612,2696,4,"Hollóway's Pillen en Zalf. Belangryk voor legereen.» Gedurende meer dan dertig ja«*a hebben deze geneesmiddelen boven alle anderen den voorrang genoten om de voldoende reden dat zy nimmer verkeerd gebnfikt kunnen worden ""hetzy by in- of uitwendige ziekten. Holloway s Zalf moet goed ingesmeerd worden op de keel en borst in gevallen van weré keel. zwelling der klieren langdurige beest en gedrukte ademhaling.— In gewone gevallen van Catairh en griep bewerkt deze Zalf goed op de zyden der borst ingewreven en geholpen door eenige doses der Pillen eene spoedige en volkomene genezing. Dezelfde behandeling nauwkeurig opgevolgd verdry ft keelziekten aamhors tigbeid bronchitis en pleuris en voorkomt de vurige ontsteking die meestal tot verzwering overgaat en gewoonlyk h t gevolg is wanneer keel- of borstziekteu verwaarloosd worden. De PILLEN worden verkocht in doosjes van 4 dozj*n »ƒ I—; van 12 dozyn af 3.—. van 24 dozyn a ƒ 4.50 ; van 04 dozyn a/9.—; van 132 dozyn a/18.—; van 208 doz. a/27.— De ZALF wordt verkocht in potjes van 1 once afl.— < v«n 3 oneen a/3.—; van 6 oneen a ƒ 4.50; van 10 oneen a/10 —; van 33 oneen a/l8-— I van 52 oneen a/27.— Te bekomen by A. BETHENCOURT.",http://resolver.kb.nl/resolve?urn=ddd:010333257:mpeg21:a0017:ocr,4,ddd:010333257:mpeg21:p004,De Curaçaosche courant,777
2491818,1871/10/23 00:00:00,2775,MMGASL01:000361067:mpeg21:a00008,http://imageviewer.kb.nl/ImagingService/imagingService?id=MMGASL01:000361067:mpeg21:p00002:image&x=2118&y=239&w=908&h=2775,MMGASL01:000361067:mpeg21:p,3026,3014,2118,239,4,Advertentie OPENBARE VERGADERIMG VAN DE ReDERIJKERSBOND „DE GRENZEN” op üfondag den 30 Oct. a.s. op de BOVENZAAL van bet Logement van BOSSCHA te Wolvega ’s avonds 7 uur. (Na afloop van ’t Concours.) I. WERKZAAMHEDEN : Voordragt van de beide bekroonden op ’t coucours van de verzen „ARME VISSCHERS” van P. A. de Géhestet en „DOOD BEDAARD” van Elliolt Boswel. II. LOSSE BIJDRAGEN. 151. Opvoering van bet Blijspel JET KAMERTJE VAN EE\ WASCHMEISJE” door de Red. kamer „Onno Zwier van Haren” van Wolvega. HU. Opvoering van het Blijspel „DE POST VAN EER” door de Vereeniging „A m 1 C 1 t I a” van StjïKV w j jk . De VOORSTELLING zal opgelmxlerd worden door Namens het Bonds-bestuur  J. POL Secretaris. De Rederijkerskamer „wilei ra uur. zal op WOEMSDAO *5en dezer ’s avonds 7 uur eene Openbare Vergadering houden  die door de Minziek van Geb. MULLER van Meppel zal worden opgeluisterd. Ie Hang voor de leden. *e  Entrée *5 et. Giethookn 20 Oct. 1S71. De Secretaris G. DONKERS.,http://resolver.kb.nl/resolve?urn=MMGASL01:000361067:mpeg21:a00008:ocr,2,MMGASL01:000361067:mpeg21:p00002,Opregte Steenwijker courant,908
2243940,1871/08/05 00:00:00,2235,ddd:010485918:mpeg21:a0018,http://imageviewer.kb.nl/ImagingService/imagingService?id=ddd:010485918:mpeg21:p003:image&x=1077&y=99&w=1004&h=2235,ddd:010485918:mpeg21,2081,2334,1077,99,8,Te koop gevraagd: Een ruim stuk ledige of Tuinland met of zonder WOONHUIS gelegen boven het Tramway Station van Meester-Cornelis langs den weg naar Buitenzorg of langs dien naar Bekassie. Aanbiedingen en opgaven onder het No. dezer Advertentien franco Bureau JAVA-BODE. (4144) För Saie: 2 Doublé Power Crab Winches. 1 Single 1 Agricole Pump with ïïorse Gear. PITCAIRN SYME & Co. (4382) Batavia en Soerabaya. ■ Ie Koop of te Huur: I Het HUIS op Kramat bewoond door den I heer Mr. R. VAN EIBERGEN SANTHAGENS. \ Adres: A. .1. DE BORDES j (2791) Makelaar. Te koop of te huur: Twee HUIZEN gelegen op (jJoeuoeng-Saüarie. Adres LANDS-ÜRUKKERIJ. (3879) Te Duur: Een PAKHUIS Kampong Miskien. (3436) W. H. HALL & Co. Te Huur: Een ruim Toko-Lokaal naast en te bevragen bij (4068) p. BELLE. Je Huur: Een Huis op Noordwijk a ƒ 130 's maands. Te bevragen bij (4515) J. BELLE Noordwijk.,http://resolver.kb.nl/resolve?urn=ddd:010485918:mpeg21:a0018:ocr,3,ddd:010485918:mpeg21:p003,"Java-bode : nieuws, handels- en advertentieblad voor Nederlandsch-Indie",1004
2540356,1871/11/11 00:00:00,2548,ddd:010486002:mpeg21:a0008,http://imageviewer.kb.nl/ImagingService/imagingService?id=ddd:010486002:mpeg21:p001:image&x=3092&y=3384&w=997&h=2548,ddd:010486002:mpeg21,4089,5932,3092,3384,6,Ontvangen: ENGELSCHE WAGEN- en BENDIETÜIGEN. ASEALTVILT. REGENJASSEN. (6622) JOHN PRYCE k Co. ■ ' ■ Ontvangen: SHIRTING merk 91. 11. van HORROCKSES MILLER & Co. (6625) JOHN PRYCE & Co. Verkrijgbaar: ALMANAK voor 1872 Geïllustreerd met Indische TYPEN vervaardigd in het ATELIER van de Heeren WOODBURY & PAGE alhier. Prijs ....ƒ!. Franco per post  1.10 (6591) H. M. VAN DOS! & Co. BOEKHANDEL van E M. VAN DORP & Co. Verkrijgbaar: Kantoor-Agenda 1872. Janssen & van Wijk ontvingen: VERSCHE ANSJOVISCH in Potjes van Kikkert te Ylaardingcn. BALKAARTJËB? nieuew model by (6611) H. M. VAN DORP & Co.,http://resolver.kb.nl/resolve?urn=ddd:010486002:mpeg21:a0008:ocr,1,ddd:010486002:mpeg21:p001,"Java-bode : nieuws, handels- en advertentieblad voor Nederlandsch-Indie",997
1012102,1871/04/05 00:00:00,1162,MMKB08:000088996:mpeg21:a0010,http://imageviewer.kb.nl/ImagingService/imagingService?id=MMKB08:000088996:mpeg21:p003:image&x=1721&y=4393&w=871&h=1162,MMKB08:000088996:mpeg21,2592,5555,1721,4393,6,Advertentie TE KOOP door plaatsgebrek twee goed bij den weg loopende PONY'S bekend voor trouw en mak ; zijnde een 4jarige Vos en een 7jarige Bruine. Brieven franko Lett. T. U. Bureau dezer Courant. Te SCHAAliSBERGEN TE HUUR: 2 WONINGEN met SCHUURTJES TUIN en BOUWLAND; te bevragen bij den Rentmeester op de Zijp  bij Arnhem. Brieven franko. Kissinger Pastilles vervaardigd uit de zouten van de Rakoczy te Kissingen over welks heilrijke werkingen de geschriften van den Hofraad Dr. Balling den Hofraad Dr. Erhardt en Diruf handelen bijzonder aanbevelenswaardig tegen traagheid der spijsverteringsorganen gebrekkige ontlasting Bleekzucht bloedsgebrek als ook tegen haemorrhoïden neiging tot jicht en scrophuleusheid. Prijs per flacon 50 ets. De Administratie van de Rotsbronnen.,http://resolver.kb.nl/resolve?urn=MMKB08:000088996:mpeg21:a0010:ocr,3,MMKB08:000088996:mpeg21:p003,Arnhemsche courant,871
2886520,1871/08/05 00:00:00,3172,ddd:011101582:mpeg21:a0013,http://imageviewer.kb.nl/ImagingService/imagingService?id=ddd:011101582:mpeg21:p002:image&x=1885&y=59&w=910&h=3172,ddd:011101582:mpeg21,2795,3231,1885,59,4,"Itoemah. Djoewalan Tanah Kongsi ~ ~ - inanarok nama CHATELIN. Boelih dt battt .Svt-V y Jpïfi v.: -t £ Oebat jang barnama EAU DES CAEMES Oebat sagala pai^jakit. Djinis panjakit jang boelih di oebat oelih dia: > Partama dari pada sakit kapala; Sakit talinga badasing-dasing; Sakit oeloe hati; Sakit 'ainpadoe; dan boelih poela di pakei prampoewan dao anak gadis gadis; Panjakit radja; Sakit gig!; „ Sakit toelang dan dek loempoe; kaloe soedab lamakan ratjoen; Sakit liropó atawa sasak oeloe bati.(i 'iv/'/it Adapoen oebat ini -di ramocb dari roepa-roepa akar dan rawpah-rampah raaka sabab itoe 'sakalian panjakit boelih di oebatkan oelih dia dan banjak ihabib ihabib dan doekoen-doekoen soedah maoebatkan kapada orang sakit dan.jalah balk dan salamat.i harga f 150 satoe botol gadang. „ I.— » » kitjil. (159) Assurantie Maatschappij tegen Brandschade I -** ' X<>\. : - cjoV De Oadergetcekende Agent"" van genoemde Maatschappij is bereid - Verzekeringen te sluiten tegen BRANDSCHADE op WOON- en PAKHUIZEN MEUBELEN' KOOPMANSGOEDEREN enz. enz. op de volgende voorwaarden als: ' > - - ' Op Gebouwen van Steen met pannen gedekt zoomede op goederen daarin tegen. .-.-.-1 pCt. 'sjaars. Op Gebouwen van Steen met pannen . gedekt afgezonderd van andere ge- (41) bouwen staande zoomede op Goederen daarin tegen V» • • Op Gebouweu van Hout met atap  gedekt zoomede op goederen daarin tegen. «r . ;>..• .1 Vi • » Padang Januarij 1869. A. H. J. DIEMONT De Ondergetekenden Agenten der j ' IMPERLYL FIHE INSURANCE COMPANY te Londen. f ii't' VERZEKERING-MAATSCHAPPIJ .VESTA"" te Amsterdam' '''"" ; -«* m. KOLONIALE ZEE- EN BRAND-ASSURANTIEMAATSCIIAPPIJ te Batavia. TWEEDE KOLONIALE ZEE- EN BRAND-ASSU-11ANTIE-MAATSCHAPPIJ te Batavia. - -7 ZEE- EN BRAND-ASSURANTIE-MAATSCHAPPIJ •DE OOSTERLING"" te Batavia -imraoT' zijn gemagtigd tot het aannemen van Assurantie op steenon gebouwen met pannen gedekt op houten gebouwen met atap- gedekt en de daarin geborgen GOEDEREN alsmede tot het sluiten van ZEE-VERZEKERINGEN. (28) ' J. F. VAN LEEUWEN & Cp.",http://resolver.kb.nl/resolve?urn=ddd:011101582:mpeg21:a0013:ocr,2,ddd:011101582:mpeg21:p002,Sumatra-courant : nieuws- en advertentieblad,910
1613502,1871/03/13 00:00:00,957,MMKB08:000088976:mpeg21:a0022,http://imageviewer.kb.nl/ImagingService/imagingService?id=MMKB08:000088976:mpeg21:p003:image&x=40&y=4502&w=1686&h=957,MMKB08:000088976:mpeg21,1726,5459,40,4502,6,Advertentie M agazijn van borstelwerïl D. J. R E U IJ L voorheen Gezusters Van Harteveld. IN GROOTE SORTERING VOORHANDEN: Luiwagens. Glazenwasschers. Ragebollen. Witkwasten. ilp^> rs . . ^ren ~cfï Ul J ers ' Ordtin n Ul J er 3. *Vé e l ^hiijers. Wi Rijers n ers - Vt^^tels. Manenborstels. Rosborstels. Vatenwasschers. Potloot-Borstels. Zilver-Borstels. Haar-Borstels. Zeemleerlappen. Glazensponsen. Rijtuigsponsen. Wachsponsen. Oost.-Inds. Borstelwerk. Schoenborstels. Wollen dwijlen. Moltonnen dwijlen. Linnen dwijlen. Plumeau's. Cocos-matten. Touwen-matten. Haren-matten. Rijtuig-matten. Biesen-matten. Stroo-matten. Garden. Schuurwissen. Matten kloppers. Stukken dwijlgoed. xj-cuir-norsieis. numeau s. ötuKKen üwijlgoe **oek KIJK- en WEVERSTRATEN.,http://resolver.kb.nl/resolve?urn=MMKB08:000088976:mpeg21:a0022:ocr,3,MMKB08:000088976:mpeg21:p003,Arnhemsche courant,1686
1592390,1871/08/28 00:00:00,1615,ddd:010485936:mpeg21:a0006,http://imageviewer.kb.nl/ImagingService/imagingService?id=ddd:010485936:mpeg21:p001:image&x=1094&y=2812&w=986&h=1615,ddd:010485936:mpeg21,2080,4427,1094,2812,4,Verkoop van een Schip. | Op Donderdag den 31 Augustus 1871 ten lO ure zullen de ondergeteekenden aan den Kleinen Boom verkoopen: \ Het Nederlandsch Barkschip ELSBOUT JtóïuffiSmL^ metende 630 Tonnen gebouwd in VMMN-M :■■■■ 1844 en nieuw gekoperd in December 1869 gevoerd geweest door Kijpt. _Efc. Tfc£. Teppema met INVENTARIS bestaande uit: DUBBEL STEL ZEILEN ANKERS KETTINGEN TROSSEN BOOT SLOEP en VLET alles in een koop. En verder; Een partij NIEUW TOUWWERK ZEILDOEK BLOKKEN PROVISIEN Een CHRONOMETER Een BAROMETER Een SEXTANT Een LANGE KIJKER enz. enz. Het schip is dagelijks te bezigtigen en informatiën zijn te bekomen bij de Heeren J. DAENDELS & Co. en bij de ondergeteekenden (4692) . VAN VLEUTEN & COX. Op de Vendutie van Donderdag den 31 Augustus a.s. zal door de ondergeteekenden nog verkocht worden: %4 We IJzeren Stoomsloep -^^ MBLATTI ter bezigtiging liggende aan den KLEINEN BOOM en waaromtrent inlichtingen te bekomen zijn bij de Eirma REIJNST & VINJU. (4871) VAN VLEUTEN & COX.,http://resolver.kb.nl/resolve?urn=ddd:010485936:mpeg21:a0006:ocr,1,ddd:010485936:mpeg21:p001,"Java-bode : nieuws, handels- en advertentieblad voor Nederlandsch-Indie",986
911178,1871/05/15 00:00:00,1362,ddd:000017608:mpeg21:a0022,http://imageviewer.kb.nl/ImagingService/imagingService?id=ddd:000017608:mpeg21:p004:image&x=1460&y=3781&w=669&h=1362,ddd:000017608:mpeg21,2129,5143,1460,3781,8,Vele lijders hebben hun volledig Herstel of verlichting bij zoogenaamde ongeneeselijke kwalen daaraan te danken dat zij den raad eener Helderziende Somnambule met vertrouwen hebben gevolgd. Tot het bekomen van consulten wende men zich tot den Magnetiseur «T. «f» Wetellng Al. te Amsterdam O. Z. Voorburgwal K 586 over de Oude Kerk. wiens Helderziende Somnambule dagelijks is te consulteeren van IO tot 4 uren. Indien de lijder niet in persoon kan komen is het voldoende naam en audordom schriftelijk op te geven-; alleen op dezo aanwyzing wordt een volledige ziektebesehrijving ingezonden benevens recept. Voor het eerste consult wordt vier voor volgende drie gulden vergoed. (3440) Lanrens Janzoon Koster BOEK- EN PAPIERHANDELAAU Oude Doelen- of verbreede Hoogstraat K 503. A M S T K » » A Jl. PLAKLETTERS tot verminderde prijzen. Op verlangen en tegen franco toezending van ir. Cents worden Monsters met Prijscourant franco door het gelieele land verzonden. ngggaaa. Hij terugzending der Monsters jffAWf wonit het daarvoor betaalde in tekening aangenomen. (3700),http://resolver.kb.nl/resolve?urn=ddd:000017608:mpeg21:a0022:ocr,4,ddd:000017608:mpeg21:p004,Het nieuws van den dag : kleine courant,669
2739744,1871/10/14 00:00:00,2718,ddd:110533398:mpeg21:a0016,http://imageviewer.kb.nl/ImagingService/imagingService?id=ddd:110533398:mpeg21:p002:image&x=2096&y=59&w=1008&h=2718,ddd:110533398:mpeg21,3104,2777,2096,59,5,"Maatschappij „Aurorn."" ' REPETITIE voor Afdeeling I=s (GEMENGD KOOR). «1» Maandag 10 Oclolirr. des avonds ten acht ure. iv Je LOGE. l)e Comiuissaris (4696) F. PLATE. MUZIEKSCHOOL. Tegen 1 \oveinf>er zullen de lessen op de muziekschool aanvangen. Het onderwijs zal vooreerst worden gegeven in de ALGEMEENE MUZIEKLEER SOLFÈGE ZANG en PIANO. ! De prijs voor iederen leerling is/ ÏO 's maands. De lesuren zijn des namiddags van 4$ tot Ö uur ten huize van den ondergeteekende bij wien nadere informatiën zijn te bekomen. MAURICE HAGEMAN (4684) Kon ingxplein. Gevraagd voor een Haiiclel^tliiiis: ife ™ KLERK die duidelijk sclivijiTt en eenigzins met de ENGELSCHE TAAL bekend is. Adres Letter X Bureau dezer. (46SS) Te Koop: Een Kapitaal en aangenaam gelegen 11 VIS met groot EK F voorzien van Gasleiding en Lampen staande op Kramat bewoond door den WEd.G. Heer W. LAJJMEREE. Te bevragen bureau dezer. (4659) Te Koop: Een HUIS met ruime bijgebouwen voorzien van Gasleiding en vele gemakken staande op Passer Baroe in CLö ILXÊttDljïxeid vari liet Spoorweg Station bewoond door den WEd.G. Heer C. G. BURGEMEESTRE. Te bevragen bureau dezer. (4690)",http://resolver.kb.nl/resolve?urn=ddd:110533398:mpeg21:a0016:ocr,2,ddd:110533398:mpeg21:p002,Bataviaasch handelsblad,1008
2642551,1876/01/25 00:00:00,2695,MMKB08:000089750:mpeg21:a0017,http://imageviewer.kb.nl/ImagingService/imagingService?id=MMKB08:000089750:mpeg21:p004:image&x=165&y=2803&w=929&h=2695,MMKB08:000089750:mpeg21,1094,5498,165,2803,4,"Advertentie Op Donderdag 27 Januarij 1876 's voormiddags 11 uur zal ten sterfbuize van *YuT Mejufvrouw M. VERMEER te Zevenaar •Öfc-a?- publiek erfhuisgewijze worden verkocht de INBOEDEL aldaar voorhanden  bestaande in allerlei MEUBILAIR 1 Kabinet 1 Mangel Kagehels Koper- Tin- IJzer- Glas- en Aardewerk  Poreelein waarbij verscheiden antieke en Japansche ""Vazen Borden Schotels Potten enz. Schilderijen. Bodden en Beddegoed; Linnengoed waarbij e< ï stuk ongemaakt Linnen en een mooi stel ongemaakt Damast en hetgeen verder zal worden voorgebragt. Alles 's morgens voor den verkoop te zien. •TE HUUR gevraagd tegen 1 Mei e. k. te Arnhem een HUIS met 5 of 6 KAMERS TUINTJE en verdere Gemakken. Brieven iranco met opgaaf van Huurprijs en Omschrijving  uiterlijk Donderdag 27 dezer  onder No. 48 Bureau dezer Courant. Tegen 1 Mei 1876 wordt te Huur gevraagd: Drie of Vier oipiaMMs Kamers voor eene Dame  als het kan met KOST en BEDIENING. Adres franco onder No. 52 aan het Bureau dezer Courant. Met certificaat van echtheid — wordt door zekere gelegenheid TE KOOP aangeboden voor ƒ 445 een groote sooit — prachtige PJ  l O BERNHARDT AINE—FILS. 3 Schuinsnarig — Cilinder. — Koper mechaniek — geheel géboulonneerd — en geheel nieuw — heden van Parijs aangekemen — de kist er bij ■— onmiddellijk heden en Dingsdag te bevragen Hotel de Zon te Arnhem WORDT GEVRAAGD tegen primo Februarij e . k.  een knap Burgermeisje als KIND EB JU FV110UW goed kunnende Naaijen en Mazen. Adres Nie uwe Plein C. 369. SSlfihiiini Cyrenaïeiiin Met het grootste succes onderzocht <loor l) r L aval in > 0 In' indeling van Longtering i:i alle graden de keelte.-iDg :i -»!!■' ;in« doeningen vin de Borsten den hals.— In «ie hospitalen van Par.js •n in die der voornaamste steden van Frankrijk aangewend -i>e Stlphtam werdt toegediend in Tinctuur Korreltjes en m Pr dersKbODï eo DKYFÉS Apothekers der 1* klasse 2 me Drouot tb Parijs j Hoofddepot voor Nederland bij Bi. SJa .frTH Pharuiacie Frangaise to Amsterdam. i Te Arnïïe voornaamste Apoth eken. wilfMI OnMIbnv M alt- iV roattnf tu m Moll*n fttrtrv# * KWJirtt tT hj »«rts « M; Ji. l*n m Itroyftw. ^",http://resolver.kb.nl/resolve?urn=MMKB08:000089750:mpeg21:a0017:ocr,4,MMKB08:000089750:mpeg21:p004,Arnhemsche courant,929
3507442,1876/12/09 00:00:00,4546,MMCODA02:000187342:mpeg21:a0020,http://imageviewer.kb.nl/ImagingService/imagingService?id=MMCODA02:000187342:mpeg21:p003:image&x=900&y=223&w=756&h=4546,MMCODA02:000187342:mpeg21,1656,4769,900,223,4,Advertentie . j j ZITD1CEI. Mr. J. N. EVERTS Notaris te Twei.lo  zal gedurende de maand December 1876 alle Maandagen en Vrijdagen van 9 tot 1 uur en 's avonds van 5 tot 8 uur (behalve Vrijdag 15 December en Maandag 18 December) ten zijnen Kantpre te Twelt.o ZITDAG houden tot ontvangst der aan hem over dezen jare en vroeger te betalene gelden. Voorts zal hij nog de volgende ZITDAGEN \\ouAcr\ telkens van 10 tot 1 uur als: Woensdag lü December bij T. KERS te Nijbroek. Vrijdag 15 December bij den Heer L. DEMMERS  op de Stroomarkt te Deventer. Maandag 18 December bij den Heer VAN DER BURG  in de Moriaan te ape [.doorn. Uit de Hand TE KOOP: Eene plaats in de JServ. Kerk in de losse Banken Apeldoornsche einde; te bevragen bij den Ouderwijzer VV. JANSEN op de Beemte of J. BERENDS VAN LOENEN te Apeldoorn. Handel in gezaagd Hout GLAZEN PANNEN GIPS TEER en alles wat tot het Metselaarsvak behoort tegen concurerende prijzen bij H. MOUW a/d Vaart. JAN BOER Wz. & Zoon Boomkweekers te BOSKOOP nemen de vrijheid hunne geeerde Begunstigers te berichten dat zij te spreken of te ontbieden zijn bij Mej. de Wed. VAN LÜNTEREN tot het opnemen van Commissiën tegen het voorjaar waarvoor zij zich beleefd aanbevelen. Hand-Dorschmachines HAKSELSNIJDERS WANMOLENS KNOLLENSNIJDERS en andere LA NDBOUW-WERKTUIGEN en GEREEDSCHAPPEN — WASCHMACHINES MANGELSKEUKENFORNUIZEN STRIJK- GAZen andere KAGCHELS enz. te bekomen bij BliTJNO TIDEMAN. DE ONTVANGER der Hervormde Gemeente van Apeldoorn zal ten zijnen Kantore Zitting houden tot ontvangst van aan de Kerk verschuldigde UITGANGEN PACHTEN en PLAATSGELDEN op Maandag en Dingsdag 11 en 12 December ek. De Oudergeteekende Jk beveelt zich aan tot het matten en repareren van allerhande STOELEN. MARINUS DE KRUIF in den Nieuwen Eng. Kerstgeschenken zullen van af WOENSDAG 13 December in ruime keuze doelmatig geétaleerd zijn bij T. D. H. PULL. M('jufvrouw M. A. Ledeboer op de Brink vraagt een knap DAGMEISJE buiten den Kost niet boven de 14 jaar.,http://resolver.kb.nl/resolve?urn=MMCODA02:000187342:mpeg21:a0020:ocr,3,MMCODA02:000187342:mpeg21:p003,Apeldoornsche courant,756
2015551,1876/12/08 00:00:00,2063,ddd:010486957:mpeg21:a0015,http://imageviewer.kb.nl/ImagingService/imagingService?id=ddd:010486957:mpeg21:p002:image&x=3148&y=63&w=977&h=2063,ddd:010486957:mpeg21,4125,2126,3148,63,4,1 Piiotog-raphie. | OLLAÏD & CO. NOORDWIJH. 438 9 De ILocoiiiotlef vergroot fomiaat OPLAAG 2500 EXEMPLAREN. Abonnementsprijs ƒ 20.— per halfjaar. Nieuwe abonnés voor het jaar 1877 ontvangen van af 15 tot ultimo December 1876 alle exemplaren gratis. 4970 DE GROOT KOLPP & Co. BUREAU VOOR SUIKERAHALYSE. A. Bochardt PASSER PlftUe. 2995 Algemeen Dagblad van Ned.-In die. EUROPEESCHE CORRESPONDENTIE MENGELWERK BOEKBEOORDEELING HOOPD-ARTIKELEN van den heer Cd. Buskeri Huet te Parijs. Redakteur J. I'Ange Huet. Oorspronkelijke gevarieerde Feuilletons. Veelvuldige Bijdragen van de meest bevoegde specialiteiten in Ned.-Indië over verschillende onderwerpen enz. Abonnements-prijs ƒ 50— 's jaars bij vooruitbetaling kwartaalsgewijze te Batavia halfjaarlijks buiten Batavia. Nieuwe Abonné's voor het jaar 1877 ontvangen de dit jaar nog verschijnende nummers gratis. ERNST & Co. Batavia Uitgevers. 4967 Madame BALDASARE ü 3? DIS TE ttms; PlAdan*. BUÏTEXZOKtt.,http://resolver.kb.nl/resolve?urn=ddd:010486957:mpeg21:a0015:ocr,2,ddd:010486957:mpeg21:p002,"Java-bode : nieuws, handels- en advertentieblad voor Nederlandsch-Indie",977
3843814,1876/09/28 00:00:00,4769,ddd:011182017:mpeg21:a0008,http://imageviewer.kb.nl/ImagingService/imagingService?id=ddd:011182017:mpeg21:p002:image&x=3865&y=1884&w=806&h=4769,ddd:011182017:mpeg21,4671,6653,3865,1884,4,"Gij BehoeftM Ie Hoesten. Velen aarzelen om oen geneesmiddel te beproeven uit hoofde van do kosten - niet alleen maar ook om do onzekerbeid ofhet wel zal helpen. Indien ze vertrouwen in het geneesmiddel hadden dun zouden de kosten de geringste zwarigheid zijn. de waarheid hiervan bewust maken wij de vol- - * gende vorrstelling: Indien iemand lijdt aan verkoudheid hoest of zeere keel lnat hem dan naar de apotheek van-P.= Ellerbroek gaan en copen ecneflesch — vau llale's Cocon v iüoiax} en als hij dezelve half gebruikt heeft en het hem ' dan nog geen goed gedaan heeft dan kan hij de flesch terug brengen en zijn geld weder ontvangen. Er is in dezo streek nog nooit een ge- ■ ncesmiddel verkocht dat zulke resultaten oplevert. Laat niet na het te beproeven . Cliïcago & North - Western raïlway. --r— Passengers for CHICAGO Detroit- Toledo Clevelund Buffalo Niagara- Falls Pittsburg Cincinnati Rochestcr. Albany Toronto Montieal Quebeo Portland Boston New York Philadcl- "" phia Balttmore Washington St. Loui.% ' Cairo San Francisco Sucramento Ogdcn. Salt Lake City Denver Councifc Bluffi Sioux City St. Paul Marquettc;;  «Escanaba Menasha Madison Chcyenné— o«.aha Yankton Winona puluth Green Bay Mllwaukee and alj pointa North West Bouth and East.'should buy their tickets via the "" "":'— Close connection* are made at Chicaga with the Lake Bhore & Michigan Southern Michigan Central Baltimore - & Oliio KankakeeLineand Pa» TTandlo Routes for all points EAST and SOUTH-EAST and with the Cbicagofc . Al ton and Illinois Central for all points SOUTII. V -Close connections are also made with tbe Union Pacific R. R. at Omaha for «II far West points. _ Close connection* are made at junetion pointe icith traint of all erot» rood* PULLMAN PALA CE' _-~ These eelebrated cars are run on alt night trains on all the lincs of this road.- This is the OXLYLINE running these ■ carse between Chicago aud St. Paul_or___ Chicago and Milwaukcc. At Omaha our Sleepers connect with' the Overland Sleepers on the Union "" Pacific Railroad for all points- wert—of rhe tfissouri Rivcr. 1 ""_..■■-. l'.- Among'the . . Inducements offered bv this >_ Rou'e to tbe tra veling public are all modern improvcments: Rock and Gravel Ballasted Track Steel Rail Roek and lron Bricgcs Parior and Drawing Room - Day Coaches Smoking and Loonginir Cars Westinghouse Safetr Air Brakev Miller's Patent - Safety - Coupling aud !ZZ Platforms Speed Safety and Absolute '■' Comfort. Running thro u gh .Fi v e _~ G i eat Statte"" and opcrating over 2000 miles of road this Company presents to the travcler facilities thitt ARE NOT and CANNOT bo offered by. any Competitor. All ticket agentscan sell you ticket»- via this route. If you wish the best traveling accomo- ---. dations you will buy your tickets by this route and will take no other. -. -':' : ■; MARVIN IItJOHITT W7n."" BTKjtlßTi.* 'fV ■ Ontml tapirti>Ua<Upt. Ctn'l !>••«?■ - _. :-.-■_.. . '"" ""' '■ -""' ' .' '■»-•■■»• *'. :* GEVESTIGD >^' II.I).»ooire&€o Groothandelaars in GROCERIFS • Spek pakkers - 23 en 25 Peari St. Roek derde St. SIOUX CITY """"""'—""' """"'_' lOWI WILLIAM HILES Horologièmaker & Jnweßer Graveren—en"" all* .reparatie» gt^u^7 rendeerd. HOEK VAN 3de EN PEARL STRAAT Sionx City lowa. v",http://resolver.kb.nl/resolve?urn=ddd:011182017:mpeg21:a0008:ocr,2,ddd:011182017:mpeg21:p002,De Volksvriend,806
2652034,1876/08/29 00:00:00,2618,ddd:010288714:mpeg21:a0022,http://imageviewer.kb.nl/ImagingService/imagingService?id=ddd:010288714:mpeg21:p004:image&x=66&y=3066&w=1013&h=2618,ddd:010288714:mpeg21,1079,5684,66,3066,4,In de volgende week zullen wjj vendutie houden van eene groote party gezaagd hout Planken en Schaalplanken achter de Gouvernements scholen 8472 SOESMAN & Co. GROOTE BOERENVENDUTIE op Vrijdag den Sen September a s instede van den 18en September zooals zulks vermeld is op de verspreide catalogus 8401 Gbbk. GIMBERG & Co. Soerabaia. I__»__LCi__-_V_*._**tO__. *^7^©_?©l<i_^_fc«rt©-__ _E3C©3__L©la*loT_»os Voorhanden bij 2944 DE GROOT KOLFF & Co. PORTRETTEN Cabinetfobmaat van wijlen de Generaals Majoor KöHLER en PEL zijn tegen f 2.50 of in lijst f 7.50 per stuk verkrijgbaar bij 8246 DB GROOT KOLFF & Co. NIEU ACT __ï RO 3VE___ INT S verkrijgbaar bij de Groot Koiff & Co. Jokay — Treurige dagen f 5.— Hacklander. Het Kaïnsteeken 2dl. „ 10. Smith — Vrouwenliefde 3 deelen _ 15. Gaboriau De strop om den hals. Een roman uit de rechtspleging 2dln. „ 10. Gaboriau Sarah Brandon of de gauwdieven der groote wereld ïdln. _ 10.— Verder weer ontvangen: A. de Molenaere. Huwelijken onder en zonder de Wet in Ned.-Oost-Indië f 6.— Mr. Scheidius. Llbo Garvema. Een verhaal _ 5.— Crem e r. De Tooneelspelers 3dln. n io. Melatti van Java. De familie van den Resident _ 5 Dezelfde. In de lente vergaard. Novellen „ 6. Ook verkrijgbaar: een nieuwe goedkoope editie in het Hollandsch van WILKIE COLLINS ROMANS i f 0.60 per aflevering. Reeds verschenen daarvan compleet: Armadaxe. Db Vrouw in hbt Wit Madonna. Zon- ' DÏK NAAM. BaSILIUS en HET DOODE GEHEIM I (8989) 1,http://resolver.kb.nl/resolve?urn=ddd:010288714:mpeg21:a0022:ocr,4,ddd:010288714:mpeg21:p004,De locomotief : Samarangsch handels- en advertentie-blad,1013
2582496,1876/11/18 00:00:00,2562,ddd:010486940:mpeg21:a0007,http://imageviewer.kb.nl/ImagingService/imagingService?id=ddd:010486940:mpeg21:p001:image&x=3142&y=1206&w=1008&h=2562,ddd:010486940:mpeg21,4150,3768,3142,1206,6,Koffij-Onderneming Tjipantjoe. Preanger-Regentschappen afdeeling Tjandjoer. Deze onderneming groot 498 bouws waarvan ongeveer 130 bouws ontgonnen zal in den loop der maand Februarij 1877 te Batavia worden verkocht. Beschrijving en Voorwaarden van Verkoop zijn verkrijgbaar ten kantore van den Makelaar C. VEIESENDOEP en van de likwidateuren in den Boedel van Dr. A. J. D. STEENSTEA TOUSSAINT 4544 GIJSELMAN k VAN EINKHUIJZEN. B A Z A R. Ontpakt: Bruidskransen en wit Satijn Lint voor CEINTUUES. Wit en gekleurd Zijden Rokken Koord. Chatelaines. STEIKKEN en diverse SOOETEN DAMES COLS. Compleete witte geborduurde Doop Cost unies met bijbehoorende zilveren rammelaar en bijtring Opgemaakte ZW ABT ZIJDEN en PEECALEN DAMESBOKKEN. Gekleurde Stoffen en (.hitsen. GEKLEURDE en ZWAETE CACHEMIREN DAMESen KINDEE-SHAWLS. KANTEN en ENTEEDEUX om Japonnen te garneeren. ZWAET ZIJDEN HEEEEN en DAMES HANDSCHOENEN enz. enz 4554 H. A. BAHLMANN & Co. BAZAR Geëtaleerd: JEen prachtige factuur SI NICOLAAS CMffi ÉTAGÈRE-VOORWERPEN. Alsmede: Surprises en KEURIG FftANSCH SPEELGOED. 4556 H. A. BAHLMANN b Co.,http://resolver.kb.nl/resolve?urn=ddd:010486940:mpeg21:a0007:ocr,1,ddd:010486940:mpeg21:p001,"Java-bode : nieuws, handels- en advertentieblad voor Nederlandsch-Indie",1008
3205370,1876/07/27 00:00:00,3158,ddd:010486842:mpeg21:a0014,http://imageviewer.kb.nl/ImagingService/imagingService?id=ddd:010486842:mpeg21:p002:image&x=2122&y=2815&w=1015&h=3158,ddd:010486842:mpeg21,3137,5973,2122,2815,4,"VOOR LIJDERS AAN MAAGKWALEN worden ten zeerste aanbevolen de gunstig bekende en onfeilbaar genezende maagdroppels van Dr. STaPPEL uit Berlijn. Maagpijn WATERGAL ook HARTWATER genaamd slechte spijsvertering brakingen maagzwakte windzucht met oprispingen maagkramp enz. worden iv korten tijd volkomen er door hersteld. Het middel bestaat uit onschuldige doch krachtige plantenbestanddeelen. Heeren geneeskundigen worden bijzonder op dit geneesmiddel ten behoeve hunner lijders attent gemaakt. Elk flesehje met gebruiksaanwijzing kost f 4—. Verkrijgbaar a contant bij H. M. VAN DORP & Co. alhkr en G. VAN MEETEREN Apotheker te Buitenzorg. N.B. Brieven en gelden franco. Heeren Tokohouders en Apothekers genieten^rabat. =QW*^. Gouden Medaille. J^^TWff^W^E0"" Pillen van QÏurXA.-L.AKOCHE M -'*■-■vüLaS--' J\ zijn zeer koortswerend. en versterkw""^fTWW^r^E^A encl voor de ma-""S en het bloed. Ï»?_L-MJLkjULSSk 7A] zijn in alle voorkomende [^~ZE*- --- V^*»A Ffre'vallen van lange en hardnekkige _*I[\'A*lHJƒ>_/koortsen aanbevolen zelfs daar % i^^ waar de Quinine werkeloos is ge- X^t> AfUS bleven: alsmede tegen koortsen die *__^in vochtige streken epidemisch zijn. *' '"" Men eische de handieekenlng. PRIJS der flacon Fl. 150 ""* PARIJS '22 rue Drooot j^gEE^L^^C/^ en bij alle apothekers. ~^ Hoofddepot te Batavia bij H. M. VAN DORP & Co. Te Samarang bij de GROOT KOLFF & Co. Te Soerabaija. bij de GEBRS. VAN DELDEN. En verder in de voornaamste APOTHEKEN en TOKOHÖUDERS van Neêrlandsch-Indië. 1186 Ontvangen: /No. 120 M. 1^ F en E F. rerry pennen no. 27 _* f J r en E F. (No. 223 E F. 2657 H. M. VAN DORP & Co UITKEERIrtfGSFONDS „La Constante ét Fidele"" te Samarang. Voorbeeld : lemand beneden de 28 jaar. verzekert door eene contributie van J 2.50 's maands aan zijne weduwe of kinderen eene uitkeering van ƒ 1000. Verdere bijzonderheden zie Reglement op franco aanvraag gratis te verkrijgen. Commissarissen van toezicht zijn de HII. G. L. DÖRREPAAL chef van de firma DORREPAAL & Co. J. C. SPENGLER Agent van de Javasche Bank. Bestuur: J. M. ROSSKOPF Voorzitter. L. C. HEIJNIS Thesaurier. W. F. G. L. HAANSTRA Secretaris. CE. VAN KESTEREN I B. V. HOUTHUïSEN ( heam' Agenten: G. K. TIMMER Batavia. L. W. VAN DER ZWAAN Soerabaia. C. A. VALK Soerakarta. J. M. PIJNACKER HORDIJK Djokdjokarta. J. C VON HERTLING Rembang. J. G. RAZOUX KUHK Ternale. G. L A. BRIËT Padang. 1259",http://resolver.kb.nl/resolve?urn=ddd:010486842:mpeg21:a0014:ocr,2,ddd:010486842:mpeg21:p002,"Java-bode : nieuws, handels- en advertentieblad voor Nederlandsch-Indie",1015
3627355,1876/03/18 00:00:00,3595,ddd:110534756:mpeg21:a0031,http://imageviewer.kb.nl/ImagingService/imagingService?id=ddd:110534756:mpeg21:p004:image&x=3174&y=2713&w=1009&h=3595,ddd:110534756:mpeg21,4183,6308,3174,2713,6,"Messaueries Maritimes. De eerstvolgende vertrekdatums zijn: van BATAVIA van SINGAPORE 2<i Maari per Emirtu .io Maart per Ttgre. '.' April « » 13 April i Hoogly. 2o i> ■ 27 * .1 Iraouaddu. 1 Mei s Mei „ SintlA. 18 • . 2_ ¥«it©»«7. 1 Junij >• » .""> Junij ■ Ara. Nadere informatien bij de Agenten der Internationale Crediet- en Handelsvereeniging Rotterdam te Soerabaya en Samarang en 'e Batavia hij den Agent van bovengemelde Maatschappij (832 W. SL'ERMON'DT W/.n. Stoomvaart Maatschappij Nederland. Geregelde maandelijksche mail-dienst. Het vertrek naar NEDERLAND via NAPELS van het Stoomschip VOORWAARTS Kommandant .1. E. GRAADT VAN ROGGEN. is vast_res«telt;l op Zaturdag 8 April 1876. Voor Vracht en passage gelieve men zicli te wenden tot rde Agenten J. DA ENDELS & Co. (ó'a; Batavia Samarang Soerabaya Stooüivaart Maatschappij Nederland. Geregelde maandelijksche mail-dienst. I lot Stoom»ollip conrld Kommandant J. DE RIDDER zal vermoedelijk in het begin van .\lei van hier via NAPELS naar NEDERLAND vertrekken. Lading wordt aangenomen voor bijna alle havens iv EUROPA waarvoor directe Connos- Voor Vracht en Passage trp]jpVe men zich te wenden tot",http://resolver.kb.nl/resolve?urn=ddd:110534756:mpeg21:a0031:ocr,4,ddd:110534756:mpeg21:p004,Bataviaasch handelsblad,1009
3484800,1876/11/30 00:00:00,3630,ddd:010100992:mpeg21:a0071,http://imageviewer.kb.nl/ImagingService/imagingService?id=ddd:010100992:mpeg21:p008:image&x=1072&y=69&w=960&h=3630,ddd:010100992:mpeg21,2032,3699,1072,69,8,"TROMP & r. Amsterdam. Keizersgr. bij Leliegr. 168. Onvervalscbte Wijnen. Fijne Bieren LAGE PRIJZEN. PRIJSCOURANTEN FRANCO. (29664) Bijzondere attentie verdient onze Prijscourant voor HH. consumenten die hunne WIJNEN (DIRECT VAN BUITEN) betrekken. (42890) TROMP & C. DE GOEDKOOPSTE de koddig.te dejollgste. de prettigste de amusantste Gi-ï.LU..T_-l_ Ki.DK ALMANAK VOOR 1877 is die van MADAME ANGOT. Onder meer Coupletten komt daarin voor: Wat mijn hart deed ontbranden. — Het Neefje —De Mosselenmeid. — Net als Papa. — De Pachter. — Wispelturige liefde. — Juffrouw Cato. — Wat ben ik toch dom — De oude babbelkous. — Oude wijvenpraatjes. — Het is maar schgn. — O ja. — Madame Angot. — Do jonggehuwde enz. enz. Prijs f 0.30. Verkrijgbaar gesteld bz D. BOLLE Noordblaak te Rotterdam toezending franco op ontvangst van Postwissel groot 35 CENT. (43405) I-E"" ST.-NIGOLAAS. <_■ SCHUMANN'S Album voor de Piano ƒ 1.50. Jugendfreuden zeer gemakkelijke 4 ra » 1.50. STRAUSS Albumj Piano 2/m (eene uitmuntende collectie van zijne beste dansen) » 1.50. CHOPIN'S Mazurka's nieuwe goedkoops uitgave..» 1.50. SCHUMANN'S Noveletten (alle acht goedkoop)..» 1.50. MENDELSSOHN's Lieder ohne Worte (alle 48)..» 1.75. CHOPIN'S Valses compleet praehtuitgavc vroeger f 7.35 nm » 2.—. CHOPIN'S Werken compleet ze» dikke deelen of 1026 pagina's gewone prijs f 140.16 aangeboden voor «30.—. Doelmatige aangename en nuttige MJZIEKBOEKEN. SEÏEEARDT'S JOEE- ES MEZIERHANDEL ETALAGE. (43055) l H. BT.--.UH.IAAS MDCCGLUVI. Aan allen die deze zullen zien of hooren lezen Salut! Heeft besloten en besluit mits deze: Aangezien er boekverkoopers zijn die reeds nu geen raad weten met lmnno bestellingen ca daarom met St.-Nicolaas gaarne van bestellingen verschoond zullen blijven; te benoemen tot omen afgezant speciaal met de aflevering van Prentenboeken bolast •J. VLIEGffiR Wink-ls bezittende in de UALVEMAANSTEEG 6 en in de HUIDENSTRAAT 6 alhier; genoemde _f. VLIEGER zal belast zijn om Vaders of Moeders iets voor hunn« Spruiten verlangende steeds met raad en daad ten dienste t» staan; om echter genoemden onsen afgezant 't niet al te lastig te maken hebben wq hem verzocht onze troonrede schrijvende een overzicht van 't geen hij zoo al heeft aan de» onze vorstelijke rede toe te veegen waaraan hij bereidwillig heeft voldaan. Lasten en bevelen onzn Ministers met de uitvoering van dit besluit bolast om hen die geen keus knnnen doen uit liet op franco aanvrage GRATIS te bekomen Feestnummer der Sl-Nicolaus Courant den Heer VLIEGER te gelasten ook de vurige nummers van zijn Weekblad de Vlieger franco m GRATIS te doen toekomen. Bevelen aan allen  die zich nog iets aan het oordeel van St.-NICOLAAS laten gelegen liggen. voor hunne Kinderen t „ sterkste aan de AARDRIJKSKUNDIGE PLAKKAARTEN waarvoor men ons drereet van 13 November jl. gelieve na ta zien. (43378) Gegeven in ons Bi-schoppeiyk Paleis den 22sten van Slachtmaand 1876 Bt.-IVI€OLAAS.",http://resolver.kb.nl/resolve?urn=ddd:010100992:mpeg21:a0071:ocr,8,ddd:010100992:mpeg21:p008,Algemeen Handelsblad,960
8222172,1876/08/13 00:00:00,5086,ddd:010972957:mpeg21:a0060,http://imageviewer.kb.nl/ImagingService/imagingService?id=ddd:010972957:mpeg21:p007:image&x=2009&y=90&w=1933&h=5086,ddd:010972957:mpeg21,3942,5176,2009,90,8,"STEMGERECHTIGDEN en MANSLIDMATEN der Ned- Herv. Gemeente minstens 23 jaren oud en sedert 1 jaar als zoodanig erkend en vasthoudende aan het Evangelie des Bijbels ressorteerende in genoemde Kerkwijk worden dringend uitgenoodigd tot eeno' SAMENKOMST op MAANÖAG 14 AUGUSTUS des Avonds te BVa Uur in hot Lokaal DE VEREENIGING ia de Plantage Doklaan tot het ontvangen van mededeelingen. NB. Belangstellenden van bovengenoemde qualiteit hebben ook uit andere Kerkwijken vrijen toegang. (29874) Bij deze heb ik de eer aan mijns geachte Begunstigers konnis to geven  dat ik mijne Zaak eVERGEBAABJ heb aan den Heer T. G. BüüaSÜELS dankende voor het genoten vertrouwen beveel ik mijten Opvolger aaa. ""m. i>. su©s. Mij refereerende aan bovenstaande Annonce beveel ik mij in de Gunst van het"" geëerde Publiek hopende door goede -Bediening het vertrouwen hetwelk mijn voorganger heeft mogen ondervinden mij ook waardig te toonen. (2987(1) ''s. g. KURRELS. Door verandering van betrekking wordt TE KOOP tcerel ele van ouds bekende TAPPERIJ en SLIJTERIJ De Bisschop Inlichtingen to bekomen bij den Heer J. D. VAN DER NOLDEN Plantage hoek Kerklaan. (29766) lIIIFISf ïïEEI. Er wordt met half September tegen RUIM SALARIS gevraagd eene W2imELJUJI?H'R©UW hoofdzakelijk voor den verkoop van MARTTELS. Franco brieven worden ingevfacht onder lelt. il. D. Bureau Handelsblad. (29801) Een net gesitueerd binnenshuis opgaand BöVEMISUSS van allirgemakken voorzien wordt op het beste gedeelte van den Nieawendijk TE ESUUR aangeboden naar verkiezing to aanvaarden. Francs te bevragen Nicuwendijk L 127. ■ . (29799) Een bekwame TWEEDE WERKSTER voor het maken van Damesnoeden kan direct of met L"". September geplaatst worden. Franco brieven onder. lett. X. aan elan Boekhandel van M. M. OLIVIER Rokin te Amsterdam. (29502) ~Tü. ümsAxosiAi ƒ& ïSand-Maaimacnlnes. Jl Door bemtderins worden 25 fk f stuks echte SAXOSIAB 1 5 - van OLEMENS MULLER om ll|* »■ spoedig van de hand to doon M\ tegen den spotprijs van ƒ3B w<frSKi& J'W niet onderricht TE'KOOP aanfi ».- - geboden. Adressen onder Let... tera M. D- Bureau Handels"" jTvblad. Verzending door geheel 'Nederland. (29873) ""IifIEKIÏIfI'eifRAÏSD. lemand van middelbaren leeftijd ongehuwd P. G. jaren lang op een en hotzclfde kantoor werkzaam geweest doGh door liquidatie dier z*ak buiten bestaan ZOEKT hier of elders eene ANDERE BETREKKUSG. Adres franco onder letter K. bij den Boek- en Kunsthandelaar C. M. VAN GOGH Leidschestraat. (29787) «sse Dutch lady who will go back to Englandina few mm weeks wishes to inforra narents who intend sen[Wm. dißg their danghters to anEnglish BOIRRIKG /W% £CH**«H t!""it the wonld be glad to take some /•—||Pl pupils with '-er. 1. JÊÊL Healthy place comfortable home moderate tcrina. For more particulars address to Mrs. i>£ Eiivbn H. VAN MUNSTER & Zn. Printers Warniocrgracht 12 at Amsterdam. (29348) leder die verlangt een solied net afgewerkt geheel rcuke-loos eu tevens zeer billijk PETROIÏM-KOORTOESTII to bezitten wordt aanbevolen om zich te vervoegen in het MAGAZIJN vui HUISHOUDELIJKE ARTIKELEN Mlenweis€lijl£ W. 161 alwaar deze PETR®LEUM-K©©KT©ESÏELLEI« ouder Garantie in groot assortiment verkrijgbaar zijn. 15. WWLÏSV Fabrikant van Petroleum-Kooktoestellen en Metaalwaren. (29881) Ifcil'-irtirl-ir. iriiH-. ri...i... ■ . ' aiti - >li"".n was koop een span Zwarte MER&B£&®ËTSPAAROEI*j zes en zeven jaren oud mak en goed bij don Hejt loopende groote maat. Te zien en to bevragen aan het Hotel la Station te Utrecht. . (29752) Aan eene inrichting waar Yrouwcnkleèdingstukken werden verraaï'digd wordt gevraagd: EENE PERSOON WELKE BK DIRECTIE OP ZICH KAN KEKEN. 181$ Offerte» franco onder Lett. L. D. Bureau Handelsblad. Als JONGSTE KANTOORBEDIENDE biedt zich aan een Fatsoenlijk JONGMENSCH oud IS i aar eenjaar ia dergelijke Betrekking geweest zijnde P. G e'jtf eefiigszins bekend met Fransche en Doitschs talen. Brieven iranco L0U.0. D. Bureau Handelsblad. (""0828) ' MANTELS EN COSTUMES. Worden verlangd WERKSTERS bekwaam in baar vak bekendheid met de machine strekt tot aanbeveling. Adres franco oneler Lett. N. D. Bureau Handelsblad. (29821) GE Vll AA-G '!>.:/' een WEM2IELJUETROUW zich aan te melden Maandag van- 10 tot 11 uur Nieawendijk K 151 iv het SINGER'S NAAIMACHINEMAGAZIJN. (29311) Voor een of twee HEEREN hunne bszisheden btjiteßshuis hebbende z-ijn in het beste gedeelte der -Kalverstraat I'weo a Drie zeer'net Gemeubileerde K ASSERS TE HU UB  voirzien van alle gemakken. Te bevragen bij den Boekh JAN D. BROUWER Kalverstraat 117 Amsterdam. (29814) ÜZEatVAJÜBN. Een geroutineerd INDUSTRIEEL RE3ZIGER. voorzien van ele beste refereutiën zagzieh gaarne VERPLAATST. Brieven onder het Motto: IJZERWAREN Worden franco ingewacht bij den Boekhandelaar J. F. VAN DOBBEN to Haarlem. (29530) Een roiaal BOYEKRUIS  2de en 3de Etsge> met 2 groote en een kleine Voorkamer Binnenkamer Slaapkamer Eenken Zolder enz. terstond te aanvaarden. Adres franco Brioven Lett. H. bij den Boekhandelaar J. T. F. STEENBERGEN Utreehtsehestraat N°. 63. (29525) ""NÖTISÊWIIMfiL. Mr. SWINDELLS TEACHER ©ï THE ENGLISH language bas reaiovedto iS°. 271 Singel noar PaUi-istraat. (29884) Een GROSSIER in IMUNUS'AÏ'.TUREN verlangt tegen genot van een f link honorarium een GEROïJTINEERD REIZIGER bekend in Noord- en Zuid-Holland Utrecht Gelderland ca Noord-Brabant. Reflecteerenden adresseeren zich met franco brieven onder Lett 8. in' den Kantoorboekhandel ""vaa Wjsd. I. ELLERMAN Rokin 2. (29870) TE HUUR op de Westermarkt om dadelijk te aanvaarden SSS.ÏBE BOVENHUIZEN voorzien van alle Gemakken elk afzonderlijk Huurprijs f 230 of in eens voer ƒ720 alle dagen te zien en te bevragoa bij C A. MARGAROLI Schoorsteenveger en Kook-verdrijver Westermarkt N°. 5. (29830) . Een ï.'otaris ten platten lande die in eene streek woon' waar vooruitgang op groote schaal zichtbaar is deeh dientengevolge veel aanvragen krijgt van kleinere geldsommen waarvoor solide onderpand kan worden gegeven wenscht. in rela'tio te komen met grootere en kleinere KAPITALISTEN die genegen mochten zijn in bovengenoemde aanvragen te gemoet te komen. Nadere inlichtingen worden ver-trekt als men zich franco aanmeldt aan het Bareel van Het Nieuws van den Dag onder lett. W. ü. (29077) GEVRAAG» .f ?§«)«© a f 300 O» op drie solide Ge ouwen. Reflecteerenden gelieven hunne brieven franco in te zenden onder Motto HYPOTHEEK aan het Adverteniènbureau van P. H. J. REINET DE LA RUB Utrechtschcstraat bij het Fjederiksplein Z 135. (29871) Een JONGMENSCH gednreßd»; verscheidene jaren in bovengenoemd vak werkzaam in Winkel-en Magazijn Mg zich gaarne met December of Januari a s. VERPLAATST op een Magazijn of ais REIZIGER de beste getuigen staan ton zijaéh dienste. Reflecteerenden gelseven zich met franco brieven to aelresseeren onder motto MANUFACTUREN aan het Advertentiën-Bnroan van P. H. J. REYNET DE LA RUE. Utreehtsehestraat bij het Frederikspiein Z 133. (29372) Een JONG DÜITSCHER hier vertoevonde niet onbekend met do Hollandsche en Enjgelsche talen negen jarea in Kedoniale Waren Vruchten en Drogerijen Bn gros et en detail bezig geweest zonde zoekt eene BETRE'&.&.BtëG. Adres franco Bureau Handelsblad Lelt. JJ. D. (29886) Het g-voote Succes dat Mj het sclirijvcnde INiblieh de door mij uitgevondene eu alleen door niij gefabriceerde Aloppo .Schrijf- 1 Anilin Biillant Schrijf- en Kopieer- ( IJVITTIJ'IVI Eoßertson's blue black Kopieer- f llllViMl ESZ. EHZ. ■ ) gevonden hebbon heeft cenigan Fabrikanten aanleiding gegeven aan hunne fabrikaten dezelfde namen te geven en onder deze door üjiie qualiteit der IMR.TEW zoo gunstig bekend geworden namen een ordinair product te leveren. Om het Publiek voor misleiding te behoeden maak ik oplettend dat al mijn Fabrikaten van Etiketten mot mijn naam voorzien zijn en verzoek ik daarop te letten. (7164) E 5. VAK ©ER IMOOIEN. MESBMÉL Hotel des gtalsoiis. Dit H©TEL van den lsten rang mag aan familiën in elk opzicht ten zeerste worden aanbevelen. Overheerlijke ligging tegenover do Kurzaal en do openbare wandel plaats. Uitmuntende BADKAMERS en het water der heete bronnen. (23669) Dn. ZAIS  Eigenaar. -",http://resolver.kb.nl/resolve?urn=ddd:010972957:mpeg21:a0060:ocr,7,ddd:010972957:mpeg21:p007,Algemeen Handelsblad,1933
5099022,1876/12/29 00:00:00,5503,ddd:010586873:mpeg21:a0058,http://imageviewer.kb.nl/ImagingService/imagingService?id=ddd:010586873:mpeg21:p011:image&x=1907&y=150&w=1777&h=5503,ddd:010586873:mpeg21,3684,5653,1907,150,12,"Verhuring te Baijum. De Notaris H. FENNEMA. te Wommels is voornemens op Zaterdag 6 Januari 1877 's namiddags 3 uur in de herberg van R. Pieterema te Baijum publiek te verhuren voor den tijd van drie jaren: Twee perceelen Greidland samen groot 2 hectare 80 are 90 centiare (ruim 1% X 363/4 are) en twee perceelen Bouwland samen groot 42 are 90 centiare alle gelegen onder Baijum en behoorende tot de Pastorie-Goederen der Hervormde Gemeente van Welsrjjp en Baijum. HUIS TE BAIJUM. De Notaris H. FENNEMA te Wommels is voornemens op Zaterdag 6 Januari 1877 's namiddags 3 uur in de herberg van R. Pietersma te Baijum provisioneel te veilen: Een in 1873 nieuw gebouwd Huis met Erf te Baijum kadaster gemeente Wommels sectie D no. 1165 nagelaten door Ruurd Hilles Meijer. Weidland te Kubaard. De Notaris H. FENNEMA te Wommels is voornemens mede ten verzoeke van zijn Ambtgenoot E. J. OFFERHAUS te Witmarsum op Woensdag 10 Januari 1877 's namiddags 2 uur  in de herberg van H. L. Wijnia te Kubaard  finaal te veilen: Een stuk uitmuntend Weidland aan de oude Kubaardervaart onder Kubaard kadaster gemeente Wommels sectie F no. 535 voor 2 hectare 91 are 80 centiare (8 X 36 3/4 are) thans in huur bij Hendrik Feddes Bos. Geboden ƒl2ll per 363/» are. Aanvaarding 5 Maart 1877. Huis met Verfwinkel te Kubaard. De Notaris H. FENNEMA te Wommels is voornemens op tijd en plaats als boven finaal te veilen: Een welonderhouden Huis bestaande uit twee Woonkamers Gang Zolder enz. met Verfwinkel Erf en verder toebehooren  aan de Vaart en bij den publieken Weg te Kubaard kadaster gemeente Wommels sectie E nos. 380 en 381 samen voor 4 are 20 centiare thans in huur bij S. van Reen en H. R. Agema samen voor ƒlOO 's jaars. Dit Huis voor allerlei bedrijven geschikt is inmiddels uit de hand te koop; doch hierover is de Eigenaar des Zondags niet te spreken. Geboden ƒ1982. Aanvaarding 12 Mei 1877. Afbraak - Watermolen DEZELFDE NOTARIS zal nog op tijden plaats  verkoopen op Afbraak: Een ""Watermolen staande onder Kubaard op het kadastrale nommer 359 van sectie F der gemeente Wommels. Inlichtingen zijn te bekomen bij Bote B. Nijdam te Kubaard. Verhuring bij gesloten briefjes voor don tijd van vijf jaren ingaande 5 Maart en 12 Mei 1877: Eene uitmuntende ZATHE en LANDEN onder Weisrijp groot 25 hectare (68 maal 363/ j are) thans in huur bij E. A. Talsma en Echtgenoote. De voorwaarden liggen na den 17 December 1876 voor de gegadigden ter inzage ten kantore van den Notaris H. FENNEMA te Wommels en in de herberg van R. PIETERSMA te Baijum. De briefjes gemerkt letter W moeten vóór of op Vrijdag 5 Januari 1877 franco worden ingeleverd ten huize van den WelEcrwaarden Heer Ds. J. NOORDINK Predikant te Welsnjp. ïrERKOOPING op DE LEIJE. - De T Notaris SCHAAFF te Stiens zal op Zaterdag 30 December 1876 's avonds 5 uur ten huize van P. Appoldoorn op de Leije onder Finkum provisioneel verkoopen: Eene ruime en hechte Huizinge no. 65 aan den Weg in do Buurt op de Leije onder Finkum met Erf en Put enz. benevens een stuk Tuingrond kad. sectie A nos. 20 en 806 samen groot 11 are 40 centiare in huur bij F. J. Bisschop voor fQB per jaar tot 12 Mei 1877 en eene Grondrente ad f 0.75 per jaar gevestigd op sectie A no. 862 aldaar. Te aanvaarden den 12 Mei 1877. HUIS EN BAKKERIJTE STIENS. DEZELFDE NOTARIS zal op Woensdag 3 Januari 1877 's avonds 5 uur ten huize van den Kastelein de Jong te Stiens finaal verkoopen: Eene Huizinge no. 13 met Erf Steeg Grond enz. op een gunstigen stand aan de Vaart en den Weg in het dorp Stiens waarin sedert onheuchehjke jaren de Brood bakkerij is uitgeoefend thans in huur bij E. D. v. d. Berg voor ƒ220 per jaar behalve 2 afzonderlijke Woningen in de Steeg welke verhuurd zijn aan F. Hiddinga met den Tuingrond voor f 53 en aan G. Plantinga voor ƒ46 per jaar kadaster sectie B 514 en 515 samen groot 5 roede 80 el. Behoudens samenvoeging te veilen in 3 perceelen. Te aanvaarden 12 Mei 1877 behalve de eene Woning met den Grond die verhuurd is tot 12 Mei 1879; geb. ƒ3341. Inmiddels uit de hand TE KOOP te bevragen bij den eigenaar P. Oenema onder Stiens. Inlichtingen te bekomen bij den Notaris. GREIDLAND~ONDËR STIENS. DEZELFDE NOTARIS zal op Woensdag 3 Januari 1877 's avonds 5 uur in de herberg van de Jong te Stiens provisioneel ter verkoop veilen: 1. 2 hekt. 34 are 90 centiare (6 p.) Greidland aan den Groenedijk op het Oudland onder Stiens kad. sectie D no. 313. 2. 1 hekt. 8 are 30 centiare (3 p.) Dito aldaar aan den Dokkumer trekweg kad. sectie D no. 331. Beide perceelen behoorende tot den boedel van de Wed. Lieuwe P. Bouma en te aanvaarden dadelijk na de toewijzing. ■"" —tra—— :—' '•■■: ; •",http://resolver.kb.nl/resolve?urn=ddd:010586873:mpeg21:a0058:ocr,11,ddd:010586873:mpeg21:p011,Leeuwarder courant,1777
5209860,1876/01/17 00:00:00,4888,MMDA03:000096273:mpeg21:a0015,http://imageviewer.kb.nl/ImagingService/imagingService?id=MMDA03:000096273:mpeg21:p003:image&x=2035&y=606&w=1010&h=4888,MMDA03:000096273:mpeg21,3045,5494,2035,606,4,Advertentie Landbouw-Lezing BEILEN. De door den Heer W. SLUIS uit de Beemster in de derde Afdeeling van het Genootschap ter bevordering van den Landbouw in Drenthe te houdene lezing zal plaats hebben op Woensdag den 19den Januarij e.k. des voormiddags elf uur ten huize van J. JOOSTEN te Beilen. Ook niet-Leden hebben vrijen toegang. Namens het Bestuur JOH. WESSELS BOER Voorzitter. Nationale Militie. De BURGEMEESTER der gemeente Smilde brengt ter kennis van de belanghebbenden dat het Inschrijvingsregister voor de ligting der Nationale Militie van 1876 en de daaruit opgemaakte Aliihabetisehe Naamlijst  overeenkomstig artikel 26 der wet van 19 Augustus 1861 (Staatsblad no. 72) van en met Maandag den 17den tot en met Dingsdag den 25sten dezer maand op de secretarie der gemeente voor elk ter lezing zullen liggen en dat gedurende dien tijd tegen het register en de lijst bezwaar kan worden ingebragtbij den Commissaris des Konings in de provincie. De bezwaren worden ingediend door middel van een verzoekschrift op ongezegeld papier onderteekend door hem die ze inbrengt. Deze bezorgt het bij den Burgemeester der gemeente en erlangt daarvan bewijs. Smilde 14 Jan. 1876. De Burgemeester voornoemd EBBINGE. WERY's Honden- en ApenTheatre. Standplaats Javastraat Assen. Buitengewone roemrijke Voorstelling op Dingsdag 18 Jan. 1876 des avonds te 7 uur MET VERANDERING VAN PROGRAMMA. Tot slot: ie Bandieten ii liet lelerite van Yeneffi OF HET OMXHTII GESTOLËW HIXD groot nieuw Roover-Pantomime in 2 bedrijven met gebergte nieuwe theatrale benoodigheden gevechten tableaux en Bengaalsche verlichting. lste Bang 99 cent 2de Rang ÖO cent 3de Bang 30 cent. ANTOINE Regisseur. WERY Directeur. Vereeniging voor Volksvermaak te Meppel. ■ ■ ■■ ■ ■ isen pri] door MMXES lioven de 18 jaar op Dingsdag 18 Januarij 1876 [IJS EN WEDER DIENENDE.) Aanvang 's morgens 11 uur. PRIJS: 110 GULDENS. PREMIE: 30 „ Inleggeld 59 cents. Ieder die zijn eerste partij afrijdt ontvangt f 1.— Aangifte den 17den Januarij tot 's avonds negen uur in het Hotel BONTEKOE te Meppel; daarna DE DIRECTIE. JLotlng. Yrouw DEKKER aan deGroningergtraat te Assen vraagt tegen 1 Mei e.k. eene flinke MEID Gevraagd tegen 1 Mei een bekwame Kleêrmakersknecht. Loon naar bekwaamheid. Franco brieven of in persoon bij J. VERMEULEN Winkelier en Kleêrmaker te Hoogeveen. Gevraagd tegen 1 Mei 1876 door Mr. A. E. J. NIJSINGH te P Meppel iemand van de P. G. die goed kan rijden en met paarden omg aan _ j) e voorkeur zal hebben een gehuwd persoon zonder kinderen ten zjjnen laste die gediend heeft bjj de kavalerie.,http://resolver.kb.nl/resolve?urn=MMDA03:000096273:mpeg21:a0015:ocr,3,MMDA03:000096273:mpeg21:p003,Provinciale Drentsche en Asser courant,1010
2372802,1876/01/14 00:00:00,1094,MMKB08:000089741:mpeg21:a0017,http://imageviewer.kb.nl/ImagingService/imagingService?id=MMKB08:000089741:mpeg21:p004:image&x=1066&y=134&w=1747&h=1094,MMKB08:000089741:mpeg21,2813,1228,1066,134,4,Advertentie üoilaiidsck Vleeschliouwerij Maurits Vos Te verkrijgen: PUIK OSSEN- KALFSEN LAMSYLEESCH benevens delicieuse ROLPENS EN Gerookte 0SSENMU1SJES op zeer billijke voorwaarden. 1 Verstopping GENEZING ZONDER PURGATIE Eén pil 's avonds — 1.25 de Doos — Dépot te Arnhem bij den Heer H. H. THIEM3 PODOPHYLLE PEISCY één doos is voldoende.  Hoek Bakker- en Vijzelstraat.,http://resolver.kb.nl/resolve?urn=MMKB08:000089741:mpeg21:a0017:ocr,4,MMKB08:000089741:mpeg21:p004,Arnhemsche courant,1747
2215210,1876/05/29 00:00:00,3382,ddd:010062552:mpeg21:a0052,http://imageviewer.kb.nl/ImagingService/imagingService?id=ddd:010062552:mpeg21:p007:image&x=98&y=1698&w=655&h=3382,ddd:010062552:mpeg21,753,5080,98,1698,8,"Astronomie. EêhuitstekendeAstj;onomisehekJ3ker van Franenhofer wordt Tfi KOOP aangeboden. Vergroating 60 en 90 ter-reStrelg jftet zonneglazen op houten voet met dutibwe schroeïbeweging voor ƒl2©!— Franco jfc'even motto Astronomie^ bij den Boekhandelaar A. C. ROLFF Wechtschestraat *S de Prinsengracht No. 88. (7756) Tjotter. TE KOOP aangeboden een vlugge snelloopende Friesche potter 3TI 4 ton ?net compleeten inventaris vosr ƒ 150.— Franco Brieven motto fjefter bij den Beekbandelaar A. C. ROLFF Utrechtschestraat biJ de Prinsengracht NOl ?8. (7757) Tn een zeer welvarende Gemeente in •*• welke eene uitnemende School bestaat voer meer uitgebreid lager Onderwijs wordt CP hoogst bil?ij Ue voorwaarden ter overname aangeboden eene Geneeskundige Zaak **et Apotheek welke jnarlijks netto ƒ5OOO oplevert. Adres met franco brieven aan het Bureel dezer Courant onder *et motto Geneeskunde. (7659) ~ ' ___ Grasveilingen. Te Spaarnwoude op Woensdag 7 Junij 1876 van LANDEBI^BN in den Inlaag ue Uiterdijken en Velserbroek. -Op Zaturdag 10Junij 1876vanLAN**ffiaiJEN in de Buiten- en Binnenpol- ?ers van Haarlemmerliede en Spaarnwoude ""e*den des morgens ten 19 ure. (7751) „De Makeïaar7j.""""H7cßboCKEWlT H.H. «ROEKMAN D. P. C. LEDEBOER C.A.A. ""ÖÖOK DE WIT en J. H. CROOCKEWIT .R- zullen als lasthebbende van hunne Meesv.ers'. op Woensdag 31 Mei 1876 des ""annddags ten 12% ure precies in de yra-kkc Grond te Amsterdam presen""^Wen te Verkoopen: 33ï Vaten en 162 Wes Siriiaaiscliß Suiker Si!iri .eenf uit zee gekomen en gelost.) tnerd hi3 Kavehngen zooals die genum- a^eLif_g^ ?an Woiilaats. §____ Men is van meening om op _RJ| ""Woensdag den 31n Mei 1876 öe^ biJ opbod en op Woensdag •vondstJuni 187 e' biJafslag beidei\des te Alk!? 6 uren ten overstaan van den KER fc gevestigden Notaris BAKceel Pu^Uf het na te melden per- Een on j te verkoopen: !A^i».aar e be»te standen der gemeente straat en up den noek van de LaDSe"" gericht to^ogstraat gelegen HUIS ïn- Koffiehuis en dèteiten '..«n waarin tevens twee Sodere voora!rin gevestigd waaraan bijzonaaarin sederj n zijn TerDOuden. alwdke ces worden u-!ele jaren met het meeste sueopleveren.; Jf'ieoefend en een goed bestaan kend in __e *' huis bij het kadaster be- 3 roeden A' No' 2186 ter Brootte beneden uit e 3 54 ellen en bestaande tot Koffiei_vj.js !_e zaal gebruikt wordende zaal gebruikt Restauratie eene groote Woon vertrekkenende tot Sociëteit voorts Tuin en böven' Kelders Keuken en gebruikt worden^11 eene zaa'' geèclm'c'; en Vergaderingen ze^e tot het houden van kamers enz. Eu verschillende Logeer- Het perceel is .„^ (6608) te koop terwijl IJfi dels uit deband te bekomen bij der . informatiën zijn W. F. VAN TEL? e'Kenaar den Heer M. C. VAN RIJNEN den Heer dam en ten kotfi^*™"" toAmster- BAKKEE SCHUT vatt den Not*ns",http://resolver.kb.nl/resolve?urn=ddd:010062552:mpeg21:a0052:ocr,7,ddd:010062552:mpeg21:p007,Het nieuws van den dag : kleine courant,655
2409715,1876/10/18 00:00:00,2845,ddd:010509128:mpeg21:a0008,http://imageviewer.kb.nl/ImagingService/imagingService?id=ddd:010509128:mpeg21:p003:image&x=92&y=1826&w=847&h=2845,ddd:010509128:mpeg21,939,4671,92,1826,4,"Door- en ten kantor? van (Ln Nota- Ti? S. 11. de GRANVDA zal op Woensdag I November e. k des voormiddags uur worden verkocht: j-. > De iv volle werking zijnde Suikerplantage V H e F F A 1 met .Ir/. i\... r GRONDEN FABRIEKEN G EBOUW EN Vaarl utgeti en \ erder tne« ouoren g ! £T;u in bet district Roven BUrintftnc voorzien van een groot aantal gecontracteerde IVfMIGRVNT&N. j De bevvijzi n van eigendom en vfil' i conditien liggen tei inzage ten kantore Van voornoemden Notaris i Paramaribo 17 October 1876. Openbare Veiling* i Ds geq. Notaris F. A. CAÜELI/; zal °P l'ry^ag «Ben lOn. I%'»veiu3»ee e k. d»s voormiddags neü-n ure tea 2l.)nen kantore in het openbaar veilen ■ en verkoopen krachtens onherroepelijke [ Volmagi ingevolge art. 1207 B. VV. Js%. 1"""". gedeelte \an de plint. £je .lasi^e B2gfeni&orf gelegen in het distivtt Boven Cottica Yr grootte van 107 'j 7 hectare tiebe* hooreude aan den beer 11. M. ELLIS. De bewijieu van eigendom eu de veil* ' Cnuditien zulleu in tijds ter inzage liggeu **u kantore van voornoemden Notaris. Paramaribo 12 October 1876. Openbare Veiling- De r j. Notaris E. L CABELL zal teu Verzoeke \m /.:j;i principaal over VIER ! *»EUE> dag en datum nader te ba-j l);>ien ten zijnen kantore in bet openbaar veilen en verkoopen : tf£% liet ï-iSSF met de daaropstaando R^L-gen alhier aan de Zw&rtenhovenbritgsl>'aal bekend ouder N. Vv. La. E No. toebehoorende aan de erfgenamen vau den beer J. Dü;\ll'lG. De bewij/.en van eigeudom en de veil- Cnuditien zullen in tijds ter inzage liggen ••eu kantore van voornoemden Notaris. Paramaribo den 12 October lÖTti.",http://resolver.kb.nl/resolve?urn=ddd:010509128:mpeg21:a0008:ocr,3,ddd:010509128:mpeg21:p003,De West-Indiër : dagblad toegewĳd aan de belangen van Nederlandsch Guyana,847
5362448,1876/01/25 00:00:00,2639,ddd:010486674:mpeg21:a0011,http://imageviewer.kb.nl/ImagingService/imagingService?id=ddd:010486674:mpeg21:p002:image&x=44&y=3267&w=2032&h=2639,ddd:010486674:mpeg21,2076,5906,44,3267,4,"/ / Keerll Men kan zich moeilijk een zachter aangenamer en /__. / nuttig| ■ vooral vsrfrisfichender parfum voorstellen Doür middel / / i» het ■ van destillatie met wijngeest uit aromatische planten X^_""__r/ Eau dAn I ■ getroKken he«s het eene weldadige en verster- /___^___r/ vers op reis! ■ kende eigenschap verkregen welke in vele om- AA^SSz uithoofde varl ■ standigheden van het grootste nut is. Het bezit //^_%>_W ziJn ""erfrisschen I ■ l.dat.iedere fijne aroma welke het dagelijksch / >C^| J/ de Beur» waardoori ■ gebruik er van bij de toilettafel zoo aange- A^^^. 1/ een aangenaam gel I B»;*i maakt. /J^^^^L/ voe* worclt opgewekt! _!■ Hst Eau dAn vers is vooral nuttig tot /04_____ / vooral wanneer het zeer! 1 inwrijving der ladematen van kinderen  / warm 's- ZiJü praktnscheH ■ jonge meisjes en gnjêfiards wie het / waarde is onbetwistbaar voorl I verstekt eu wien het krachten en ge /%s \!^r personen die veel denken  voorl 1 zondheid schenkt. Ook wordt het /j*m2 T_/ schrijvers artisten enz. omdat heil ■ aangewend lij hoofdpijn welke //^ %l / het verstand versterkt en de werk-l ■ geheel verdwijnt en bij rhu- / dadigheid van hét geheugen verhoogt! ■•matiek (wrijving). /. door sterke inademingen als ook door! Uitgevonden en gede- /__>_ / het voorhoofd er eenige malen mede tel ■ stilleerd door A.x\jg. /^^^__)/ wrijven. Op de zakdoek verspreidt hetl ■de -Vïarbaix: /.^___^'y eene zeer aangename geur die iedereen he-l ■ Anlieerpen Rue Saint /__^^«l|^fc'/ Ta't- Het wordt uitsluitend verkocht bij ge! I l'ierre et Paul /___)v3y/ renommeerde kappers en de grootste hande-l no. 7. / 'aars 'm parfumeriën. 9 / Bijzonder wordt aanbevolen LA ROYALE en| 1 _\ ' V LA DOUBLÉ. 4H4 - Varkrijabsar bij ELLÏNG__.& VAN LISSA. Simpangsche en Javasche Apotheek Soerabaya. !»T|\TpTaT'Xn7J§[¥TK Het eenig goedgekeurde middel in Frankrijk y iVJ '^ '1^ 'T»""--1 ""fjj fi^if _____li MSie> Oostenf'4* en'- Rusland gewaarmerkt door de - handteekening van Dr. GH__L__.U_3J_J__.t_J van den; M._ Germts. Het aantal zuiverende middelen is zeer groot ; maar aan de IE-Ot» Boyveau L'affeCteUr kwam altijd den eersten rang daaronder toe zoowel om. hare sedert meer dan drie vierden eener eenw erkende radicale werking al» om hare plantaardigêsamenstelling. Zij geneest volledig zonder kwikzilver ~*r-aandoeningen der huid den huiduitslag;- de-kirergezwellen de ongemakken van het kraambed van den critieken leeftijd en van de scherpe vochten. Deze JE_ob is vooral aarin<jvdfenswaardig*t«geiï r_*nte besmettelijke verouderde of hardnekkige ziekten waartegen de copahu het kwik en het Todium potaasü niets vermogen -Gene raal depot te Parijs 12 rue Richer. l3e_>6tl_Ouderss Batavia L. PLATON RATHKAMP fc Co^ O _ Ï.WC. r. «61 1 ' ' -7-n-j. ... _ '"" ' ■ T ; ____ | _^p^f%\ £Lll_:_*ilft* ». u^Pt9^ _»^Xs_' ""^» □ /y^pL\ Ö^fc. ïï Sgk 'm der Benediktpe monniken der abtdij van Pécamp ÏA HcW _)_ uitgevonden in 1510; bekcr.d'onder den naam van 8_; I ""_■* I _ll I  Jl_lii_i_i_OT I "" - ™_G__HHi_CSS—SBBsS___—_______■__ ~—fg^t—*- Eetlustonwekkeud spijsverterend versterkend balsemend en uitmuntend van smaak/is de Bénédictine heden de ïióningin' der Likeurenj op alle tafels komt zij voor. Haar dagelijksch gebruit vergemakkelijkt I de functiëa van' de maag. I Generaal Depot le Fe'camp (Frankrijk). Hoofddepöt voor Nederlandsch Indie bij H. M. VAN DORP & Co. te Batavia. 1251 I 'l \ \",http://resolver.kb.nl/resolve?urn=ddd:010486674:mpeg21:a0011:ocr,2,ddd:010486674:mpeg21:p002,"Java-bode : nieuws, handels- en advertentieblad voor Nederlandsch-Indie",2032
1937858,1876/01/14 00:00:00,1898,ddd:010338756:mpeg21:a0013,http://imageviewer.kb.nl/ImagingService/imagingService?id=ddd:010338756:mpeg21:p004:image&x=2206&y=115&w=1021&h=1898,ddd:010338756:mpeg21,3227,2013,2206,115,4,! D. J. SIMONS «al op Waensdatj den 19n. dezer des voorun tdags y uro tegen gereed geld verkoopen : PitÖVISIEN SWKGOEDERE V; Voor rekening v.ui wien het mogt aaa» gaan: Ken partij besch. balen HIJ of gemerkt A D. <J. S. eu een kist gemerkt 11. A. T inhoudende bescheid pakken  allen gelost uit bet bohip Lida kapt. V mc k e Muller. SloSßowó.y'il. Kaïl era leasen. Hoest Gnep. De verzaebtende eigen*cbappen dezer medica. meuten mak-n ze een proefneming waardig. iv alle ongesleldbedeii der adembalingsorganen. Bij gewone verkoudheden eu griep zijn de Pi'len Inwendig en de Zalf over de borst en keel gewreven buitengemeen krachtig werkzaam. Wanneer gri'n besmettelijk heerschi 'v\ dnze behandeling het gemakkeii|ksl  veiligst en zekerst. Holloway's Pillen zuiveren In I b'oed verdrijven alles wat zijn viijen omloop door de lo.gnu belemmert verligtcn de o'verkruptc luchtpijpen en inakea de ademlialiug vrij zonk-r de krachten te verminderen de zei uw te prikkelen ot' den geest neder te drukken Z< odanig ;.i]ii ile gereede middelen om lijden le besparen vvauneer iemand gekweld wordt door verkoudheid hoe*t  bronchitis eu andere Lorslziekleu waardoor in de meeste landen zooveel personen ernsiig eu bestendig gekweld zijn.,http://resolver.kb.nl/resolve?urn=ddd:010338756:mpeg21:a0013:ocr,4,ddd:010338756:mpeg21:p004,Suriname : koloniaal nieuws- en advertentieblad,1021
80968,1876/09/11 00:00:00,116,ddd:010062651:mpeg21:a0037,http://imageviewer.kb.nl/ImagingService/imagingService?id=ddd:010062651:mpeg21:p004:image&x=2828&y=5099&w=698&h=116,ddd:010062651:mpeg21,3526,5215,2828,5099,4,§SF* Wegens plaatsgebrek zijn wig ge- 1 noodzaafct vele advertentiën tot een I volgend nommer uit te stellen. ¦,http://resolver.kb.nl/resolve?urn=ddd:010062651:mpeg21:a0037:ocr,4,ddd:010062651:mpeg21:p004,Het nieuws van den dag : kleine courant,698
5193801,1876/11/22 00:00:00,5199,ddd:011102137:mpeg21:a0015,http://imageviewer.kb.nl/ImagingService/imagingService?id=ddd:011102137:mpeg21:p003:image&x=2100&y=658&w=999&h=5199,ddd:011102137:mpeg21,3099,5857,2100,658,4,"(Voor. Het■ Land). «ÏMBESTEDHG. Up MAANDAG den vierden December 1876 f des voormiddags ten 9 ure zal door den Kwartiermeester van het Garnizoen te Vadang-Pandjang ten zijnen bureele in het openbaar worden heraanbesteed de levering van: - ...' 1- rr. VARKENSVLEESGH ten behoeve van het Departement van Oorlog aldaar voor één jaar (1877) en voor drie jaren (1877 1878 en 1879).  - De voorwaarden dezer heraanbesteding leggen met uitzondering \ van Zon- en feestdagen dagelijks voor belanghebbenden ter inzage ten bureele van voornoemden * Kwartiermeester en van den ondergeteekende alwaar tevens alle ter zake verlangde inlichtingen te bekomen zijn. ' De inschrijvings- billetten moeten vóór of uiterlijk op het uur aer aanbesteding ten bureele van voornoemden Kwartiermeester worden ingediend. -. > : i-Ti.- Onder-Intendant ter Sumatra'» . Westkust - * : L._«« Onderhoorigheden W>. „• N.: ;■ f . (VoorlMimi.) ■ • IMMMESTEDIKG. ; Op MAANDAG den vierden December 1876 des voormiddags ten 9 ure zal door den Kwartiermeester van het Garnizoen te Fort-dc-Kock ten zijnen bureele in het openbaar worden heraanbe«teed de levering vans RIJST ten behoeve van het Departement van Oorlog aldaar voor één jaar (1877; en voor drie jaren (1877 1878 4en 1879). . - <v De voorwaarden dezer heraanbesteding leggen met uitzondering van Zon- en feestdagen dagelijks voor belanghebbenden ter inzage ten bureele van voornoemden Kwartiermeester en van den ondergeteekende alwaar tevens alle ter zake verlaugde inlichtingen te bekomen zijn. Do inschrnvings-billetten • moeten vóór of uiterlijk op het uur aer aanbesteding ten bureele van voornoemden Kwartiermeester worden ingediend. <: .liirii De Onder-intendant ter. Sumatra's Westkust <m m{%£ËÊ£r: VENDUTIE u . _u.. ten huize van wijlen den Heer iW- BARTHÉLEMY (thans bewoond door den Heer Mr. DOORNIK) 34 lovember van. ROERENDE GOEDEREN behoorende tot .diens boedel als: stoelen tafels waaronder een met marmeren blad kasten een ijzeren geldkist enz. Voorts: van restanten TOKOGOEDEREN waaronder behangselpapier hoofdstellen etc. ..... "" De Venduhouder •<BM> :  IN TVELD. 1 VENDUTIE j' __1: MAANDAG 27 November 1- wegens verhuizing- "" ■' ten huize van de Heeren vi Mr. Verwen en Hollingerius Pijpers van hunnen INBOEDEL; waaronder ijzeren-en-hou- 2 persoons ledekanten Kroonlampen k 2 en 3 armen hanglampen glazen-en gzergazen dispenskasten enz. 'Um ' : ° * De Venduhouder (630) '.: Y. INTVELD VENDUTIE VRIJDAG 1 December bfl Krijgsman & Co. Van een groot faktuur esquise Suiker- en Chocoladewerken fraai Speelgoed porcelein-en Kinderserviesjes dito Bloempotten geassorteerde Provisien Petroleum-kooktoestellen enz. * 807> * <. t"" « . .MM) i'? f# v / Tngevolge bevelschrift van den Regter Commissaris in 1 het faillissement van den chineschen handelaar TJOA TIK IM alhier worden alle bekende en onbekende schuldeischers in dat faillissement daaronder begrepen'de bevoorregten en depand- of hgpotheekhebbpnaen. opgeroepen • tot het bijwonen eener eerste bijeenkomst.' hetzij in persoon hetzij bij behoorlijk daartoe gemagtigde welke door hem regter-Commissaris in tegenwoordigheid van de weeskamer alhier als Curatrice .in dien faillieten boedel zal worden gehoudeni op Jlaandag den elfden December 1800 xes en zeventig des voormiddags ten tien ure in het gebouw van den Raad van Justitie alhier ten einde over te gaan op de wijze bij de wet voorgeschreven tot het verifiëren hunner schuldvorderingen. Geschiedende deze bekendmaking in voldoening aan artikel 803 van het Wetboek van koophandel in verband met het staatsblad 1855 No. 79. art 11. Namens de Wees- en Boe ielkamer De Sekretaris MAIDMAN P. dang 22 November 1876. (534) ; Ontpakte Een keurig faktuur' .Chocolade en Suikerwerken ' ts#   KRIJGSMAN & Co. | Op nieuw ontvangen i j •!u l ' uitmuntende SrotVLAnTAAaxs. lII'I' ' t (532) KRIJGSMAN di Co.",http://resolver.kb.nl/resolve?urn=ddd:011102137:mpeg21:a0015:ocr,3,ddd:011102137:mpeg21:p003,Sumatra-courant : nieuws- en advertentieblad,999
2563328,1876/08/07 00:00:00,2356,ddd:110534874:mpeg21:a0009,http://imageviewer.kb.nl/ImagingService/imagingService?id=ddd:110534874:mpeg21:p001:image&x=3163&y=3863&w=1088&h=2356,ddd:110534874:mpeg21,4251,6219,3163,3863,4,"Wedero >n ontvangen Stob wasser BILLARD LAMPEN. KANTOOH LA_MPEN met 2 Lichten. (2747) VAN VLEUTEN & COX. ""NOOTEBOOM ra~ar JSenin. (Jntvan jen BLAAÜW MARINE BAAI bijzonder geschikt voor EXP..DITIE UNIFORM. (j^7s) TtfOOTEBOOM lPassser S_>e__i__. Ruim voorzien van Militaire Ornamenten. | (2594) Huile Suriine (prix modéré.) (2611)) En. HERMENT. Steeds in voorraad: Eene groote hoeveelheid Marmeren Vloersteenen in verschillende afmetingen. BERGKALK uitmunteud geschikt voor bouwen. LI.M KOEN YOE. OEY KIM LONG (2737) Kongsi besaar. Tarwe Zemelen. Van af' lo Junij is de prijs / 250 per zak van 50 pond.",http://resolver.kb.nl/resolve?urn=ddd:110534874:mpeg21:a0009:ocr,1,ddd:110534874:mpeg21:p001,Bataviaasch handelsblad,1088
1541176,1876/12/18 00:00:00,1508,ddd:110534988:mpeg21:a0016,http://imageviewer.kb.nl/ImagingService/imagingService?id=ddd:110534988:mpeg21:p002:image&x=3144&y=3058&w=1022&h=1508,ddd:110534988:mpeg21,4166,4566,3144,3058,4,"Stoomvaart Maatschappij Nederland. Geregelde maandelijksche maildienst. Het Stoomschip "" •""/>^ Prins van Oranje Kommandant T. AUKES zal vermoedelijk in de eerste helft van Februari 1877 van hier via PADANG eu NAPELS naar NEDERLAND vertrekken. Lading wordt aangenomen voor bijna alle havens van de MIDDELLANDSCHE ZEE Noordelijk EUROPA benevens AMERIKA waarvoor directe Connossementen worden afgegeven. Voor Vracht en passage gelieve men zich te wenden tot de Agenten J. DAENDELS & Co. (4606) Batavia Samarang Soerabaya.",http://resolver.kb.nl/resolve?urn=ddd:110534988:mpeg21:a0016:ocr,2,ddd:110534988:mpeg21:p002,Bataviaasch handelsblad,1022
3171664,1876/01/04 00:00:00,1452,MMDA03:000096217:mpeg21:a0024,http://imageviewer.kb.nl/ImagingService/imagingService?id=MMDA03:000096217:mpeg21:p004:image&x=3329&y=129&w=1962&h=1452,MMDA03:000096217:mpeg21,5291,1581,3329,129,4,Advertentie eene ruime Keuze zeer FANTASIEHOEDEN supra fijn mi fijn f 7.— - 6.50 en heeft steeds voorhanden meer ORDINARE SOORTEN zoomede fijne zijden W^rehkv m h~n Kv t allerlaatste modellen. Berigt tevens de ontvangst eener ruime keuze PETTESf en MUTSESf alles tot concurrerende prijzen. jMssen. MEJL V1NGJL Jr. ®en rijk a§§orüineiit PENDULES in marmer brons albast en verguld allen met slagwerk en 11 dagen gaans welke tot buitengewoon lage prijzen en met vier jaar garantie zullen worden verkocht beveelt beleefdelijk aan LEOPOLD HüLSTER Groningen Vischmarkt. RJLAAUWE FORSEUEMWSIÏKEI.. ST.B. Bij verzending EMBALLAGE vrij en BREUK voor onze rekening.,http://resolver.kb.nl/resolve?urn=MMDA03:000096217:mpeg21:a0024:ocr,4,MMDA03:000096217:mpeg21:p004,Provinciale Drentsche en Asser courant,1962
410268,1876/09/13 00:00:00,573,ddd:010984816:mpeg21:a0027,http://imageviewer.kb.nl/ImagingService/imagingService?id=ddd:010984816:mpeg21:p003:image&x=1550&y=2516&w=716&h=573,ddd:010984816:mpeg21,2266,3089,1550,2516,6,ADVERTENTIE!* f VIJF ü TWINTIGJARIGE ECIIïïEnEEMGIXG§ ü VAN J? Ö E. F. LEIJZERS-VIS & # en # J. C. VAN DER WIELEN. gjjg x> Hunne dankbare Kinderen. *«* w Gbave 12 Sept. 1876.,http://resolver.kb.nl/resolve?urn=ddd:010984816:mpeg21:a0027:ocr,3,ddd:010984816:mpeg21:p003,De Tĳd : godsdienstig-staatkundig dagblad,716
2924530,1876/09/19 00:00:00,2870,ddd:010288732:mpeg21:a0055,http://imageviewer.kb.nl/ImagingService/imagingService?id=ddd:010288732:mpeg21:p004:image&x=1072&y=67&w=1019&h=2870,ddd:010288732:mpeg21,2091,2937,1072,67,4,")ci e 16 i t kmi c 11 i&. - Algemeene Vergadering v_n 6' ƒ e mger e c h l 't qde L cd e n op . ï-ij'ïiis ~- «lezer» -ids BV_ uui"" voor ] n i'o.r do Di •|) rekeai.'ig uu re i""g en het uitbrengen vau •pen Soeii 83J5 DE DIRECTIE. PP* GEVRAAGD ~9f tegen 1 October a. s.: EEN MACHINIST voor d 6 Suikerfi'.br'. k MA JONG (Kocdoee). htingea te b;k__.en bij den Administrateur 8803 J. H: R/.USÓIÏ. Een Gouverneur aam om behalve de gewone vakken ook Teek enen ■i: ca Gymnastie te onderwijzen _.. «•orden. tter Z. bureau va. dit blf.d. 8857 pF* lEMAND jaren ia den handel eu bekend kantoor•..e-ks&axaheiden aoekt plaatsing in een handelshuis dj een landelijke onderneming. Adres letter Gr. C. Bureau Locomotief. 5444 rpf^* Bij eene dame citaat gelegenheid tot het verkregen van etöH buitenshuis tegen een billeken prijs Adrc-s: letter C. Lo c om o tic f. 86 5 3 Een Europeesche Dame van middelbaren leeftijd z_g_ich gaarne geplaatst als JUFFROUW VAN GEZELSCHAP ter -s.Utentie eener huishouding. Franco brieven letters X. Y. U. de Groot Kolff & CO. 8813 Ten spoedigste gevraagd in do il: iuienlai-den vau Soei-aiiarla: EENE GOUVERNANTE van iiiiddelbaien leeftijd ter opl.iditig van eene Dochter van 12 en een Joegen van 8 jaren. Ver.i<cï:u-u llcllanöache taal en muziek. Salaris f 100.— 's maaiuls vrij kost inwoning bediening en bewasschi.g. Brieven fianco adres: Lt. D. Djiwo [Klatten1. 8790",http://resolver.kb.nl/resolve?urn=ddd:010288732:mpeg21:a0055:ocr,4,ddd:010288732:mpeg21:p004,De locomotief : Samarangsch handels- en advertentie-blad,1019
1492592,1876/05/05 00:00:00,752,MMDA03:000096967:mpeg21:a0018,http://imageviewer.kb.nl/ImagingService/imagingService?id=MMDA03:000096967:mpeg21:p004:image&x=1219&y=271&w=1962&h=752,MMDA03:000096967:mpeg21,3181,1023,1219,271,4,"GUARANA C3- XX -A. R -A- IT van GRIMAULT en C""% Apothekers te Parijs. Een enkel pakje van deze poeder met een weinig water aangemengd is voldoende om de hevigste hoofdpijn schele hoofdpijn of andere zenuwpijnen te doen verdwijnen. Tevens is de Guarana zeer werkzaam tegen koliekpijnen diarrhee en dysenterie of persloop; het vervangt daarbij met voordeel zonder eenige bloedsophooping te veroorzaken de samentrekkende middelen zooals opium en bismutb. Elk doosje bevat twaalf pakjes en draagt de handteekening van G rimault et C<*. Depots ln alle goede Hollandsche apotheken. £",http://resolver.kb.nl/resolve?urn=MMDA03:000096967:mpeg21:a0018:ocr,4,MMDA03:000096967:mpeg21:p004,Provinciale Drentsche en Asser courant,1962
366404,1876/12/05 00:00:00,556,ddd:110619833:mpeg21:a0006,http://imageviewer.kb.nl/ImagingService/imagingService?id=ddd:110619833:mpeg21:p003:image&x=22&y=4245&w=659&h=556,ddd:110619833:mpeg21,681,4801,22,4245,4,"A. C UUV "" > • To all who oro pnfTcring from tlic i error» and indigcrctioii* of youtlu ncrvous wg&kitgg** carly «ivcar. los* of innnliood. &c  ï will ïrïïd a rwlpêthat trjll curc you KREK OK CHAltGË. TT1IU Krent rt'rtïêdv wan discovcrcd l»v a uiiiwiotiary in South Amorica.' Scnd a itclf-addrt-avd «ure* lopc lo the Ue\% Jusern T. liimau * Stal Ion ] D. Bilde House New Vork Cil v«l9HBH|ri||| • - Bminliful nature nflbrdx 110 HIKT ' Spccific for *klu tbiin Sirfphur a fact ia clearïv proven V»v Ihe net ion opon th«j l ent iele afflictcd • wHh eruption* or ulcerou* anrti of tlint *upr*- mo purififr («lcnn's Sulphur Soap.""*3 DcpotCrit! trnton'a No.' 7 Sixtli HiH'f üair ii 1 WUIskcr l)yc black or brówn .SOcts.'",http://resolver.kb.nl/resolve?urn=ddd:110619833:mpeg21:a0006:ocr,3,ddd:110619833:mpeg21:p003,De grondwet,659
2592832,1876/05/11 00:00:00,2552,ddd:010288623:mpeg21:a0023,http://imageviewer.kb.nl/ImagingService/imagingService?id=ddd:010288623:mpeg21:p004:image&x=2105&y=87&w=1016&h=2552,ddd:010288623:mpeg21,3121,2639,2105,87,4,m ttmrtmjmmmm*^*mMmmMmtmMmmMMmMmmmWmmmmm^tmmmMmm*mmMm D'HO-WETO- • RTiTslTlfiim SCHELE HOOFDPIJN MAAGKBAMP en alle zenuwzie kien worden onmiddellijk genezen door de An t- Néuralgisch.e Pillen van Dr. Cnon i i R de doos 3 fr. emist der le klasse 23 Bue de la Monnaie Par ij s.— _msterdam en in de voornaamste Apotheken van Nederland. (4089) Petroleum a contant tegen f 9.50 per kist bij (1011) P. BUIJS. Hz.. Bloemstraat. Hotel Soerakarta. Aan het reizend publiek aanbevolen. (1509) J. H. T. VAN EECKE. lemand oud 24 jaar in Europa geboren ONDERADMINISTRATEUR van een in ontginning zijnde Koffielaud goed bekend met de Javaansche taal en schrift door verkoop der onderneming zyne betrekking verliezende zoekt plaatsing. Brieven Adres J. E. bureau Locomotief. 'v 1869) itigT lEMAND im van middelbaren leeftijd gehuwd ruim zeven jaren logementhouder zag zich gaarne geplaatst als Logementhouder of Administrateur op een gezondheidsétablissement liefst in een koud klimaat kunnende hy over eenig kapitaal beschikken. Beüecteerenden brieven franco onder letter Z. O. Bureau Locomotief. (1904) ÏJr GOU 7EKNEÜR. ïjjji op een Suikerfabriek wordt gevraagd: een geëxamineerd Gouverneur tot het onderwy'zen van drie kinderen waarvan het oudste negen jaar. Aanbiedingen onder het nummer dezer Advertentie. (1907) Op een Koffieonderneming wordt gevraagd: EEN OPZIEN EB tractement f 100 a f 125 's maands afhangende van bekwaam en geschiktheid. Vereischten: Europeaan van geboorte echter niet te vroeg hier in lndië gekomen bewijzen van eerlijkheid goed gedrag en vooral sterke gezondheid. Alleen zij die Javaansch spreken kunnen geplaatst worden. Adres: bureau Locomotief letter 25. Xj (1925),http://resolver.kb.nl/resolve?urn=ddd:010288623:mpeg21:a0023:ocr,4,ddd:010288623:mpeg21:p004,De locomotief : Samarangsch handels- en advertentie-blad,1016
1084336,1876/10/13 00:00:00,1342,ddd:010872347:mpeg21:a0017,http://imageviewer.kb.nl/ImagingService/imagingService?id=ddd:010872347:mpeg21:p004:image&x=1644&y=3770&w=808&h=1342,ddd:010872347:mpeg21,2452,5112,1644,3770,4,"1 _—- ÜF"" Bekendmaking. Wij gevoelen ons verplicht tot deze . over te gaan ten einde onze geachte Beguustigers in kennis te brengen dat ; wij geregeld voortgaan met onze Koks-Affaire en dat dezelve door ons op zeer accurate en soliede wijze wordt gedreven . en niet zooals door personen wordt gepubliceerd dat wij gemelde zaak niet meer uitoefenen wat geheel en al buiten de is. Daarom verzoeken wij adressen aan ons gericht niet anders en uit: sluitend aan ABRAHAM WAFELMAN & ZOON Lokaal Casino Zwanenburgerstraat en niet in de Israël. Vleeschhal Muiderstraat of Weesperstraat waarmede wij volstrekt in geen connex staan. \ A. Wafelman & Zoon [401] Casino Zwanenburgerstraat.",http://resolver.kb.nl/resolve?urn=ddd:010872347:mpeg21:a0017:ocr,4,ddd:010872347:mpeg21:p004,Nieuw Israelietisch weekblad,808
3043456,1876/11/20 00:00:00,3068,ddd:010288785:mpeg21:a0030,http://imageviewer.kb.nl/ImagingService/imagingService?id=ddd:010288785:mpeg21:p004:image&x=1098&y=107&w=992&h=3068,ddd:010288785:mpeg21,2090,3175,1098,107,6,Tooneelkijkers 8937 F. H. BOUMA. G-RASBOTER in vaatjes en in blikken van 1 2. S/3 «. 3988 F. H. BOUMA. Voor de Regenmoesson: WITTE EN ZWARTE JASSEN met kappen en pjjpen. 8939 F. H. BOUMA. POEOELEINEN EETSERVIEZEN voor 12 personen. Porceleinen Theeservieen Glaiwerh JloiiiseUne Glazen in stellen van 5 dozijn met en zouder sterretjes. KRISTALLEN GLAZEN in stellen van 5 dozijn. Bi lrjke prezen. Te tekomen bij 8985 F. H. BOUMA. MAGAZIJN van IJzeren Ledikanten Bultzakken en Klamboes. 4054 F. H. BOUMA- Prima qualiteit Suiker in blik van 25 pond. 4055 F. H. BOUMA. Ontvangen: Gerookte Bokkums in blikken van 6 en 12 Stuks. SttncïJ» de Ilologne. Cervelatworcrt. Hrunen tl' Ente. 8298 Chs. BOYEB. Tooneelboekjes! Tooneelboekjesl Catalogus gratis bij 4043 G. KOLFF & Co. te Batavia. Schoolboekjes en Schoolbehoeften 4044 bij G. KOLFF & Co. te Batavia. Catalogus op aanirraag. ■ ■■ ■ — Vier Romans van Gustave Droz: Mejuffrouw Cibot — De Beau-Monde — De lastige vrouw en Schetsen als Vrijgezel Echtgenoot en Vader te zamen voor f 6.— franco per post bij 4046 G. KOLFF & Co. te Batavia.,http://resolver.kb.nl/resolve?urn=ddd:010288785:mpeg21:a0030:ocr,4,ddd:010288785:mpeg21:p004,De locomotief : Samarangsch handels- en advertentie-blad,992
4364824,1876/01/23 00:00:00,5256,MMKB04:000166635:mpeg21:a0023,http://imageviewer.kb.nl/ImagingService/imagingService?id=MMKB04:000166635:mpeg21:p004:image&x=3415&y=206&w=818&h=5256,MMKB04:000166635:mpeg21,4233,5462,3415,206,4,"Advertentie door en ten huize van den Boekverkoop e J F. K SGHWAEBE in den Oppert No. 116 te Rotterdam MORGEN (Maandag) Hollandsche Rotna B! Dinsdag Plaatwerken. — Donderdak Prenten. — Vrijdag SCHILDERIJEN  LIEFHEBBERIJEN. (975) Bij W. VAN GULICK te ' s-Hebtogenbosc is verschenen en verzonden: STUDIËN OP BODSD. WETENSCH. [| LETTERK. GEBIED. Achtste jaargang. tktjb:liet II ük Larautoeka op het eiland P L O B E 9 IN Nederlandsch Indie door P. C. HEIJNEN Pr. Ct^ LOSSE BLADEN. De vrije Universiteit van Leuven (976) door S. V. d . A Boekhandel van W. VAN GULICK te 's-Bosct Dépot van H. Goemaere te Brussel. VERMAKELIJKE BIBLIOTHEEK KUNST LETTERKUN DE en WETENSCHAf Verschenen in den derden jaargang 1. Het erfdeel van Francisca. Geluk e: ongeluk schetsen uit het Voikslevet door Math. ... 2. Zelfopoffering en edelmoedigheid of di schat van den uitgewekene en de ouds:; Zuster. 3. De Stier der Vogeezen. Tafereelen m den Fransch-Duilsclien oorlog v 1870—71. 4. De Vos der Ardennen. Tafereelen uit dt; Fransch-Duitschen oorlog van 1870—7! 5. Idem  deel II. 6. De Kerk en de fabriek door J. Chantrei Van de Vermakelijke Biblt Otlieek verschijnen jaarlijks v. lijvige boekdeelen elk van ongeveer 2Dl' bladz. voor slechts /' 3.— den jaargang. (977) Theologische Boekhandel van W. VAi\ GULICK's Bosch Deput van II. 60IÜME11E te Brussel Debiteert met succès: 1. Boppert. Liber Sacerdotalis Seu ecutum fidei ad usus. quotidianos Sacerdotum 6 gr. vol. in 18° {Uandelsprijs f(i) f iJi. 2. Bosmans. (prof.) Piactisciie leerwijze om de kinderen te onderrichten in dei kleinen en grooten Catechismus. Nieuw uitgave /""LM 3. Dutripon- Bibliorum Sacrorum coucordantiae vulgatae editionis ab. recog nitionem Jussu Sixti V. pontif. Maï> Bibliis adhibitam recensitae atque erneii' datae ac plusqaam viginti quinqM millibus versiculis auctae insupei et nutii historicus geographicis chronologici! loeupletatae. 1 deel in 4 J van 1512 in 3 kol. (Uandelsprijs f 16). . f 10.4. Praats. De lijdende en stervende Jesus uit de overeenstemming der vier Evangelisten  en 208 meditatiën en 32 sermonen van den predikstoel voorgedi agen. 9 deelen in 8' (Uandelsprijsf lOj fb.-~ 5. Goffiné- Onderwijs- en ötichtingsboek of korte uitlegging der epistels en evangeliën voor alle Zon- en Feestdagen <l« s jaars met de daaruit getrokken Geloofsen Zedeleer nevens eene duidelijke verklaring der bijzonderste gebruiken de r Kerk — eene huismis alsook de levensbeschrijving van verscheidene heilige""; 2 deelen (Uandelsprijs f 2.) . . f 1.-5 G. Henckens. (pr.) Korte onderwijzing? 11 over de Christelijke leering of beknopt uitlegging van den Mechelschen Catecliis' mus. 3 deelen in 12. nieuw vermei' derde en verbeterde uitgave. . f 3.— 7. Hunolt. Christelijke Zedeleer d e ' evangelische waarheden aan het christenvolk in Zon- en Feestdaagsche Sermoiiefl voorgedragen. In zes afdeeiingen verdeeld bestaande uit 25 deelen elk va» 350—460 blz. Tweede uitgave. (Hd n ' delsprijs f 39.^ f 15.— 8. Lambertini. Commentarius de JL>. J. Chr. matiisque ejus festis. 2 deeW (Uandelsprijs / 2 50) . . . . f i-'f 9. Vercruysse s. J- Nieuwe praktisch overwegingen voor alle dagen des jaarSi over het leven O. IJ. J. Chr. voornam®"" lijk ten gebiuike van religieuzen. 2 dlHtweede uitgave f ^ Voorhanden de Gl'aduale en VöSperale  uiigave Pustet alsmede deszelfs fondswerken. (915)",http://resolver.kb.nl/resolve?urn=MMKB04:000166635:mpeg21:a0023:ocr,4,MMKB04:000166635:mpeg21:p004,De Maasbode,818
782844,1876/08/05 00:00:00,804,MMCODA02:000187324:mpeg21:a0014,http://imageviewer.kb.nl/ImagingService/imagingService?id=MMCODA02:000187324:mpeg21:p003:image&x=143&y=3437&w=951&h=804,MMCODA02:000187324:mpeg21,1094,4241,143,3437,4,"Advertentie De Notarissen WESTENBERG te Barneveld en WALTER te Apeldoorn zullen op Dingsdagen 15 en 29 Augustus e.k. telkens des voormiddags ten 11 uur in het Logement *den Arend"" ten verzoeke van Mej. de Wed. C. HOPSTER te Barneveld  bij luzaat en toeslag VEILEN: De Bouwplaats „HOOG BERGHUIS genaaund met bijstaande GETIMMERTEN BOUW- en WEILAND HAKHOUT en HEIDEGROND te zamen groot 59—74—64. In 5 perc. kolommen en massa. (1079) I)",http://resolver.kb.nl/resolve?urn=MMCODA02:000187324:mpeg21:a0014:ocr,3,MMCODA02:000187324:mpeg21:p003,Apeldoornsche courant,951
2153715,1876/12/15 00:00:00,2143,ddd:010338852:mpeg21:a0012,http://imageviewer.kb.nl/ImagingService/imagingService?id=ddd:010338852:mpeg21:p003:image&x=2216&y=2439&w=1005&h=2143,ddd:010338852:mpeg21,3221,4582,2216,2439,4,"Op nieuw ontvangen en te bekomen bij Colicn 4 Drielsma: Esn mooi asscr&me&t Schoemakersmate riolen. CassceïvleescSi en WORST Diverse Slaiinractaren als 10/4 Hf f\llfll?f ftfil pIiBEIJIIf MIJ Idem ZWART CALICO LINTINEIsT ""in DIFFERENTE qnaliteiteu Wit gebloemd SKMJMSÖEfë VBIE3- & POOLSOUI KOTSEN en SOKKEN BORBUCESSLS en veel meer andere GOEDEREN I €*oedkoon mits Contant.",http://resolver.kb.nl/resolve?urn=ddd:010338852:mpeg21:a0012:ocr,3,ddd:010338852:mpeg21:p003,Suriname : koloniaal nieuws- en advertentieblad,1005
469944,1876/12/03 00:00:00,214,ddd:010062730:mpeg21:a0011,http://imageviewer.kb.nl/ImagingService/imagingService?id=ddd:010062730:mpeg21:p004:image&x=347&y=217&w=2196&h=214,ddd:010062730:mpeg21,2543,431,347,217,4,Ift 1115 5. WUHlljiiiliJiloJiH.,http://resolver.kb.nl/resolve?urn=ddd:010062730:mpeg21:a0011:ocr,4,ddd:010062730:mpeg21:p004,Het nieuws van den dag : kleine courant,2196
2471828,1876/09/26 00:00:00,3974,ddd:011178950:mpeg21:a0025,http://imageviewer.kb.nl/ImagingService/imagingService?id=ddd:011178950:mpeg21:p004:image&x=2701&y=2141&w=622&h=3974,ddd:011178950:mpeg21,3323,6115,2701,2141,4,"CALIFORNIA TIli: CMICAGO & KOItTH-WESTER KAII.WAY Emlirares undcrone management IhcOreafTrnnk KnilwayLincsofllieWE:?Taiid NORTUWEST and with lts nuinerous branches and coniiecllons Urn.* tbc sliortest and i:i:iokc. I route het wem 'Chicaj*o nnd all polnts in lllinois Wisconsin. Northcrn Mlchigan Minnesola lown.Keliraska Callilornia and the Western Terrilories. lts Omaua and Califokma Line Is the shoitest nnd l.est route for all po!nls in Northein lllinois lowa Pakota Ncliraska YVvoming Colorodo Utah Nevoda Califurnia Ore •jon China Japan nnd Australia. lts CiIICAGO Jladison and St. Pacl Lini: Is llie unly ruulc for Winont Rochcster Owalonna Jla'nkato St. Peter New Ulm and all points in Southern and Central llinnc6ota. lts Green 15ay and Mahquette Line Is tlic only line for Janesville Walertotvn. Fond Du Lnc Osbkish; Appleton Green Bar. E-cana lia Negounce. Marcp'.ctte. Hougiiton Hancock nnd the I.ake Superior Country lts FuEEroßi and Duuuque Line. Is the only route for Elgin Hockford Freeport and all points via Frcepoit. lts « Ciiicago & Milwackee Line. Is thcold Lake Shoie R' ute and is the onlyone passing Ihrough Evanston Lako Forcst lïigliland I'ark Waukegan Kacine Kenosha lo ililwuukee. Pullman Palp.ce Cars are run on all llirnugh traint of this load. This is the ONLY LlNEiunning llicse cars lietwccn Chieago and St. Paul Cliieaguaud Milwaiikee or Chieago and Winoua. At Om.il.aour Sleepers connect with IhcOvcrlaud Sleepers on the Uuion Pacilic ltaüroad for all poinU West of the Missouri Rlver. On tlio «rrivalof Iho traint from the East or Scuth the trains of tlie Chieago k Norlh Western Haüway LEAVE CHIOAGOas follotvs: For Council lilufl's. Oniaha and Califotnia.Two Tlirough Trains daily «ith Pullman Palaee Drawing Room :nd Slecping Cars thiough to Council Bluflt For St. Paul and Minncnpolis Two Thiough Trains daily with Pullman PallaceCarj attachcd on l>olh trains. For Green Har and I-nkc SuperiorTwo Trains daily willi Pullman Palace Cars atlaehed and lunninc tlirough to Marquttie. For Milwaukce Four through Train» daily rullrr.au Care on nij;lit Irainr Prior Cl uii Cuis 011 day trains. For Spn-tii and Winotia and points in Miunesola. Ono Through Tialu daily with Pullman Slei pers to Winoua. For Ilulmquc ria Freeport Two Throngl: Trains daily with Pullman Cars on n'zlil trains. For Duliuquc and LaCrosse via Clinton Two Thiough Trains daily with Pullman Cars uu night train lo Mc Gregor lowa. For Sioux City and Yunklon Two Trains daily. Pullman Cars lo Missouri Vnlley Juuttiun For Lake Geneva. Four Trains daily. For Rockfurd Sterling. Kenosha J icsvillc nnd other poinls you eau have from t oto ten trains daily New York Office No 415 Braadt ir; Boston Office No. 5 State Streel; Oma!« Office 'J.VI Farnham Streel; San Francit'w Ottiee 121 Monlgomery Streel; Chieago Ti .et Offices: di Clark Street iindcr Stierman House;cornerCanal and Madison Streelt; Kinzie Streel Depotcorner W. Kititie and Canal Streets; Wtlls Streel Depot corner Wella and Kinzic Streel». For rales or iufurination not uttaiuablc from our home ticket a(.ents applvto W. 11. Stennitt Martij Hcohitt Gen. Pa6flAj;'l Cliicngo Gen. Sup'l Chieago. Eastern.j pis ittwtiel- VAN VAN LANDEGEND & MELIS. No. ótt ACHTSTE STRAAT Altijd voorradig: ceu zeer grooten voorraad van allerlei Landbouwgere'edschappen KOOK- KAMER-en KANTOOR KAGCUELS. Timmermans- en Keukengereedschappen) Tafcl-licnoodigdhcdcn Hangen Sloten Spijkert (ilas enz. en/. Ramen Dei:ion Pompen IJzeren Pij 1:011 en allerlei IJZVAi- EN BLIKWARK N"" ALLES TEGEnGkAXD ItAfIDSI'HI.!Z!.\. CS'° Ouk een nieuw foorl Gcpalcntccidc van koperen randen voorziene Wcsch-ketels tegen 3.50. Duren langer dan eei.ig ander soort. Allcile rcparalien spoedig en naar Vol-oc' ing verrigt. KulLuJ Micb.'2: Juni; IS7.Ï.",http://resolver.kb.nl/resolve?urn=ddd:011178950:mpeg21:a0025:ocr,4,ddd:011178950:mpeg21:p004,De grondwet,622
3259154,1876/07/17 00:00:00,3410,MMKB08:000087258:mpeg21:a0034,http://imageviewer.kb.nl/ImagingService/imagingService?id=MMKB08:000087258:mpeg21:p004:image&x=96&y=2221&w=925&h=3410,MMKB08:000087258:mpeg21,1021,5631,96,2221,10,"Advertentie BUITEN-SOCIETEIT. van het Muziekcorps der Infant © ir ± © op Zondag 16 Julij t6n 7 ure. Ar nhem  15 Julij 1876. DE DIRECTIE Café A. PRIKTOEW Hommelstraat H 556. Met zeer aangenamen Verlichten TUIN"". Heden ZATURDAG ZONDAG en MAANDAG PIANOMUZIEK. DEVENTER KOEK fabrikaat van J b. BUSSINK in de van oudsher gekroonde Allemansgading is steeds verkrijgbaar bij H. C. BLOKHUIS te Velp. W. L. SLOTEMAKER Commissionair in (Effecten Belast zich met het koopen en verkoopen van EFFECTEN en van COUPONS  en met hetgeen verder tot den Effectenhandel behoort. Kantoor Bhriehonine«n#traat G. 9*3. GIFFEY'S KINDERMEEL (Farine Lactée) | volkomen vervanging van de MoederI m e 1 k door de voornaamste H. H. GoneesI kundigen aanbevolen als het erkend voortret! felijkst en goedkoopst voedingsmiddel voor j Zuigelingen en Kinderen is 4 80 Cts. de bus verkrijgbaar bij C. FRIKKERS Jr. en R. HAGENBEEK te Arnhem. Hieuw Aiattemloniiater euTanipoeSer. Het ANATHERIN-MOND WATER en TANDPOEDER van Apotheker S. JACOBS Azn . door de geheele wereld met het beste succes aangewend bij KIESPIJN CARIES SCHEURBUIK en bloedend TANDVLEESCH en om deszelfs verfrisschenden en aangenamen arouuatieken smaak een zeer gezocht Toilet-artikel is voor Gelderland k 60 Cents verkrijgbaar te Arnhem bij C. DE VISSER Roggestaat en LAMBOOIJ-ÖRIJSEELS & VISSER Grooten Oord. » Apeldoorn bij C. BRUINS Coiffeur. y Doesburg bij H. BIER. » Oosterbeek bij N. GERRITSEN. y> Keppel bij W. GEERLINGS. » Nijmegen bij STRUNCK & WESSELS. 3> Velp bij Apotheker VAN KROON. j> Zutphen bij J. H. A. WANSLEVEN. ■» Zalt-Bommel bij AREND WOLFF. Op a "" e andere plaatsen worden Depóts gevraagd. KINA LAROCHE bij Apotheker S. JACOBS A zn . ƒ1.20 de flacon.",http://resolver.kb.nl/resolve?urn=MMKB08:000087258:mpeg21:a0034:ocr,4,MMKB08:000087258:mpeg21:p004,Arnhemsche courant,925
3189900,1876/08/25 00:00:00,3255,ddd:010972969:mpeg21:a0054,http://imageviewer.kb.nl/ImagingService/imagingService?id=ddd:010972969:mpeg21:p006:image&x=1022&y=102&w=980&h=3255,ddd:010972969:mpeg21,2002,3357,1022,102,6,"RIJKS HOOGERE BURGERSCHOOL _e TsllMirg. De TOELATINGSEXAMENS tot dan Cursus 1876/77 zuilen np Maandag en Dinsdag 4 en 5 September e. k. afgenomen werden. Ouders en Voogden gelieven vóór dien termijn schriftelijk of moadeling aangifte te doen bij den Heer L. B. FIKKERT Leeraar aan gemelde inrichting. De Directeur (30415) Dr. HÏ_LSMANN. TILBUBG Aug. 1370. UUKSVHSAKTS A. Til. U. DRBffl hoek Amstel en Nisuwe Kerkstraat N°. 81  van 9—lo nar Voorin en 1-2 nur Nam. to EONSULTEEREN over kleine en groote Huisdieiec. (3-844) ' JÖISE SPABRIBOBSGIEI ca HEIDEVELD TE KOOP gepresenteerd 410 Hectaren te Driebergen. Adres franco d.n Heer M. SLEGTEN aldaar. (30272) bjj fatsoenlijke Lieden te Amsterdam tegen 1 October een VRIJE H.AMER met MOST voor een Jongmensch van circa 21 jaar. Adres franco brieven met ongas. van conditi?n onder lett. Q- bij de Boekhandelaars BROESE & COMP. te Breda. (30995) em___DE~w__ï__c_______N zijn voortdurend VOORHANDEN bij de Wed. L. F. A MULLER Singel bij de Hoistoe 402. ' (21181) in Talen Boekhouden Handels ijl en het aanleeren van vlag en net Schrift. Cui'BUS: twee lessen ƒ 3 vier leasen ƒ 5 zes lessen ƒ7.50 p. m. PrivaaÖessen ƒ0.75 a ƒ 1 per les. Brieven franco ouder Lett. K bij den Boekhandelaar O. L. BRINKMAN Hartenstraat. (30889) MANÜFA_.ÜJ_E__ In dat vak wordt ©EVRAAG» een J.UEEROUW van den P. G. eenigszins met den verkoop bekend doch ervaren in het knippen en maken van Costumes om na overleggen van goede bescheiden terstond iv betrekking te treden. Adres franco onder lett. H. G„ bij den Boekhandelaar A. F NIET VELT Korte Nieuwendijk N. 27. (31110) ___T___ÜÏD_iiËß__~ Een JONGMENSCH 25 jaren oud grondig bekend met bovengenoemd vak zag zich GAARNE met November VERPLAATS!' om als Bediende werkzaam La zijn. Brieï_ .„.'anco' oniler leU- M. V- bij do Boekhandelaars VAN EüMOKD & HEUVELI..K te Arnhem. (31114) TEN SPOEDIGSTE GEVRAAGD: Een bekwame WïELENMARER bekend met Stelwcrk. Brieven franco adres B. H ARTS HALT Rntuigmaker te Amsterdam. (31104) Terstond te aanvaarden: EEN ROIAAL BOVENHUIS bevattende VOOR- en ACHTERKAMER ruime Alkoof met Keuken alsmede Waterleiding en voorzien van alle gemakken Golderschekade N°. 11. T. bezichtigen dea Maandags en Woensdags van 10—2 uur of te bevragen bij E. M KLEEBKOOPEB Rapenburg ü 22. (31137) ER WORDT IN EEN DRUK GEZIN GEVRAAGD: een KINDEBJUSTROUW van den P. G. geneigd ia de Huishouding behulpzaam te zgn. Goed to kunnen Naaien Strijken en met de Wasch omgaau zijn vereischten. Adres franco lett. 8. bij den Boekh. L J. E. v. d. BOR Nieuwmarkt 38. (31096) IN EEN PROTESTANTSCH GEZInT"" wordt terstond gevraagd: een fatsoenlijk DIENSTMEISJE die alle werkzaamheden kan verrichten tegen goede belooning. Brioven franco lett. K. bij den Boekhandelaar G. ""VAN PEURSEM St. Jansstraat J 30 te Amsterdam. (31101)",http://resolver.kb.nl/resolve?urn=ddd:010972969:mpeg21:a0054:ocr,6,ddd:010972969:mpeg21:p006,Algemeen Handelsblad,980
502520,1876/07/31 00:00:00,680,ddd:010984779:mpeg21:a0053,http://imageviewer.kb.nl/ImagingService/imagingService?id=ddd:010984779:mpeg21:p004:image&x=819&y=74&w=739&h=680,ddd:010984779:mpeg21,1558,754,819,74,6,"BUITENGOED. -\ *~A""*\ a nde nabijheid van fflHg gV\LK!:\ltilt<.. | =4M^BW dicht bij het station al- ' leraangenaamst en aan den grooten weg gelegen is te Huur en kan onmiddellijk aanvaard worden een bijzonder prachtig i nieuw en naar den laatsten smaak inge! richt BUITEN VERBLIJF met !Serre. Tuinen. Park. enz. Een gezin zonder kleine kinderen heeft ide voorkeur. Adres: MARCKX O. L. Vrouweplein [2704 te Maastricht. (7439)",http://resolver.kb.nl/resolve?urn=ddd:010984779:mpeg21:a0053:ocr,4,ddd:010984779:mpeg21:p004,De Tĳd : godsdienstig-staatkundig dagblad,739
123600,1876/06/27 00:00:00,120,ddd:110534839:mpeg21:a0008,http://imageviewer.kb.nl/ImagingService/imagingService?id=ddd:110534839:mpeg21:p001:image&x=97&y=4020&w=1030&h=120,ddd:110534839:mpeg21,1127,4140,97,4020,4,"■ ""***§ 'W T_- — _ ■ .- - ''. - - 6 ï L l.",http://resolver.kb.nl/resolve?urn=ddd:110534839:mpeg21:a0008:ocr,1,ddd:110534839:mpeg21:p001,Bataviaasch handelsblad,1030
46569,1876/08/27 00:00:00,57,ddd:010186912:mpeg21:a0031,http://imageviewer.kb.nl/ImagingService/imagingService?id=ddd:010186912:mpeg21:p004:image&x=2519&y=4545&w=817&h=57,ddd:010186912:mpeg21,3336,4602,2519,4545,4,Snelpersdruk ran N. Luïjtkn  Tilburg.,http://resolver.kb.nl/resolve?urn=ddd:010186912:mpeg21:a0031:ocr,4,ddd:010186912:mpeg21:p004,Tilburgsche courant,817
1585488,1876/03/29 00:00:00,1072,ddd:010264071:mpeg21:a0010,http://imageviewer.kb.nl/ImagingService/imagingService?id=ddd:010264071:mpeg21:p004:image&x=2283&y=80&w=1479&h=1072,ddd:010264071:mpeg21,3762,1152,2283,80,6,"HISTORISCHE TENTOONSTELLING VAN AMSTERDAM!. ©E COMMISSIE heeft de eer te berichten dat zg na Zaterdag * April e. k. geene Voorwerpen voor hare Tentoonstelling meer in ontvangst &9' nemen. De Secretarissen der Commissie voornoemd: Amsterdam P. A..BRUGMANS. 27 Maart 1876. (4335) J. C. DE MAREZ OIJENS. CtT^T^OOTiSOTI-AT-* „LIEFDADIGHEID MAAR WERIÖGEi"" AfISTEI-OASI. Het BESTUUR heeft de eer te berichten dat de Vijfde Jaarlijk' sehe Algemeene Vergadering zal gehouden worden op Donder' dag 3© Maart 1876 des avonds ten acht ure precies in »Odéon"" eU dat Z. K. H. Prins Hendrik der Nederlanden het Genootschap de hooge eer zal bewijzen die Vergadering bij te wonen en te presideeren. (4337) HET BESTUUR.",http://resolver.kb.nl/resolve?urn=ddd:010264071:mpeg21:a0010:ocr,4,ddd:010264071:mpeg21:p004,De Tĳd : godsdienstig-staatkundig dagblad,1479
2339959,1876/05/08 00:00:00,2347,ddd:010486774:mpeg21:a0001,http://imageviewer.kb.nl/ImagingService/imagingService?id=ddd:010486774:mpeg21:p001:image&x=71&y=1241&w=997&h=2347,ddd:010486774:mpeg21,1068,3588,71,1241,4,B E RICH T. Wordt beleelH verzucht om franco .toezending van de sïibonnemeiitssÊgelden voor het eerste lialf jasn* 18*76. H. M. VAN DORP k Co. POSTKANTOOR. I^lwiti-igr derJEngei^^email op Maar* dag 8 Mei en Maandag 22 Mei 1876. a»**-^?* Met dezen niailstoomer sullen brieven-pakketteu **4Si^ verstonden worden voor EUROPA. -aMEIUIKA' BBITSCHINDTE AFRIKA AUSTRALIË CHINA. JAPAN ■-tnz. enü.: benevens voor BANKA  PALEMBANG  RIOUW DELI EDI en ATJEH. der ÏTrai-gsol-e mail op Woensdag 17 Mei en Woensdag 31 Mei 1876. Sluiting van Postpakketten: Voor Anjer Tjilatjap  Patjitan  Makassab  de Molükken en Timob op Zondag 14 Mei 1876. Voor Padang Telok-Bmong Benkoelkn en Atjeh  op Maandag 15 en Maandag 29 Mei 1876. Voor Banmjebmasjn op Vrijdag 19 Mei 1876 Uren van sluiting: in de Stad ten *•_ ure te Weltevreden 's namiddags 5 uur. Sluiting der Mailpakketten te Weltevreden 's avonds 8 uur. VJESrVÏ>üTXE-l^T. Dinsdag 9 Mei. Ten huize tan den h:er van Hogezand door John Hopf Ten huize van den h.er Suijkerbuijk door W. Ij. ian Slooten en Voor de toko van G. G. Batten k Co. Woentdag 10 Hei. Pandgoederen Tan Rijswijk in 't Vendu'.okaal door Oeij Kangsoeij Execntie bij van Hengel (Pintoe Bessie) door Caasa en Hontvendutie door van Vleuten & Cox. Donderdag 11 Mei. Van een inboedel door W. L. van Slooten Voor het Kommiasiehni» van John liopff en Voor de toko van John Pryce - Co. Vrijdag 12 Mei. -___■- Ten huize Tan den heer de Graaff door Tan Vleuten & Cox en Voor de toko Tan Tan den Abeelen & Co. Zaterdag IS Mei. In het Venrinlokaal. 4¥¥¥Mrl¥7iTMr,http://resolver.kb.nl/resolve?urn=ddd:010486774:mpeg21:a0001:ocr,1,ddd:010486774:mpeg21:p001,"Java-bode : nieuws, handels- en advertentieblad voor Nederlandsch-Indie",997
5158960,1876/08/27 00:00:00,5465,ddd:010972971:mpeg21:a0073,http://imageviewer.kb.nl/ImagingService/imagingService?id=ddd:010972971:mpeg21:p008:image&x=4003&y=1444&w=944&h=5465,ddd:010972971:mpeg21,4947,6909,4003,1444,8,"EPILEPSIE (VALLENDE ZIEKTE) kan genezen warden deor «."" BCS__aiS_E_LB.HK.Ei- EiAAB té Tragen van den spe""I' len Arts Db KILLISCH te Dresdan Neustadt. Reeds && dan 8080 Lijders zijn met gunstig gevolg door hem ""* haudcld. (247«fl NIEUWE I_F* Ki-tger's 'm ENGEL_.II VLEKKENWATER Terwijdert ONMIDDELLIJK SPOORLOOS ALLE schrift t papier onverschillig of het vóér korten of vóór lansen *? is geschreven; op gelijke wijae kan het dienen om IMftI**! WMiS- en andere VAE____A_:M uit Linnengoed en and*1' stoften te dosn verdwijnen. Alleen onvervalscht te bekoH13 hij den Uit .inder F. KRÜGER . in Flacons a 1 Mark ** Berlijn S. W. Borgoiannstrasse N. 93. §JSSP Winkeliers genieten RABAT. (27799) WANDGEDIERTE. I Ik ondergeteekende verklaar dat de Heeren DAVIDSON & ?J voor mij in het jaar 1872 DRIE _%'tflk__C>E_ti __EBB*£ eEZUMVEKB. waarvan een door het menigvuldige W*% gedierte oe bewoon baar was en zoo kunstmatig gezuiverd <*L er hoegenaamd niets meer van dien aard is ontdekt wa»fp ik bovengenoemde firma een ieder aanbeveel. Is geteekend: J. VAN £*£_& n©HS.» van der Werfstraat Rotterdam. Adres: B. BAVIBSOM & C. Koninklijk gooctroieard (1623* Kalverstraat over den fleiligenweg N°. 189 Arasterd...' GEEN WANDGEDIERTE MEER . Gebr. GOEDHART en C°. j feelasten ziefe me* het 'MJlwmm vm HEUB*' LES HUJIM EMXS- ca BTAB-___ll. van ALLE S€MA©I_IM.S_ INSECÏEF. Biel «jw* garantie ©agelijls te spre__c_ ca doer bet gelic*'1 «tijk te ontbied.!.. Betaling na verkiezing cc* jaar na de werkzaamheden. PaMsstraat bij dea ©a_.3 Ss. 13. ©EMEEIL BfBEüWE VHÏ__>_2.<K tot FINALE XÏ& ROSIING van «onder Reuk of iets te beschadigen raet 6 jaar garantie. *J ontbieden door bat geheele Desverkitzende te betal*1 een jaar na de zuivering. (23347) _f • GOBDHABT & €7«* .fll-GEL BIJ ©E TOffiEtëSTEEG N"". 171 Amstard-* Vroeger DAMSTRAAT. JMjk Maar SOERABAJA WëÊÊÊËk (direct) LIGT ALHIER IN HET OOSTERDOX TE LADEN: expeditie einde Angustus het snelz.i.end CL EP PER BA KAL SC SIP 5/3 L 1.1 Verlies. A. 1. NEB. VEïXEENBGSMG. Kapitein P. SORGDRAGER. UITMUNTEND INGERICHT VOOR PASSAGIERS- Adres HüIJ&AN & SCHUURMAN Amsterdam. (2Ö2OS) A A BBDSTffIIÜÏ AZSsh Pffi\ Geregelde Postetoomvaai""' -Rotterdam ei* Amerika PHILADELPHIA EN NEW-YORK DIRECT met de expresselijk voor Passagiers ingerichte PoststoorDschepall' alle nieuw mot dubbelen bodem voor solidileit sterkte & corafonabiiit.it onovartivffelijk. De eon i g e directe Lijn van het vaste land naar Pbil*"" delphia! In verbinding met den wereldbcroeinden Pennsijlrani""' spoorweg de directate kortste route naar het Westen Noord' en Zuidwesten van de Vereenigde Staten. De vertrekdagen zija bepaald als volgt: SI Ang. SS. VADERLAND. 124 Sent. SS. NEDER LAND.  12 Sept. SS.SWITZERLAND.\ 6 Oct. SS. KENILWORTÏÏ- Passaeeprii_e*: le Kl. ƒ220 2o Kl. ƒ145 3a Kl. ƒ 55. Retonrbfijetten voor da _VEH_E__B-TE!SIT®©MS!EI> SL_K_ tegen veel verminderde prijzen geldig voor één jaar- B. VON DEit BEÜKE Generaal-Agent voor Euro'; a *3 Antwerpen. __ ©BKECTE 15 ©___L ©©FEI-SE PLAATgBSLJ.E'ï' '_.E_- worden afgegeven van en naar alle plaatsen in W Vereenigde Staten door U. _. E. VAN HEERBE Generaal-Ag-_t voor N_' DFKLAN- Wcnhaven N*. 1 ROTTERDAM A. w_...©Eis__ _.L____ Dam N°. 2 AMSTERDAM e» overige Dg.-ten. (24748) ■____ _ -"" GEREGELDE DIENST TUSSCHEN ' (IMIIJSCT) met de Snelvarende uitstekend voor Passagier» en Goedere* ingerichte Postsioomschepen der NEBERLA.NDSCH-MIERIKAANSCMB STOOMViiARTMAATSCHAPPIJ. Vertrekdag vaa ROTTERDAM i R©TTE_-_BAB__ Kapt. VIS Zaterdag 2 September. E 3. CALAN©. Kapt. DEDDES Zateidag 16 September. W. A. SCHOLTESf Kapt. JANZEN Zaterdag 30 Sept- MAAS.  Kapt. CHEVALIER Zaterdfg 14 October. Passag.prijs lsto Kajuit ƒ 200. 2de Kajuit ƒ 150 e» ƒ 100 Tusschendek- f 55. Reductie voor Retonrbiljetten. BILJETTEN naar New-York en allo plaatsen der Vereeniga* Stalen worden afgegeven door  VAN E_ _V___l___t_-_ & RUT» Rotterdam' Adres voor Goederen: WAfBBERSEE & _-•» Rotterdam. Goederen naar verschillende plaatien der Vereenigda State» worden aaagcnoinen in doorvracht. (170)^ """"(ÏÏ.DKÜK- 13[J u. a. SPIN & ZOON.",http://resolver.kb.nl/resolve?urn=ddd:010972971:mpeg21:a0073:ocr,8,ddd:010972971:mpeg21:p008,Algemeen Handelsblad,944
4443264,1876/12/04 00:00:00,4256,MMHCO01:000068987:mpeg21:a0019,http://imageviewer.kb.nl/ImagingService/imagingService?id=MMHCO01:000068987:mpeg21:p004:image&x=3424&y=703&w=1044&h=4256,MMHCO01:000068987:mpeg21,4468,4959,3424,703,4,"Advertentie Manufacturen. De Deurwaarders VOETELINK en VAN OORSCHOT zullen heden Maandag namiddag 2 uur in het Odeon te Zwolle (ingang Praubstraat) verkoopen: Eene aanzienlijke partij WINTER-MANUFACTUREN nader bij strooibilletten vermeld en te bezien heden morgen vóór den verkoop van 10—1 uur wanneer stalen zijn te bekomen. De Deurwaarders MIJNDERS en VAN UTTEREN zullen publiek verkoopen in het Nieuw Verkooplocaal in de Goudsteeg te Zwolle: 1°. Japansche en Ohineesclie Goederen Op Maandag den 4 December a.s. des 's avonds om zes uur: Eene fraaije sorteering •lupnnMflip Cüiiiie«*!jche <É »oe€leren bestaande in: prachtige vazen met voetstukken fijn geteekende koppen en schotels; voorts een grooten voorraad fijn lakwerk als: zilver- en byonteriekastjes in verschillende grootte keurig bewerkte presenteer- en theebladen sigaren- tabak- thee- eu lepelkistjes handschoendoozen sleutelmandjes en kelkbakjes; een ruime collectie kristal- en glaswerk bestaande in fijn geslepen compotes wijn- en likeurkaraffen wijn- likeur- en punchglazen kaasstolpen botervloten olie- azijn- zuur- en likeurstellen. Een keurige partij Fransch porcelein bestaande in rijk gedecoreerde vazen fijne kcffij- en theeserviesen heeren en dames koppen en schotels gebakmanden  fruitschalen en een aantal andere smaakvolle artikelen te veel om te melden. Te bezien op den verkoopdag van 10—4 uur. 2° MOBILIA. Op Dingsdag den 12 December a.s. des morgens om tien uur: Ouderscheidene mobilaire goederen en kagchels waarbij dagelijks goederen kunnen worden ingebracht. De Deurwaarders MIJNDERS en VAN UTTEREN zullen op Zaturdag 9 December 1876 's morgens om 10 uur ten huize van den logementhouder VAN URK te Dedemsvaart publiek verkoopen: 40 magere loopvarkens. UIT I)E HAND TE KOOP een huis met tuin gelegen aan het kanaal van Hattem naar Apeldoorn zeer geschikt voor alle affaires; des verkiezende met ruim 2 hectaren best bouwland. Te aanvaarden 22 Februari 1877. Brieven franco aan het Hulpkantoor te Heerde. TE HUUR twee verwulfde wafervrjje kelders de eene van 40 vierkante meters de andere van 25 vierkante meters beiden geschikt voor entrepot en gelegen in de Walstraat te Zwolle onder het huisperceel F No. 3702 laatstelijk bewoond geweest door de Dames DOIJER. Te bevragen bij Mr. G. J. STORM BUIJS1NG Sassenpoortenwal. 3 pet. Buitenl. Spanje. De ondergeteekende firma belast zich met de verzilvering der stellen COUPONS zijnde de coupons van 31 December 1874 tot 31 December 1876. Deventer. G. VERMEER Joh.zn. 0. I. HOLSÏÏEIIEK W alstraat Siwolle. Binnen- en buitenlandscli gedisteleerd voor gehalte wordt ingestaan. JENEVER 50 procent f 0.50 48 proc. f 0.68 46 proc. f 0.66 44 proc. f 064 42 proc. f 0.62 40 proc. f 0.60 per flesch. BRANDEWIJN dezelfde gehalte per flesch 5 ct.hooger. AALBESSEN-JENEVER 60 ct. per flesch. FRAMBOZEN-BRANDEWIJN 70 ct. per flesch. SAKSISCHE POMMERANZKN-SPIRITUS 10 ct. per fleschje. DEVENTER KOEK. Steeds voorhanden bij den Heer W. SCHURING (Buitenkant) MejulVrouwen GEZUSTERS SMIT (Diezerpoort) en H. WESTEROP Ez. (buiten de Kamperpoort) versche DEVENTER SUCADE- KRUID- en TAFELKOEK uit de van oudsher zoo zeer beroemde bakkerij van //KLOPMAN BAERSELMAN."" Zie vervolg der advertentiön in het bijvoegsel.",http://resolver.kb.nl/resolve?urn=MMHCO01:000068987:mpeg21:a0019:ocr,4,MMHCO01:000068987:mpeg21:p004,Provinciale Overijsselsche en Zwolsche courant,1044
1994395,1876/04/19 00:00:00,2515,ddd:011066153:mpeg21:a0049,http://imageviewer.kb.nl/ImagingService/imagingService?id=ddd:011066153:mpeg21:p004:image&x=3259&y=105&w=793&h=2515,ddd:011066153:mpeg21,4052,2620,3259,105,4,"Door A. VAN OOSTERZEE wordt uitgegeven: (320-1) De Legende van de Lohengrin DOOR 0"". 6 D. J. SCHOTEL. Prijs ƒ0.40. «■^^mmmmii^—————wmk—— ■« 11 H Heden ziet het licht de tweede veel vermeerderde druk van: Lijden en Heerlijkheid DOOR (3176) J. H. GUNNING Jr. 176 bladz. compres gedrukt . ft.—■ in linnen stcmpelband . . . . » 1.50 Amsterdam. B. VAN DER LAND. inplaats van f 18 voor f 4.80 Stichtelijke Overdenkingen in onze Huiskamers ter Gcloofs versterk ing en Opbomving tot een Godsdienstig leven met Bij dragen van fircnsreld Drycc Dasebroek Ten Ivatc. huyper Laiuillard Van Maasriijk Ten Oever Van der Pot Van Schaick Sepp soustral Gei ik van Wijk Zeegcrs enz cnz.cdui aüe voorzien van een fraaie staalplaat. (3164) Leiden. D. MOOTHOVES VM GOOR. Frans Hoffmann liet beleg van Maagdenburg1 met gekleurde platen in linnen voor f 0.75. Geld geen Geluk met gekleu-rde platen in linnen voor f 0.75. In bet hooge Koorden met gekleurde platen in linnen voor f 0.75. De stem des gewetens met gekleurde platen in linnen voor f 0.75. Kleine oorzaken en groote gevolgen met gekl. platen in linnen voor f 0.75. Lotgevallen van een Keniplacant in't groote leger met gekleurde platen in linnen voor f 0.75. Rechte en Kromme Wegen met gekl. platen in linnen voor f 0.75. Zoo Heer zoo Knecht twee Verhalen met gekleurde platen voor f 0.90. De Boekjes van Frans lïotïtnaaii blijven steeds gezocht omdat de inhoul zoo degelijk en tevens leerzaam is vooral voor prijsuitdeeling zijn ze bij uitnemendheid geschikt. Te bekomen bij D. BOLLE Noordblauß te Rotterdam en verder alom. (3199} Bf» CATALOGUS van goctTkoo; e Boeken waarin ook andere Kinderwerken op aanvraag gratis.",http://resolver.kb.nl/resolve?urn=ddd:011066153:mpeg21:a0049:ocr,4,ddd:011066153:mpeg21:p004,De standaard,793
1415500,1876/08/08 00:00:00,1900,ddd:010984786:mpeg21:a0020,http://imageviewer.kb.nl/ImagingService/imagingService?id=ddd:010984786:mpeg21:p004:image&x=3027&y=94&w=745&h=1900,ddd:010984786:mpeg21,3772,1994,3027,94,4,MODISTJL Op een dorp in Zuid-Holland wordt gevraagd eene bekwame MLodiste voor Hoeden van den R.K. Godsdienst om direct in dienst te treden. Brieven franco onder letter H aan den Boekhandelaar J. W. van Leeuwen te Leiden. (7634) 13 Rue Radziwill 13 PARIJS. Dit fiOTl<:ii geheel gerestaureerd en modern ingericht in het Centrum van de Stad gelegen tusschen de Bank en het Palays Royal eenig Hollandsen Hotel in Paris wordt om de zindelijkheid en goede behandeling bijzon» tier aanbevolen. Ter lezing de ft '. B. Courant en het Handelsblad. (7167) ' I™omat ' VOOR Jou ge Juffrouwen op den Huize Bporp te YOOBiCHOTEM. De Cursus begint weder 1 September. Kost- en Leergeld 400 gulden. En voor de Gymnastie èn voor het aanleeren van Engels ch eu Duitsch wordt niets extra betaald. Prospectussen en nadere inlichtingen te bekomen bij den Zeer-Eerw. Pastoor BONGAERTS te Voorschoten of bij de Directrice van het Pensionaat. (7636),http://resolver.kb.nl/resolve?urn=ddd:010984786:mpeg21:a0020:ocr,4,ddd:010984786:mpeg21:p004,De Tĳd : godsdienstig-staatkundig dagblad,745
4357776,1876/08/31 00:00:00,5127,MMGARO01:000167561:mpeg21:a0016,http://imageviewer.kb.nl/ImagingService/imagingService?id=MMGARO01:000167561:mpeg21:p004:image&x=915&y=127&w=815&h=5127,MMGARO01:000167561:mpeg21,1730,5254,915,127,4,Advertentie » Het Bestuur der Parochiale Kerk van den H. JOANNES BAPTIST te Rosendaal maakt bekend dat van de Geldleening ten behoeve van voornoemde kerk zijn uitgeloot en van af 1° Januari 1877 zullen worden afgelost de volgende Nummers; N° 30 44 66 76 7ï 78 81 88 83 93 119 183 194. STRACK & Cie. Steeds voorradig zwarte en gekleurde Glacé Handschoenen Garen Zijden Kinder- Dames- en Heerenhandschoenen . Witte en gekleurde Dames- en Kinderkousen. Ungebleekte witte en gekleurde Sokken. Linnen eti Katoenen Manchetten Boorden Fronts Halfhemden. Ruime soTteering Heeren- en Damesdasjes. Nieuwe Dames- en Kinder-Corsetten. VOOR HET SAÏSON. Citroen Frambozen Kerzen Vanille Aardbeziën en Oranje Limonade Limoensap en Gemberbier alles op heele en halve flesschen. Ontvangen Hardglas Gas- en Petioleumlampenglazen zoomede modellen van Bierglazen en andere voorwerpen. Handel in Sigaren en Tabak Wgnen Likeuren Gedistilleerd enz. alsook in Olie en Loog om zeep te bereiden. Wed. A. van der Ven & Zoon Markt 103 Rosendaal. H. BLOM-BULENS Molenstraat Rosendaal. HANDEL in Boter Kaas Kruidenierswaren Amerikaansch Spek Reuzel en Petroleum. Blosendaal. Heeft weder op nieuw ontvangen: 5000 kilo BANDIJZER a 8 cent per kilo met de 100 kilo a 7 cent KARBAND1JZER a 5 cent per kilo. Een paar DRAAISCHIJVEN. Eene partij SUIKERZAKKEN (inhoud 100 kilo); per 25 tal a 25 cent per stuk; per 100 stuks a 227» cent; per 1000 stuks a. 20 cent. J. PECHER Steenhouwer-Marbrier te ROSENDAAL. M A G A Z IJ N van 5 in differente modellen kleuren en grootens. Wordt in den kortst mogelijken tijd naar Profil en Teekening bewerkt alle verlangde Marmerwerken  Marmervloeren  Meubel bladen Grafzerken en alle soorten van HABDSTEENWERKEN Het echte EAU D'ANVERS wordt veel gebruikt door hen die aan hoofdpijn lijden die veel denkon studeeren of andere hoofdbrekende werkzaamheden verj richten daar de frischheid I en sterkte van dien geur het geheugen opwekt De zakdoek er mede bevochtigt en de slapen van het hoofd | er mede gewreven verdrijft de pijn verlevendigt den geest en brengt ver j frissching aan. /A % HetS isdeaan-i genaamstéj geur die totl heden bekend! V 's. Alom verkrijgbaarj :i|| De echte komende! rechtstreeks uit del stokerij van den uit—I vinder te Antwerpen! (België) draagt de woor-| den: Eau d'Anvers del >w/kroon de wapens van Anti-| y/werpen alsook den naam AUG. DE MARBAIX gegoten in het glas op den ach-! terkant van alle de flacons.,http://resolver.kb.nl/resolve?urn=MMGARO01:000167561:mpeg21:a0016:ocr,4,MMGARO01:000167561:mpeg21:p004,De grondwet,815
4807736,1876/05/31 00:00:00,4876,ddd:010972884:mpeg21:a0069,http://imageviewer.kb.nl/ImagingService/imagingService?id=ddd:010972884:mpeg21:p007:image&x=2987&y=146&w=986&h=4876,ddd:010972884:mpeg21,3973,5022,2987,146,8,"NATHANS i G°. JBiiisaeai-Amstel JT _92. Decorateurs van Tuinen Bruilofts- en Tentoonstellingszalen. Verhuurders van vlaggen wimpels en stokken. Leveranciers van Kunstbloemen Chineesche Ballons Bengaalsch vuur Ulumincerglazen Fakkels en Vuurwerk enz. enz. (20393) Attesten van verschillende gelegenheden zijn ter inzage. IOFHEHÜISBEDIEHDËT GEVRAAG» tegen 1 Juni een vlugge BEDIENDE liefst Amsterdammer tusschen 16 en 18 jaar. Kennis van hot vak wordt niet bepaald vercischt. Adres in persoon Café L'Y van P. C. WEKTH Westordoksdijk. (20588) COMMANDITAIR VENNOOT ■WORST GEVRAAGD in eeno zaak van dagelijksche behoeften waaraan eene groote clientèle is verbonden. Bet in te brengen bedrag ƒ6OOO wordt verlangd voor zes jaren of' langoren tijd naar keuze tegen eene vaste rente met aandeel in de winst. Brieven franco onder lett. B. A. adres de Heeren de Wed. DOM & DE VRIES Damstraat te Amsterdam. (20594) EEN GEHUWD PERSOON 33 jaar oud van den P. G. gezond gestel reeds sedert ruim 6 jaar aan eene groote Maatschappij verbonden en bekend met administratie wenscht. om redenen van zijn wil onafhankelijk  van BETRERRBNG TE VERANKEREN kunnende desverkiezends de boste ; getuigenissen orerleggen. Inclineerenden geheven zich met ■ franco brieven to adresseeren onder lett. J. S.r bij den Boek- i handelaar C. F. STEMLER Haarlemmerstraat 2 'Amsterdam. ; (20514) | Êfl« UIL __ ta¥a* \ '*_*'• SKifie V 9 _T_ .3 Een beiaarde WEDUWE verlangt in een rustig Gezin een ! HAMER met Slaap- en Stook plaats of Twee kleine HA- ' HEERS preferent gebruik van Tuin; liefst in hot midden der  stad. Brieven franco onder bovenstaande Initiilen bij den ' Boekhandelaar S. VAN HELDEN Leidschestraat tusschen de ! Kerkstraat en Prinsengracht C C 75. (20447) j WORDT GITOAASD.- Tegen I°. Augustus e.k. in e>n klein Gezin met 2 Dienstboden eene fatsoenlijke KEUBiENSBEBD van den P. G.. goed kunnende koken en werken. Loon ƒBO buiten verval. Brieven worden franco ingewacht ondor Lett. S. aan den Kantoorboekhandel R. C. LEPPER & ZOON Rokin 14. (20441 TIMM._£H_S_AM_ Een Bouwkundige van don P. G. wenscht cenIiinkcTBÏKBISIERJKAAR OVER TE NESSEN waaraan eene goede clientèle verbonden is. Reflecteerenden adresseeren zich franco onder Lett K. aan dc Boekhandelaren SCHELTEMA & HOLKEMA Beursstraat 12 Amsterdam. (20407) mËAMDT Om direct of met 1 Juli a. s. in dienst te treden wordt in om Hotel in eender Provinciale Hoofdsteden een TWEEDE HEB.LNER gevraagd voorzien van goede getuigenissen. Adres franco Brieven Lett. W.R. Bureau Handelsblad. (20414) Uil. HOTa_ïl___'_^v Een Jongmensch oud 25 jaar P. G. niet onbekend met het Fransch en Duitsch zoekt eeno betrekking als KES.fi.NER onverschillig waar. Sedert 5 jaren in aio betrekking werkzaam zijnde is hij in staat goode getuigschriften over te leggen. Brieven franco ' onder lett. XX aau do Boekhandelaars SOHOLTENS & ZOON te Groningen. (20429) MAIVÜEACTÜREIV. ;Tegen primo Augustus of oerder wordt een flinke WIS« RELBEDBENRE gevraagd grondig bekend met het vak on goed kunnende etaleeren. Tevens wordt tegen ruim -.alaria j eene J!SJfi""fi""R»BJW verlangd flink voor den verkoop en onbesproken gedrag. Reflecteer ONDEIIWÏJJ& Een JO' B. VA. ven onder lett. R.S. Bn lolsbUd. (2033) BËs¥]____iÏAP. Een TUINDER in het Westknd biedt TE BiOOP AAN ] circa 4©© Flesschen Zuivere EESSENSAP. Te bevragen bijN.LAPÈRE Singel Appslmwkt alhier. (20436) __nifflÖ__MH~ oud 20 jaren ruim twee jaren in don handel werkzaam goed bekend met Administratie en den Comrmesiehandel zag zich gaarne met oonige AGENTUREN voor Binnenlandsche Huizen belast. De beste infórmatien aangaande zijn ijver en geschiktheid kunnen verstrekt wordc-n. Franco Brieven  onder Lett. X. Y„ worden ingewacht bij denßoekh. H. W. WILLEMS Leidschestraat Amsterdam. (20554) TE KOOP voor slechts ƒ 275 of TE HUURa .f§o per jaar eene brillante 7 Octaafs PBANBN© solide fabriek in fraai palisander zwaar vergulde ornamenten en?.; benevens eene 6 Octaafs PSANO van RAAIJ fraaie blocmhouten kast voor slechts ƒ75 huur ƒ 2.50 per maand. Te bezichtigen bij H. VERKOOIJ Piano-Stemmer Spinhuk.stecg N°. 11 Amsterdam. (20457) LEES HIER.' Door vertrek wordt terstond TER OVERNAME aangeboden te 1! otterdam EEN WINKEL MET NIEUWE GEMAAKTE HEEREN- EN ZEEMANSKLEEDEREN. Het BBBJBS er bij TE HUUR op den Schiedamschen Dijk Adres in persoon Boompj-.s N°. 85 aldaar. i20i24)",http://resolver.kb.nl/resolve?urn=ddd:010972884:mpeg21:a0069:ocr,7,ddd:010972884:mpeg21:p007,Algemeen Handelsblad,986
4664205,1876/01/05 00:00:00,5355,MMKB08:000089725:mpeg21:a0013,http://imageviewer.kb.nl/ImagingService/imagingService?id=MMKB08:000089725:mpeg21:p003:image&x=948&y=60&w=871&h=5355,MMKB08:000089725:mpeg21,1819,5415,948,60,4,Advertentie Minssterie va» Justitie. Gevangenissen en Regtsgebonwen AANBESTEDING. Op Woensdag 19 Januarij 1876 des namiddags ten één ure zal aan bet Ministerie van Justitie te 's Gravenhage bij enkele inschrijving worden aanbesteed: Het uitvoeren van VERNIEUWINGEN en HERSTELLINGEN aan-en het ONDERHOUDEN gedurende 1876 1877 en 1878  van: de regtsgebouwen te Arnhem. Zutphen  Leiden Dordrecht en Amersfoort  de gevangenissen te Arnhem Zutphen Tiel 's Gravenhage Rotterdam Leiden Dordrecht Gorinchem Brielle Amersfoort en Montfoort. De bejtekken liggen ter lezing: te 's Gravenhage in het Lokaal van het Ministerie van Justitie ; te Arnhem  Zutphen Leiden Dordrecht en Amersfoort in het Regtsgebouw; te Tiel Rotterdam  Gorinchem  Brielle en Montfoort in de gevangenis. Zij zijn voorts op franco aanvrage te bekomen aan het Ministerie van Justitie; bovendien voor Arnhem bij den Opzigter W. A. NICOLA; voor Zutphen bij den Opzigter D. J. ITZ; voor Tiel bij den Opzigter G. A. SCHOLTEN; voor Rotterdam Dordrecht Gorinchem en Brielle bij den Hoofdopzigter G. J. VAN DER GOES te Rotterdam ; voor Leiden bij den Opzigter A. HORREE ; voor Amersfoort en Montfoort bij den Opzigter W. H. SCHOONHEIM  te Utrecht. Inlichtingen worden gegeven door den Ingenieur-Architect voor do gevangenissen en regtsgebouwen J. F. METZELAAR te 's Gravenhage en door de Opzigters bovengenoemd. Aanwijzing zal worden gedaan: te Arnhem  Zutphen Tiel 's Gravenhage Leiden Dordrecht en Amersfoort Dingsdag 11 Januarij des voormiddags ten 11 ure voor Arnhem Leiden Dordrecht en Amersfoort te beginnen aan hot regtsgebouw ; te Rotterdam : Maandag 10 Januarij des voormiddags ten 11 ure te beginnen aan het huis van arrest; te Gorinchem en Montfoort  Woensdag 12 Januarij des middags ten 12 ure; en te Brielle Vrijdag 14 Januarij des middags ten 12 ure. 's Gravenhage den 30 December 1875. Voor den Minister De Secretaris-Generaal CL ANT. Ieder die iets te vorderen heeft van- of verschuldigd is aan den Boedel van wijlen Mejufvrouw M. H. J. VAN GALEN  gewoond hebbende en overleden den 31en December 1.1. te Arnhem  gelieve daarvan opgave of beta ling te doen vóór den 12en dezer maand ten kantore van den ondergeteekende in de Weerdjesstraat A. 215. Arnhem De Executeur-Testamentair 4 Jan. 1876. W. ROMBOUTS. EïpiiilË De COMMISSIE voor het Fonds voorOuden van Dagen op het eiland Urk maakt bij deze bekend dat zij zich aan de huizen der Ingezetenen zal vervoegen met verzoek om Inteakening op eene verzameling Kunstplaten en ChromoLithograüen welke zijn afgestaan als Cadeau en waarvan de opbrengst strekken zal ten behoeve van Ouden van Dagen op het eiland Urk. De Commissie voornoemd K. KOFFEMAN Secretaris. Eene Dame Weduwe uit den beschaafden stand R.-C. die zelve Kinderen heeft zag zich gaarne belast iet de zeri voor een a twee Meisjes. Er is gelegenheid tot Fransch en Duitsch spreken en man kan vxn de Piano gebruik maken: Ook zou zij genegen zijn eene Dame ter inwoning bij zich te nemen Men adressere zich met franco brieven onder No. 6 Bureau Arnh. Ct. Eïüe ervarene Gouvernante P. G. Hoofdonderwijzeres die behalve de vakken van het Lager Onderwijs ook de Moderne Talen onderwijst en tevens acte heeft voor M. O. zoekt tegen Juni e. k. eene gewenschte Plaatsing in- of externe. Brieven franco onder No. 5 Bureau dezer Courant. Eine geprüfte Deutsche Dime bietet jungen Madchen die die deutsche Sprache zu erlernen wünschen Gelegenheit zu Literatur- & Conversationsstunden. Adr. unter No. 3 in der Expedition dieser Zeitung. TWEEÖEMEID Te Velp wordt tegen Februarij gevraagd eene DIENSTBODE  die flink kan werken naaijen mazen en met de wasch omgaan. Adres franco Lett. W bij den Heer VAN HENGEL Boekhandelaai -  te Velp. Mevrouw MAR IS Nieuweplein 401 VERLANGT tegen Mei eene kimme keukenmeid | genegen Huiswerk te verrichten  van de P. G. i en voorzien van goede getuigschriften. Inclinerenden gelieven zich aan te melden des morgens vóór 1 ure. Mevrouw METELERKAMP Huize Engelenburg te Brummen VRAAGT met 1 Mei a. s. eene linnenmeid ' van de P. G. bekwaam voor haar vak en van j goede getuigen voorzien.,http://resolver.kb.nl/resolve?urn=MMKB08:000089725:mpeg21:a0013:ocr,3,MMKB08:000089725:mpeg21:p003,Arnhemsche courant,871
269880,1876/08/07 00:00:00,390,ddd:010062615:mpeg21:a0059,http://imageviewer.kb.nl/ImagingService/imagingService?id=ddd:010062615:mpeg21:p007:image&x=2809&y=1361&w=692&h=390,ddd:010062615:mpeg21,3501,1751,2809,1361,8,•: BEKNOPT OVERZIGT der Militaire Wetboeken voor bet krijgsvolk te water DOOR J. W. VISSEB Luit en ant ter nee. ¦ ¦ Prijs 50 Ct.,http://resolver.kb.nl/resolve?urn=ddd:010062615:mpeg21:a0059:ocr,7,ddd:010062615:mpeg21:p007,Het nieuws van den dag : kleine courant,692
1557344,1876/08/11 00:00:00,656,ddd:011066249:mpeg21:a0036,http://imageviewer.kb.nl/ImagingService/imagingService?id=ddd:011066249:mpeg21:p004:image&x=1676&y=3596&w=2374&h=656,ddd:011066249:mpeg21,4050,4252,1676,3596,4,"Stoom vaart-Maatschappij ZEELAND. sA ytr. Dagclijkschc Dienst voor Personen en Goederen Vlissingen en Londen via Queenboro. Vertrok uit VLISSIXOKUT t Vertrelt uit LO.VDK1V : j a j o ai\ _-• .'"" t Victoria Station ... 8 uur 4L& min. des Avonds 8 uur 40 min des Avonds Ludgatk Hill <*  «3  Zondagen uitgezonderd f Holborn Viaduct ... 8 » «o > Infovmatiën verstrekken: de Koninklijke Kederlnndsche Stoomboot-Maatschappij; de Heeren JOH. P. BEST & DE GROOF Agenten te Vlissingen en den Heer JOH. P. BEST Hoofdagent 122 Carinonstreet te Londen. (6674)",http://resolver.kb.nl/resolve?urn=ddd:011066249:mpeg21:a0036:ocr,4,ddd:011066249:mpeg21:p004,De standaard,2374
1058922,1876/01/12 00:00:00,1322,ddd:011066070:mpeg21:a0051,http://imageviewer.kb.nl/ImagingService/imagingService?id=ddd:011066070:mpeg21:p004:image&x=2467&y=2091&w=801&h=1322,ddd:011066070:mpeg21,3268,3413,2467,2091,4,"Sterven en Herleven. lets tot troost op den wegnaar het Grof door J. BRAVE 3e diuk. IVijs / 0.90 thftiin f O.üO Staf op den Levensweg wenken herinneringen en gebeden door J. BR \VE 5e druk tbana t 1.50 op best papier in linnen band ff 8..ï». Zatsgeu der L'efde doorBENN. JANSSONIUS in prachlb. iidje vergi*'d op cnee tltatiN f O 75. S. If. Serué HOSANNA 63 L?ede co; voor diic- en v*crsteranv3 MsrneiVoo' ten dieD'rle \.n Chr. Zrnj^eie'scu open. Piija t «.85 in heel linnen f C.50. Dr. Jolia Cum 111 in»' Stemmen v?n den Na< 'it. uit het En-\elsch 1 üetl. Prijs f 1.55 thans r 0.'75. D-\ Jolm Cummlng Het leven en de leer van on<:en Hei and r'. het Eng. 1 Dl. Piös f 5.50 ttin'tm f f .«l». Dr. Jolia Cusumioif ware te/sesgeluk vit bet Eng. F.ljs f '.50 than« f 0.00. Dr. Jolm ClJm»»""•><* CbrL.us recmt de Zondaars aan. Pri's f 1. tliaiis f O.SO. gSJT- De Werken va . Dr. JOHN Cü.M- V NG behoeven wel geenc aanbeve'ing de prijs is thans zoo ge* ing dat iedceen die werken k~n aarschaffen. Te bekomen bij f). COLLE Noordblaak te Kotterdam en verder alom brieven en geld franco. (316) I",http://resolver.kb.nl/resolve?urn=ddd:011066070:mpeg21:a0051:ocr,4,ddd:011066070:mpeg21:p004,De standaard,801
4190380,1876/03/16 00:00:00,3953,MMDA03:000096668:mpeg21:a0019,http://imageviewer.kb.nl/ImagingService/imagingService?id=MMDA03:000096668:mpeg21:p004:image&x=103&y=1690&w=1019&h=3953,MMDA03:000096668:mpeg21,1122,5643,103,1690,4,Advertentie Ontvangen voor het arm ongelukkig huisgezin te Sleen: Bij Ds. HEERSPINK te Sleen: van H. opbrengst van een boek f 2.80. Bij W. J. BOELKEN te Diphoorn: van Jhr. VAN DER WIJCK te Klenke f 10; van Baron VAN HAERSETTE van Zutphen f 3. Bij D. ROOS te Coevorden door tusschenkomst van T. OOTMARSUM: van T. A. S. een postw. f 1. Bij Ds. LESTURGEON te Zweeloo door tusschenkomst van D. VAN BUREN te Rotterdam f 2.50. Bij H. LIEFTINK te Groningen: f 2. Bij de Redactie der Groninger Covrant: f 6.89 5 . Bij S. A. KAN Jr. te Assen: van M. L. te Assen f 0.50; van M. C. E. te Assen f 1. Bij J. I. JOCOBS te Sleen: van A. v. L. D. te Roswinkel f 0.50. die Naar men verneemt zijn de Heeren BLOM en OLIVIERSE Boekhandelaren te Kuilenburg thans bezig om alle stukken bijeen te verzamelen zoo pro als contra op vergaderingen gesproken in tijdschriften en brochures geschreven zjjn over het -wetsontwerp eener verbruiksbelasting op tabak. Dit OEDEïtfliBOEK hetwelk niet alleen voor het oogenblik maar ook voor volgende tijden zoowel voor 'slands regeering als voor de handelaars fabriekanten en producenten van takak in ons Vaderland eene blijvende waarde kan bezitten verdient aanmoediging en ondersteuning door eene ruime inteekening op genoemd GEDENKBOEK van alle belanghebbenden en belangstellenden in het artikel van tabak. Amsterdam 14 Maart 1876. Een belangstellende in het artikel van tabak in verband met de algemeene volkswelvaart. Kiezerslijsten. BURGEMEESTER en WETHOUDERS van Sinilde brengen ter algemeene kennis dat de I.IJSTEV der kiezers van leden van de 3de Kamer der StatenUenernal  van de Provinciale Staten en van den Gemeenteraad zijn vastgesteld en aangeplakt in den gang van het gemeentehuis; alsmede dat zij gedurende 14 dagen van af den 15den dezer op de secretarie ter inzage zullen liggen teneinde belanghebbenden in staat te stellen hunne bezwaren daartegen bij den Gemeenteraad te kunnen indienen. EBBINGE Burgemeester. S. KOOGER Secretaris. CENTRALISATIE van hooger onderwijs dook II. W. MIDDENDORP Hoogleeraar in de Gmeeskunde te Groningen. a 50 ets. Te Groningen bij R. J. SCHIERBEEK. LETTERZETTERS die VLUG en ACCURAAT boekwerk kunnen zetten vinden vast werk en goed loon op de Boekdrukkerij van H. C. A. THIEME te Nijmegen. De reiskosten worden gedeeltelijk vergoed. Bakkersknecht. Een B1HKËKSKXECHT gevraagd die zijn werk grondig ver— staat om met Mei e.k. in dienst te treden bij de Wed. KRUIZE te Odoorn. K. H. ZIERTS vertrekt Vrijdag aanstaande van Kroningen en Maandag van Assen naar Nieuw-Amsterdam,http://resolver.kb.nl/resolve?urn=MMDA03:000096668:mpeg21:a0019:ocr,4,MMDA03:000096668:mpeg21:p004,Provinciale Drentsche en Asser courant,1019
2759000,1876/03/30 00:00:00,2759,ddd:010486742:mpeg21:a0008,http://imageviewer.kb.nl/ImagingService/imagingService?id=ddd:010486742:mpeg21:p001:image&x=3081&y=3097&w=1000&h=2759,ddd:010486742:mpeg21,4081,5856,3081,3097,4,"JtrkeudiiiaMiiig'. De RESIDENT van Batavia maakt !________-. ___^x aaa e 'ngeze*;euen bekend dal de Geneesheeren bij de groote hitte welke dagelijks heerscht het wenschelyk achtende volgende voor» zorgsoiaatregelen te nemen: a. Om tot drinkwater zooveel mogelijk gebruik te maken van artesisch putwater; b. Om waar van rivierwater gebruik wordt gemaakt dit vooraf hetzij door ijzerchlori.d en koolzure soda hetzij door overmangaanaure potasch te zuiveren; c. Om des nachts het ligchaam te bedekken ; d. Om dagelijks in verhouding tot het aantal huisgenooten eenige desinfecterende zelfstandigheid zooals car< bolzuur chloor uiaugaanloog ijzervitriool of iets dergelijks in de latrines te werpen; e. Om ten minste eenmaal dactgs in de kampoogs vuren te branden van voorhanden ruigte; If. Om geen komkommers laboe ayer papaja watermeloenen of andere verkoelende vruchten te eten. De Resident voorneetnd JELLINGHAUS. Batavia den 30 Maart 1876. 1277 ölagazijüvan Muziekinstrumenten. Ontvangen: Eene bezending prachtige Salon Piano's welke in volheid vau toon e.n CABINE!' VLEUGEL overtreffen. J. BELLE 1278 Pia.ofabriekant. Ontvangen: _H--_ropee-_<.l_e IJzeren één en twéé persoons Ledekanten gemakkelyk in en uit elkander te zetten. 1267 JOHN HOPFF Pang Petjenongc Zaturdag avond: Warme Saucijsenbroodjes. BITTEBKOEK.I ËS\ KLESKOPJES J JODENKOEK I Jb_ oter t>ies j es  TURONS ) per Gewicht. VANILLE BESCHUIT [ AMBTERDAMSCHE KORSTJES I WOIVBONa. 1 enz. enz. / jßrtg*» BESTELLINGEN voor -Provisien »n ■""•"" Dranken alsmede voor de J3an-ketbakkerif worden met de meeste accuratesse ten uitvoer gtürao.t. GILBERT ZEH 812 Gang Patjenenaam.",http://resolver.kb.nl/resolve?urn=ddd:010486742:mpeg21:a0008:ocr,1,ddd:010486742:mpeg21:p001,"Java-bode : nieuws, handels- en advertentieblad voor Nederlandsch-Indie",1000
2702394,1876/12/15 00:00:00,3006,ddd:010586867:mpeg21:a0081,http://imageviewer.kb.nl/ImagingService/imagingService?id=ddd:010586867:mpeg21:p014:image&x=78&y=2662&w=899&h=3006,ddd:010586867:mpeg21,977,5668,78,2662,14,"Weidland te Akkrum. De Notarissen BOKMA te Akkrum en WIERSMA te Roordahuizum zullen op Vrijdag den 22 December 1876 's avonds 7 uur bij J. J. Visser Az. te Akkrum finaal verkoopen : Een stuk uitmuntend Weidland gelegen tegenover het station Akkrum der Staatsspoorwegen onder Akkrum kadaster Akkrum B nummer 312 groot 2 hectaren 65 aren en 10 centiaren in gebruik bij Fetze J. Koopmans  tot 12 November 1879 voor ƒ4OB 's jaars en de Grondbelasting Floreen enz.; staande op ƒ9300. Burgerhuis te Akkrum. De Notaris BOKMA zal op tijd en plaats voormeld finaal verkoopen: Eene sterke en best onderhoudene Burgérhuizinge  no. 148 Erf en Bleek veld aan den Driegreppel te Akkrum in gebruik bij Tetman de Groot; staande op onderdeel 1 ƒ 400 2 ƒ625 3 ƒ360 zamen ƒ 1385; te aanvaarden 12 Mei 1877. i > . Burgerhuis te Akkrum. DEZELFDE NOTARIS zal alsdan finaal verkoopen: Eene hechte en best onderhoudene Burgérhuizinge met Stede en Bleekveld c. a. aan den Straatweg op een besten stand midden in den Dorpc Akkrum in gebruik bij S. S. Visser en F. Wierda; staande op onderdeel 1 f 1400 ? 2 ƒBB4 zamen ƒ2284; te aanvaarden 12 Mei 1877. HOOILAND - AKMARIJP JISKENWIEL. De Notaris BOKMA te Akkrum zal op Woensdag den 27 December 1876 's avonds 7 uur bij G. Schaafsma te Terkaple  finaal verkoopen : Een perceel Hooiland  de Jiskenwiel gegenaamd  gelegen onder Akmarijp groot 3 hectare 28 are 60 centiare; waarop in 2 perc. geboden is: 1 ƒ 1401  2 ƒ 851. Te aanvaarden dadelijk na de toewijzing. Woonhuis Tuin Bouwterrein ' JENGWIRD3N. .-—Be Notarissen BOKMA te Akkrum on BOSCHLOO te Heerenveen zullen op Saturdag den 30 December 1876 's avonds 7 uur bij Vernimmen in het Stations Koffijhuis te Heerenveen  provisioneel verkoopen: Een voor weinige jaren gebouwd hecht en goed onderhouden Woonhuis met grooten Tuin wan-in vele fijne Vruchtboomen en een stukje Laü4 „het lange Land"" genaamd geschikt voor louwterrein en bijzonder om daarop eene fabriek te stichten alles staande en gelegen aan de. Straatweg en het algemeene Vaarwater de Heerensloot onder Torband  iEngwirdon OVIS minuten afstand van H.e-renveen; te veiln in 6 perceelen; bij billetten en kaartjes in hv breede omschreven en aangeduid ; behouden een gedeelte van het Huis 8 dagen va de fin^ toewijzing te aanvaarden.",http://resolver.kb.nl/resolve?urn=ddd:010586867:mpeg21:a0081:ocr,14,ddd:010586867:mpeg21:p014,Leeuwarder courant,899
1632355,1876/03/03 00:00:00,2383,ddd:010062469:mpeg21:a0033,http://imageviewer.kb.nl/ImagingService/imagingService?id=ddd:010062469:mpeg21:p004:image&x=2832&y=2774&w=685&h=2383,ddd:010062469:mpeg21,3517,5157,2832,2774,4,"Franco per Post worden aan elk adres in Nederland verzonden tegen toezending van een postwissel (of postzegels) ad ƒ I.— 30 PAKJES der meest bekende exquise Bloemzaden voor den vollen grond met gedrukte aanwijzing van behandeling enz. Nette verpakking. Briefschrijven onnoodig. Ook te Amsterdam verkrijgbaar ad. / 1 hij den Boekhandelaar P. G. VAN LOM Kalverstraat No. 189. Bussurn. — Bloemisterij 't Gooiland van DE JONGH VAN ABKEL. Catalogus van Bloemen en Zaden worden op franco aanvrage franco toegezonden. Groot Babat yoor Zaadhandelaren en Bloemisten. (747) Vrijdag 3 Maart 1876 Groot Vocaal en Instrumentaal CONCERT J*1- voordeele van de Louisa-Stichting te sGravenhage door het Orkest van het ¦Paleis voor Volksvlijt onder directie van den Heer JOH. M. COENEN en met medewerking van de Dames FRANCISCA STOETZ ?*Zangeres van Z. M. den Koning (Zang); Y^WIARDINA KONING (Piano) en den Heer jUöEPH CRAMER (Viool) benevens de Kon. ¦-ettert. Vereeniging: Hooger zij ons doel waarop onder anderen zal worden opgevoerd: BïHIffIAIREfILLÏMSORDI cnJTlpi!sche Schets in één Bedrijf door ¦mSr..R FAASSEN en Declamatorium: ¦^.f'J- LIED VAN DE KLOK van VAM7t?R> vertaald door wijlen Mr. J. AW LENNEP Muziek van LINDPAINTNER. T„/1J?'e? der Plaatsen: Beneden enßovenp£f en stalles ƒ 2.- Amphitheater ƒ 1.50 r:""Te..en 2e Amphitheater ƒl.— ie Gaanderij /060 3e Amphitheater ƒ0.50 Gaanderij ƒ 0.30. Aanvang 7*/_ uur. PLM£?EN EEESTE BANG NIET VEBKRIJGBAAB. GÏZs.ICHïIÏELA4EILOÏS op het Groote Noord te Hoorn hebben een DEB6T van Bedden met loebehooren ontvangen uit het gerenommeerde Magazijn van C. F. HENDRIKS te Amsterdam. Tot Zuivering van Bedden nemen zij voor gemeld Kantoor ook Bestellingen aan. Daar de prijzen precies gelijk aan die van genoemd Magazijn zijn bevelen zij zich vertrouwend by Stadgenooten en Begunstigers aan. (1814)",http://resolver.kb.nl/resolve?urn=ddd:010062469:mpeg21:a0033:ocr,4,ddd:010062469:mpeg21:p004,Het nieuws van den dag : kleine courant,685
1991772,1876/11/30 00:00:00,2721,ddd:011182026:mpeg21:a0019,http://imageviewer.kb.nl/ImagingService/imagingService?id=ddd:011182026:mpeg21:p004:image&x=3157&y=159&w=732&h=2721,ddd:011182026:mpeg21,3889,2880,3157,159,4,"' LE MARB~'ADÏEBTBNfIEXr SPRING BROTHERS BAKDXLAASI XV TZSRWAREN. TZER KAOCSELB — SsUkers - 4 Dllkwerk. - Landbouwers - g•• — reedaanappan HvUraad tus. LkMar*. '••— -""' -—""' — lOWA. S. BURNSKiLL H.nd.laarl. Vleesch ea SE «fries» *j»ViTßch vlrrtch * «pek wordt prompt yeititiïTlrn naar evnigu plaau aau dra Sp;oorvrtf MAÏS STRAAT. Ut MAKS lOWA Ileeft **n vol asiortsment uitgezochte ■ KW BOERENGËIuiDSCHTPrENi ; Winkel"" Zuid >»n "" 8.~ %T Tr««- tellSM ~ X»wa — - J.~ A!BEaT TnOMPSO» '•••• hAtciuv ■•»•"""" HOROLOIULa iiuS .CLOUS UARUOüI KERD NIEUWS MODE WIKOL"" Mrs.Atkinson&Co. te LE MARS lOWA7"" Altijd voorhanden een groote voorrand.van dames goederen r.aar de laatate mode. Hoeden enz. óp korte notitie tremankt. Standplaats eenige deuren weit van de nieuwe bank. aan de 6de traat. Brengt haar een bezoek.",http://resolver.kb.nl/resolve?urn=ddd:011182026:mpeg21:a0019:ocr,4,ddd:011182026:mpeg21:p004,De Volksvriend,732
2940716,1876/04/24 00:00:00,2929,ddd:110534786:mpeg21:a0010,http://imageviewer.kb.nl/ImagingService/imagingService?id=ddd:110534786:mpeg21:p002:image&x=1152&y=71&w=1004&h=2929,ddd:110534786:mpeg21,2156,3000,1152,71,4,"I'oko Sic Boen Soeij Fa. .._._* Senin. Pas ontvavgen GEROOKTE BOKKING per stuk verkrijgbaar. STOIvVISCB. (13-4) ___ T E I_ 1 e _a Van der Putten £m Lefebre. ENoordwijk-Batavia. het repareeren en accordeeren vau VLEUGELS PIANO'S en < >I* .. El__--B__.'"" N.B. Voor alle reparatien wordt ge! PETZ & Co~ Photographisch Atelier. _X< m >i'<l wij le. (7303) -■■^________-__i_-_------__-__-_______________-_-________-___-it-_-it^""i""^» | PÜOTOGRAPHIE.] 11ET _V TEI lER is geopend van 's inorsens 7—ll uur. I OLLAND V.-o_.lv.ij__n_C7rr_ _ i_ < > < > >. Noordwijk over de Harmonie. Oud. Boekhandel. — Boekbinder.]. Encadreren. Opmaken van "".» Kaarten enz. '': Pi'fd'kant der Ned. Herv. ' .*___• Kerk -■•■v-ti_-d in een.- derselioon.<■ streken van Nederland op ruim een half uur aftands eener welvarende stad niet uitstekende inrit-tingen voor lager meer uitgebreid lager Onderwijs hoogere burgerschool voor JONGENS als MEISJES en GYMNASIUM verklaar! ach bereid met de opvoeding van kinderen uit Neerlands-Indie van deftigen huize zoo JONGENS als MEISJES zich te /.uilen belasten. Informatien zijn te bekomen bij den Heer DE PINÈDA Directeur der Landsdrukierij te Batavia. (1355)",http://resolver.kb.nl/resolve?urn=ddd:110534786:mpeg21:a0010:ocr,2,ddd:110534786:mpeg21:p002,Bataviaasch handelsblad,1004
6174600,1876/01/22 00:00:00,6150,ddd:110534708:mpeg21:a0016,http://imageviewer.kb.nl/ImagingService/imagingService?id=ddd:110534708:mpeg21:p004:image&x=1139&y=104&w=1004&h=6150,ddd:110534708:mpeg21,2143,6254,1139,104,6,"He Heer HERMAN BEZOET DE v|»BJ* BI E reeds sedert Augustus 1874 tijdelijk belast geweest met het te Soerabaya gevestigde Agentschap dezer Vereeliging is thans detinitief benoemd tot Agent /an de Internationale ('rediet- en Handels- Vereniging Rotterdam te Soerabaya. Batavia 20 Januarij 1876. Internationale ('rediet- en Handels(243) W. SUEKMONDT Wzn. Avis. Les soussignés avant accordé k B I_ PLATON ■P le monopole de la vente de leurs Eaux de Vie a Java out rhonnenr de prérenir le public qu'ils ne peuvent garautir la provenance que de celles vendues par le susdit lont le nom est apposé sur chaque bouteille. OTARD DUPUY & Cie. Cognac Juin 1875. 4818) Attentie! J3jé___Ö—*• De ondergeteekende beveelt zich aan voor het BOUWEN. REPAREREN en SCHILDEREN enz. van HUIZEN zoo wel bij AANNEMING als alleen als OPZICHTER. L. SEIJDELL. Adres Gang Thiébault. (96) TE KOOP: Een Verticale Stoommachine met handpomp enz. geheel compleet en in goeden staat diameter van den cylinder _l/a Eng. duim lengte van slag een Eng. voet; diameter van het vliegwiel 3 voet 9 duim Eng. Benevens drijfas lang 3ü voet en 2V2 Eng. duim dikte niet koppelbussen en kussenblokken compleet en 18 losse en vaste riemschijven. Te zamen of afzonderlijk te bekomen. Te bevragen bij TAYLOR & LAWSON (7688) Noordwijk. T E KOO p: Het Woonhuis op Rijswijk van (74) Mr. F. ALTING MEES. Attentie. Te Huur of te Koop. Een STAELIXi voor 22 PAARDEN. WAGENLOODS met WOONHUIS en KOETSIERSKAMERS gelegen Tanah Njonja. Senin. Alsmede: Drie Huizen te Koop: waarvan 2 gelegen kampong Kwitang langs de kalie en 1 in kampong Bezaar nabij Gang Keiiangah. Te bevragen bij HALBERG (88) Senin. Te koop a / .100. rEen span goed gedresseerde SUMBAWA l?__.A.:__r>l_X. Adres Letter B Bureau dezer. (134) TE KOOP: Een flink loopend en goed gedresseerd HAJNDWAG__NPAARD gezond zonder gebreken en 4 voet 2]/j duim hoog. Adres letter VV bureau dezer. (215) Uit de hand te koop: r>We ht I.T PAARDEN van wijlen den kontroleur bij het Binnnenlandscb Bestuur A. M. G. MEERTENS 1 SIDNEY. 1 SANDELWOOD 1 PREANGER. Te bevragen bij Mr. A. M. MEERTENS. (7700) Koningsplein. Te Koop of te Huur: - Een HUIS met 6 BIN/■"" Wk NEN- en 2 BUITEN KAjï|s MERS in de nabijheid van „gsSfeflllPte Iet Station Noordwijk. u?~:~r:7~riï?ëëS£ Te bevragen bij (5019) H. MARGADANT. Gevraagd tegen lo Februarij a.s: Voor een Heer eene GEMEUBILEERDE KAMER met of zonder genot van KOST in de nabijheid van den Tram of Spoorweg Stations Noordwijk of Sawah Bezaar. Het liefst op Sawah Bezaar. Hierop reflecterenden gelieven zich met franco brieven onder het motto KAMER bekend te stellen bij de uitgevers dezes. (239) TE lIUUH: Een Huisje op Tana Njonja. (225) Wed. VOERMANS. Te Huur met 1 Februarij te aanraarden: Een Iluis in Gang Scott. « dito op liet Koningsplein. « dito Bidara Tjina. Adres: (258) W. L. VAN SLOOTEN.",http://resolver.kb.nl/resolve?urn=ddd:110534708:mpeg21:a0016:ocr,4,ddd:110534708:mpeg21:p004,Bataviaasch handelsblad,1004
5086000,1876/07/27 00:00:00,5086,MMSADB01:000007317:mpeg21:a0019,http://imageviewer.kb.nl/ImagingService/imagingService?id=MMSADB01:000007317:mpeg21:p004:image&x=95&y=71&w=1000&h=5086,MMSADB01:000007317:mpeg21,1095,5157,95,71,4,"Advertentie HET BESTUUR DER P1US-L0TERIJ heeft de eer ter algemeene kenni«te brengen dat de TREKKINGSLIJSTEN/an af heden ter inzage liggen op de KorenWurs bij de Leden van het Bestuur en Heejren Commissarissen zoomede bij alle 11. W. Boekhandelaren en Sub-Commissiën bij/wien loten verkrijgbaar varen gesteld. '§- H ektogekb9^ii 26 Juli 1876. Namens het Bestuur F. X. C. LUYCKX President. F. H. W. VON EUGEN Secretaris. u wordjjeyraagd tegen 1° September genegenheid voor vijf of meer Hepirea om eenvoudig maar goed te dmeeren. Adres met J>rfnco brieven onder letter O. bij de Uitg»r^rs dezes. W. BOUMAN vraagt in zijn Bierbrouwerij een GESCHIKTPERSOON om dadelijk in dienst te tred^jrf /!('' iïallii bi in eene Brood- en Kotfkbakkerij  een ^/^LEERLING tj tegen nader over een te komen voorwaarden. P . a Brieven franco/ onder het motto Leerling """" aan het Bureau dezer Courant. 4 - - - _ »n ur te Oijen a/d. Maas vraagt ten spoedigste / ( tegen hoog salaris 2 al^zins bekwame R. K. fil*. lIlillliMl/lliuunuun ï kj i - onder verzekering van minstens één jaar vast £_ werk. Ajyfoieding met franco brieven doch liefst iiy""persoon. op een net dorp in de omgeyèüig van 's-Bosch wordt zoo spoedig mogeïyk gevraagd een' FLI\K>*ÉlkEMlll tegen goed^twn. Adrjg^onder letter H. aan den Boekhandeljwtr P. C. BAIJENS te Waalwijk. of vroeger worden gevraagd; bekwame StllS alleszins EID Gulden; en eene salaris drie hoi zindelijke 1RKMEID salaris hefiiderd vijftig.Gulden; beide R. K.yAdres met franco brieven onder lett. Z. Mj den Boekhandelaar P. KUIJ LAARS te /Breda. OPZIC HTER gev raagd. ' W. J. ALBEIJS . Botertóndelaar t&Grave vraagt zoo spoedig mogelijk als Opzichter .ƒ in zijne fabriek van onbesproken /gedrag kunnende goed  . lezen en schrijven ^n van goede getuigschriften /voorzien tegeiy'genot van vrije Woning en behoorlijk weekgeld. Liefst een gehuwd gepensioneerd Ambtenaar of Onderofficier. LABOMTORIl! VOOR IIVGIËMSCII  PATJWLOGISCH EN v Pharmaceutj^ch-Chemische Onderzoekingen Ginnekedfstraat A. 64/65 Breda.' Bovengenoemde Inrichting zal gedurende drie Wken gesloten zijn zoodat de ondergetekende eerst na 15 Aug. a. S. >veder0m is te coDSulteeren. P. G. STEBNSMA.",http://resolver.kb.nl/resolve?urn=MMSADB01:000007317:mpeg21:a0019:ocr,4,MMSADB01:000007317:mpeg21:p004,Provinciale Noordbrabantsche en 's Hertogenbossche courant,1000
1156288,1876/09/08 00:00:00,712,ddd:011066273:mpeg21:a0059,http://imageviewer.kb.nl/ImagingService/imagingService?id=ddd:011066273:mpeg21:p004:image&x=2461&y=118&w=1624&h=712,ddd:011066273:mpeg21,4085,830,2461,118,4,"Door Het K* angellßCh Verbond Ia uKpegevoi; ELMHAÜSEN Waar liefde woont gebiedt de ïïcer den zegen. UIT HET DUITSCH. Prijs Inff. /l.ao «el». / 1.75. Ds. A. VAN TOORENENBERGEN zegt van dit boek in de Kerkelijke Courant van Zaterdag 2 September jl.: *Met niet minder genot durven wij het lieve verhaal »Elmhausen"" aanbcvclctt dat wel veel meer duitsch maar toch CClit Evangelisch is. Indien het Verbond zoo voortgaat dan geeft het eene belangrijke bibliotheek aan ons opkomend geslacht een rijken tegenhanger van de veelzins treurige literatuur waarmede duizenden in onze dagen bedorven worden."" (7493)",http://resolver.kb.nl/resolve?urn=ddd:011066273:mpeg21:a0059:ocr,4,ddd:011066273:mpeg21:p004,De standaard,1624
3006344,1876/03/22 00:00:00,2959,ddd:010288580:mpeg21:a0038,http://imageviewer.kb.nl/ImagingService/imagingService?id=ddd:010288580:mpeg21:p004:image&x=2100&y=2746&w=1016&h=2959,ddd:010288580:mpeg21,3116,5705,2100,2746,6,Vrijdag zullen worden verkocht zioxiöLex* reserve: 8 kisten porcèleinen Eierdoppen. []206] G- A. WERMUTH. Vrijdag continuatie met den verkoop van Petroleum prima qualiteit. (1210) WERMUTH. Hout- Venciixtie nabij het station a 2% vendusnlaris op Vrijdag- den 24 Maart a. s. (1203) door P. BUUS Hz. Vendutie wegens vertrek Op Woensdag den 29en dezer /.uilen SOESMAN & Co. op Randoesarie vendutie bouden ten huize van den WelEdclGr. Heer Mr. R. VORSTMAN van ZEdGr. zeer netten iuboedel bestaande uit: Bataviasche Stoelen Banken vierkante en rende Tafels Knaapjes Divans keurig geborduurde Stoelen twee prachtige Luiaardstoelen een Elegant Toilet- Ducliesse Waschtafels met marmeren bladen soliede Kleerkasten een Schrijftafel Boekenrekken Schutsels een Buffet Spiegels Schilderijen Ilimg- en Tafellampen Glas- Porcelein- eu Pleetwerken waaronder Llskan een voor dit klimaat vervaardigde Pianino van Berden nieuwe Rottingmatten. Voorts: Ecu zoo goed als nieuwe Mylord ecu span hardloopeude Bimaneesclte Wagenpaarden Wagentuigen Stal- en Goedanggereedschappeu een schoone collectie Bloemen in potten waaronder zeer fraaie Varens en wat verder te voorschijn zal worden gebracht r1094j SOESMAN 8. Co. Vex__.clv_.l-ie wegens vertrel_c op den 30e.. Maart ten huize van den WelEd. Heer J. ïï. VAN DER VELDE Zeestrand van zijn zeer compLeten inboedel waaronder: Een Seraphine Speeldoos Piano's l Vis it-Vis 1 Teutwagen 1 Phla.ikijn 1 Kot-.ts 1 no.; nieuwe Calèche met. Engelsen onderstel Rij- en Wagenpaarden 1 Dames- en Heerenzadel en Tuitten! Melkgevende Koe. Geene --oedereu kuunen worden bijgebracht. (1121) SOcSMAN & Co. Openbare Verkoop! Op de vendutie van Vrijdag den 31 Maart 1876 zullen door de Weeskamer alhier alsnog verkocht worden de tot de boedels van wijlen H. O HIDDINK en van de weduwe M. H. M. SEVERIJNS behoorénde loa_e goederen. Samarang Namens de Kamer voornoemd: den 21 Maart51876. De Secretaris. (1215) R. DE LANInOY.,http://resolver.kb.nl/resolve?urn=ddd:010288580:mpeg21:a0038:ocr,4,ddd:010288580:mpeg21:p004,De locomotief : Samarangsch handels- en advertentie-blad,1016
3001208,1876/04/11 00:00:00,3083,MMHCO01:000068610:mpeg21:a0015,http://imageviewer.kb.nl/ImagingService/imagingService?id=MMHCO01:000068610:mpeg21:p004:image&x=2460&y=1859&w=960&h=3083,MMHCO01:000068610:mpeg21,3420,4942,2460,1859,4,"Advertentie De Directie van het Zieken- en Begraafnisfonds //TOT VOORZORG VAN ' t ALGEMEEN"" op. gerigt te Zwolle door den Heer G. J. VAN DER VEEN in December 1842 maakt aan hare leden bekend dat tengevolge van het overlijden van den Heer G. J. VAN DER VEEN deszelfs zoon de Heer J VAN DER VEEN Beurtschipper van Zwolle op Apeldoorn in de overledene zijn plaats als Directeur is opgetreden en dat alles op denzelfden voet blijft voortgaan. Daar dit fonds bijna 34 jaar heeft bestaan en onderscheidene jaren van epidemische ziekten heeft doorgestaan bovenal het jaar 1866 toen er in een week 50 sterfgevallen zijn voorgevallen en een ieder terstond zijn uitkeering heeft ontvangen zoo durft de Directie dit fonds gerustelijk aan een ieder aanbevelen. AGENTEN worden GEVRAAGD waar dit fonds nog niet gevestigd is. Z wolle  April 1876. De Directie. Directeuren der ALGEMEENE ERIESCHE LEVENSVERZEKERING-MAATSCHAPPIJ gevestigd te Leeuwarden zien zich genoodzaakt aan belanghebbenden te berigten dat B. KOK niet alleen in geenerlei betrekking meer tot genoemde Maatschappij staat maar dat ook de vergunning om zijnen broeder te mogen adsisteren bij diens werkzaamheden als bode is ingetrokken. L eeuwarden  8 April 1876. Directeuren voornoemd W. J. OOSTERHOFF Jz. H. BEUCKER ANDREAE. De ondergeteekende maakt het geëerd publiek bekend dat hij den 9 APRIL jl. zijn WAGEN DIENST heeft geopend van Deventer naar Apeldoorn visa versa en dat er gelegenheid bestaat tot het vervoer van passagiers en goederen. Vertrek van Deventer te 9 uur van den Heer P. L. D. SPIJKER aan den Brink waar het bestelhuis voor de goederen gevestigd is. Vertrek van Apeldoorn te half vijf ure van den Heer KARES aan het Marktplein waar ook het bestelhuis voor de goederen gevestigd is. H. J. BOSMAN Ondernemer. DIENSTBODEN kunnen te allen tijde in en buiten de stad tegen goed loon DIENSTEN BEKOMEN. Adres Koestraat H 145 bij de Sassenpoort. Geen marktgeschreeuw! doch werkelijke r aad en hulp. HET ZELFBEHOUD. Raadgever voor mannen van eiken leeftijd. Hulp voor zwakte-toestanden. 36e uitgave 232 bladzijden met 60 anatomische afbeeldingen in staalgravures in verzegelden omslag. Origineele uitgave van Latuentius in Duitsche taal. Te bekomen in eiken boekhandel ook te Keulen bij J. Kreuter Höhle 17 alsmede bij den Auteur Hoogstraat Leipzig. Prijs 4 mark. Dr. L.",http://resolver.kb.nl/resolve?urn=MMHCO01:000068610:mpeg21:a0015:ocr,4,MMHCO01:000068610:mpeg21:p004,Provinciale Overijsselsche en Zwolsche courant,960
2743158,1876/08/05 00:00:00,2802,ddd:010486850:mpeg21:a0009,http://imageviewer.kb.nl/ImagingService/imagingService?id=ddd:010486850:mpeg21:p002:image&x=1110&y=90&w=979&h=2802,ddd:010486850:mpeg21,2089,2892,1110,90,6,Lakens en Tricots. BLAAUW en ZWART SICILIEN. DRAP DÉTÉ. ZIJDEN en FIL d'ÉCOSSE HANDSCHOENEN. Witte en zwarte Dassen. STAANDE en LIGGENDE BOORDEN. Echte MILITAIRE ORNAMENTEN. Borduursels voor heeren Ambtenaren. 2957 .1. KIND Batavia. ONTVANGEN VAN MANILLA: Eene partij zeer goede H 1 Ci A M. E X Nuevo Cortado Malabon in kistjes van 200 en 500 stuks. 3000 DE LANGE k Co. champagne LOUIS roedever. id. Moét & Chandon. 2951 CAVADINO k Co. Huilt Canon9 op 1/1 en 1/2 flesschen. 2952 CAVADINO & Co. ROOKVLEESCH. GEROOKTE OSSENTONGEN. 2953 CAVADINO » Co. STEEDS RUIM VOORZIEN van NIEUWE en GEBRUIKTE RUTriCï'EK zoowel hier als in Europa vervaardigd. Zoomede: FIJNE TUIGEN voor 1 2 en 4 Paarden. REPARATIE^ aan RIJTUIGEN en TUIGEN worden met den meesten spoed uitgevoerd tegen civiele prijzen. F. BELLE Rijtuigfabrikant 3020 Batavia. PER MAARTEN VAN ROSSEM ontvangen: Fijn afgewerkte Brusselsene Paniers. F. BELLE 3021 Rijtuigmaker.,http://resolver.kb.nl/resolve?urn=ddd:010486850:mpeg21:a0009:ocr,2,ddd:010486850:mpeg21:p002,"Java-bode : nieuws, handels- en advertentieblad voor Nederlandsch-Indie",979
645320,1876/04/22 00:00:00,680,ddd:010099983:mpeg21:a0011,http://imageviewer.kb.nl/ImagingService/imagingService?id=ddd:010099983:mpeg21:p002:image&x=3028&y=100&w=949&h=680,ddd:010099983:mpeg21,3977,780,3028,100,6,BJLOC _¥OTJES EN ]fIi]IOE4IDIJ_I§ 9 in RUSSISCH LEDER en ENGELSCH C_.__.lC©  weder voorhanden bij 32. WESTEftffliM & ZOON  Kalverstraat 95. I i Het ALGEMEEN ADVERTENTIEBUREAU van | NIJ Gil & VAN DITMAIt te Rotterdam zorgt met spoeden ! nauwgezetheid voor de PLAATSING VAN ADVERTEN; TlÈN^in alle Dag- Weck- of Advertentiebladen van Nederland Nederl-Indië België Duitschland Oostenrijk-Hongarije Zwitserland Frankrijk Groot-Brittannië en lerland Denemarken Zweden Noorwegen Kusland Turkije Griekenland Eiland Malta Luxemburg Italië Spanje Gibraltar Porta• gal Amerika Azië Afrika Australië.,http://resolver.kb.nl/resolve?urn=ddd:010099983:mpeg21:a0011:ocr,2,ddd:010099983:mpeg21:p002,Algemeen Handelsblad,949
5672301,1876/10/30 00:00:00,5159,MMDA03:000096609:mpeg21:a0014,http://imageviewer.kb.nl/ImagingService/imagingService?id=MMDA03:000096609:mpeg21:p003:image&x=3182&y=229&w=1000&h=5159,MMDA03:000096609:mpeg21,4182,5388,3182,229,4,"Advertentie HEDEN ONTVANGEN: eene collectie inooije FANTASIE- en LAKHOEDEN NIEUWSTE MODELLEN. Tevens voorhanden vele soorten Jongens Wintermutsj'es. de ondergeteekende zich E. HAVINGA. Tot de levering beveelt de ondergeteekende zich beleefd aan. MODES! De ondergeteekende heeft de eer hare geachte Stad- en Gewestgenooten te berigten de ontvangst der nieuwste modellen voor Dames- en Kinderhoeden LINTEN BOftUETTEN VEEREN etc. etc. Verzoekt beleefdelijk gunst. S. C0HEN Rolderstraat naast den Heer POELMAN Assen. Specialiteit in Heeren en Dames Bottines KINDERSCHOENEN ENZ. De ondergeteekende zal wederom den lsten en aden November te Assen komen en te spreken of te ontbieden zijn bij H. SOMERS nieuw Hotel. "" H. v. d . BOSCH. Postwagen dienst THOMAS & Co. Hoogeveen — Koevorden. Einde der ZOMEBBIENST op a.s. Zaturdag 38 Oct. WIUïTEBDIESrST van af MAANDAG 30 Oct. dag. beh. Zondags. Van Koevorden 's morg. 5.30 doch Dingsdags en Vrijdags 'smorg. 4 uur. Van Hoogeveen 's midd. 13.48. Bovendien eiken MAANDAG van Hoogeveen 's morg. O van Koevorden 's midd. 3 uur. NI) De DIENST DALEN—EMMEN • I)• wordt tot nadere aankondiging GESTAAKT. ' ovërh|£s£ j |che ■ ooTrt- Ctc - - ' B. H. EGBERTS & C°. te DALFSEN. Deze extract van Cichorij overtreft andere soorten in geur en smaak daarom de eenige bekroonde te Londen in 1862 Arnhem 1868 en Weenen 1873. Van bovenstaand etiquet en naam zijn de pakjes voorzien. Men gelieve daarop te letten want ze worden nagemaakt. De Stoom-Stoffenverwerij van D. K0ETSER Mz. te Groningen beveelt haren AGENT den Heer N. AM COHEN te Assen in ieders gunst aan. Ten zijnen huize zijn een menigte der Keurigste stalen ter bezigtiging gesteld. I ilïillW l'JMiHU-MliA/jNU Et ten iaaraan YoobonStn IMektalel thans vooraan Oude Boteringestraat K ï l. Groningen. JD. VAN DRUTEN. Wordt gevraagd: t! wegende minstens 50 kilo per stuk te leveren voor den eersten Junij 1877 franco naar den wal in het Zwolsche Diep bij Genemuiden. Betaling naar verkiezing. Aanbiedingen worden ingewacht door den aannemer K. SCHUT te Kampen.",http://resolver.kb.nl/resolve?urn=MMDA03:000096609:mpeg21:a0014:ocr,3,MMDA03:000096609:mpeg21:p003,Provinciale Drentsche en Asser courant,1000
994840,1876/02/18 00:00:00,1045,ddd:010099921:mpeg21:a0013,http://imageviewer.kb.nl/ImagingService/imagingService?id=ddd:010099921:mpeg21:p002:image&x=3015&y=2029&w=952&h=1045,ddd:010099921:mpeg21,3967,3074,3015,2029,6,'ftcrlamr 0* VAM 1 TOT 5 REGELS S »•*•• BOVEN 5 REGELD a 50 Cts. OE REGE£^_ «ui umin n tiiikmmmmmmmmmmmmmmmmmmmmmmmmmmmmmmm^^mtmmmmt. DE AMERIKAANSCHE SCHRIJFMACHINES (Type-WRITERS) ziin dae.liiks in werking bij en alle inlichtingen wordea verstrekt door Wed. L. ïAkRE & ZOON den llaag. *m*i«m*m imm-gm*mmimmw*aaa**ja^ 290ste STAATSLOTERIJ. lste Klasse. 4de Lijst. Trekking van 17 Februari. N°. 3142 ƒ 400. N°. 10774 ƒ2OO. N°. 20729 ƒ 100. Prijzen van ƒ2O: 200 2533 4723 6935 8849 12139 14059 15967 18704 19789 201 2777 4808 7150 9225 12192 14387 16350 18738 20110 913 278ê 5004. 7237 10438 12332 14567 16357 18820 20182 994 3071 5116 737. 1 «84 12474 14624 17498 18858 20455 1325 3302 5417 7563 11116 12500 14664 17561 18949 20473 1471 3329 5511 8244 11572 12779 15053 17753 19366 20813 15.9 3762 5609 8274 11878 13303 15656 17983 19457 20912 1916 3796 61 .3 8501 11953 13734 15715 18053 19698 2129 4339 6531 8766 12003 13897 15827 18.91 19713 2354 4494 6661 8847 12035 13999 15943 18496 19785,http://resolver.kb.nl/resolve?urn=ddd:010099921:mpeg21:a0013:ocr,2,ddd:010099921:mpeg21:p002,Algemeen Handelsblad,952
3135158,1876/12/25 00:00:00,3259,ddd:010101017:mpeg21:a0032,http://imageviewer.kb.nl/ImagingService/imagingService?id=ddd:010101017:mpeg21:p004:image&x=59&y=84&w=962&h=3259,ddd:010101017:mpeg21,1021,3343,59,84,4,"De Burgemeester van Marken roept mits deae op alle degenea die vermeenen recht te hfbben ep een uit de Zuiderzee onder Edam opgevischte BOOT (zijnde wrak) met kleinen Inventaris. De Burgemeester vao Marken (39080) C. DE GROOT. AMSTERDAMSCHE KANAALIAATiGHAPPIJ. Do Directie bericht dat ten Kantore van do NEDERLANDSCfIE BANK alhier zullen worden betaald: i*. Op 1 Januari 1877 en volgecdo dagen de alsdan verschenen COUPON X"". 16 der Obligatiën van de 4 pCt. Leening ten laste der genoemde Maatschappij met ƒ 20; 2"". Op 15 Jasuari 1877 en volgende dagen de RENTE» en DIVIDEND-BEWIJZEN 91°. 24 van de Aandeelen in het Maatschappelijk Kapitaal groot ƒ 8500C00 met ƒ 17.50 per Aandeel van ƒlOOO r 8.75 r ii r r 500 * 1.75 * * ut 100 De Directie Ambtebdam JITTA President. 9 December 1876. (44817) P. H. BRUYN Secretaris. P. J. DEGENS Makelaar zal op MAANDAG 15 JANUARI 1877  des avonds na 6 uur in het Lokaal de Brakke Grond ten overstaan van de Noterissen MULDER & KANNE. in veilicg brengen: DRIE BOUWTERREINEN naast elkander gelegen in de PLANTAGE FRANSCHE LAAN elk lang 46.50 meter en breed 7.40 meter gelegen achter de hierna vermelde te amoveeren Perceelen N°. 17 19 en 21. N°. 4. Tot amotie den OPSTAL van Drie BUIZEN en aanhoorigheden gelegen in de Plantage Fraüsche laan ""N°. 1719 en 21; te zameH in één koop. llsze Perceelen zullen eerst ieder afsonderlijk bij opbod en afslag geveild daarna N*. 1 en 2 vervolgens N"". 2 en 3 daarna jN"". 1 2 en 3 en eindelijk N°. 1 2 3en4 in massa worden afgeslagen. Te zien Dinsdags en Donderdag* alsmede op den Verkoopdag van 2 tot 4 uur. De toegaüg is door bet psrciifl in de Kerklaan N°. 39. De Bewijzen vaa Eigendom en de Veilconditiën zullen 4 dag.^n voor alsmede op den Verkoopdag ter lesing liggen ten Kantore van de Notariseen MULDER & KANNE. Nader onderricht bij den Kakelaar P. J. DEGENS Maarten Janszoon Kosterïtraat 16. (45443) j_&* BELANGRIJKE VEILING «db PAARDEN RIJTUIGEN ROUWKOETSEN TUIGEN enz. WILLEM GIDEuN KLEMAN en FREDRIK WILLEM WEï'HE'a zu'len ten overstaan van de Notarissen R- UFFAER & MARTENS. op MAANDAG den S JANUARI 1877 des Voormiddags te IO uren aan den STAL op de hoogto van den Kaaijk N 17 w^g-ns quitecring der Stalhoudersaffaire van den Heer JU M. HELLER presenteeren te verkoopen: 14 stuks alle bi't^nde en tbans uo» in gebruik zijnde zwarte en bruine PAARDEN onderscheidene . alle tto^d onderhoulene zindelijk beklemde HIJITUIGEN als: DRIE kapitale ROUWKOETSEN ca een ROUWSLEE met daarbij s/e.bnukt zijnde Ronwdekken. Kappen Mant.de enz. Twee KOETSEN een BERLENKOETS een COUPÉKOETS twee ruime CALEBSCHEN twee lichte CALESCHJE» voor 1 en 2 paarden een weinig minder dan nieuwe COUPÉ GLARENCE twee COUPES vier VICELANTEN twee TENTW AGENS cm PHAËTON een Poolsehe ASiRESLEDE twee platte KARREN op veeren en een VRACHTWAGEN mitsgaders eenige net gemonteerde Spannen Staatsie- Koetsen Eenpaardstuigen wollen en andere Dekken Halters Zweepen Bitten Rijtr.igwippi'n Emmers. Gieters Imperialen iSchuierwerk en meerdere STALGOEDEREN zooals alles genummerd Zaterdags te veren en op den Verkoopdag te zien zal zijn. Do Verkooping zal geschieden op 8 JANUARI 1877  des Voormiddags te IO uren. Nader onderricht te bekomen ten Kantore van W. G. KLEMAN & F. W. WEEBER op de Keizersgracht bij da Rr-jjuliersjzracht. (46194) NB. In deze Verkooping kan niets worden bijgevoegd.",http://resolver.kb.nl/resolve?urn=ddd:010101017:mpeg21:a0032:ocr,4,ddd:010101017:mpeg21:p004,Algemeen Handelsblad,962
2913624,1876/08/07 00:00:00,2952,ddd:010288695:mpeg21:a0040,http://imageviewer.kb.nl/ImagingService/imagingService?id=ddd:010288695:mpeg21:p006:image&x=3131&y=100&w=987&h=2952,ddd:010288695:mpeg21,4118,3052,3131,100,6,"Samaro \ potheeh voorbanden: Teerzeep Tnndpneder. — Sainarajigsclic Siropen. (2964) KLAASESZ. Samarangsclie Apotheek I Bmokeglasbrilien en andere Brillen in Gouden sn en Stalen Garnituur. [2963 J R. KLAASESZ. Erf pach t. Door byzondere omstandigheden ter overname aangeboden twee aaneengrenzende Erfpachtsperceelon respectievelijk 499 en 497 bouws Inclineerendea gelieven zich te wenden tot A. RESINK (2681 j Djokdjo. pB-F Lees Hier! ""XTetxx Goetl-em _Er_.o£tlliex* &0. Constructeurs te Brussel zijn bereid rechtstreeks of door tusschenkomst van hun hoofdagent de levering aan te nemen van Doublé effets met bijbehoorende stoommachines voor f 15250 met bronzen tubulaire platen en voor t 148 00 met geslagen ijzeren tubulaire platen. Een Doublé Effet werkende zonder koolzuur en zonder beenzwart is sedert oogstjaar 1874 in werking op de Suikerfabriek Poerwodadie Madioen en aldaar dagelijks te bezichtigen. Informatiën zijn te bekomen by' B. VAN DER ZWAAN te Soerabaia en by' den Hoofdagent A. BLOET te Madioen op de fabriek Poerwodadie. 2174 B. VAN DER ZWAAN & Go. Debiteuren van de ondergeteekenden wordt beleefdelijk verzocht spoedig hun debet aan te zuivere u. BOERS St Co. iv liquidatie Djokdjo. Juli 1876. Lur.Q] Dos-a-Dos- Verhuurderij .over J ii v a-H o t e 1 T a w ang. BEMAN. MARIOTAT Spekstraat. Opnieuw ontvangen: Sigarettepapier (duc) groot formaat. [2919] ~TE HUUR: Een huis in de Konijnenstraat by (2991) Chs. BOYER.",http://resolver.kb.nl/resolve?urn=ddd:010288695:mpeg21:a0040:ocr,6,ddd:010288695:mpeg21:p006,De locomotief : Samarangsch handels- en advertentie-blad,987
2539537,1876/02/29 00:00:00,2537,ddd:010288561:mpeg21:a0026,http://imageviewer.kb.nl/ImagingService/imagingService?id=ddd:010288561:mpeg21:p004:image&x=2096&y=78&w=1001&h=2537,ddd:010288561:mpeg21,3097,2615,2096,78,4,Eeremetaal Astlima jNevralgïën Kuch Boestbeklemmingbn Hoofdpijnen Maagkkam- SCHOKHEID HaKTKXOPPIN- PEN ZENUWPIJNEN en bijna OEN alsmede alle kwalen der alle ZenüWAANDOENINGN Auf.jhialingsokgani'N wor- welke aan de meeste beden met het beste gevolg handelingen weerstand geo-enezen door de boden hebben worden bin„ . .  nen één uur genezen door de Buisjes van Levasseur Dr. Apoth e k e r der lste Anti-Nevralgische Pillen klasse. van Dr. CRONNIER. i Centr aal-Depot bij Dr. Levasseur. Opvolger van ROBIQUET lid der geneeskundige Eac u 11 ei t. Parijs 23 Rue de la Monnie (vroeger No. 10) (3810) Bij G. KOLFF $ Co. Batavia is tegen remise van f 5 verkrijgbaar: de Regeerings-Almanak 1876 (831) Tijdelijke Goedkoope Aanbieding VAN DE Indische Staatsbladen Noman-Editie 1816—1873 in 3 sterk gebonden deelen. Prijs f 55 voor zoolang de voorraad strekt. 674) G. KOLFF & Co. te Batavia. Accurate Briefwegers. jE»rijs- t 1350 of ls.lei--a.e-r f O. — hij G Kölff & Co. te Batavia. (701) -ii n-i i ■ ■ ■ ' -■ ......... . At3oiixio-iïiexite*ïi voor 187Q *c>3£» HET GEÏLLUSTREERDE NIEUWS worden tegen vooruitbetaling van f 17.— aangenomen en dadelijk uitgevoerd door (832) G. KOLFF & 00. te Batavia. ATSJ XJST. Gebr. VAN~ DËËT ZIJL in Dranken en Frovisien Bestelt.ngen uorden ten spoedigste bezorgd. (S«3),http://resolver.kb.nl/resolve?urn=ddd:010288561:mpeg21:a0026:ocr,4,ddd:010288561:mpeg21:p004,De locomotief : Samarangsch handels- en advertentie-blad,1001
122500,1876/11/26 00:00:00,140,MMWFA01:000179199:mpeg21:a00018,http://imageviewer.kb.nl/ImagingService/imagingService?id=MMWFA01:000179199:mpeg21:p00004:image&x=3691&y=5082&w=875&h=140,MMWFA01:000179199:mpeg21:p,4566,5222,3691,5082,4,Advertentie Gedrukt bij P. J PERSIJN te HOORK,http://resolver.kb.nl/resolve?urn=MMWFA01:000179199:mpeg21:a00018:ocr,4,MMWFA01:000179199:mpeg21:p00004,Hoornsche courant,875
1861134,1876/09/09 00:00:00,1903,ddd:010486880:mpeg21:a0017,http://imageviewer.kb.nl/ImagingService/imagingService?id=ddd:010486880:mpeg21:p003:image&x=77&y=4059&w=978&h=1903,ddd:010486880:mpeg21,1055,5962,77,4059,6,J. DVRET Grand choix DINSTRUMENTS DOPTIQUE DE MATHEMATIQUE ET DE MARINE a prix tres réduits: LUNETTES or controle gamies de verres première qualité .... ƒ 15— Do. arg_nt * 6— Do. acier fin . . . . n _ A/— Do. ordinairea . . . . n 250 Grand choix DE BIJOUTERIE ET D'HORLOGERIE des meilleures fabriques. REPARATIONS. 6097 RIJSWIJK —BATAVIA. Geraffineerde witte Parakantroes SUIKER bekroond met de Zilveren Medaille op de TENTOONSTELLING te Buitenzorg ia blikken van 25 ponden netto a / .6— contant verkrijgbaar bij DE LANGE & Co. BATKNBCHG (ir Co. VAN VLEUTEN St COX. LOA POSENG. Pa.er Baroe l».l TIO TJBNG 80UIJ Passer Baroe.,http://resolver.kb.nl/resolve?urn=ddd:010486880:mpeg21:a0017:ocr,3,ddd:010486880:mpeg21:p003,"Java-bode : nieuws, handels- en advertentieblad voor Nederlandsch-Indie",978
1668518,1876/10/07 00:00:00,1711,MMSAVL02:000429107:mpeg21:a00021,http://imageviewer.kb.nl/ImagingService/imagingService?id=MMSAVL02:000429107:mpeg21:p00004:image&x=1462&y=3276&w=1014&h=1711,MMSAVL02:000429107:mpeg21:p,2476,4987,1462,3276,4,Advertentie Zmum üii; vereenigt in zich de eigenschappen van het Carlsbader Emser en Mariënbader zout en bewijst uitmuntende diensten bij hoofdpijn verstopping en slechte spijsvertering benevens de kwalen die daaruit voortkomen zooals maagpijn migraine aambeijen en in ’talgemeen de ziekten waartegen men zich van laxeermiddelen bedient. In verzegelde „Ix an STAALWIJI. Bet is van algemeene bekendheid dat ijzer een onmisbaar bestanddeel van ons bloed is. Waar het in te geringe hoeveelheid voorhanden is zijn kwaadsappigheid bleekzucht en klierziekten de natuurlijke gevolgen. Van alle zoogenaamde ijzerpraeparaten is deze oplossing de geschiktste. Eén eetlepel beval 015 gram ijzer in een licht verteerbaren vorm. De flacon kost f 1. BOTERPOEDER verkort den tijd van het karnen maakt de boter vaster beter van smaak fraaijer van kleur en verhindert het sterk worden. In pakken voldoende voor 500 kan melk a 30 cents. W BU ieder artikel is eene uitvoerige gebruiksaanwijzing. Bovenstaande Artikelen zijn te bekomen in de bekende depóts voornamelijk: TI. D. v. HofTen Brielle. J. II. D. Koch Delfshaven. J. Poortmans Maassluis. Gebr. Ledeboer over ’t StadhuisRotterdam. J. H. Meijer en Wouter Pleijsier te A. W. Groote Kalverstr. L 4 en H. H. Vlaardingen. Ulotli Apotli. Amsterdam. D. Maltha Gz. Schiedam. L. Kooyman IIz. Oud-Beijerland.  £n in de andere plaatsen in de bekende depóts. LMMERICIL H. VON GDUJORN.,http://resolver.kb.nl/resolve?urn=MMSAVL02:000429107:mpeg21:a00021:ocr,4,MMSAVL02:000429107:mpeg21:p00004,Vlaardingsche courant,1014
1884960,1876/06/16 00:00:00,2720,ddd:010062569:mpeg21:a0033,http://imageviewer.kb.nl/ImagingService/imagingService?id=ddd:010062569:mpeg21:p004:image&x=739&y=2402&w=693&h=2720,ddd:010062569:mpeg21,1432,5122,739,2402,4,"Bafiliatters-lleliflfïïoiiw. Een in dat vak bekwame JUFVROUW 24 jaar oud en van de P. G. reeds eenige jaren als zoodanig werkzaam zag zich tegen Augustus gaarne als zoodanig geplaatst of tot assistentie in een Huishouding. Adres letters M R bij den Boekhandelaar W. C. WANSLEVEN te Zutphen. ""NAAISTER. Een Heer die op Kamers woont zoekt eene Naaister die bereid is een dag van elke veertien dagen ten zijnent te komen tot het nazien en zoo noodig herstellen van zijn ondergoed. Voor middageten kan gezorgd worden. Zij die daarvoor in aanmerking wenscht te komen gelieve zich in persoon te vervoegen Utrechtschestraat'l32. Baarn. Te Huup: gemeubileerde Appartementen met Kost en Bediening. Brieven franco onder letters A H bij den Boekhandelaar D. R. HINSE Leidschestraat No. 19 te Amsterd. IOUDEÏSIfYÖOGDEI. Bij een Predikant in de nabijheid van een stad met vele en uitmuntende Inrichtingen voor Onderwijs Gymnasium H. B. School enz. bestaat gelegenheid voor een of meer Jongelieden toS Inwoning met toezicht en leiding bij de Studiën Iten einde met zijne Zoons eene van die Inrichtingen te bezoeken. Brieven franco 'onder Lett. EA Bureel v/d Blad. (8815) In eene der groote steden van Zuid- Holland bestaat bij den Directeur van eene school voor uitgebreid lager onderwijs eene zeer goede gelegenheid tot plaatsing van een paar Jongens die behoefte hebben aan toezicht en leiding bij hunne studiën. Brieven franco onder lett. V R aan het Bureel van dit Blad. (8712) _ TE HUUR: een Zomer- en Winter- verblijf bij het Oosterspoor te Diemen; desverkiezende ook voor de Zomermaanden met gebruik van Tuin en Boomgaard. Te bevragen bij A. VEDDER te Diemen. (8818 TWet 1 Juli a. s. op de Lindengracht bij Tpde Brouwersgracht TEHUUR vooreen Heer eene ongemeubeleerde geplafonneerde Kamer met Slaapplaats of Zijkamer _?Ü« apvertrekJB en Bedienine voor ƒl_ per maand. — Brieven franco""onder letters F H by den Boekhand. D.ALLART Haarlemmerstraaws Amsterdam. (8897) Villa te HilTOsumT Steller dezes een der vijf aan den Heer BIJVOETS. Architect te Amsterdam toebehoorende Villa's met grooten Tuin aan den Laarderweg te Hilversum gehuurd' hebbende doch door ziekte zijner Echtgenoote die niet kunnende betrekken biedt deze die primitief gehuurd is voor Twaalf Honderd Gulden met toestominß van genoemden Eigenaar voor Acht Honderd Gulden (met inbegrip van Gordijnen) voor een jaar ter overname aan. Franco te bevragen onder motto Villa Hilversum aan den Kantoorboekh. van L. HOLTKAMP Rokin k/d Beurssteeg te Amsterdam. (8809)",http://resolver.kb.nl/resolve?urn=ddd:010062569:mpeg21:a0033:ocr,4,ddd:010062569:mpeg21:p004,Het nieuws van den dag : kleine courant,693
4519812,1876/01/28 00:00:00,4142,MMKB08:000114046:mpeg21:a0014,http://imageviewer.kb.nl/ImagingService/imagingService?id=MMKB08:000114046:mpeg21:p004:image&x=42&y=979&w=1087&h=4142,MMKB08:000114046:mpeg21,1129,5121,42,979,4,Advertentie Met 1 Mei a. s. te huur: Een HUIS met TUIN bevattende zes Kamers Keuken Kelder Zolderkamertje enz. en EEN GROOT BOVENHUIS met vijf Kamers Keuken met ruime Zolders twee Zolderkamertjes; beide gelegen op de Koornmarkt. Te bevragen bij H. P. DB KONING Mr. Timmerman. Door toevallige omstandigheden wordt alhier ter overname aangeboden : een PAKHUIS MET BOVENWONING van alle gemakken vootzien en aan bet wster gelegen waarin eene Affaire in Brandstoffen en Stoelenmaker sbiezen met het beste succes wordt uitgeoefend. De verkooper zal desverkjezende het grootste gedeelte der koopsom als le hypotheek op het Pand houden. en wat betreft de Affaire den kooper gedurende eenigen tijd onderrichten. Adres met franco Brieven onder letter C bij den Boekhandelaar I1ENNEVELD. Terstond te huur een gemeubeleerde Boven-Voorkamer met Slaapplaats voor ƒ16 maands. Adres Bureau dezer Courant. TE HUUR: op een goeden stand  een of twee NET GEMEUBILEERDE KAMERS met Alcove. Te bevragen bij den Boekhandelaar HENNEVEL D. Te Huur gevraagd: EEN PAKHUIS OF OPEN GROND. Franco brieven ondsr lett. B Bureau dezer Courant. Er bestaat voor 6 ük 7 Heeren gelegenheid om goed te DIN E E R E N. Adre9 Oude Delft wijk 2 n*. 63. Er wordt gevraagd in het zuidelijk gedeelte der stad EEN GELEGENHEID TOT BERGPLAATS VAN GRIND. Brieven franco onder lett. d. H. aan het Bureau dezer Courant. Door vertrek naar elders wordt te koop aangeboden EEN BEKLANTE TAPPERIJ. met daarbij behoorenden INVENTARIS Het huis is daarbij voor ƒ225 's weeks in huur te bekomen. Adres Bureau dezer Courant. De oudergeteekende heeft de eer aan zijne geachte Begunstigers te berigten dat hij van af heden bij zijne METSELAARS- en STUCADOORSAFFAIRE ook dc Steenhouwersaffaire zal uitoefenen waartoe hij zich minzaam aanbeveelt belovende eene accurate en civiele bediening. Dilft  21 Januarij 1876. G. de Ronde & Zoon. BOUWMATERIALEN? Portlandsche Cement Waalsteen IJsselsteen Roodeen Blaauwe Pannen 1ste soort steeds voorhanden tegen civielen prijs bij G. DE RONDE & Zn. te Delft.,http://resolver.kb.nl/resolve?urn=MMKB08:000114046:mpeg21:a0014:ocr,4,MMKB08:000114046:mpeg21:p004,Delftsche courant,1087
2820956,1876/12/29 00:00:00,3284,ddd:010586873:mpeg21:a0033,http://imageviewer.kb.nl/ImagingService/imagingService?id=ddd:010586873:mpeg21:p006:image&x=1932&y=2381&w=859&h=3284,ddd:010586873:mpeg21,2791,5665,1932,2381,12,"Verkoop. - Hooiland onder Rroek. De Notaris MUNNIK te Joure zal op Maandag 8 Januari 1877 des namiddags 4 uren bij den Logementhouder Boersma te Joure in veiling brengen: 1. 2 H. 71 A. 70 C. uitmuntend Hooiland met Rietpolle aan de Broekstervaart onder Broek. 2. 2H.40A. 30 C. dito Hooiland aan den Noorter Oudeweg tegenover de Bloksloot onder Broek. 3. 69 A. 40 C. Rietland of Rietpolle mede aan den Oudeweg onder Broek gelegen ten zuiden van perceel 2. Alles eigen aan G. J. W. Tjepkema. Aanvaarding Sint Petri 1877. Breeder bij biljetten omschreven verkrijgbaar ten kantore van gemelden Notaris. Door verandering van Woonplaats verkoop van eene Winkel- en Woonhuizinge te Joure. De Notaris MUNNIK te Joure zal ten verzoeke van den Heer EISMA te Bolaward op Maandag den 8 Januari 1877 s/a. 8 uren in het Hotel Terwisga finaal verkoopen: Eene zeer beklante Winkel- en Woonhuizinge op het Oosteinde van de Midstraat te Joure waarin een handel in Manufacturen Hoeden en Petten en Affaire van Kleedermaken wordt uitgeoefend voorzien van ruimen Winkel met Kamer achter eene flinke Woonkamer Keuken waarboven Werk- en Bergplaats ; voorts Zolder met Logeerkamertjes voor en achter groote Plaats Bleek en Tuin beste Bak en Pomp. Eigen aan en bewoond door den Heer G. Eisma. Aanvaarding 1 Februari 1877 of vroeger. Geboden ƒ3300. Verkooping te Harlingen. De Notaris W. SIJPKENS KIJLSTRA te Harlingen zal op Woensdag den 10 Januarij 1877 des namiddags 4 uur bij F. Wiersma in de „Roode Ploeg"" te Harlingen finaal verkoopen : Eene STELPHUIZINGE met Hieming en 2 perc. uitmuntend Bouwland  gelegen aan den Schapendiik onder Almenum nabij Harlingen bij L. Bleeker als eigenaar in gebruik  en zulks in 3 perceelen; geboden: perc. 1 ƒ1625 perc. 2 ƒllO4 perc. 3 ƒl4Ol. DEZELFDE NOTARIS zal op Woensdag den 10 Januarij 1877  des avonds 7 uur bij Fekkes in de Korenbeurs te Harlingen finaal verkoopen: Eene HUIZINGEmet ruime Plaats Bleek en Tuin aan de Schritsen te Harlingen wijk F no. 78 bij den Heer W. Keun in gebruik; geboden ƒ2399. Verkooping van Boomen. R. L. van NOORD Deurwaarder te Rauwerd zal op Woensdag den 10 Januarij 1877 des voormiddags te 10 uur op de Hieminge bij de Zathe bewoond door P. K. van der Weijde Landbouwer aan den Swigchumerdijk onder Wirdum tegen contante betaling verkoopen : Eene partij fraaüe Esschen en IJperen Boomen Populieren  Hagedoorn  Mispolboom Notenboom en eene aanzienlijke hoeveelheid Appelboomen alles om te worden gerooijd en zeer geschikt tot vervoer aan het Water.",http://resolver.kb.nl/resolve?urn=ddd:010586873:mpeg21:a0033:ocr,6,ddd:010586873:mpeg21:p006,Leeuwarder courant,859
1137162,1876/07/28 00:00:00,1434,ddd:011066237:mpeg21:a0026,http://imageviewer.kb.nl/ImagingService/imagingService?id=ddd:011066237:mpeg21:p004:image&x=883&y=2711&w=793&h=1434,ddd:011066237:mpeg21,1676,4145,883,2711,4,Geheel nieuwe vinding tot final»- uitroeiing van Wandgödißï ?tè'ii zonder reuk of iets te beschadigen met 6 jaar garantie. Adres: J. <;OC<:iH2AitT & Co. (6263) Oppert. Xo. frt Botter Hm. Belangrijk voor Burgers maar ook voor Boeren. Onder den titel van een vreeseiijkeen gevreesde Vijand y;eeh de Heer E. gf:r- DES in het fraaie werk DL ZAAIER van 1874 eene uitvoerige beschrijving van den I Geruchten ©oiorade- of A»rd«ppel-1 kever voor iedereen maar vooral voor ! hen die zich met Aardappelteelt bezighouden is dit geschrift allerbelangrijkst. j DE ZAAIER Tijdschrift voor Burger l en Boer keur van Verhalen Novellen 1 Reisbeschrijvingen Wetenswaardigheden  i enz. enz. alles rijk geïllustreerd met fraaie platen en verzameld door de allerbeste schrijvers. DE 7>AAlERjaarg;aii!r 1873 en 1874 te zamen 1000 bladz. in groot formaat over 2 kolommen gedrukt wordt aangeboden voor slechts ƒ3.— in plaats van ƒ8.70. Elke jaargang is afzonderlijk te bekomen voor slechts ƒ 1.50 bij D. UOliLfv | Noordblaak te Rotterdamen verder alom. Catalogus van goedkoope Boeken gratis op aanvraag. (6264),http://resolver.kb.nl/resolve?urn=ddd:011066237:mpeg21:a0026:ocr,4,ddd:011066237:mpeg21:p004,De standaard,793
374262,1876/04/22 00:00:00,399,MMKB08:000089825:mpeg21:a0020,http://imageviewer.kb.nl/ImagingService/imagingService?id=MMKB08:000089825:mpeg21:p003:image&x=2618&y=4448&w=938&h=399,MMKB08:000089825:mpeg21,3556,4847,2618,4448,4,Advertentie In een der voornaamste straten van Doetinchem wordt tegen 1 Mei TE HUUR aangeboden : Een BENEDEN-VOORKAMER ALCOOF en KEUKEN. Alles behangen en geplafonneerd met stookplaatsen voorzien. Adres met franco brieven onder Letts. W Z bij H. W. KUNEN Boekbinder Doetinchem.,http://resolver.kb.nl/resolve?urn=MMKB08:000089825:mpeg21:a0020:ocr,3,MMKB08:000089825:mpeg21:p003,Arnhemsche courant,938
1710940,1876/04/29 00:00:00,2420,ddd:010062523:mpeg21:a0018,http://imageviewer.kb.nl/ImagingService/imagingService?id=ddd:010062523:mpeg21:p004:image&x=2797&y=567&w=707&h=2420,ddd:010062523:mpeg21,3504,2987,2797,567,4,S. STOKVIS Heiligenweg D. 10 bericht de ontvangst der nieuwste STOFFEN en der nieuwste gemaakte HEEREÏTKLEEDING alles van solide kwaliteiten en voordeelijßo prijzen. (2835) I IJSBRANDSZPANNEN EH VORSTEN. i. S Bekroond met de Zilveren Medaille te - I Heerenveen en met het Zilveren Kruis 1 te Amsterdam in 1875. I Van deze nieuwe dakbedekking zijn j MONSTERS verkrijgbaar bij de Fabri_ ! kanten - LUCAS IJSBRANDSZ & ZOON e (4896) to Makkum. : LOUIS RÖOTHAASf a Singel JJ 414. Amsterdam. CANTATE r ISeofltMlilaEYaiiMStaiieeU OP 18 MEI 1876. Gedicht van H. J. SCHIMMEL. Muziek van W. F. G. NICOL AI. Verschijnt 17 IVÏei a.s. Prijs bij inteekening tot den In Mei a.s. BSBN GULDEN. Buiten inteekening ï één Gulden en Vijftig Cents. i KMerwageos met en zondes1 Stalen Veeren; STRANDSTOELEN rietenTUlN' BANKEN en STOELEN enz. KEBiF.&LJERIIIR [Riet- en MandenfaMek,http://resolver.kb.nl/resolve?urn=ddd:010062523:mpeg21:a0018:ocr,4,ddd:010062523:mpeg21:p004,Het nieuws van den dag : kleine courant,707
2180850,1876/05/26 00:00:00,2170,ddd:110534813:mpeg21:a0017,http://imageviewer.kb.nl/ImagingService/imagingService?id=ddd:110534813:mpeg21:p002:image&x=2176&y=2803&w=1005&h=2170,ddd:110534813:mpeg21,3181,4973,2176,2803,4,Te huur: Een bijgebouw met Iwee ruime Kamers met de Kost. Brieven franco onder lett. __.« Bureau Bataviaasch Handelsblad. (1343) KüTIMEiNSALENHUIS van Mevrouw SC II EE L Molenvliet Hoek van Gang Eetapang. KAMERS 1)1 SP OM DEL f 3584) KOMMEXSALEXHÜIS \an Mevrouw lIEUSSER Passar Baroe Batavia Eten buiten 's huis. Stoomvaart Maatschappij Java. Het vertrek naar NEDERLAND via NAPELS van het Stoomschip C EL E BE S Kommandant 11. ORDEMAN bestemd tot overbrenging der maandelijl_j*che ïnail. is vastg-essteld op Zaturdag II Junij 187t>. des morgens ten 6 uur. De Altenten f 1491) E. MOORMAXN & Co.,http://resolver.kb.nl/resolve?urn=ddd:110534813:mpeg21:a0017:ocr,2,ddd:110534813:mpeg21:p002,Bataviaasch handelsblad,1005
991134,1876/10/12 00:00:00,474,MMHCO01:000068946:mpeg21:a0018,http://imageviewer.kb.nl/ImagingService/imagingService?id=MMHCO01:000068946:mpeg21:p004:image&x=1330&y=1001&w=2091&h=474,MMHCO01:000068946:mpeg21,3421,1475,1330,1001,4,NOTARIAAT-REGISTRATIE. NOTARIAAT-REGISTRATIE. Bij voldoende deelneming wordt 5 November a.s in een der aan 't spoor gelegen plaats in 't Noorden van alle zijden (gemakkelijk te bereiken een O TT lE^ SS TT JS geopend over bovenbedoelde vakken en dit wel DES ZONDAGS. De tijdsverdeeling is zoo geregeld dat zij die een gedeelte van den cursus wenschen te volgen slechts kort ter plaatse behoeven te zijn. Van 9''j—11 ure Burg. Recht (B. W.); van 12'/—2 ure Fiscaalrecht (Registratie); van 2'/—3'/ ure Burg. Recht (Kooph. Rechtsv.); van 4'/j—5 1 / ure Notariaat; van 6'/i—7% ure Fiscaalrecht (Successie Zegel enz.). Per kwartaal wordt berekend f 40. Inclineerenden gelieven zich vóór 17 dezer onder No. 4706 aan te melden bij DE ERVEN J. J. TIJL te Zwolle waarna bij voldoende aanmelding  nadere informatien zullen worden verstrekt.,http://resolver.kb.nl/resolve?urn=MMHCO01:000068946:mpeg21:a0018:ocr,4,MMHCO01:000068946:mpeg21:p004,Provinciale Overijsselsche en Zwolsche courant,2091
4245030,1876/01/13 00:00:00,4203,ddd:010288521:mpeg21:a0021,http://imageviewer.kb.nl/ImagingService/imagingService?id=ddd:010288521:mpeg21:p004:image&x=2078&y=1535&w=1010&h=4203,ddd:010288521:mpeg21,3088,5738,2078,1535,4,") ATELIEfi-CAMEKIK. { \ Photografie. Fc k Horlogerie. f Goudwerken. (4674) \ Jér'ï_.^r^.uer%.^%.jr^.-_'^ ONMISBAAR VOOR DAMES LAIT DIRI^E. T. PIYER ter conserveering van de huid de frischheid en schoonheid van tint. Affi&\ DE EENIGE EN ECHTE ZEEP van LATU VA/SAP (Seul Savon véritable au SUC Dl. LAITUE) ZIJNDE DE BESTE TOILETZEEP. Ji l l'l \hK uitvin-ler ALGEMEEN ENTKEiöT: 10 boulevard de Strasbourg 10 te I'AUMs (3821) en in alle plaatsen ter wereld. ---«—ulimii i il. i „„il a_»»«__.WMnw| il_i«ai»i^l_a-ï»iii.. EEN GEHUWD PERSOON goed bekend met de .Tavaansche taal Admiuistratiewerk en een vlugge en nette hand schrijvende door omstandigheden buiten betrekking geraakt SBOEJISLT PLAATSING. in een handelshuis toko dan wel op een landelijke ondernemiug. Goede getuigschriften kunnen geproduceerd worden. Adres onder Lt M. Bureau Locomotief. [174] EEK JOJTOMMSCH geboren Nederlander kunnende omtrent zijne capaciteiten en zijn gedrag de beste getuigenissen produceeren wenscht met eenige JONGELIEDEN (zeer danslustig) een ten DANSMEESTER te vinden. Adres bureau Locomotief initiale* J. K. [160] tW Eene Dame welke voornemens is spoedig naar Europa terug te keeren zag gaarne eenige kinderen aan hare zorg toevertrouwd gedurende de reis. Ook is zij genegen die kinderen bij haar in huis te houden en voor een gesoigneerde opvoeding zorg te dragen. Men kan zich verzekerd houden van eene goede verpleging. Nadere informatiën te bekomen bij de familie VAN HAEFTEN Soerabaia brieven franco. (130) DOOR VERTREK wordt het Logement „Zeestrand"" vanaf heden opgeheven. Samarang Wed. LAMMERDING 11 Januari 1876. (133) geb. Lama. A G r ü n b e r g Kleermaker Samarang werkt en verkoopt tegen billijke prijzen. (101) RIJPAARD. Te koop gevraagd: een goed afgericht RIJPAARD te gebruiken bij de infanterie. Opgave van prijs enz. letter A. bureau dezer Courant. [175] 7E KOOP-. Drie Stoomfiltc.rprrsen van gewone afmeting met 2 Montejus vergaarbak Koperen Kraantjes en Stoompijpen compleet. Adres Administrateur suikerfabriek Balong Bendo MODJOKTSBTO (5095)",http://resolver.kb.nl/resolve?urn=ddd:010288521:mpeg21:a0021:ocr,4,ddd:010288521:mpeg21:p004,De locomotief : Samarangsch handels- en advertentie-blad,1010
6403152,1876/04/22 00:00:00,3304,ddd:010099983:mpeg21:a0053,http://imageviewer.kb.nl/ImagingService/imagingService?id=ddd:010099983:mpeg21:p006:image&x=2091&y=3560&w=1938&h=3304,ddd:010099983:mpeg21,4029,6864,2091,3560,6,"»_EVAf_lïï_¥TA 4EAEICA. Een Man alhier die niet gaarne zijn naam openlp vermsld ziet is eloor het gebrewk der «IE VALENTA ARABICA van eono ornstige en langelurige Maa^kwaal genezen. Uaarno ben ik bereid mondelings nadero inl'onnati.n to geven.  „__ „ „....„ T Hoogevsen J- VAW i>iiU WOIiUI. Jr. De volmaaktste gezondheid kracht en nieuwen levenslust hergoolt Dc Rcvalcnta Arabica. Slechte spijsvertering diarrhee maag- en onderbuikskwaloii slijni zuur galziekten oprispingon spanning op de maag «inkings hoofdpijn en oone menigte andero ziekten genoest DU BARRY's W.VAI.ENTA speeedig en mot weinig kosten. Als voeding voor kleino Kinderen is zo ook bijzonder aan to bevolen en verdient do voorkeur boven de voeeling me_ molk. Zrj vortoert licht verzunrt niet goel't voel voedsol en gezonde sappen. Zieken kunnen geen beter dieet houden dan zien bij de REVALENTA te bepalen  die op verschillende wijzo zeer smakelijk goreod kan gemaakr woreien. De prrj3 der Bevalen.a is: kleino bussen /1.10 1 _ ƒ 2.10 2 « /3.W ft « ƒ 8-75 12 « ƒ 17. De iÜEVALENTA-BISEUITS in bussen van Itf kosten /2.10. _ ■ • „„.-„„. „ ™ Vr-Vnnv Men lette er vooral op dat iedere bns tot waarborg der echtheid door #F. VON WINDHEIM & _  VEhAOÜIHVIS"" geteekend is. (515/> VERKOOPIIOIS en de bekende Depots. ~mT COPAHIVATES ASSIMILABLES T_ t) A f . . Q P _TIT P T. _$ bestaande uit IJzcrdeelen Magnesia en Teer. Geen Ge- JU Il ü XSt li _£_ ö UH H i U U Il neesmieldel dal sneller werkt goedkooper is en gemakkelijker kan ingenomen worden strekkende tol fe™»»""- ™ftcS{l'ï 'ü en nieuwe ziekten. Depots: Te Arasterdam ULOTH Zeeeelijk; GROOTE Kalverstraat; WAKKKU halverst Kuit; lOUKliü BAUM Weesperstr. 's-Gravenhage SNABILIE; Rotterdam SNABILIE; Utrecht OROTENDOR-1'- VA_ SI'ANJ-. (1565) IKEEL STEM MOND. I PABXIM.I-8 _a>J_ OKBTAIII. Deze PASTILLES genezen spoedig KEELPIJIN SCUORDEID ONTSTERING VAN DEN | mii-IYI- ni.mi'do de prikkeling eloor do TA BAR veroorzaakt en de riadceligo werking van de R*WIK op de JB Tamlen '- Zij worden bijzoneier aanbevolen voor REDENAARS PROFESSOREN en ZANGERS tot behoud I van ele STE»^ dc A thokorg DETHAN faub. St-Donis 00 te Parijs; — ULOTH te Amsterdam; —eude H voornaamste Apothekers vau Nederland. - Prijs ƒ 1.50 do Doos. (29-5) g L BORSTZIEKTEN ê l SIROOP VAN ONDERPHOSPHORIGZURE KALK I? V GRIIU-.UL.T & t'° Apotheker- te PAttVS j I 0 I Sedert 1857 is dit midelel nlpe-moon in ge'lijuik goknmon tor gone'zinjï van den Hoent ' i 0 Verkoudheid Zinkingen de Griep der Kinkhoest en Bor_staandoeningen. Q  liet is vooral bij tering (■% SteopfftuW !_(»>.;idi; d:>' h.l tnlniunleij-fi res-Uftten irp\ey«r\; Yï I onder zijn invloed bedaart i\c (loos!; h. nYilen «Ie imchieiijke uitwai-einipgpß op en de Al O ziekte; krijè- binnon weinig lijd zijne jj._ou.Ut..| uu u'.«i!.i>ei.j i-'ru«D« ifoiie>eshcoren VB AsSÊnrjjVQJl Iftpsclfdef lije} 11. . j{et)i-ik vfiur V_ij i« avoi-eoi tifkc B O KSTFAS T ILIjES van 'H LatUw'*''*- eB Launi-rKtepa van .;i.i_faï-i.i- cl 0. die voldoende zijn ter ge.'iiev.ing van [|8 _. 'p-vonon heiest en verkimdlieMd. Oal n.utual. te; voorkomen yeliove men acht te geven _____ _?_\ Tip de onderteekening GRIMA-U_T & C«. *&% ' f™* Dopot3 In alle goede Hollandsche apotheken. il X-. 0--FT?^^|^'^'•••^0■~(^^^>•-^<^-•^""^-- ~"" C' l 7.2t7_i^i' VmnMtmm^..^ (2394) G«ML STFifIVIGATION GOHP_kNYÖ~ IK ROTTERPiIII eeXOÜTIiOM. mm 'm\\ DE STOOMSCHEPEN VOOR GOEDEREN U VEE VERTREKKEN: VA* BOTTIBR-OAM tferetfeW iederen Dnisdaff Donderdag en Zaterdag. iederen 'Waciisdaff en «atordaff run st. €ATicpiiii<;!f. s■Tl^wwl*Al..l. Te#en eene- {>wfn{ye vr.srluïverboo^iï.^ wonleii f>;_. lileren 'nok freiïfO domioiliè jpftleY(.rd. ""»**») _ SIMITH. AKontem.",http://resolver.kb.nl/resolve?urn=ddd:010099983:mpeg21:a0053:ocr,6,ddd:010099983:mpeg21:p006,Algemeen Handelsblad,1938
381981,1876/12/31 00:00:00,811,MMWFA01:000179209:mpeg21:a00019,http://imageviewer.kb.nl/ImagingService/imagingService?id=MMWFA01:000179209:mpeg21:p00009:image&x=256&y=1255&w=471&h=811,MMWFA01:000179209:mpeg21:p,727,2066,256,1255,16,Advertentie RIJKSTELEGRAAF. KANTOOR TE HOOR \. VERKORTING EX. ■ittm. Rotterdamsohe telegraaf maatschappij . Jlsn. Hollandsche Spoorwegmaatschappij. Rsm. Rijnspoorwcgmaatschappij. Csm. Centraal Spoorwegmaatschappij <tc. r Grand Central Beige”. Ndsni. Noordbrabantsch-Duitsche Spoorwegmaatschappij. Sse Maatschappij tot exploitatie van Staatsspoorwegen. Bse. Algemeene maatschappij tot exploitatie van spoorwegen in België. Wanneer eene der bovenstaande verkortingen nevens het woord „ Aangenomen” voorkomt wordt daardooi aangoduid dat het telegram op eer kantoor der Maatschappij welkt door die verkorting wordt aangewezen  aangenomen is.,http://resolver.kb.nl/resolve?urn=MMWFA01:000179209:mpeg21:a00019:ocr,9,MMWFA01:000179209:mpeg21:p00009,Hoornsche courant,471
2619436,1876/05/20 00:00:00,2609,ddd:011102084:mpeg21:a0022,http://imageviewer.kb.nl/ImagingService/imagingService?id=ddd:011102084:mpeg21:p004:image&x=2089&y=3221&w=1004&h=2609,ddd:011102084:mpeg21,3093,5830,2089,3221,4,": VOOR DEN HANDEL. :! De ondergeteekénden zijn weder voorzien van groote en l<leiiie KANTOOR- en IIANDELSBOEKEN in groote verscheidenheid. PAKHUIS- en VERKOOPBOEKEN voor bijzondere vakkon worden binnen den kortst mogelijken tijd legen billijke prijzen afgeleverd. (485) CIIATELIN & Co. MICHOSCOI'ICAL invcstigalion lias proved lliat tlir decaying &ul>- sianccs- wliïcli ariumulatc bclwcen tlic leclli conlain animal and vcgctalilc parasites and lliat the tuotu powm.r.s paste.* asd washks in cesebal l'sf. liavc no effect u|Min these Mcssis GABItIKL'S COl4Al.ru: TUOTII PASTE IIOYAL DENIIFISICE and ODOX TALGIQUK KI.1X11! coinplclcly destroy and remove liicsc animalculae and also preserve «nd iieaulify tlic TEETH AND GUMS. MESSsl{. GABRIELS' CELEUIIATED-PHEPAIIATIOIVS FOK PRESERVING AND BEAUTIFYING THE TEETII & GUMS AND PREVENTING TOOTIIACHE ARE SOLD BY ALL CHEMISTS & PERFUMERS IN ALL PARTS OF THEWORLD PREPABED ONLYBY MEESRS GABRIEL. DENTISTS LUDGATE HILIi. LONDON.E C. \i««™ „SEDADEN"" THE OHLYBEAL CURE KOU TOOTII-ACHK prcpared fur general usc OABBIEIj'B aficr 25 years expcrience in thcir own practicc xivcs immediate reliëf liy lbo painless deslruclioo of llio iicrve and formt * Stopping. Prire 1/1 jWHÏTB QUTTA PJ3BCHA. ENA MEL. ' "" nor stopping decaycd and tender leetli Renden tlic GEBRIEL'S jtoolb sound and useful Tor m.isti cation; no matter |lio\v f.ir decaycd Prire 1/6. „ CORALITE TOOTH PASTE for clean- sing and improving tbe tecth and imparting a na- GABBIEL'S tural redness to tlic gums whiUns the tcoili without leaving belween tlicin any tracé of powder and gives brilliancy lo lbo Enaniel' Price 10. ~ ROYAIi DENTIFBICE perpared from a 5 "" recipe as used by lier M.ijcsty. Whilens and pre- GABRIEL'S serves tbc teetli and imparts a delicious fragrance lo tlic brcalb gives the Tceth a pcarllike wbitcncss and proleets lbo cnamel. Price 1/iï. ODONTALGIQUE ELIXIR — The CElecbated Moltii Wasii A few drops in water pro„ duces a most ple.i.'ant agrccablc and refreshing • < >*'>' Mouth VYash; it harders llie gums prcvenls the ac- GABRIEL'S cumulation o( tertar gives the brealb a deligblful pertume removing all tracés of lobaceo smeke or unpleasant odour arising from derayed teeili and is an excellent detergent. 5/. OSTEÖ ENAMEL STOPPING warranled to renain white and Qrm as the Tootb ilself. 1 GABRIEL'S Tbis beiuliful pieparalion rcslorcs front leetb and can bc ejsily used. SulDcient to stop sii Teetb Price 5/. '» Fl'LI. DinnCTIONS ton L'SE E.NCLOSKD IN FACU HOX. • Messrs. CA'tPiIKL are parlicularly succcssful in thcir syatem of AIITIFH'JAL TEETII whicb lliey fix Grmly ia lb« moulb by means to an ELASTIC GUM wilhoul springs painlessly and wilhout any operation."" All correspoiidciicc must bc addressed— Messrs. GABIUM DenlisU (12) 72 LUDGATE BILL CITY LONDON.",http://resolver.kb.nl/resolve?urn=ddd:011102084:mpeg21:a0022:ocr,4,ddd:011102084:mpeg21:p004,Sumatra-courant : nieuws- en advertentieblad,1004
1649942,1876/01/14 00:00:00,1759,ddd:010338756:mpeg21:a0010,http://imageviewer.kb.nl/ImagingService/imagingService?id=ddd:010338756:mpeg21:p004:image&x=81&y=113&w=938&h=1759,ddd:010338756:mpeg21,1019,1872,81,113,4,"Surinaanisclie Eank Worden lij iiitchrijving TE KOOP aangeboden: £0 vaten-SUIKER fcikcu stig van plant. Visümcre. Ee veervw arden liegen ter lezing aan bet kantoor der Bank. De opening zal plant? hebben op VQllH*-> gag deu igß. {jrCKCr ten IO irrr. J urun.ari.lo div 1 Jovmuij lh""»G. De Directie. rkntage BE EIEGLUÏIE. ICÖ«T die wegens in 1 *'5 gedane levm.it.e neg iets te leidireu nioj_T liebl en vnn Boveigei oim.lc- Plantage wó/dr*èrzociii: daaraan vóór den kü dezer opgaaf te doen. Veidere leverantien znller alleen gtldig ziu tegen door mij gekekende orders. Parnn.arilo 12 Jauuarij 1876. Ue kenlovrhoudende Adminhlraleur vun de pluntagn de liesolütie O. LUIKEN' HU ET.",http://resolver.kb.nl/resolve?urn=ddd:010338756:mpeg21:a0010:ocr,4,ddd:010338756:mpeg21:p004,Suriname : koloniaal nieuws- en advertentieblad,938
5133609,1876/02/02 00:00:00,2581,ddd:010099905:mpeg21:a0022,http://imageviewer.kb.nl/ImagingService/imagingService?id=ddd:010099905:mpeg21:p004:image&x=2008&y=4259&w=1989&h=2581,ddd:010099905:mpeg21,3997,6840,2008,4259,6,Votsclic ZAIijH per 5 Ons ƒ 3.85. _ e l*_ EYGENRAAM STILSTEEG. F 9. <__> * 9 J/ /^SPECIALITEIT I %m OVERHEMDEN. >M) <J f. ADRIAAf. SCHAKEL . ' __k 1 J'\ ) Hofleverancier van Z. H. den Koning. \ \ / / ° Heiligenweg 11 13 15 lï Jofr\\\ B Jr T\ ahstei_.:dam. (3397) //T \ *2ril IIMAL STËAM MVI6ATIOI\ IiPANÏ. ;t BOfTDRBiH en LOIDOI »ÉillM>DE STOOMSCHEPEN VOOR GOEDEREN EN VEE VERTREKKEN: r VAM MÖTTEMJAM geregeld iederen Dinsdag Woensdag Vrijdag en Zaterdag*. * VAH lOIDOI iederen Woensdag en Zaterdag van St CATHEROES STEAMWHABF. *! Tegen eene geringe vrachtverhooging worden Goea deren ook franco domicilie geleverd. d IJSGAUTO VOOBBEHOUÖ-BH.. (2995) GEBROEDERS OM-TH Agenten,http://resolver.kb.nl/resolve?urn=ddd:010099905:mpeg21:a0022:ocr,4,ddd:010099905:mpeg21:p004,Algemeen Handelsblad,1989
3334112,1876/05/20 00:00:00,3361,ddd:110534809:mpeg21:a0018,http://imageviewer.kb.nl/ImagingService/imagingService?id=ddd:110534809:mpeg21:p002:image&x=3226&y=2963&w=992&h=3361,ddd:110534809:mpeg21,4218,6324,3226,2963,4,Hotel Passar Bahroe. Logies per 554 aren ƒ 3.£SO. Omeubeleerde Kamers te Huur. Eten buiten 's huis in abonnement per maand: fSSSSÜT: : : : : : i IS:= Per portion ƒ I.— Mevrouw VAN SPANJE Ziedses des Plantes. (7793) Ganp: Passar Baroe IMessageries Maritimes. De eerstvolgende vertrekdatums zijn: van BATAVIA van SINGAPORE 1 Junij per Emime 5 Junij per Ava. Nadere informatiën bij de Agenten der Internationale Crediet- en Handelsvereeniging Rotterdam te Soerabaya en Samarang ca te Batavia bij den Agent van bovengemelde Maatschappij (Bi' 2) W. SUERMONDT Wzn. Stoomvaart Maatschappij Nederland Geregelde maandelijksche mail-dienst Het Stoomschip Prins Hendrik Kommandant M. C. BRAAT sal vermoedelijk tegen .Juli a.s. van hiel na NAPELS naar NEDERLAND vertrekken. Lading wordt aangenomen voor bij na alli ïavens in Europa waarvoor directe Connossfr nenten worden afgegeven. Voor vracht en passage gelieve men zich I (1568) Batavia Samarang Soerabam (Stoomvaart Maatschappij H Nederland. kommandai <^xWmM^y[- C- BRAAT in de laat: van >Xci alhier verwact te Tjilatjap komen laden. Voor vracht en passage gelieve men zich t renden tot,http://resolver.kb.nl/resolve?urn=ddd:110534809:mpeg21:a0018:ocr,2,ddd:110534809:mpeg21:p002,Bataviaasch handelsblad,992
1751452,1876/03/31 00:00:00,2531,ddd:010062495:mpeg21:a0030,http://imageviewer.kb.nl/ImagingService/imagingService?id=ddd:010062495:mpeg21:p005:image&x=21&y=2619&w=692&h=2531,ddd:010062495:mpeg21,713,5150,21,2619,10,"Tadverte-Vtiee ; Van 6 of minder regela / 1.20. ledere regel meer 20 Cts. HULPÖ!VMIiWIJZ!.fi : Aan de Openbare School in wijk A te . Sliedrecht (Hoofdonderwijzer DULCURG ; SCHLIEF) wordt ton spoedigste gevraagd een Hulponderwijzer- Salans ƒ 6)oen na een vol jaar verblijf een toelage van /J5O. Brieven en stukken franco aan den Burgemeester vóór 15 April a.s. (373?) Tn de Stads-Apotheek te Alkmaar wordt ¦*¦ tegen 1 Mei gevraagd een bevoegd ASSISTENT op een salaris van f 500. j (sjaars benevens vrije kamer. — Brieven . gorden franco ingewacht bij den President |der Commissie van d Stads Apotheek. "" Een JONGMEMSCH - S 0 jaren oud zag zich gaarne als OPZICHTER of iets dergelijks-geplaatst. I Brieven franco onder No. 1863 aa« het . International 1 Annoncen-Bureau Reguliersbreestraat 16. $113) ; i In eene Stoom-Grutterij tevens Koren-  maalderij vraagt men ten spoedigste _ «en fatsoenlijk BURGERJONGE- _ LING van de Prot. Godsdienst die«jrst- - genoemd vak verstaat. (3741) Adres met franco brieven onder letter O aan 't Hulppostkantoor te Waddinxveen. j T- - ¦—-—— ¦ '—""""5 ""Op eene kleine Binderij wordt tegen 1 Mei a. s. een (3743) flinke BeekMnder gevraagd.'Adres met goede getuigscßriften of in persoon bij H. TEN BRINK te Meppel. aTfrïMMERiM gevraagd bü A. MOLENAAR ; te Zaandam. \6llJ' _ ~Tra Schoeiifflaierskneclits kunnen een dadelijk en de ander tegen lo Mei vast werk bekomen. Men vervoege *ich in persoon of met franco oneven bij ] P- HENDRIKS Mr. Schoenmaker te Velsen. -.._ | --— : f 3000. ColporteüFs. 13000.] Men vraagt zoo spoedig mogelijk een in alle opzichten bekwaam en solied OUii ¦ Ï'OR'PB'ÜR die bijgo-edenwil minstens 1 /JSOOO per jaar knn verdienen ai- i - "" [Worden die voldoende getuigschriften van Pen laatsten tijd kunnen bijbrengen. Brie-!*en franco onder het motto ColporUur. aan het Bureel van dit Blad. (3702)",http://resolver.kb.nl/resolve?urn=ddd:010062495:mpeg21:a0030:ocr,5,ddd:010062495:mpeg21:p005,Het nieuws van den dag : kleine courant,692
3843814,1876/11/30 00:00:00,4262,MMKB08:000087393:mpeg21:a0008,http://imageviewer.kb.nl/ImagingService/imagingService?id=MMKB08:000087393:mpeg21:p002:image&x=1911&y=1539&w=881&h=4262,MMKB08:000087393:mpeg21,2792,5801,1911,1539,4,"Advertentie TB KOOP: Een prachtige Paragon VÉLOCIPÈDE (Bycicle) Engelsch fabrikaat prijs ƒ 130.—  te bevragen met franco brieven bjj A. J. BIEMANS & Zn . Hooge Zeedijk No. 30 Rotterdam. Er wordt TE HUUR GEVRAAGD een net WINKELHUIS zoo spoedig mogelijk te aanvaarden. Franco brieven met opgaaf van stand en prjjs onder No. 681  aan het Bureau dezer Courant. Wordt gevraagd: Tegen Februarij aanstaande eene ""nette fatsoenlijke DIENSTBODE  om als Meid-Alléén op een klein Buiten te Oosterbeok te dienen. Franco opgave waar en bjj wien gediend hebbende  onder No. 682 Bureau dezer Courant. — — In een klein gozin WORDT GEVRAAGD om dadelijk in dienst te treden eene zeer bekwame KEUKENMEID Of NOODHULP van goede getuigen voorzien. Adres onder No. 680 aan het Bureau dezer Courant. A GENTBN GEVRAAGD door een solied Huis in WIJNEN te Bordeaux. Goede conditiën. Franco brieven aan den Heer H. VAN EK  27 Rue Ferrère Bordeaux. Euglisli Laiigiiage. Mr. KENDRICK (University of London) teaches private pupils by the objective method conversation reading and composition. Pupils prepared for special examinations. Koningstraat F. 54a. Mejufvrouw M. J.| JANSEN in Modes Nieuwe Plein met primo Januari) aanstaande hare zaak aan Mejufvrouw V. H. STADLMATR overdragende wenscht de nog voorhanden zijnde Goederen tegen verminderde prijzen OP TE RUIMEN. Van HOUTEN'S zuivere oplosbare CACAO in POEDER verkrijgbaar in blikken van ƒ 1.60 f 0.85  f 0.45  bij W. A. VAN DER HORST & Co Turfstraat Arnhem. Alle burgerlijke Rijksambtenaren en Oud-Ambtenaren in Arnhem en omstreken woonachtig worden uitgenoodigd tot het bjjwonen eener BIJEENKOMST op Zaterdag 2 December a. s. des namiddags ten twee ure  in het Gebouw der Loge (Rjjnstraat) alhier ten einde alhier te vestigen : eene afdeeling van het Pensioenverbond van welk Verbond de Statuten zjjn vastgesteld in eene Algemeene Vergadering van Afgevaardigden te Utrecht den 28en Augustus jl. het voorl. bestuur Mr. C. G. BIJLEVELD Rechter in de Arr.-Rechtb. Mr. J. H. ANDRÉ DE LA PORTE Rechter in de Arr.-Rechtb. B. A. JANSSEN Directeur van 't Postkantoor. J. J. T. EVERS Controleur der Dir. Bel. enz. Stolïwerck'sche Borstbonbons uit de Fabriek van Gebr. Stollwerck keizerlijke en koninkl. nederlandsche Hofleveranciers te Keulen het beste sedert 40 jaren ingevoerde en beproefde huismiddel togen hoest heescbheid enz. op alle tentoonstellingen zoo als ook op de laatste in Philadelphia met de hoogste Prjjsmedailles bekroond wordt verkocht te Arnhem door J. J. H. Adrion L. Frikkers ; J. Groot Rijnstraat; van den Heuvel frères; A. Ilollender ; Apotheker II. N. Rutgers; F. Schmeink  G. A. Smits en Vernimmen en Fuchs; te Velp bij Apotheker C. Koek; te Groenlo bij J. H. Huyskes. ï",http://resolver.kb.nl/resolve?urn=MMKB08:000087393:mpeg21:a0008:ocr,2,MMKB08:000087393:mpeg21:p002,Arnhemsche courant,881
1552500,1876/11/28 00:00:00,2250,ddd:010062725:mpeg21:a0050,http://imageviewer.kb.nl/ImagingService/imagingService?id=ddd:010062725:mpeg21:p006:image&x=1435&y=48&w=690&h=2250,ddd:010062725:mpeg21,2125,2298,1435,48,8,Tweede Meid Loon ƒlOO. Tegen lo Februari verlangt men te Amsterdam eene in allen deele bekwame TWEiIDE MEID P. G. keurig Strijken is een eerste vereischte. Alleen die zeer bekwaam zijn in haar Vak komen in aanmerking. Adres met franco Brieven met opschrift: Loon ƒlOO bij den Boekhandelaar J. NOORDENDORP N. Z. Voorburgwal bij den Dam 159. (8944) Men vraagt om spoedig in dienst te treden eene gezonde fatsoenlijke Hollandsche of Duitsche Burgerdochter niet onder de 25 jaar goed kunnende wasschen en strijken en in staat zich algemeen nuttig te maken om met jonggehuwden naar Zuid-Afrika te vertrekken. Hoog loon mits van goede getuigschriften voorzien. Adres met franco Brieven onder letters W M. bij den Boekhandelaar J. C. SCHRö- DER Kalverstraat hij den Heiligenweg 174 Amsterdam. (8913) ATT~ÈNTIE. Men vraagt zoo spoedig mogelijk eene fatsoenlijke BURGERDOCHTER van den P. G. om in het Buffet en Huishouden behulpzaam te zijn. Degenen die hiertoe genegen zijn gelieven zich persoonlijk aan te melden aan het Advertentie-Bureau van KOK & VRIJLANDT Boekhandel te Gouda.. Ibtow Vau LweFiÉita Heerengracht over de Warmoesgracht 194 verlangt tegen Februari of eerder eene bekwame nette KEUKENMEID van goede getuigen voorzien. Men adresseere zich in Persoon vóór een ure aan bovenstaand adres. (89431 tegen 1 Mei a. s. te Muiden aan de Heerengracht een welingericht HUIS bevattende zes ruime Kamers Keuken en verdere gemakken desverkiezende met TUIN. Te bevragen bij den Heer C. TIMMER Mr. Timmerman te Muiden en te Amsterdam Singel F 259. (7970) Te Huur Aangeboden: Moderne Huizen Bovenhuizen en Winkelhuizen waarvan één een Hoekhuis is. Huurpijs van af ƒ 800 tot en met ƒ 300 per jaar en eenige Weekwoningen van ƒ 2.25 per week dadelijk of later te aanvaarden. Franco te bevragen bij den Makelaar 11. OVEREEM Andrieskade No. 4. (8897),http://resolver.kb.nl/resolve?urn=ddd:010062725:mpeg21:a0050:ocr,6,ddd:010062725:mpeg21:p006,Het nieuws van den dag : kleine courant,690
99712,1876/04/25 00:00:00,128,MMKB08:000089827:mpeg21:a0004,http://imageviewer.kb.nl/ImagingService/imagingService?id=MMKB08:000089827:mpeg21:p002:image&x=1077&y=4477&w=779&h=128,MMKB08:000089827:mpeg21,1856,4605,1077,4477,4,Advertentie Ingezonden mededeolingen betreffende zaken van particulier handels- en n ij verheidsbelang.,http://resolver.kb.nl/resolve?urn=MMKB08:000089827:mpeg21:a0004:ocr,2,MMKB08:000089827:mpeg21:p002,Arnhemsche courant,779
2659020,1876/05/01 00:00:00,2730,ddd:110534792:mpeg21:a0011,http://imageviewer.kb.nl/ImagingService/imagingService?id=ddd:110534792:mpeg21:p002:image&x=1152&y=112&w=974&h=2730,ddd:110534792:mpeg21,2126,2842,1152,112,4,"mmmmmmmmmmmmmmmmmmmmmmUmmmmmmmmmmmmmmmmmmmmmm | PETZ & Co. Photographisch Atelier. ISoordwijk. (7303) --i- i-i- -imm-i | „ -1 —n-Tii— i ■"" rr~ir ■—-*—""■ T'llOTOORAPlIIE."" hei' ___rr__i_i__r.L is geopend van 's morgens 7—ll uur. OLLAND | IV oord w ij k:--(7305) — Norwieh Union Fire nsuranee Society o. opgericht m 1821. KAPITAAL t 550000. De ondergeteekenden hoofdagenten van bo vengenoemde Maatschappij . gaan voort verzekeringen te sluiten tegen BRANDGEVAAR op de gebruikelijke voorwaarden. VAN BEEK REINERE ._: Co. Sub-agenten : G. A. WERMÜTH Samarang. WILLE GANS .. Cn. Soerabava. M. OHL & Co. Mak.i. .ar. PI7RVIS & Co.. P_dan_. (6656) Nederlandseli-Indische Spoorweg- Maatschappij. ■______-__-------_-■ Voor de lijn BATAVIA BUITENZORG It gezocht een t «?l «*_._• ïi.i Co p- Zi l: t «* i•. Retlecteereuden geleven zich met franco brieven of in | wenden tot den onder- I t..n DE CHEF DER EXPLOITATIE. BAILLY St. LAUREI.T. Uitverkoop wegens veitrel* mei I<> Rabat^ van hcilcn tot den 15 Mei 1870. (1381)",http://resolver.kb.nl/resolve?urn=ddd:110534792:mpeg21:a0011:ocr,2,ddd:110534792:mpeg21:p002,Bataviaasch handelsblad,974
5250242,1876/11/08 00:00:00,4786,ddd:110534954:mpeg21:a0006,http://imageviewer.kb.nl/ImagingService/imagingService?id=ddd:110534954:mpeg21:p001:image&x=3159&y=1437&w=1097&h=4786,ddd:110534954:mpeg21,4256,6223,3159,1437,6,Verkrijgbaar: tuitmixiatend g-elirnid St. Nicolaas Gebak per pond en per blik:. Tokohouders genieten ruim rabat. C. STRUNCK Soc. Concordia. N.B. Bestellingen buiteu Batavia moeten vergezeld gaan van remise. (3708) Ontva noen: DIVERSE FACTUREN ! BIJOUTERIEN. Benevens: Een groot factuur IIOROLOGIES in alle mogelijke genr<-si. (3935) VAN ARCKEN. Dagelijks verkrijgbaar: tVERSCH Bt Nicolaas Gebak Banketletters. Tokououders genieten rabat. (3932) CAVADINO & Co. *&> ST. NICOLAAS Pllp? CADEAÜX. BEI- MOUVEAÖTÉ3 DE PARIS: BIJOUTERIEDOG'ÓEN. HANDSCHOENDOOZEN. ZAKDOEKDOOZEN. DAMES NECESSAIRES. PORTRETLIJSTJES. TOILETSPIEGELTJES. PRESSE-PAPIERS. INKTKOKERS. ASCHBAKJES. HOROLOGIESTANDAARDS. ZAKFLACONS. BALBOEKJES. BEDAKDOOSJES. PORTEMONNAIES. PORTE CARTES. Bronzen Beelden PRESENTGLAZEN. KARSPELDEN. COIFFURES enz.. Ceintures Jeanne d'Arc laatste Smaak i;i groote keuze. (4008) CAVADINO & Co. __—————————-——————-————————___—_—__ Jfe St. Nicolaas ffi' fü _a ■__ *a fi i ~üf ■ o._ UaueaUZi PEN ZILVEREN SERVETBANDEN. BLOEDKORALEN COLLIERS. BERGKRISTALLEN ',http://resolver.kb.nl/resolve?urn=ddd:110534954:mpeg21:a0006:ocr,1,ddd:110534954:mpeg21:p001,Bataviaasch handelsblad,1097
2267552,1876/09/23 00:00:00,3056,ddd:010984825:mpeg21:a0025,http://imageviewer.kb.nl/ImagingService/imagingService?id=ddd:010984825:mpeg21:p004:image&x=1553&y=2359&w=742&h=3056,ddd:010984825:mpeg21,2295,5415,1553,2359,4,In de Gemeente Cuyk en St. Agatha Provincie Noord-Brabant wordt .gevraagd: een lEDIIM DOKTER of GENEES-. HEEL- EM VERLOSKUNDIGE. Aan die betrekking is voor de waarneming der Arinenstractijfe een vaste jaarwedde van ƒBOO.— behalve de medicamenten verbonden. Sollicitanten geheven zich onder overlegging hunner diploma's jranco te adresseren aan den Heer BURGEMEESTER van bovengenoemde Gemeente vóór den i° Oclober aanstaande. (8730) HULPONDERWIJZER Aan de Openbare Lagere School te Loon-op-Zand  wordt gevraagd een Hulponderwijzer op eene jaarwedde van ƒ5OO.—. Sollicitanten worden uitgenoodigd hunne stukken vóór 20 October e. k. franco in te zenden aan den Burgemeester. (8747) MANÜFACTÜREM. Men vraagt zoo spoedig mogelijk op een net dorp een burger Juffrouw R. K. niet beneden de 25 jaar goed bekend met bovengenoemd vak < van goede getuigschriften voorzien en die tevens genegen is in het huishouden be- ' hulpzaam te zijn. Zij die eenige kennis bezitten van het modisten genieten de voorkeur. Men adresseere zich met franco brieven onder lett. X. V. bij A. T. van Hooydonk Boek- en Papierhandel te Nijmegen. (8746) p. a grüpïnkT' O 34. HEILIGEN WEG D 34. CiROOTE AFSLAG. PUIK. KOFFIE THEE 65 60 Ct. per 5 ons. 70 Ct. ƒl.— ƒ1.25 62[57}» bij 56? ƒ1.50 per 5 ons. Bloemen-Thee 25 Ct. per Pakje. (8761) G. B. van GOOR ZONEN debiteeren met succes: J. KRAMERS Jz. NOUVEAU DICTIOMAIRE Francais-Aeerlandais et Neerlaodais-Francais. Dit werk onderscheidt zich door GOEDKOOPHEID en VOLLEDIGHEID. De SB de el en bevatten niet minder dan 395© bladzijden van 3 kolommen ieder van 88 regels en nochtans wordt het geheel afgeleverd tegen ƒl*.— in 2 linnen banden en tegen ƒ 14.— in 2 s e:: rij n lederen banden een prijs zoo mterst gering dat men voor meer dan drie zooveel bevattende pagina's no~ geen cent betaalt. (84i)8),http://resolver.kb.nl/resolve?urn=ddd:010984825:mpeg21:a0025:ocr,4,ddd:010984825:mpeg21:p004,De Tĳd : godsdienstig-staatkundig dagblad,742
263074,1876/03/16 00:00:00,266,ddd:110534754:mpeg21:a0002,http://imageviewer.kb.nl/ImagingService/imagingService?id=ddd:110534754:mpeg21:p001:image&x=96&y=4298&w=989&h=266,ddd:110534754:mpeg21,1085,4564,96,4298,4,"Okw"" De Bibliotheek vau het Bataviaasoh-Genootschap van Kunsten en Wetenschappen is geopend elke we.-k (les Woensdag en Zaturdags van 71 2 tot 9 ure en des Zondag-3 van 8 tot 11 uur.",http://resolver.kb.nl/resolve?urn=ddd:110534754:mpeg21:a0002:ocr,1,ddd:110534754:mpeg21:p001,Bataviaasch handelsblad,989
3631658,1876/12/02 00:00:00,1622,ddd:011194530:mpeg21:a0016,http://imageviewer.kb.nl/ImagingService/imagingService?id=ddd:011194530:mpeg21:p004:image&x=1107&y=2398&w=2239&h=1622,ddd:011194530:mpeg21,3346,4020,1107,2398,4,i Norllißnlisli and Slcrcantile liisurasice Companj. SiOJV:a^^bÏNBIIRG. ' - ESTABLISUED 1809. \ ' _ IncorporateU by ROYAIi CIIARTÜII. <t-. _____ ■ - ■ X^xreslö-eixt. ! llis Grace the Duke of . Roxbu»-g K. G. | . Vlo© Presidents. . Tlis Grace the Duke of Sntherland' K. G. Ilis Grace the Duke of Abercorn. * '3 Sutosoritood oapital 2 000.000 pd. st __—_• •..■: ■■ - . |||| ; Paid up Capital ;v' * ' ' 250.000 pd. Ster!. • Fire\Reserve Fund ' 1.040.744 » » . Incojiié of the Fire: Department . 917.178 » » v For the véar.endiiie 31 st. December ; 1875. All losses settled liberally and proniptly. SAML. BARSER & Cw. : . ; General Agcnts for British and:Dulch Guyanai CBÜSEËNHÜÊT Sub Agent for Dutch Guyana. ... ' •* .... f ',http://resolver.kb.nl/resolve?urn=ddd:011194530:mpeg21:a0016:ocr,4,ddd:011194530:mpeg21:p004,Surinaamsche courant en Gouvernements advertentie blad,2239
869934,1876/12/14 00:00:00,1174,ddd:010984894:mpeg21:a0017,http://imageviewer.kb.nl/ImagingService/imagingService?id=ddd:010984894:mpeg21:p002:image&x=2321&y=3967&w=741&h=1174,ddd:010984894:mpeg21,3062,5141,2321,3967,6,"SJu*e*a»»ÉS.»«?*»Ii«g«r5n»g-ei«jiJe-i..-- STAD BRUSSEL. 3 pCt. AAND. a fr. 100. LEENINO 1872."" 24«fe Trekking op 11 December. N° 215C31 fr. 15C00 | N° 196503 fr. 500 Losbaar 1 April 1877. 8 pCt. TURKSCHE AANDEELEN a fr. 400. LEENKO 1870. 41rte Trekking op 30 November. N° 650380 fr. 600COO Nr. fr. Nr. fr. Nr. fr. 126001 60000 1O4O300 20000 1302773 20000 De volgende Nrs. met fr. 6000: 113405 440084 488656 828577 938216 12818S4 De volgende Nrs. met fr. 3000: 311416 404272 828576 93S220 1133109 1667817 403376 488640 904142 1111209 1301083 1917064 De volgende Nrs. met fr. 1000: 168811 527269 638348 1040648 1176957 1302775 227470 581452 G55854 1109801 1176958 1499189 869066 581454 66SS00 1109803 1205594 1640212 4C0744610892 828579 1111210 1301085 1832165 488638 6108931006243 1133106 Losbaar 1 Juni 187"". 298ste Staats-Loterij. Prezen van ƒ1000 en daarboven. 5de Klasse 6de Lijst: N° 12210 /2000 N° 72 500 2535 en 15654ieder ƒ 1000.",http://resolver.kb.nl/resolve?urn=ddd:010984894:mpeg21:a0017:ocr,2,ddd:010984894:mpeg21:p002,De Tĳd : godsdienstig-staatkundig dagblad,741
1182102,1876/11/19 00:00:00,1454,ddd:010586856:mpeg21:a0033,http://imageviewer.kb.nl/ImagingService/imagingService?id=ddd:010586856:mpeg21:p008:image&x=2831&y=4139&w=813&h=1454,ddd:010586856:mpeg21,3644,5593,2831,4139,8,"Gimborns Maagzout vereenigt in zich de eigenschappon van het _^ bader Enter eu MariJnbad ar ioni e» wijst uitmuntende diensten bij hoofdpyn ▼«* *Tj» en slechte spijsvertering benevens de *""""' 'me daaruit voortkomen zoonis mnngpij"". ""^ jj^en aambcijen en in 't algemeon de riekten ™' e\jt men zich van laxeermiddelen bedient. In Te doozen ___ 00 cent. STAAL WIJN. een Het it van algemeene bekendheid».dw^Bar het onmisbaar bestanddeel van ons bloed is- . tffBjjin te geringe hoeveelheid voorhanden is ZJ iriijkB sappigheid bleekzucht en klierzickten de ow gevolgen. Van alle ïdogenasröde ij*erpra«p^^s deze oplossing de tfefefchiktst*. Één eetlepel 80(jj gram ijzer in een ligt verteerbaren vorm. kost / 1. BOTERPOEDER ]e lioter verkort den tijd van het kamen """"?'R en vef vaster beter van smaak  fraaijer van kie ..„. hindert het sterk worden tn pakken voiaue 500 kan melk i 30 cent. ...(^ 0f Wer arf/M (V. «ene uitvoerige gelruikiaanv»]- Verkrijgbaar in de bakende dcpMs: Akkrum A.S. Visser; Bolsward R. S. Dokkum J. J. -Hansma; üragten D- ' ((„rlin- Franeker J. Drager; Gorredijk s-G„ «verdiep gen I. L. Mirande £___.; Heerenveen H- u p. oen W. Zwart; Kollum Wr. Jellema ; Ko in # van der Wnl; Leeuwarden S. &cr""m. S. &• L. Braun; Makkum J. B. de Boer; «cnftl''. P<ü»»i Barüema; Oldoboorn F. G. Veldman ; önei  Qc3lel. tei-naard J. J. Hoogeboom; Workum ""■ 'n {n i» baan; St. Anna-Paro.hie H. K. Ferwera» bekende dépöto in de andere «teden. Gu|goß>'^ Emmerik. H. von .^^",http://resolver.kb.nl/resolve?urn=ddd:010586856:mpeg21:a0033:ocr,8,ddd:010586856:mpeg21:p008,Leeuwarder courant,813
2204323,1876/11/28 00:00:00,2189,ddd:010288792:mpeg21:a0006,http://imageviewer.kb.nl/ImagingService/imagingService?id=ddd:010288792:mpeg21:p002:image&x=72&y=3188&w=1007&h=2189,ddd:010288792:mpeg21,1079,5377,72,3188,6,"Woensdag- 29 November Vendutie in het lokaal van ""01* - A MEIJER Op vendutie zullen nog worden verkocht: 300 picols Koffie. _>00 kistjes Zeep. 5015 A. MEIJER. — Woensdag den 29en dezer Vendutiia het Vendulokaal vau *°°1 F. H. BOÜMA Op mijne Vendutie -___T V(7OE-NTSDAG tal ik verkoop.n voor rekening van b.hnghebband.ni 1 ljb 727/41 15 Jasten ieder inh. ÏOO pakjes Ultramarijn door reewater beschadigd gelost ut bet Nederl. schip Dordrecht 11 kapt. C. J. ROTGANS 8038 F. H BOUMA. Op mijne yendutie van Woensdag Bal ik verkoop in a tout prix: 2 kisten Speelgoed in houdende: Diverse soortengekieede e_nge«leede Poppen Wagens Paarde» diverse Dieren Keukengereedschap Militair Speelgoed ent. 5084 P. H. BOUMA. Op mijne vendutie van Vrijdag 1 December worden verioc'it; 400 picols Koffie in soorten. 5063 G. A. WJBRMIJTH.",http://resolver.kb.nl/resolve?urn=ddd:010288792:mpeg21:a0006:ocr,2,ddd:010288792:mpeg21:p002,De locomotief : Samarangsch handels- en advertentie-blad,1007
354438,1876/08/14 00:00:00,522,ddd:010062622:mpeg21:a0029,http://imageviewer.kb.nl/ImagingService/imagingService?id=ddd:010062622:mpeg21:p004:image&x=748&y=3194&w=679&h=522,ddd:010062622:mpeg21,1427,3716,748,3194,12,Buiksloter Tolhuis. Wegens besloten partij GEEN TOEGANG voor het Publiek in de Zalen en een gedeelte van den Tuin op Maandag 14 Augustus 1876. (239?) Wij vestigen de aandacht op onzen heerlijken PORTWIJN die a één Gulden per halve flesch buiten de f_es_h verkrijgbaar is bij VERWBY & CO. Heerengracht bij de Warmoesgracht.,http://resolver.kb.nl/resolve?urn=ddd:010062622:mpeg21:a0029:ocr,4,ddd:010062622:mpeg21:p004,Het nieuws van den dag : kleine courant,679
2288660,1876/09/26 00:00:00,2060,ddd:110534917:mpeg21:a0011,http://imageviewer.kb.nl/ImagingService/imagingService?id=ddd:110534917:mpeg21:p002:image&x=14&y=4194&w=1111&h=2060,ddd:110534917:mpeg21,1125,6254,14,4194,4,Portland Cement merk Knigt Bevan en Sturge. Voor prima kwaliteit wordt gegarandeerd. (3012) W. H. HALL & Co. Mm. J. DUFFOURC. Ohemises sur mesure (1847) Patjenongan. Stemmen repareeren en einhalleeren van PIANO'S ORGELS enz. enz. J. BELLE. (3035) S oord u-ijk. Piano Makers Atelier VAN DER PUTTEN & LEFÈBRE voor aUe voorkomende REP ARATIEN Vleugels. Piano's en Orgels. STEMMEN in en buiten abonnement. (15-25) IPHOTOÖRAPHIE. ;[ EMST ATEI .1 ER Is dagelijks geopend. OLLAND NoordwiJ li. (7305) Bij eene 1° ii mil i e alhier $|P ■? bestaat gelegenheid tot PLAATSING Wi van KOSTKINDEREN. Adres Brieven Franco Letter X. (3421),http://resolver.kb.nl/resolve?urn=ddd:110534917:mpeg21:a0011:ocr,2,ddd:110534917:mpeg21:p002,Bataviaasch handelsblad,1111
3004250,1876/10/29 00:00:00,3050,ddd:010100961:mpeg21:a0071,http://imageviewer.kb.nl/ImagingService/imagingService?id=ddd:010100961:mpeg21:p008:image&x=1030&y=3769&w=985&h=3050,ddd:010100961:mpeg21,2015,6819,1030,3769,10,"MAWUFACTCREW. Een Jongmensch P. G. 4 jaren in bovengenoemd vak werkzaam  zag zich gaarne VERPL AATST  liefst in eene der steden van de provinciën Groningen of Friesland. Adres franco onder lett. M. aan het Advertentiebureau van i M. B. A. KONING te Deventer. (29454) . ~~ÉEN R7Ë7ÏEISJÈ ' 21 jaar BIEDT ZICH AAN tegen l November in een of anderen winkel trgeu e no kleine vargoeding. Brieven franco lett. X. X. Bcraau Handelsblad. (39513) SEYFFARDT'S MUZIEKHANDEIT"" Gocdkoopc Uitgaven. Voorhanden voor Piano 3 b. C. VAN TAL Schettisch et Galon / 0.50. C. VAN TAL Le repos aprèj lo bal » 0.50. Th. OESTEN op. 3i Martha « 0.70. T. HPIAIDLER op. 41 Maulöckchen » 0.30. D. KRIJG VVcnu dia Schwalben // 0.25. *». SSIITH Songe d'une nuit d'été de Mendelssohn.» 0.70. STRASNV Kutschkc Polka u 0.25. FRANCOIS Rtii naar do Maan » 0..30. SEYFFARDT'S Muziekhandel. (39507) Door bijzondere omstandigheden wordt in eene der Hollandsche staden aan ean actief JongmeESch dis over eenig vermogen beschikken kan icno goedo GEVESTIGOE Z4AK. TER OVERNEMING aangeboden. Deza Handels- en Winkelzaak waaraan vele relatie'a verbonden zijn kan voordeelig worden uitgebreid Alleen op eigenhandig getcekende brieven wordt regard geslagen en franco onder lett. Z. ingewacht bij den Heer A. KNOOP Klein Heiligland te Haarlem. (195 4) TE KOOP AANGEBODEN voor f 7500 een HUIS opbrengende f fiS't buur 's jaars staande alhier aan de EGELAAiTIESIMGEiACHT. (37-78) Gegadigden adresseeren zich franco onder motto HUIS asn den Kantoorboekhandel BUKMAN & SARTO'. lU3 Rokin 17. SWBVKRVERU. IJI-MerD."" CHEMISCHE KUNSTWASSCHERII va» (39451) 4». M. Wessendorf. Bij deze heb ik de eer mijner geachte Cliënt èla te berichten d>it \\ steeds voortga met bet verven van ZIJDEN en WOLLEN STOï'FEN in alle dessins; ook beveel ik mijne KunstwasscheMÖ vaa HEEREN- eu RAVZESGAROEROBES en alles wat het vak Verder aangaat beleefdelijk aan. MA«AZIJI¥ : WAUMOESSIiJAAT lU.. JtöiEXSTRAAT 140. Alle lichte Rhumatische aandoeningen worden na een kort gebruik van de ABSHAIiIIBISS OF ANTHIHIMTME WATTEÏS geheel hersteld alsof zij nimmer bestaan hadden. Pr js 30 Ots. per pakje met gebruiksaanwijzing. Hoofddepot brj A. BRWH'VELT Az. te Delft en verder bg: A.F. Benken Amsterdamhoek i Wed. F. G. Seydenzaal-Erjfert Vg/endamen Warmoesstr. Amst Vijzelstraat. H.J. Renken Jr. Amst N. Z. | Gez. Putz Amst Reestraat Vo >rburgw;el lm. k Molsteeg. bij deKeizersgr. in de Nieuwe W.A.Schade & Zonen Amst. FakkeL Leilsch.straat in da Vlijt. F. A. Hesselvelt Amst. hoek Meurs & Cv Amst. liap-.nburg. Prinsengracht en Anjelier' H. Leniiiig Jr. Damatr Amst straat. (34007) TE HUUR AANGEBODEN met' I°. December een VRIJ BOVENHUIS bevattende 5 Kamers Keuken Zolder Meidenkamertje en voorzien van Duinwateraanleg en Gasleiding- desverkiezende met overname van Spiegels Klecden Gordijsen en Gasernamenten gelegen in de P. O. Hooftstr.iat. Huurprijs ƒ550. Franco te bevra- Sen onder lett. M. W. bg de Boekh. A.G.&P.G.VANLOM .alverstraat 189 alhier. (39495)",http://resolver.kb.nl/resolve?urn=ddd:010100961:mpeg21:a0071:ocr,8,ddd:010100961:mpeg21:p008,Algemeen Handelsblad,985
2533032,1876/01/16 00:00:00,2606,ddd:010099888:mpeg21:a0016,http://imageviewer.kb.nl/ImagingService/imagingService?id=ddd:010099888:mpeg21:p003:image&x=3967&y=4243&w=972&h=2606,ddd:010099888:mpeg21,4939,6849,3967,4243,8,"S KACHELS!! voor PETROLEUM of STEENKOLEN PETROLEUM KOORTOESTELLEN LAM. PEN VERLAKT BLIKWERK en meer andere HUISHOUDELIJKE A R TIKELEN worden tot de CIVBELSTE PRIJZEN GELEVERD door B.H. VASLINSCHOTEA HEILIGENWEG 49. (1691) OP EEN \SSIJRffIIEK\I\TOOR wordt GEVRAAGD voor Copieeren en loopwerk: een fatsoenlijk JONGMENSCH eeno goede hand schrijvende. Eeflecteerenden adresseeren zich met eigenhandig geschreven brieven franco onder lett. A. E. bij den Rantoorboekverkooper R B DEWESEN op den Haarlemmerdijk bg de Korten Prinsengracht UU 18 te Amsterdam. (1631) HLAMTOORo ■Rekend met Cargadoors- en Avariizaken moderne talen zeer net kunnende schfijven wenschte hier of buitenslands GEPI AATST te worden. Prachtige referenten goede familie. Adresseer franco Vijzelgracht bij de Baangracht N° 61 onder Letters S. B. (lelO WINKELJUFFROÜW. _ Tegen Februari of later wordt GEVRAAG» eene JUFFROUW bekend met het vak van Garen en Band P- b- « ""liiÖR ƒ 100 100 S EfVÉRVAI"" lUUII J 1 „_r«__-KMElSJiEvandenP. G. wordt GEVRAAGD een -»»-!*_j!k zenen Wasch opdoen gewend met kinaeren om to g*- ._ 0(m q{ . b »'• ™ <""»»> ——_   t/^gMENSCH '20 jaar oud sedert drie Een beschaafd J^B(.urg in den Effectenhandel werkzaam jaar op *^_%__ï]_AAT3T als BEHIENDE of als BOEK- M^mén in een Handelszaak in Nederfand. Reflcctecren- HOsjB»«|» vn w.jeven met opgave van conditiën te adreseeren onder lett. B. 0. franco Bureau Handelsblad. (1608) Alen verlangt op een Kantoor te dezer stede een JONGIMFNSCH  goed kunnende lezen schrijven en rekenen wen een aanvankelijk salaris van ƒ 250 'sjaers- en m eene nette Winkelzaak een WINKELBEDIENDE tegen een aanvankelijk salaris van ƒ 5 's weeks. Brieven franco onder lett. L. 0. Bureau Handelsblad. 0&30) EEN ENGELSCHMAN BIEOT ZICH AAN tot het Examen voor te bereiden alsmede om in korten tijd het Engelsch te leeren spreken en schrijven. Motto Engclsch. Adrei LOMAN & \LRbIhR Kalverstraat 14. O6B^",http://resolver.kb.nl/resolve?urn=ddd:010099888:mpeg21:a0016:ocr,3,ddd:010099888:mpeg21:p003,Algemeen Handelsblad,972
4801280,1876/10/23 00:00:00,3410,ddd:010062694:mpeg21:a0070,http://imageviewer.kb.nl/ImagingService/imagingService?id=ddd:010062694:mpeg21:p008:image&x=1443&y=1802&w=1408&h=3410,ddd:010062694:mpeg21,2851,5212,1443,1802,8,""" Groote Najaarsmarkt te ïïïtgeest op WOENSDAG den 25ste_. OCTOBER 1876. 1 ö___llM-_l-_lsl_ly|-]_|| _Slll van GecomP°seer(ie Salsaparilla Zacht en zeker geneesmiddel zonder Kwik voor de radikale genezin"" der Huidziekten. _ Ontstekingen overloop van gal puisten jeuking rheumatische pijnen en kwaad bloed. r Personen die aan die ingewortelde ziekten lijden kunnen zich met het vo_te vertrouwen tot dit plantaardig zuiveringsmiddel wenden dat het bloed verzacht en de gezondheid herstelt. Hoofddepot voor Neder and bij H. H. ULOTH te Amsterdam: bij D. WAKKER Kalverstraat 196.  (5925) ' NAAIMACHINES Door benadering zijn ver beneden Fabrieksprijzen TE KOOP een partij TBAPen HAKD-—IAOHI—TES extra solide qualiteiten. Tevens onderricht en garantie. Inlichtingen en bezichtiging Ferdinand Bolstraat No. 23 en R'echtboomsloot boven No. 101 Amsterdam. (6740) I£ Kr ""I'ere'wien eere toekomt. I De Ondergeteekende verklaart bij deze dat hij in een der Kistjes Sigaren van I den Heer HEGENER te 's Hage heeft gevonden de aanwijzing voor het Cadeau van I] DUI-E-X» GTJLDEM"" welk bedrag hem onmiddellijk tegen afgifte der aanwij- 1 ' zing is voldaan. 1 P. W. MEIJER Fabrikant van Zuig- en Berspompen enz. enz. i Lindengracht PP 75—78 Amsterdam. Hony soit qui mal y penseü Uitslag der verkochte Tienduizend Kistjes Sigaren: f De Heer P. W. MEIJER Fabrikant te Amsterdam f 1000. Mejuffr. B. W. KOSTER Hamerslop te 's Hage » 500. De Heer A. MESLIER Kattenburg te Amsterdam ...... 500 » A. W. POORTMAN Zeedijk » .... 5> 300. » E. A. SPONK Utrechtschestr. » ?...» 200. » J. HOUKING Valkenburgerstr. » » 190. » A. J. V. te Vlissingen „ 200! > KOKER te Dedemsvaart 3> 25 » FRANK te Rotterdam ** » 25. » CORN. v. P. te Nieuwediep "" . j 25.' » KRUGMAN te Rotterdam . » 25. Mejuffr. T. P. S. te Haarlem.  . » 25. » W. v. P. te Zierikzee » 2ö! | Van de overige namen is ten mijnen/Kantore inzage te verkrijgen. De spoedige verkoop en de vele nabestellingen geven mij aanleiding NOG i EEMS en wel voor het laatst tienduizend kistjes elk inhoudende HoDderd I fljne Slïraren van ƒ250 ƒ360 en ƒ450 gereed te maken waarvan er 128 I stuks zullen voorzien zijn van een aanwijzing op de navolgende prachtige en doel- M matige CADEAU-.. leder die bij ontvangst van zulk een kistje niet tevreden 1 is over de qualiteit der Sigaren kan dezelve tegen restitutie der betaalde gelden | i onder rembours terugzenden onder voorbehoud dat de daarin gevonden enveloppe i H in haar origineelen staat is gebleven. H No. 1. 1 aanwijzing ter waarde van ƒlOOO. * o' 4 aanwijzingen ieder ter waarde van ƒ5OO. . . » 2000. » 3. 1 Muziekdoos 8 airs met zichtbare trommels en schellen welke door drie Chineesche poppen worden geslagen ter waarde van » 300. S 1 » 4. 1 Brandkast ter waarde van ... „ 300 » 5. 1 Muziekdoos 6 airs voix célestes ter waarde van » 250.' » 6. 1 Garnituur Pendule en Candekbres verguld met Porselein stijl Louis XVI (haute nouveauté) ter waarde van ...... „ 459 * l' \ Gouden Remontoir quinze rubis ter 'waarde van » 12o'. °- 1 Anker Moet et Chandon ter waarde van . . . » 130. I » 9. 1 Singers Trap-Naaimachine ter waarde van . . » 100 *-?• i Gangklok Régulateur met slagwerk ter waarde van » 60."" » 11. 10 aanwijzingen ieder van ƒ25 te zamen. . . » 250 *!:KJ? s ' 1000 Sig. i ƒ3O tezamen » 15o'. I  *_Ü__! * * * 100 SiS-è/25.tezamen » 250. C 128 aanwijzingen ter gezamenlijke waarde van ƒ 5080. De vinders dezer aanwijzingen kunnen desverkiezende de volle waarde aan R 1 i contanten ontvangen. — Tegen toezending van Postwissel Postzegels of op | |j franco aanvrage tegen rembours worden de Kistjes door het geheele Rijk onmid- » h g dellijk verzonden. Bij bestelling van 5 stuks franco aan huis. ff v Ben Haag lieuvehavenstraat 1. ' I JOSEPHÏÏS J. P. ÏÏEGENEE. Is O PS. Het Magazijn is geopend van 's morgens 10—2 en des avonds van 6—B i uren alwaar de Cadeaux in natura zijn te bezichtigen. Bestellingen van B V _\ 5 stuks franco aan huis. (4792) Mj - d*Hl|lllalHlMH*ia|l|*>>Mi^^",http://resolver.kb.nl/resolve?urn=ddd:010062694:mpeg21:a0070:ocr,8,ddd:010062694:mpeg21:p008,Het nieuws van den dag : kleine courant,1408
1604741,1876/02/26 00:00:00,461,MMGAVL01:000000754:mpeg21:a0033,http://imageviewer.kb.nl/ImagingService/imagingService?id=MMGAVL01:000000754:mpeg21:p004:image&x=1136&y=5256&w=3481&h=461,MMGAVL01:000000754:mpeg21,4617,5717,1136,5256,4,Advertentie DE PILLEN TOT HET BEVORDEREN VAN EEN LANGS- LEVEN van 1) r . BRISSAUD bloedzuiverend atvoerend en bederfwerend gebaseerd op het stelsel Raspuil genezen spoedig de verzuimde Verkoudheden Tering Borstziekten Kwijning en Verstoppingen in den onderbuik. Door haar gebruik vordwijnen Huiduitslag Puisten in het aangezigt en Bloodgebreken op verwonderlijk snelle wijze. Zij die eon kwaadaardige wond hebben zullen haar van daar zien veranderen een gelukkige wending nemen en eindelijk genezen onder den weldadigen invloed van dit Geneosmidde!. Na verloop van drie of vier dagen dat men er gebruik van maakt deelen de Pillen tot liet bevorderen van een lang leven aan de Urine een zeer welriekeuden geur mede en blijven zeer lang werken eer zij tot ontbinding overgaan 't geen een zeker bewijs is van eene gelukkige vorandering in het organisme en herlevende gezondheid. Doze Pillen zijn omgeven van eene laag Suiker waardoor zij met het grootste gemak worden ingenomen. (Men leze de belangrijke brochure die bij eiken Flacon wordt gevoegd.) Fr. '-J.GO de Flacon. Men vordere de Handteekening van Dr. BHI8SAUI). Generaal-depot te Brussel 26 Boulevard extérieur du midi; te Venloo in alle goede apotheken. dhbnaH .ts-wnhmiW » .m IU HTS .1,http://resolver.kb.nl/resolve?urn=MMGAVL01:000000754:mpeg21:a0033:ocr,4,MMGAVL01:000000754:mpeg21:p004,Venloosch weekblad,3481
3339250,1876/04/11 00:00:00,4625,ddd:010062506:mpeg21:a0036,http://imageviewer.kb.nl/ImagingService/imagingService?id=ddd:010062506:mpeg21:p004:image&x=2805&y=541&w=722&h=4625,ddd:010062506:mpeg21,3527,5166,2805,541,4,"¦X-^ALaEMEE^HE VEREENIGDE ¦3J COMMISSIE VOOR DEN WA¦ TERSNOOD bericht dat de volgende bij haar ingekomen zijn: ¦ Bij Jhr. Mr. C. J. A. DEN TEX: Los ¦ Graicos ƒ5O; W. ƒ300; F. A. & J. K. A. ¦ ƒ10; 11. J. K ƒ10; D. Keijzer Voorzitter ¦ van het Tooneelgezelscbap Aurora te Edam ¦ ƒ 178; G. O. en L. J. L ondanks patentver¦ hooging ƒ 25; De vier volgenden door den ¦ Burgemeester te Veenendaal opbrengsl ¦ collecte der gemeente ƒ437.78; opbrengsl ¦ collecte Openbare School ƒ 21.56; opbrengsl ¦ collecte school v/d Heer Mulder ƒ 15.03. ¦ opbrengst collecte Meisjesschool van Mej ¦ Pels ƒ7.10; Officieren Ambtenaren min¦ dere geëmploijeerden en werklieden van ¦ 's Rijks Marinewerf ƒ 474.121/2; Commissie ¦te Zeist ƒ1550; Commissie te Bommel ¦ (Overflakkee) ƒ330; Van de Redactie der Crt. bij haar ingekomen certif. I W. Schuld 2pCt. groot ƒ 100; Burgemees¦ ter Wijhe ƒ 383 34; Commissie te Zuidzande ¦ ƒ 75.391/2; Commissie te Cadzand ƒ 101.16; ¦ Meer ontvangen dan opgegeven ¦ Commissie ts Sioten ƒ412 37 en een paar ¦ vreemde munten; Burgemeester St Anna¦ land (Tholen) ƒ161.75; 11. K. No. 2 ƒ5; ¦ Arbeiders der Stoomspinnerij en Weverij' ¦ te Veenendaal ƒ103.26; Opbrengst der ¦ uitvoering van de ZangvereemgingEWjo¦ nia te Hengelo ƒ135.05; H. A. H. ƒ25--¦ R. J. M. d. G. ƒ21.62; V. 11. ƒ 25; Red! ¦ Delftsche Courant bij haar ingekomen gif¦ ten ƒ500; Sociëteit Harmonie Sas van ¦ Gent f 85 75 11. J. van Eek Burge¦ meester Axel ƒ4.50; Burgemeester Hellen¦ doorn ƒ243; E. Appy opbrengst soiree ¦ musicale te Haarlem ƒ309; Zr. Ms. afge¦ zant te Brussel 2e storting ƒ1000; Burge¦ meester Bodegraven opbrengst collecte ¦ ƒ502.25 en opbrengst collecte bijzondere ¦ school ƒ9; p. a. Riedel van eenige inge¦ zetenen van Wijdenes en Oosterbeek ƒ35; ¦ Burgemeester van Tholen ƒ425.61 V"" i J. A. I S;/10; G"" h' f'ioi W- S. J. ƒ5; Wed. S. ¦ ƒ10; K. ƒ5; 11. J. L. ƒ5 Wed. J.B /19.80; ¦ opbrengst concert liedertafel «Apollo» en I orkneftvereer""g'')S per Aspera ad Astra ¦ J 131.50; Burgemeester van Dockum ƒ3BO ¦ bopaia Maria Christina ƒ5; Hulst burge¦ meester Genemuiden ƒ260; commissie te ¦ 4e bijdrage ƒ 1000; gezellige bijeen¦ «mst te Bresk.ens ƒ 7.«91/2; opbrengst too¦ neeivoorstelling door het liefhebberij gezelschap «Ruijsch» te Krommenie ƒ195; I m£LThSe le^xel- 34°; burgemeester v I be™bU^'n/75VCurSemeester Drie- MdtS2J ? ¦ °Pbre""Sst voorstelling door ¦ Kolómaa. Werfdepot en van de dienst¦ doende schutterij te Harderwijk ƒ192--¦ commissie te Vlissingen ƒ600; Mof coupons ¦ ca postzegel. ƒ3.49; Wed. J ƒ4.50; W. S. ¦ / 3; door tusschenkomst v. H. N. H. te Londen I °' /1260; C' B' '""tdenspeelpot ¦ ƒlO Burg. en Weth. te Velsen ƒ314.90; ¦ Burgemeester en Weth Soetermèer ƒ2341 ¦ burgemeesteren Weth. Zegwaart ƒ127 971/' I fflr CoriSeDe /iso' - ¦ Kamer «luimopt to Zwartsluis fV\mv«- I Medemb Ik ƒ 220 80 k ¦ meentebstuur Opperdoes ƒ17120 Vt Ibl^ur^r^^tr^^^80-7^ |mensh.ievendn;!'^pi!:nb7^^rv- I meester van Fijnaart c. a. ƒ45101 Bur- I huchtSa^ttMn¦}&'' Collecte seh°ol g<=ƒ 200 • oobedfn' S?a""J*ard Nieuwediep f /ut oPble«§-staergymnastiekuitvoerin/ gegeven door de Amsterdamsche Gymnaft.ekyereen.gingen «Isthmia» AmsteU Gym nastiekvereeniging Uchilles» ""liracht ™n' Vriendschap»: eu de VeWinzJ. ¦ . ?  ri'as» ƒlOll 90- M ?clouPeae-club «Veloburn ƒ6557 n \Mp BarZem' Valken/"">f'9oDcfrwr Va"" EwP. Lisse f 915 RuTo -Pm ' S^retaris 0-d""v«meap ƒl3 '¦ Sto™ « W> Van 01d«markt flóo^ btoim van 's Gravensande Burgemeester Lonneker ƒ347; de in 'de vorige advertentie vermelde bijdra-e van den Burgemeester te Hekendorp ad ƒ 153 sa is bijeengebracht door de gemeente 11? ktl°rP^os3; eem*emgeL_£erus: w<yle/70;5°; gemeente Papekop ƒ29 85 Bij Mr. J. A. SILLEM: Voor de Noodlij denden door den Watersnood A Z Awmissie te Gouda 2e storting ƒ32'"" 181/„ Bij Mr. I J. G. VAN OgM>P: Van'de leerhi|en der Coornhertsschoo^27.ssl/8. lij Mr. R VAN REES: Nog een kleinigheidje voor den Watersnood van P v D ƒ 1 Bij H- VAN EEGHEN; Van n! IJ ƒ300; P. A. O. t is zaliger te geven als te ontvangen ƒ d; het Personeel der Biei brouwerij- Azijnmakerij »de Gekroonde Valk* ƒ3O; de Hervoimde Gemeente te Muiden Kerkcollecte ƒ4O; H. .1. K. te Nieuw Pekela postwissel ƒ37.50; H. D Terwel Burgemeester te Oegstgee-t bedrag der collecte aldaar ƒ215; Joh. Enschedé & Zoon te Haarlem 1 pak kleeren en het bedrag der bij hen ingekomen gelden ƒ310.90; J. P. G. Muller Predikant te Dinxperloo bedrag Kerkcollectc aldaar ƒ61.20; van de directie van de Standaard. 5e storting ƒ650. Bij A. M. BAP.GE: N. N.ƒ 10; N.N.voor de noodlijdenden van den watersnood ƒlO Eij Mr. J. P. TEDING VANBERKHOüTi Door een dienstmeisje ingezameld ƒ7 25 Bij Ds- H V BERLAGE: van .1 B. ƒ3.96--uil Edam f' 5 ..... ƒ10; I. G. ƒ49; H. W. fWO. ' i BÜ C. P. VAN EEGHEN: van N.N. ƒlOO1! leine psumngen van de kinderen der voor-",http://resolver.kb.nl/resolve?urn=ddd:010062506:mpeg21:a0036:ocr,4,ddd:010062506:mpeg21:p004,Het nieuws van den dag : kleine courant,722
6268492,1876/06/18 00:00:00,6557,ddd:010972901:mpeg21:a0071,http://imageviewer.kb.nl/ImagingService/imagingService?id=ddd:010972901:mpeg21:p008:image&x=1063&y=360&w=956&h=6557,ddd:010972901:mpeg21,2019,6917,1063,360,8,"___/ N° 211 ._&_B__ * ****■*■ Jpjmm NEDERL. FABRIEK VAN LEDERARTIKELEN ZEGELAAR & fl"". Mcuwendijk H 311 het 3de Huis van de Zoutsteeg AÏB STERDAM. Groote Sorteering HEEREN-ZOltflEß-BOTTBNES voor gevoelige voeten in STOP CHEVREAU en GLACÉ. Fijn Lederen en Stoffen DAMES-AARZEN met eb zonder Louis XV hakken. Stof Chagrin-Glacé- en Goudlederen DAMES-WANDELSCHOEMTJES met Louis XV hakken model Mac-Mahon. GROf.TE KEUZE Piine DAMES-PANTOïïELS <n KENDEe-.LAARS.BES. (147) Alles tot de alom bekende lage vastgestelde prijzen. JE. H. Bfl_€_HE_lfl AMM  Jllaeliincfabriek HELMOND. SPECIALITEIT van MACHSNES ter BEWERKENG V.m BïETALEN. (14085) STOOMWBKKTÜIGEN DRIJFWERKEN POMPEN. sXTRA lnilll ZEEGRAS evcren D. & M. GROOTES GEBRs. te Westzaan franco aan Boord of Station bij pirtij tegen fl 1/2 per pak van 100 KG. Proefpakken aƒ 8 ond;r inzending van Postwissel. (162) ""PÉTRÖLEUiVIKOOKTOESTELLEN uitmuntende door een zeer solide bewerking sierlijke vormen geheele reukeloosheid en uiteist billijke prijzen zijn in groote verscheidenheid zoowel met koperen als met ijzeren Kacheltjes onder Garantie verkrijgbaar in het MAGAZIJN VAN HUISHOUDELIJKE ARTIKELEN Meuwendijk 'S. 161. Tevens voorhanden een uitgebreid assortiment van GOEDEREN benoodigd tot inrichting eener Huishouding solide vervaardigd en zeer voordtelig in prijs. D. WOLFF (i 2070) Fabrikant vaa Metaalwaren portlatcb-cemeotT PRBMA ENGELSCHE QUALETEET. Wekelijksche aanvoer voor binnenlandsch gebruik en uitvoer. Merk RIESELP&SON per Vat ƒ6.60 per 25 Vaten ƒ6.30 en per 50 Vaten ƒ6 ook merk KNIGHT BEVAN & STURGE is mede verkrijgbaar benevens allerlei prachtige BOUW ORNAMENTEN in PORTLAND GIPS en TERRA COTTA etc gWßS**** ' Adres: PLELTSIER & Comp.  Amsterdamsche Cementsteenfabriek over het Paleis voor Volksvlijt N°. 789. (163) Warmoesstraat 187 TSt njunTrlÜEs. ItE . W* Mn prijzen zeer goedkoop «iMlria Zijde  Garen Naalden ■'SsSjgPB Olie en;. 09395) * A. LEWEKBTEIIV. Een *WENE4EL.BCEFROUW kan dadelijk GEPLAATST worden. STEENHOUWERIJ EÏ FABRIEK M \\mwm SCHOORSTEENMANTELS. ©RHESI_EW3_E_Im"" VAN CIPS ES PORTL. GE9IENT van DOBBEVANPELT.'S-HERTOGENBOSCH. Specialiteit van Marmeren SCHOORSTEENMANTELS en GRAFMONUMENTEN. Groote sortering voorradig. Alles wordt volgens Teekening ten spoedigste vervaardigd. Inlichtingen eu Prijscouranten verkrijgbaar aan het Magazijn 47. Kantoor Gerard üoustraat 130 Amsterdam. NP. Verzoeke voor Amsterdam vooral goed op het adres te letttn ter voorkoming van misleiding. (20353) OBIüEÏI-JiirFHÏil O. Z. VOORB. RGWAL 3de huis van de Pijlstoeg  J 158 Speciale behandeling van GEHESME ZEEBATEN. (167 Dr. EWIOH te Keulen beveelt het gchruik aan van zijn HAEMOIIRUOEDAL en JBCEBTWATES&  en PASTBLLE. Hrochuies franco. Depots te Amsterdam bij JOHN MA.VOR STILL en Wïo. G. D. NIEMAN. (H 41148) (19917) g ZOMER KOSTEN M FRANCO I Ba verisendeH wij op franco aanvrage een 100 bladzijden dik m Ëf& met vesl gi tuigschriften van gelukkig gciiezenen voorzien |@ I UETTRERSEL ÜBT Du. AERY'S NATUUR- M Ij Een ieder die zich van d-s voor- 9 H treffslijkheid van het geïllustreerde 400 blz. dikke ori- m H gina.ds Werk. (Prijs slechts ƒl bij eiken Boekhan- W _ delaar verkrijgbaar gesteld) wensclit te overtuigen ma g ontbicde het BIBTTRERSEL vau RECHTERS I | BOEKIEANE»EL te NIJMEGEN. _ PS~ Geen zieke verzuime het zich met de beproefde §2 1 »k AERY'S NATUUBIGENEESWEJIZE be-1 Jf KALMEERENDE SIROOP ~^^ f BROMIUM POTASSIÜMI VEIIMENGD GETROKKEN UIT BITTERE ORANJE-SCHILLEN tan J. P. LAROZE Pharmacicn 2 RUE DSS LIOH3-SAINT-PAUI. A PAHIS Hartaandoenin.en Epllepsio Hysterie Migraine alle Zsnuwlijden eu Slapeloosheid bij kinderen. Te Amsterdani : DLOTH 40. D. WAKKEH. M (8530) BHÏTfiri?U Volkomen GENESSNG bewezen _\__U_a.J_B_?B. door talrijke Certificaten. Bijzondere behandeling der moeielyke en verlatene gevallen. J. WAERSEGERS Breukmeester der Hospitalen ca des Legers Komuiandeur en Ridder van verschillende Orden 25 Scnoenmarkt Antwerpen. Consult alle dagen van 9 tot 6 uur. (10796) MiBÏSGHE GQIBALLEN TE ALPBRSS3ACE3 tegen hoest en aandoeniiig der slijmvliezen; htt is een losmakend en verzachtend middel dat onmiddellijk de priikeliagin de luchtpijp waardoor het ho sten ontstaat wegneemt. Doosjes van 20 en 40 Ct. Hoofddepot bij A. W. &RÖOTE Kalverstraat 43 en verder bij ULOTH Zeedijk; BRANDTSZeedijk;VORSTMAN Keizersgr. hij dc Spiegelstr.; CLEBAN Heiligenweg. (1755) ÜÜTt anllase ittj. ö *ml -fc *X* ïxer Ma a ï. (FRANKRVIC departement de I'ALLIER.) ïüseraitosiu van den fr__nehe_ SïSaat. Administratie : PARI.IS Si Boulevard Montmartr*. E 3 A\. 23 - £3 A\. X *£3 O EJ r»J Aaa hetEiabUssenient van Vichy eon der best geinstallecrdo ?an Europa vindt men Badsn «m stortbaden van allerlei soort voor do bshandtling der maag-lever-en blaaifiekten hot jrsveel óq jicht pisvlojd en piszitkten etc. Elkon dag van af den 45 mei tot don 15 september : Theatre on Concert in het Casino. — Muiiek iv hot park. — Leesiaal. — Gereserveerde Salon voor Dames. — Ispiel —conversa- —en billardzalen.  ' _~ . 1 Allo spoorwegen porrespo-nderen op Viehy. Amater lam 481 Prinsengracht bij de Bereustraat. {661}",http://resolver.kb.nl/resolve?urn=ddd:010972901:mpeg21:a0071:ocr,8,ddd:010972901:mpeg21:p008,Algemeen Handelsblad,956
3028988,1876/11/26 00:00:00,3662,MMKB04:000166760:mpeg21:a0014,http://imageviewer.kb.nl/ImagingService/imagingService?id=MMKB04:000166760:mpeg21:p003:image&x=21&y=1852&w=826&h=3662,MMKB04:000166760:mpeg21,847,5514,21,1852,6,Advertentie Aan den Handel. Het AGENTSCHAP der Stoombootdienst van de Heeren W. MEETER & Co wordt van af heden niet meer door mij waargenomen. Van de Zwolsche en Rotterdamsche Schroefbooten van de Heeren W. J. & H. SCHUTTEVAER te Zwolle blijft hetzelve op de gewone wijze bestaan. P. S. ENGERIN6. Schiedam  25 November 1876. (662) TH 11 UIT 31» TE HUUR AANGEBODEN een zeldzaam zeer laag bij de weg staand en van alle gemakken voorzien riant BOVENHUIS gelegen aan den WESTERSINGEL. Te aanvaarden Mei a. S. Huurprijs ƒ 700. Franco brieven Letter S aan den Boekhandelaar W. A. HOOGVELD te Rotterdam. (665) in het Park HONINGEN te KRALINGEN tegen 1 FEBRUARI of 1 MEI aanstaande DE VILLA MOV BÏOU met fraai aangeJegden TUIN  groot circa 2000 vierkante Meters. Bevattende het Huis zeven meerendeels bijzonder aangename VERTREKKEN voorzien van VERANDA SERRE en BALKON voorts MARMEREN GANG van vele gemakken voorziene ruime KEUKEN en KELDER DIENSTBODENKAMER enz. Te bevragen ten Kantore van den Notaris W. VAN TKAA posthoornsteeg alsmede bij den Heer W. VAM HATTEM Az„ Hoogstraat N°. 381 over de Steigersche Kerk te Rotterdam. (654) Een net en goed onderhouden RIJTUIG Phaeton-Auiericalne toet verzetbare kap uit de Rijtuigfabriek van den Heer ALEX. D'IETERIN tc Brussel. Te bezichtigen en te bevragen bij den Heer J. 0. DOLK Mr. Zadelmaker te Rotterdam. (653) Verhuurkantoor van Dienstboden (536) hoek OPPERT van B. M. SPANJEItSBERG. Aan bovenstaand Kantoor 7ijn nog voorhanden goede DIENSTBODEN voor dadelyk; ook de Dienstmeisjes die nog niet voorzien zijn kunnen dadelijk een GOEDEN DIENST ^bekomen. Ook vraag ik nog voor buiten de Stad voor een Gesticht eene goede KEUKENMEID en 3 KAMERMEIDEN. Getrouwde Rieden zonder kinderen; kan ik ook plaatsen.,http://resolver.kb.nl/resolve?urn=MMKB04:000166760:mpeg21:a0014:ocr,3,MMKB04:000166760:mpeg21:p003,De Maasbode,826
3795294,1876/12/05 00:00:00,3754,ddd:010486954:mpeg21:a0009,http://imageviewer.kb.nl/ImagingService/imagingService?id=ddd:010486954:mpeg21:p002:image&x=1095&y=2167&w=1011&h=3754,ddd:010486954:mpeg21,2106,5921,1095,2167,6,Etablissementen Derosne & Cail MAATSCHAPPIJ CAIL & Cie. No. 15 Quai de Grenelle è Paris. CAIL & Cie. | te Parijs Denain Yalenciennes en Douai. CAIL HALOT & CIE. te Brussel. Fabriekanten en Constructeurs van STOOM- en andere WERKTUIGEN IJZEREN BRUGGEN en GEBOUWEN IJZEREN KAPPEN LOCOMOTIEVEN en SPOORWEGMATERIEEL IRRIGATIE- en LANDBOUW-WERKTUIGEN enz. enz. Specialiteiten voor Sieraiacleeie Agentschappen te Havana Brazilië Porto-Rico Martinique Guadeloupe La Reunion Mauritius Egypte en Java. Ondergeteekende neemt de vrijheid bovengenoemda Maatschappij aan to bevelen aan H.H. Militaire en Civiele Ingenieurs Industriëlen Aannemers en speciaal aan H.H. Landheej-en en Suikerfabriekanten om hare uiterst solide doelmatige en zorgvuldig afgewerkte Machinerie. Bij beter werk zijn de prijzen niet hooger dan die van anderen terwijl de kolossale fabrieken en werkkrachten waarover de Maatschappij te beschikken heeft haar in staat stellen de grootste werken in korten tijd uittevoeren. Inlichtingen te bekomen bij ondergeteekende on bij de Heeren B. F. DE LANGE Suikerfabriekant te Bajeman Probolingo. J. G. J. BREIJMAN idem te Pagongan Tagal. Chs. J. LEWSEY Ing. Werktuigk. te Tjiledóek Cheribon. Brieven aau ondergeteekende te adresseren bij de Agenten de H.H. G. SUERMONDT & Co. te Batavia Soerabaya of Pasoeroean. ii e DORREPAAL & Co. te Samarang. M. VAN GEUNS Jzn. Ing. representant der firma CAIL & Cie. houdende voorloopig kantoor in de localen der H.H. G. SUERMONDT & Co. te Batavia. 4185 Oude Firma Briet. Gashoud__.de Dranken Medaillen en eer o olie vermeldingen op de Wereldtentoonstellingen van Parijs 1855 Londen 1862 P-Rilt 1807 Lïon 1872 Weenen 1873. BRIET'S GAZOGENE TOESTEL ter onmiddellijke zelfbereiding van JS-ltzer Viohy . odawa.or Mousserende Wijn • Spultwat.r etc. Door middel van het hierbij afgedrukte eenvoudig kleine Toestel van Briet zoo algemeen bekend kan men zelve onmiddelijk en zonder de minste chemische tennis een uitmuntend Spuitwater (Seltzèfwater) bereiden ; hetwelk in kwaliteit 1 verre de alle tot hiertoe bekende gashoudende dranken (sip hons óf sodawaters) overtreft. De bijval van het Gazogène Briet is vooral te wijten aan de herhaalde verbeteringen welke dit Toestel ondergaan heeft. Te bekomen bij MONDÜLLOT FILS. Ingénieur- Werktuigkundige 72 me du Ch_teau d'Eau te Parijs. — Te Bata. via bij H. M. van DORP en Cic Doorloupcüde toestellen voor de industriële fabricatie van gashoudendo dranken seltzerwater sodawater enz. Stelsel Mondollot zondor gazometer de eenige in gebruik bij de pharmacie centrale der Hospitalen te Parijs. De verzending geschiedt geheel en al gereed om te werken. Verklaringen en breedvoerige prospectussen bij de hierboven vermelde depothoudcre. 2060 Ontvangen: ■II MIJIIS YOOE 1877. Prijs/ 150 franco per post ƒ 2.— j 455» G KOLFF fc Co ',http://resolver.kb.nl/resolve?urn=ddd:010486954:mpeg21:a0009:ocr,2,ddd:010486954:mpeg21:p002,"Java-bode : nieuws, handels- en advertentieblad voor Nederlandsch-Indie",1011
469935,1876/11/21 00:00:00,531,ddd:010338845:mpeg21:a0010,http://imageviewer.kb.nl/ImagingService/imagingService?id=ddd:010338845:mpeg21:p003:image&x=116&y=3986&w=885&h=531,ddd:010338845:mpeg21,1001,4517,116,3986,4,"laiüß '* i-j ï% 'i' i si*. i%. Hervormde Gemeente. jfTT^^r*' Godsdienstoefening «a**""*^ op WOENSDAG 22 Nov! des avonds ten 7 ure.",http://resolver.kb.nl/resolve?urn=ddd:010338845:mpeg21:a0010:ocr,3,ddd:010338845:mpeg21:p003,Suriname : koloniaal nieuws- en advertentieblad,885
4090164,1876/06/17 00:00:00,4082,ddd:010288652:mpeg21:a0022,http://imageviewer.kb.nl/ImagingService/imagingService?id=ddd:010288652:mpeg21:p004:image&x=1077&y=1623&w=1002&h=4082,ddd:010288652:mpeg21,2079,5705,1077,1623,6,Pas ontvangen: ZEILDOEK in verschillende soorten zeer geschikt voor huiszeilen. Billijke prjjs. P. VEBSCHUUB 1689 Spekstraat. 1 Houtkap-Onderneming Tempo e r a n. Balken Dolken Sirappen en gezaagde houtwerken Brandhout en gros en per picol. Adres: F. M. Hornung Zeestrand No. 74. De Administrateur [914] IMMERZEEL. Reparatie onder guarantie van alle soorten UURWERKEN (3340) Chs. BOYEB Bloemstraat. Etablissements Paren. Schaken Houel et Caillet. Compagnie de Eives-Liile. pour constructions Mécaniques et Entreprises Société anonyme Capital: 6000.000 Francs Atelier de Constructions 159 Rue de L'université Paris. Five-Lille (Nord) et a Givors (Rhone) Installation complete de Sucreries et distilleries systèm Savalle Moulins a cannes appareils a cvi dans le videappareils a évaporer dans le vide pouvaut travailler a doublé effet Générateurs Chaudières a déféquer et a carbonater et autres appareils et machines en usage dans les Sucreries. Charpentes et Ponts en fer. Matériel Roulant et Matériel Fixe pour Chemins de fer. Locomobiles Machines et Matériel d'exploitations Houillèrcs et d'Usines métallurgiques. E. DELAUNAY Ingenieur representant de la Compagnie de Five-Lille aux Indes-Neerlandaise. Batavia 23 Oct. 1875. Met verwijzing naar bovenstaande advertentie heeft de ondergeteekende als medevertegenwoordiger en hoofdagent van de Compagnie de Fives-Lille voor Ned. Indië de eer haar bjj H. H. Suikerfabrikanten en aannemers van publieke werken aan te bevelen met bekendstelling wjjders dat als Subagenten te Samarang en Pasoeroean respectievelijk zjjn aangesteld de Heeren C. A. REIJERS en GIJSELMAN & VAN RINKHUDZEN bij wie mede de noodige informatiën | te bekomen zijn. Mr. R. VAN EIBERGEN VAN SANTHAGENS. Batavia. 13 October 1876. £1482] (xymnastiesciiool. Ouders en voogden worden op deze hoogst nuttige inrichting in het belang hunner kinderen en pupillen attent gemaakt. De leergelden zijn thans vastgesteld op f 3.— f 2.— en f I.— per kind en per maand respectievelijk voor de eerste tweede en derde klasse van betaling. Gedurende de lessen welke dagelijks van 5—6 uur gegeven worden wordt toezicht gehouden door Commissarissen en wel: des Maandags door den Hr. HEYNIS. „ Dinsdags „ „ „ ROMEIJN. „ Woensdags „ „ „ KA.FFMANN. „ Donderdags „ „ „ FRERIKS. „ Vrijdags „ „ „ EIJKEN. „ Zaterdags „ „ „ VAN DE POL. Bjj elk van de HH. zijn verdere inlichtingen te bekomen; ook bij den Hr. N. KLOESMEIJER en bij C. E. v. KESTEREN President. P. ZWAGER 932] Secretaris. JSJEÏEÏÏ-M& Sr. (Eortademstraat SAMARANG.) Horologemaker Graveur toovoolt zloh beleefd _____l. [1750],http://resolver.kb.nl/resolve?urn=ddd:010288652:mpeg21:a0022:ocr,4,ddd:010288652:mpeg21:p004,De locomotief : Samarangsch handels- en advertentie-blad,1002
4321088,1876/07/08 00:00:00,5048,MMSADB01:000007281:mpeg21:a0029,http://imageviewer.kb.nl/ImagingService/imagingService?id=MMSADB01:000007281:mpeg21:p005:image&x=935&y=147&w=856&h=5048,MMSADB01:000007281:mpeg21,1791,5195,935,147,8,"Advertentie De Notarissen A. P. BOLSIUS Jr en V. VAM DE MORTEL gevestigd te 's-Hertogenboscli  /uilen aldaar in het Koffiehuis het Parleine/t bewoond door Mej. de Wed. VAN VLIET Dinsdag den 18 Juli 1876 /eilen en Dinsdag den 1 Augustus 1876 finaal Verkoopen telkens des avonds/ten 7 ure: Onder Rosmale 1. Een pt/rceel Hooiland  y(enaamd den sRouwenkamp in de Lunerkampen kadaster sectie/ A. N 741 ter grootte van 2 Hectaren 14 Ai/en 50 Centiaren. Opbrengst bij publieke verpachting in 1875 f 202 en in 187/ ƒ 157. 2. Een perceel Weiland met daarbij gelegen Bouwland genaamd den Annenberg kadaster sectie A. Nos 584 585 590 en 602 ter grootte vaii 5 Hectaren 89 Aren 90 Centiaren. Verhuurd tot ^79 voor ƒ 243 per jaar 3. Een perceel /Bouwland genaamd den Rijtakker kadaster sectie F. N° 1760 ter grootte van 2 Hectaren 10 Aren. Verhuurd tot 1878 voor ƒ125 'sjaars. Binnen /s-Hertogenboscli. 4. Vier Huisjes of Woningen onder één dak metr Erven  staande en gelegen op de Hofstaö nabij het Hinthamereinde gemerkt E. ^56 257 258 en 259 kadaster sectie H. N/s 2147 2148 2149 en 2150 ter grootte vai/ 72 Centiaren. Ie4cr afzonderlijk verhuurd voor 75 per week. fetaaldag der kooppenningen 1 Sepiber 1876. Tot/het bekomen van inlichtingen vervoege men /zich ten kantore van bovengenoemde Notarissen. IJe Notaris van de mortel gevestigd te 's-Hertogenbosch zal al/aar in het Koffiehuis het Parlement beyoond door Mejuffr. de Wed. A. C. VAN VLIET Dinsdag den 18 Juli 1876 v/ilen en Dinsdag den 1 Augustus 1876 finaal Verkoopen telkens des avonds/ten 8 ure-. Binnen 's-Hertogenbosch. 1. Een goed ter /ering staand Winkelhuis en Erf in de Snelüyöstraat gemerkt H. 24/ kadaster sectie G. N"" 693 ter grootte vaur 48 Centiaren. Bevattende groot Winkelhuis Binnenkamer nog twee Kamers Kelder Privaat eu grooten Zolder iryet afgeschoten Kamers. Verhuurd aan /A. VAN ELTEREN voor ƒ174 per i 2. Een Huis Erf in de Lange Tolbrugstraat gemer/t C. N° 329 zijnde het kennelijk afgeseh/iden gedeelte vaiv het perceel kadastaal /lekend sectie G. N"" 2036 voor het geheet groot 1 Are 7 Centiaren. Dit Ili/is bevat vier Kamers Openplaats ofi Zolder en is verhuurd voor ƒ3.15 /er week. 3. Eey Huis en Erf op den Uilenburg gemerkt^I. 105/* kadaster sectie G. N° 2982 ter groiAte vau 30 Centiaren. Ferhuurd voor ƒ 2 30 per week. Naflere informatiën te bekomen ten kantore vair den Notaris VAN DE MORTEL. Openbare Verkooping ten overstaan van den Notaris 9. C. SIGMOND te 's-Gravendeel op Vrijdag den 14 Juli 1876 des voormiddags te 11 ure in het Koffiehuis „Koophandel en' Zeevaart"" van J Q/ VAN DER HORST te Dordrecht van rui 50 HËKTAAEN 1KKDVII in den Bol  geheel gezaaid van Riga Tonzaad  buitengewoon schoon te veld staande op nieuw land in de Grcnsblok en Sionspolder gelegen/onder de gemeente Dubbeldam tegenover heyBenedenveer van Sliedrecht; in 23 pereeelen Betaling/de eene helft 1 December en de wederhelft 1 April 1877. Koopers moeten van soliede borgen voorziet^ zijn. Vau af /Maandag den 10 Juli zal er aan het Beneden-Stoombootenveer van Sliedrecht een vaartuig gereed liggen dat de gegadigden kosteloos naar en van den Polder zal brengen. onderricht bij den Bouwman op voormelden Polder en de Notarissen SLOTEMAKER en VAN NOORDEN te Sliedrecht 'apendrecht en bij voormelden Nolaris *>/?/ / tz)",http://resolver.kb.nl/resolve?urn=MMSADB01:000007281:mpeg21:a0029:ocr,5,MMSADB01:000007281:mpeg21:p005,Provinciale Noordbrabantsche en 's Hertogenbossche courant,856
3983070,1876/05/02 00:00:00,3942,MMDA03:000096958:mpeg21:a0015,http://imageviewer.kb.nl/ImagingService/imagingService?id=MMDA03:000096958:mpeg21:p004:image&x=269&y=792&w=979&h=3942,MMDA03:000096958:mpeg21,1248,4734,269,792,4,Advertentie Ter gelegenheid van de VOORJAARSKERM1S te Oosterwolde op Bingsdag 9 Mei 18?6 MUZIEK van het beroemde gezelschap HIILSMAS en BOJËSMCH van Steenwijk in de GOUDEN KLOK aldaar. Entree vrij. Schutter ij. BURGEMEESTER en WETHOUDERS van Smilde roepen bij dezen op alle mannelijke ingezeten die op den lsten Januarij j.L hun 25ste jaar zijn ingetreden (en alzoo in 1851 geboren zijn) om zich na den 15den Mei en vóór den lsten Junij aanstaande ter Gemeente-Secretarie voor de SCHUTTI I1I.1 te doen inschrijven. Wordende voorts herinnerd dat tot deze inschrijving ook verpligt zijn diegenen welke ofschoon in eene andere gemeente reeds ingeschreven sedert de laatste inschrijving in de gemeente Smilde zijn komen wonen. EBBINGE Burgemeester. S. KOOGER Secretaris. 1® ii l&Tfc atl e* DE BURGEMEESTER van Ooststellingwerf brengt ter algemeene kennis dat op den 4den Mei 4876 des v/m ten elf ure in het Gemeentehuis te Makkinga Raadsvergadering zal worden gehouden. Makkinga 29 April 1876. De Burgemeester van Ooststellingwerf C. W. AMENT. JÉK3T In de gemeente Ooststellingwerf zjjn vacant betrekkingen van: Hulponderwijzer te Makkinga Oosterwolde en Appelscha. De jaarwedden bedragen f 450 terwijl voor een voljaar dienst eene gratificatie van f ÏOO wordt verleend die bij vertrek tusschentijds als Hoofdonderwijzer evenzeer wordt genoten naar gelang van den diensttijd. Sollicitanten gelieven zich aan te melden vóór 15 jyffti ek« Makkinga 29 April 1876. Burgemeester en Wethouders van Ooststellingwerf: C. W. AMENT Burgem. L. OOSTERHOFF Secret. S. L. WOLEF - Zuideinde Meppel Magazijn van Behangselpapieren Gordijnen enz. Levering van Binnen- en Buiten- Jabusiën. Handel in witte en grijze papieren. Fabriek van geplakte WMeelzakken. verzenden wij op franco-aanvrage een 100 bladzijden dik met veel getuigschriften van gelukkig genesBenen voorzien Uittreksel uit Dr. AlBY'S Natuurgeneeswijze. Een ieder die zich van de voortreffelijkheid van het geïllustreerde 400 blz. dikke Origineele werk. (Prijs slechts f 1 bij eiken Boekhandelaar verkrijgbaar gesteld) wenscht te overtuigen ontbiede het Uittreksel van RICHTER'S Boekhandel te Nijmegen. §jBp- Geen zieke verzuime het zich met de beproefde Dr. AlBÏ'S Natuurgeneeswijze bekend te maken. SÉeiMip analyse op sclailelijto tataiilii iet émail van De ondergel eekende berigt dat hij door den Heer E. POST STHEEMAN alhier een scheikundig onderzoek heeft doen instellen op schadelijke bestanddeelen in het émail zijner braadpannen enz. Op grond van dit onderzoek is het hem thans mogelijk met voldoende zekerheid te kunnen zeggen dat de door hem verkocht wordende soorten GEHEE1L VRIJ K1JN van die bestanddeelen welke geacht kunnen worden nadeelig te zijn voor de gezondheid. Het origineel certificaat ter inzage. Meppel 28 April 1876. M. TOE 1I1S.,http://resolver.kb.nl/resolve?urn=MMDA03:000096958:mpeg21:a0015:ocr,4,MMDA03:000096958:mpeg21:p004,Provinciale Drentsche en Asser courant,979
2640270,1876/06/01 00:00:00,2635,ddd:010288639:mpeg21:a0022,http://imageviewer.kb.nl/ImagingService/imagingService?id=ddd:010288639:mpeg21:p004:image&x=66&y=83&w=1002&h=2635,ddd:010288639:mpeg21,1068,2718,66,83,8,'ADVERTENTIËN. Vrijdag 2 Juni Vendutie in het vendulokaal van A. M E IJ E R van diverse Koopmanschappen bijgebrachte goederen en producten. [2214] A. MEIJER. EXECUTORIALE VERKOOP. Op 2aterdag den derden Juni 1800 zesenzeventig des morgens te negen uren zullen door mij Deurwaarder op Pedamaran alhier worden verkocht ten laste van den Chinees Kob. Tjien Hiang en ten behoeve van de firma E. GrRASZHOIT & Co. by wege van executie: Een groote partij Javaansche Medicijnen^ Zwavel Peper Verf Rozenwater Harst Meubelen enz. enz. De Deurwaarder voornoemd (2210> J. E. VAN DER WAALL. Vendutie van Savoeneesche Paarden. Op Dinsdag den 6 dezer zuüen wij tegen 2% vendusalaris verkoopen: 150 Fraaie Savoeneesche Paarden alhier aangebracht per Bach Mastora Gezagvoerder ACHMAT BAWASIB. Onder deze lading bevinden zich prachtig gebouwde Paarden en schoone Spannen van twee zoowel als van vier zoomede uitmuntende Rijpaarden te bezichtigen aau den Boom. $%%%) SOESMAN k Co. BOEKEN VENDUTIE Woensdag den 7en Juni a. s. des avonds te zeven uur in een der lokalen van de Sociëteit Amicitia alhier. De Catalogus is vanaf heden gratis verkrijgbaar. Met Commisßiën belasten zich [2153] DE GROOT KOLFF St Co. Bemak* Vendutie wegens vertrek ten huize van den WelEd. Heer St J G VAN OVERYELDT van een compleeten en goed onderhouden inboedel: bestaande uit Stoelen Kasten Tafels Schilderijen Consoles houten en ijzeren Ledikanten enz. enz. Voorts: Twee span hardloopende Wagenpaarden. Eene ijsmachine (Systeem Carré) met bijbehooren. Een Mylord met lossen bok (zeer goed onderhouden) en wat verder te voorschijn zal worden gebracht. (2212),http://resolver.kb.nl/resolve?urn=ddd:010288639:mpeg21:a0022:ocr,4,ddd:010288639:mpeg21:p004,De locomotief : Samarangsch handels- en advertentie-blad,1002
2518645,1876/02/22 00:00:00,2557,ddd:010288555:mpeg21:a0020,http://imageviewer.kb.nl/ImagingService/imagingService?id=ddd:010288555:mpeg21:p004:image&x=1090&y=79&w=985&h=2557,ddd:010288555:mpeg21,2075,2636,1090,79,4,"Van ouds bekende firma Briët C^_^Sl_:C>TJX>""EÏlV__> ""OT^_i_.""T""E3_=l.. Medaille en eervolle vermeldingen op de Wereldtentoonstellingen vau Parijs in lö£s te Londen 1801 Parijs 1869 Lyon Weenen 1873 enz. G-ebreveteerd toestel van Briët voor Spuitwater om zelf onmiddelijk Seltzerw ate r Vichy water Sodawater mousseerenden Wijn; enz. te bereiden. Uitsluitend goedge- J^rf^ Uitsluitend toegekeurd door de Fransche ffi]f_sf\ kend m (*e Hospitalen Academie van Genees- ixSffsSjj mn Parijs en geheel kunde te Parijs. ScWTTOflf frankrijk. Door middel van het nevenstaand eenvoudig toestel van Briët zoo algemeen bekend in de geheele wereld _*_&W '""an meu ze^ onmi(l-dellijk zonder de m'n-^""*^2l ste chemische kennis en met geringe kosten MOOOa een uitmuntend Seltzer- Water bereiden dat HngMa wegens zijne buitengewone qualiteit met **$fflf geene andere oplossing van dien aard kan feg vergeleken worden; heizij dezulke in kruik- ___m___mJes Ciphons of Sodaicaters bevat zijn wel- ke gewoonlijk weinig kis bevatten. Het succes van het Briëttoestel is vooral te wijten aan zijne onbetwistbare Superioriteit en de opvolgende verbeteringen welke dit toestel ondergaan heelt. ' Te Par ij s bij MONDOLLOT EILS Ingenieur werktuigkundige. I Te Lo n d e n bij dezelfde firma 13 Litie-James Street. ""BEDEORD ROW W. C. : Te Batavia te bekomen bij H. M. VAN DORP & Cic (8897) RE(!U DE PARIS: Un beau choix de peignes pour Dames spécialité ED. PINAUD de Paris; Blanc de Lys pour dunner a la peau la blancheur la plus delicate et naturelle. Odeurs et Parfumeries assorties. (659) EUZIÈRE. Inlandsehe Geneesmiddelen. Het nu bewezen eclite ""OoelSLO© Oloa-t van Mevrouw VAN GENT wordt tot 15 Maart nog afgeleverd voor f 5.— IDe dan nog resteerende exemplaren van den len druk worden gebracht op f 10.— Eene tweede geheel onveranderde uitgave is ter perse en verschijnt in de tweede helft vau dit jaar. Bestellingen zonder remise worden niet uitgevoerd. De uitgever (703) H. BUNINC IDjol-djo.",http://resolver.kb.nl/resolve?urn=ddd:010288555:mpeg21:a0020:ocr,4,ddd:010288555:mpeg21:p004,De locomotief : Samarangsch handels- en advertentie-blad,985
4444824,1876/10/23 00:00:00,4484,MMDA03:000096583:mpeg21:a0017,http://imageviewer.kb.nl/ImagingService/imagingService?id=MMDA03:000096583:mpeg21:p004:image&x=269&y=216&w=984&h=4484,MMDA03:000096583:mpeg21,1253,4700,269,216,4,"Advertentie *LS* 68 OPLAGEN tST heeft wel geen verdere aanbeveling noodig; dit feit is het beste bewijs voor deszelfe deugdelijkheid. Voor zieken die slechts een beproefde geneeswijze tot herkrijging van hun gezondheid noodig hebben is zulk een werk van dubbele waarde en een waarborg daarvoor dat er niet de minste sprake van is met nieuwe geneesmiddelen op hun ligchamen proeven te nemen zooals dit helaas maar al te vaak geschiedt! Van de Hoogduitsche uitgave van Dr. AlBÏ'S Bfatuurgeneeswljze zijn 68 oplagen verschenen en is de tweede oplage van de Nederduitsche uitgave 496 blz. sterk in betrekkelijk korten tijd reeds geheel en al uitverkocht zoodat een derde oplage noodzakelijk werd. Duizenden en duizenden hebben aan de in dat werk behandelde geneesmiddelen hun gezondheid te danken gelijk uit de veelvuldige getuigschriften die er in voorkomen blijkt. Niemand verzuime derhalve dit uitmuntende populnir-geneeskundige werk dat slechts f 1.— kost bij zjjn gewonen Boekhandelaar tekoopen of legen toezending van 1 Postwissel is f.— van Richter's Boekhandel te Nijmegen te ontbieden die op franco aanvrage vooraf een uittreksel uit dit werk van over 100 blz. gratis en franco ter b&oordeeling zendt. Assurantie-Compagnie TE AMSTERDAM OPOESIOT isr 1771. De ondergeteekende geeft bjj deze kennis dat de Algemeene Verzekering-Maatschappij }SBCURITAS"" te Amsterdam In liquidatie is overgegaan en dat door hem de Agentuur der ASSL RAM TIE-COHPACUHIE te Amsterdam van 1771 is aanvaard welke Compagnie bereid is de bestaande POLISSEN der SecnritaN (uitgesloten die op Molens loopen) kosteloos tegen nieuwe POLISSEN in te wisselen. Assen 15 October 1876. B. VOS. A LflE MEKN E Assurantie-Maatschappij tegen gevaren van brand DE LOSBARSTING TAN HET GAZ den Bliksem en de Stoomketels. Bij tasMt vat Z.MJen MiierMerMei in dato 2den Junij 1830 no. 99 gevestigd te Brnssel. Maatschappelijk Kapitaal f 8000000. Reservefonds . . j> 810000. Premie- en Intrestrekening i 1906000. Verwaarborgd Kapitaal HO O millioen gulden. Getal geteekende Polissen circa S millioen stuks. AANDEELHEBBERS. De aandeelhebbers zijn ten getallevan308 waaronder zich bevinden: De Hooge Erfgenamen van wijlen Willem II Koning der Nederlanden. Z. K. H. Prins Willem Frederik H. K. H. Prinses Marianno H. H. D.D. H. H. de Prinsen en Hertog van Arenburg. Verzekering op matige vaste Premiën tegen alle hierboven genoemde gevaren. Geene Inleggelden Aandeelen in de geleden verliezen Administratie- Taxatie- of Verificatie-kosten Mijlgelden Briefporten enz. worden bij deze Maatschappij gerekend. De eenige kosten zijn die der POLIS welke in evenredigheid der verzekerde som zeer billjjk zijn gesteld. Inlichtingen zijn te bekomen bjj de volgende Heeren Agenten: Amsterdam H. H. DE LEEUW; Groningen J. B. JAGER; Veendam R. R. LEGGER J r. ; Meppel L. DE VRIES; Zwolle H. MIDDENDORP Hz. en verder in de meeste Kantons-Hoofdplaatsen van Nederland. Op plaatsen alwaar de Maatschappij nog niet is vertegenwoordigd kunnen soliede personen tot Agenten of Lorressponden ten worden aangesteld. Adres aan den Inspecteur der Maatschappij te Utrecht •r. W. VAN DER HOFP.",http://resolver.kb.nl/resolve?urn=MMDA03:000096583:mpeg21:a0017:ocr,4,MMDA03:000096583:mpeg21:p004,Provinciale Drentsche en Asser courant,984
2187783,1876/12/22 00:00:00,2439,MMKB08:000087412:mpeg21:a0017,http://imageviewer.kb.nl/ImagingService/imagingService?id=MMKB08:000087412:mpeg21:p004:image&x=63&y=3063&w=897&h=2439,MMKB08:000087412:mpeg21,960,5502,63,3063,4,Advertentie BIJ C. FRIKKERS Jr. j • VOORHANDEN Gerookte Hamburger OSSENRIBBEN  Yorksche- Westfaalsche en gewone HAMMETJES Delicieuse HOOFDKAAS  ROLPENS  GALANTINE DE VEAU MARBRÉE WILDZWIJNSKOPWORST ROOKWORST Gerookte ZALM  PALING in GELEI enz. enz. FRETTEN te Koop. ZEfe stuks a 5 Gulden per stuk. Te bevragen met franco brieven bij E. J. G. VAN DER SANDE te Nijmegen. Grand Bazar de Paris 24 RHEINSTRASSE 24. Grosser Collection von WeihnachtsSeschenke. Twee jonge DAMES uit den beschaafden stand door bijzondere omstandigheden daartoe genoodzaakt zoeken liefst zoo spoedig mogelijk plaatsing als GEZELSCHAPSJLFVROUW of ter adsistentie in een deftig Huishouden. Ook zijn zy niet ongenegen beiden in een nette zaak werkzaam te zijn. Onverschillig welke plaats uitgezonderd Rotterdam. Brieven franco onder letters M F aan het Algemeen Advertentie-Bureau van NIJGH & VAN DITMAR  Rotterdam. VKLEMMffHIS kunnen vast werk bekomen aan de Fabriek van Gebogen Houtwaren te Deventer. Op een Kantoor alhier kan dadelijk GEPLAATST WORDEN een «3Ton^en P. G. van 12 tot 15 jaar eene goede hand schrijvende als Leerling en voor loopend werk. Salaris voorloopig ƒ 1.— in de week met opslag. r di es met eigenhandig geschreven brieven  onder No. 723 Bureau Arnhernsche Courant. Te Ve!p eene KEUKENMEIQ GEVRAAGD die ook Huiswerk verrichten wil. Loon ƒ80 Al 90. Briëven onder No. 23 aan het postkantoor te Velp.,http://resolver.kb.nl/resolve?urn=MMKB08:000087412:mpeg21:a0017:ocr,4,MMKB08:000087412:mpeg21:p004,Arnhemsche courant,897
3311434,1876/07/10 00:00:00,2954,MMHCO01:000068867:mpeg21:a0024,http://imageviewer.kb.nl/ImagingService/imagingService?id=MMHCO01:000068867:mpeg21:p004:image&x=2323&y=1903&w=1121&h=2954,MMHCO01:000068867:mpeg21,3444,4857,2323,1903,4,Advertentie Hollandsche Jaagharing in groote en kleine vaatjes tot Vlaardinger prijzen bij Lensman & Stillen Aaplein Zwolle. Per stuk tot den prijs van den dag bij J. RAVE Groote Markt. M. ïï. YAN IERSEL firma B. F. Langneaux Diezerstraat over de Spiegelsteeg. Groote sorteering van Heeren en Dames Bottines en Laarzen Kinderlaarsjes alsmede Heeren Molier-Schoenen. Bestellingen of aangemeten Schoenen enz. worden ten spoedigste bezorgd. Ook te ontbieden buiten de stad. DIRK MSMI & Co. DIEZERSTRAAT hoek Smeden E 17. Magazijn van PIANIN0S en Orgels (met vijfjarige schriftelijke garantie) SPEELD00ZEN EN MUZIEK * (Ed. PETERS KOKSMA enz.) Verhuren ruilen repareeren en stemmen. STEEDS RUIME KEUZE. lïniverseel-Zulverings-Zout is het eenvoudigste en goedkoopste huismiddel tegen maagpijn maagkramp slechte spijsvertering zuur hoofdpijn duizeligheid hartkloppingen enz. en moest daar het ook bij het inmaken van zure vruchten het weekkoken vau groenten vooral peulvruchten als: erwten boonen linzen enz. zeer goede diensten bewijst in ieder huisgezin gevonden worden. In pakjes a 18 33 en 60 cents. Haarbalaeni of Eau phlloeome Deze balsem is een spiritus oplossing van een zeer fijn vet met een toevoeging van Peru-balsem extract vau kina en welriekende olieën. Hg reinigt de huid van het hoofd en kan het beste middel genoemd worden om de groei van het haar te bevorderen en het uitvallen te voorkomen. In flacons a 45 en 90 cents. Anatherln-Mondwater. Met een gelijke hoeveelheid water gemengd is het de aangenaamste mondspoeling. Het neemt eiken slechten smaak weg reinigt de tanden versterkt zwak tandvleesch en verhindert de vorming van kalk op de tanden daar het slijm en overblijfselen der spijzen oplost. Het flacon kost 75 cents. KngelHch Tandpoeder. In elegante dozen van 100 en 50 grammen a 45 en 25 cents. Idlaton-Droppels zonder schadelijke bestanddeelen bevrijden oogenblikkelijk van de hevigste kiespijn. Het fieschje kost 25 cents. Bij ieder artikel is eene uitvoerige gebruiksaanwijzing. Depots : Zwolle K. du Pre W. Bergman. Almelo J. B. Remmers. Borne J. Hulshoff Jz. Dalfsen J. F. Kortmann. Delden M. J. H. Bransz. Deventer Boerboom. Diepenheim J. Groenendaal. Enschede Wed. A. Stevens. Enter H. J. Plaggemars. Goor J. H. Koning en Zoon. Hardenberg Z. Koeslag. Hellendoorn H. J. v. d Berg. Hengelo G. O. Boom Apoth. Emmerik. Holten F. Wonning. Kampen L. F. Janssens. Markelo Wed. Stokkentreeft. Meppel J. A. Boom Apoth Oldenzaal F. B. Banning Ootmarsum L. Wilmes. Raalte J. H. Schrader. Rijssen Wed. D. ter Harmsel. Steenwijk v. Urk & ten Kate. Tubbergeu J. Koopmann Az. Triezenveen 1. ten Brake. Wjjhe B. G. Elfrink. Zwartsluis Wed. H. Slagter Lz. H. VOH G1MBORN. Er wordt gevraagd een bekwaam BAKKERSKNECHT . liefst dadelijk of met 1 Augustus. Adres onder No. 4546 bij DE ERVEN J. J. TIJL.,http://resolver.kb.nl/resolve?urn=MMHCO01:000068867:mpeg21:a0024:ocr,4,MMHCO01:000068867:mpeg21:p004,Provinciale Overijsselsche en Zwolsche courant,1121
151050,1876/06/22 00:00:00,150,ddd:110534835:mpeg21:a0007,http://imageviewer.kb.nl/ImagingService/imagingService?id=ddd:110534835:mpeg21:p001:image&x=113&y=3947&w=1007&h=150,ddd:110534835:mpeg21,1120,4097,113,3947,4,Advertentiën.,http://resolver.kb.nl/resolve?urn=ddd:110534835:mpeg21:a0007:ocr,1,ddd:110534835:mpeg21:p001,Bataviaasch handelsblad,1007
1714410,1876/06/18 00:00:00,2215,ddd:010186892:mpeg21:a0022,http://imageviewer.kb.nl/ImagingService/imagingService?id=ddd:010186892:mpeg21:p004:image&x=938&y=144&w=774&h=2215,ddd:010186892:mpeg21,1712,2359,938,144,4,"Gras te Goirle. De Notaris DAAMEN <g% . zul op Maandag 8© •funij /ËÊLsr^A""fi&s© 's namiddags ten 2 ure iflö^bij W. van PUIJENBUOEK te 'publiek verpachten2^ Voor den Heer P. van de Lisdonk  C. van Erven Kinderen Anssems de Armen en Gemeente Goirle C. H. van Ravels C. van Boxtel en Peter Adriaansen '-wis?. '^ Eene groote partij gras iv eu i^W slachter den Goirlesche Vloed Mus- J||§§|sfg§|£senbee-r)d Breheesche Stoep Hoogen Vonder Gemeente Breedijken Krombeemden Ruiters en Elzeubosch  Brand  over eu voor de Brug en Brehees; benevens _J_B koopen -Beï«ïe tisrl' in de Vosserijten. J^_^» Bij billetten breeder omschreven. 15 t. De Notaris Jfe^VAN -DEIt VOORT TE GELDROP zal ten verzoeke van het Gemeentebestuur van Geldrop. 2s/'jS5 I IT OPEISBAAR VERKOOPEN: %g vijf Een perceel weiland. ii_j|li?_X*B.. genaamd „d e Waa r d ""¦ """"groot 86 aren 33 centiaren gelegen te Geldrop kad. sectie C No 542 in drie koopen en in massa. Dit weiland  gelegen tegen de bebouwde kom der gemeente Geldrop met drie zijden langs de Dommel is uitmuntend geschikt tot het oprigten eener zaak waarbij loopend water vereischt wordt. De verkoop zal geschieden te Geldrop provisioneel den 3® Juni; 185 G ter herberge van de Weduwe G. VAN GAAL en finaal den 4-. .ïulij 189© ter herberge van HUB. VAN GESTEL telkens 's namiddags om G ure. 7 '",http://resolver.kb.nl/resolve?urn=ddd:010186892:mpeg21:a0022:ocr,4,ddd:010186892:mpeg21:p004,Tilburgsche courant,774
7515148,1876/12/02 00:00:00,4339,MMSADB01:000007550:mpeg21:a0046,http://imageviewer.kb.nl/ImagingService/imagingService?id=MMSADB01:000007550:mpeg21:p008:image&x=2050&y=871&w=1732&h=4339,MMSADB01:000007550:mpeg21,3782,5210,2050,871,8,"Advertentie sch. Vughterstraat H. 5 Wie nu nog wil profiteeren van den FINALEN UITVERKOOP C. J. H. MER H"". daar kan men voor e^n spotprijs een mooi stuk SPEELGOED KOOPEN. Komt/Ziet en Oordeelt het 'Magazijn van A. S. WESTERMAN-NICOLAI Hofleverancier van Z. M. den Koning Fonteinstraat A. 258 !^-Hertogenbosch vindt men geëtaleerd /eene groote keuze SURPRISES GALAKTERIEN BÏMTERIEN MENT CBRISTOFLE MODES EN/PELTERIJEN alle buitengewoon geschikt voor Dagelijks Tombola",http://resolver.kb.nl/resolve?urn=MMSADB01:000007550:mpeg21:a0046:ocr,8,MMSADB01:000007550:mpeg21:p008,Provinciale Noordbrabantsche en 's Hertogenbossche courant,1732
56480,1876/07/22 00:00:00,80,ddd:010984772:mpeg21:a0058,http://imageviewer.kb.nl/ImagingService/imagingService?id=ddd:010984772:mpeg21:p003:image&x=3030&y=2652&w=706&h=80,ddd:010984772:mpeg21,3736,2732,3030,2652,4,ADVERTENTISN  -■-■' ' ■ ——,http://resolver.kb.nl/resolve?urn=ddd:010984772:mpeg21:a0058:ocr,3,ddd:010984772:mpeg21:p003,De Tĳd : godsdienstig-staatkundig dagblad,706
1160775,1876/12/31 00:00:00,1407,ddd:010509148:mpeg21:a0017,http://imageviewer.kb.nl/ImagingService/imagingService?id=ddd:010509148:mpeg21:p003:image&x=2607&y=3158&w=825&h=1407,ddd:010509148:mpeg21,3432,4565,2607,3158,4,Ue Zalf en Pillen van ISoiïoway Eene belofte. Alle üide-rs aan zweren  etterbuilen scl.'-urbuik ca huiduitslag kuuotii mei volkomen vertrouwen hunne verschillende ongemakken met dexa kealeude en reiuigeuda middelen bebaudeten Onder li 011 ow a y's beproeleie geu&stnidJelea suilen de ergste gevallen npjédig een veel beier e-in guuati. ger aanzien verkrijgen en io elon voortgnug dergenesing zal de lijeier nimmer cl >or m 'eije. lijkheden belsmmej i  uocb a.i-n- teleurstel. botten ontmoedigd worden hen weinig vvl* gardiag eu renige oplètteöhheM ojj de bruikaaanwyziug waarin iedere pot £->«f en iedere doos «'ili.'u gewikkeld is anfl* leu iederen lijder m staat iich selvem te genezen eu j-.i-ne kwaal tut eene guosiige og* lossing te brengen  terw--| bij verzekerd kua zijn vat door liet opvolg--]] van de-ie etuinm.. dige maar doordungenae bebauioliug /.ime huid gezond gemaakt heHg lij len bedpjaré eu zijne gezondheid k.rsteid woidt. Deze Zalf eu Pillen zijn alhier verkrijgbaar gesteld bij -Uekra.iU^aeit va le Sttrajiuuoaatmut.,http://resolver.kb.nl/resolve?urn=ddd:010509148:mpeg21:a0017:ocr,3,ddd:010509148:mpeg21:p003,De West-Indiër : dagblad toegewĳd aan de belangen van Nederlandsch Guyana,825
502740,1876/12/23 00:00:00,588,MMKB08:000087413:mpeg21:a0004,http://imageviewer.kb.nl/ImagingService/imagingService?id=MMKB08:000087413:mpeg21:p002:image&x=1008&y=2016&w=855&h=588,MMKB08:000087413:mpeg21,1863,2604,1008,2016,4,"Advertentie Ingezonden mededeelingen betreflende aaken van particulier handels- on nijverheidsbelang. Van de groote couranten in Nederland is HET VADERLAND de goedkoopste: prjjs ƒ 4.2Ö voor Den Haag en ƒ4 90 fr. p. post per 3 maanden. HET VADEBLAND behelst dagelijks een feuilleton : thans »DE FAMILIE MIXPICLE"" door mej. C. F. Van Bees — Nieuwe abonnés ontvangen de deze maand verschijnende nommers en het reeds verschenen gedeelte van »de Familie Mixpicle""",http://resolver.kb.nl/resolve?urn=MMKB08:000087413:mpeg21:a0004:ocr,2,MMKB08:000087413:mpeg21:p002,Arnhemsche courant,855
2884560,1876/09/01 00:00:00,2828,ddd:110534896:mpeg21:a0008,http://imageviewer.kb.nl/ImagingService/imagingService?id=ddd:110534896:mpeg21:p002:image&x=1133&y=77&w=1020&h=2828,ddd:110534896:mpeg21,2153,2905,1133,77,4,"■ i.ritifv .'nuu-ais ile UüUtviu. i. periiüstion de Mr U tissuie Vemlr«-tli 1 Septernbrt. | SPEOTAGLE DEMANDÉ. . lrc répréseutation du lOmi; mois de i'Abonnen LE DOMINO NOIR. I Opéra Comique en 3 Artes de Mr. AUBER. Prix d'eutrée *?> tl. Galerie ï£ ft. !.e Spectacle uomaiencera a buit heures lucessament Liuda de Ckamouny. (3(J$4) VAN' KIXSKEKCvBX. Met toestemming van den Resident van Batavia. Fancy Fair ten voordeele van Let INDISCH LANDBOUWGI STICHT te Depok op Zaturdag en Zondag 2 en 3 September 1876 iv de Achterlokalou van het GEBOUW der Sociëteit Harmonii. aanvangende op beide dagen 's avonds te >-* uur. Entree ƒ 1.— per persoon. (2^941 Militaire Sociëteit Coocordia. Zaterdagavond 2 September 1876. Geen muziek. De Secretaris (3075) C. J. BOREL. Militaire Sociëteit Concordia. Zaterdag 30 September 1876. I Thè-dansant. De Secretaris. (307'; ('T BOREL. «. Solicitanten voor de betrekking van bij het Grondpefl* wezen op ƒ ÏOO s maands worden verzi ebt zich persoonlijk te melden ten kantore van den Hoofd-Ingenieur P. VAN"" DIJK. Secretarielaan. (3005)",http://resolver.kb.nl/resolve?urn=ddd:110534896:mpeg21:a0008:ocr,2,ddd:110534896:mpeg21:p002,Bataviaasch handelsblad,1020
2109027,1876/03/12 00:00:00,2181,ddd:010099944:mpeg21:a0050,http://imageviewer.kb.nl/ImagingService/imagingService?id=ddd:010099944:mpeg21:p007:image&x=46&y=4701&w=967&h=2181,ddd:010099944:mpeg21,1013,6882,46,4701,8," SLOOTSTRAAT ttaJi en v-> K»<l- Sectie D N°. 8114 en f.591 ts zamen No. ai'«i. 'f> centiaren. *i da' ~en 3 zu""(;n erst 'eclcr afwmdcriflk worden geveild Brp^na Kecombincerd in slag gelegd. •Ws r ""'ï B'Hetten omschreven. Te bezichtigen des liiis-Ifi *n Donderdags: N°. 1 van 2 tot 4en N"". 2en 3 van bij v' •* nur niit3 vertoonende voor N"". 1 een Toegangsbewijs Êi»e7engenoemde. Makelaars verkrijgbaar. De Bewijzen van den V i en de VeilCollditié!n zullen vier dagen vóór en op *U Ou. °Pcla*f ter lezing liggen ten kantore van den Nota- >AN MOUEIK Singel bij den Heiligenweg W. -«7. ENrblJl!i A7-' H- J- M FRANKKJ;..L:'N. .T. A. U/J-NBETtQ \vz>. F. O. BOELHOÜWER ]I. .1. PKTERS <*. n&JFRANKE4IOLEN Jr. S. H. NEES J. SMIT en 3. *>AAi«w KNT' Makelaar3> zuU'-u °P MAAMDAG «O •&•(«/* 1870 des Avonds na. Zes uren in bet Lokaal de ERv i Grond in veiling brengen: N°. 1. Ken HUIS en aan d ran den SinSel N°- 89. N'J. 2. Ken HL'SS -n ERVE U» j e Kleine Kattenburgerstraat N°. 181. Te bezichtigen JJqö(i Hea Dinsdags en Vrijdags en N°. 2 des Dinsdags en N» j 'aa""s beide van 1 tot 3 uur mits vertoonende voor *onene5n Bewijs van Toegang. Veilconditiën z.jn op den ge- Mr j _-1 te« lozing van N°. 1 ten kantore van den Notaris ' *■ *""■ VAN ETTEN van N°. 2 MULDER en KANNE. -—-_______ (Tiii) BlNfiPi?PJAfiOBS' -T- TEKELENBURÖ Jr. M.H.BOAS. F. A. Wht?' T-„J- TKN BRINK «■ -T- TE^ELENBURG Jsn. 6 ur-n • ' zullen <V MaauJ-!g 20 Maart 1376 des avonds na ?«n v^1"". !let Lokaal de Brakke Grond ten overstaan van h«cht» .*""* Mr- J- F- WERTHEIM in veiling brcnaa: Het £e ""n weidoortiwmerde KOOPiHAASHVISinet aPa»^ v-^Ü1""' P»3en>ui AcSrV-rmrfs ov.-rd-kto Binnenplaats leVir Verbwir:l wordendan I'akkelder en Erve staande en ge«eii aaa &<a t Achterburgwal ïs/2 de Uwndesteeg en Blo3dstraat Bunrt K N°. 89 «ö Don? j N°-21/'r'' groot '5 Gentianen. Te zh-n Maandag bewiia ) •• *Sf ran 1 tot 2'/j nur op vertoon van een toegangïen ""T' 'J. bovengenoemde Makelaars verkrijgbaar. De Bewrj*We U e'Söndom ?n do Veilconditiën vullen vierdagen vóór gau  ö 0P d«n Verkooadajr des voeronddaas ter inzage lig*eiz' 0'zn K<mtore van den Notaris Mr. J. 'f. WERTHEISÏ ■^gfMht bg den Anutel 792. (7343) jMiiusfi te Rotterdam }~ «tn iB-""** t-* MAART 1870 des middags te ft Ui _%""_'_' 2**! aan de Kcheemiiakcrshaven N"". 29 van • «*?O©Q Stuks le soort T*u i  ?t. Pctersbmjrer Vuren Delen *n biév.jV1' '• ""'*- 'Vu en --1 «likte e-u onderscheidene lengte Taö ie U.L 7-ooalB bet ia liggende op de Sche-epstinimerwerf ■ren UEB- VISSER; aan den West-Zeedijk te Rotte; n.&*w°?t tS*6? aanirrage te bekomen bij eh. Makelaars WJVAN nsß' MONTAOBAÏT VAN 3WIJNÖREGT «F.4 AAI- . . (7201)",http://resolver.kb.nl/resolve?urn=ddd:010099944:mpeg21:a0050:ocr,7,ddd:010099944:mpeg21:p007,Algemeen Handelsblad,967
1733034,1876/06/21 00:00:00,1873,MMKB08:000089876:mpeg21:a0009,http://imageviewer.kb.nl/ImagingService/imagingService?id=MMKB08:000089876:mpeg21:p003:image&x=2683&y=61&w=914&h=1873,MMKB08:000089876:mpeg21,3597,1934,2683,61,4,Advertentie Voor de vele bewijzen van belangstelling betoond bij het smartelijk verlies van onzen geliefden oudsten Zoon CORNELIS betuigen wjj onzen har tel y ken dank. C. KOEK M. J. C. KOEK— Velp  19 Juni 1876. van Rouendal. AANBESTEDING ei VERPACHTING. De BURGEMEESTER der gemeente Arnhem zal Donderdag 29 Junij 1876 's namiddags 1 ure in het openbaar ter Gomeentehuize AANBESTEDEN: Hot onderhoud van GEMEENTEGEBOUWEN enz  en hot verrigten van eenige werkzaamheden aan deze gebouwen  in 4 perceelen  en VERPACHTEN: voor den tijd van drie jaren het JAGTREGT op de Gemeente-Weilanden en Heidegronden in 2 perceelen. Bestekkeu te verkrijgen en voorwarden ter lezing ter Gemeente-Secretarie. BASVIRKDDi en Verpachting van Naweide. De Noterissen KUTJK en WILDSCHUT te Arnhem zullen op | Vrijdag 30 Juni 1876 's namiddags 5 uur in het Arnhemscli Koffiehuis aan de Steenstraat aldaar publiek verkoopen: 12 perceelen extra zwaar HEELGRAS op de Koppelweide en 12 perceelen dito HEELGRAS op de Prinsenweide daarnaast alles in het Arnhemsche Broek aan te wijzen door A. MINKMAN in de Spjjkerstraat; voorts 12 perceelen dito HEELGRAS op het Sluisje van den Heer KOELS in Malburgen en 1 perceel op de Grift aldaar; aan te wijzen door BOSMAN te Elden; alsmede verpachten de NAWEIDE van de Prinsenweide voornoemd.,http://resolver.kb.nl/resolve?urn=MMKB08:000089876:mpeg21:a0009:ocr,3,MMKB08:000089876:mpeg21:p003,Arnhemsche courant,914
3453807,1876/03/17 00:00:00,3423,ddd:010486730:mpeg21:a0013,http://imageviewer.kb.nl/ImagingService/imagingService?id=ddd:010486730:mpeg21:p002:image&x=2085&y=84&w=1009&h=3423,ddd:010486730:mpeg21,3094,3507,2085,84,4,msummmmmrr- — ' ' .*•-»<■• Avee la permissicn de Mr. te Resident. VENDEEDTIYMars 1876 Abonnement Suspetidu. Ii Bißl DI SEVM.B. Opéra Comique en 3 Actes. MM. ROBSINL JPfix de** Places. Pour Mêssieurs los-Abonnés Tetenant leurs places Jeudi de 8 beures a Midi: Loges / 4.— Parterre et Amphii théatre f 3«— Pour non-abonnéa et abonnés apiès Jeudi Midi: Loges Amphithéatre et Parterre ƒ ö.— Galerie f S— Le Spectacle commencera a huit heures. ö l'Etude LA GRANDE DÜCHESSE. 1026 VAN KI NS BERGEN. Liet wel! CREDITEUREN der firma F\ Göringr & Co. worden beleefdelijk uitgenoodigd om op ZATERDAG 18 MAART 1876 des voormiddags ten ÏO ure. te vergaderen ten kantore van den ondergeteekende gelegen aan de Ocstzyde der Groote rivier binnen Batavia ter beO spreking hunner belangen. Mr. Th SCHUURMAN Johzn. 1070 Adv. en Proc I 4*eltflourij teo behoeve van den *0i Bataviaschen Schouwburg. 1 PRIJS van ƒ 100000— 1 » n n 20000— 1 « u u 10000— 1 u u ..» 5000— 10 PRIJZEN van r 1000— 10 * „ u 500— 50 « n u 100— 100 i u i 50— tl \\ De trekking geschiedt als bij de laatste loterij van het Djattiegesticht. Tot 1° Mei 1876 «uilen de loten verkrijgbaar zijn a / ÏO»— per lot. Later zal de prijs verhoogd worden op ƒ 16.—. LOTEN zijn verkrijgbaar: te Batavia bij den Heer Notaris J. R. KLEUN. „ „ » J. H. HAAK BASTIAANBE (Paleis van Justitie.) „ de Heeren DE LANGE & Co. „ B „ VAN VLEUTEN fc COX. n „ 3 CAVADINO & Co. „ „ _ H. A. BAHLMANN & Co. (Bazar.) „ den Heer VAN DER PUTTEN Noordwijk. „ LOA POSENG. te Mb. Corneïis bjj den Hfer Notariß P. J. JANB3ENB. „ Buitbnzobs „ „ n „ J. H. VORSTMAN. „ Bandong „ „ „ P. G. HELMAN. „ Soerabaya » „ „ „ A. J. SNOUCK HURGRONJE. „ Kedibik „ n „ H A. B. VAN PELT. „ Passoeboban „ „ „ C. WEBER. „ Pbobolin«> „ „ „ K. PREIJER. n Samabano „ de Heeren SOESMAN & Co. „ Tagal n den Heer R. VAN LAWICK. „ CfliaißON „ n „AA. RUZETTE. „ Pbcalonoan „ de Heeren HANA MULLEMEISTER fc Co. „ Padano „ den Heer J. H. DE BRUIJNE. „ Pausmbang „ „ „ C. H. C. BUVANCK.,http://resolver.kb.nl/resolve?urn=ddd:010486730:mpeg21:a0013:ocr,2,ddd:010486730:mpeg21:p002,"Java-bode : nieuws, handels- en advertentieblad voor Nederlandsch-Indie",1009
1682460,1876/04/24 00:00:00,2340,ddd:010062518:mpeg21:a0052,http://imageviewer.kb.nl/ImagingService/imagingService?id=ddd:010062518:mpeg21:p007:image&x=751&y=2804&w=719&h=2340,ddd:010062518:mpeg21,1470,5144,751,2804,8,VOORZORG. . Met de nieuwste vinding tot geheel machinale uitroeiing van Wandgedierte belasten zich de ondergeteekenden tot het ' zuiveren van Huisen Stads- en Rijksgebouwen zonder beschadiging van be hangsels of meubelen onder de stiptste ge heimhouding. Inspectie gratis. Verzoeke s. v. p. op adres te lettendaar i wij met geen andere firma in betrek king staan. \ GEBR. GOEDHART & Co. ' Paleisstraal b/d Dam 11 Amsterdam. ; Attesten van Diakoniehuizen eu vele an deren liggen ter inzage. (3978) GL^NSSTÏJFSËL. De Stijfsel onder deze benaming door mij in den handel gebracht heet oorspronkelijk: GLOSS SATEENA wat op elk pakje staat gedrukt. Men zij indachtig hierop te letten aangezien reeds andere kwaliteiten onder de benaming GlaESStijf3el worden aangeboden. (5409)  Wormerveer. JAJT DEKKER. EAU DE COLOGNE van J. O BOLDOOT per maatje en per diverse flesschen. EAU DE HOLLANBB alleen per flesch a ƒ 040; bij W. VAN UER GAAG Apotheker Prinsengracht bij de Vijzelgracht 638. Levertraan per flacon a zö.6o. Staalfaoudende ' Levertraan a f 0.70. (4485) VAN  LANDBOUW. ] Afdeeling Amstsrda a. I BERICHT aan LANDB.OUWEftS. * De bekroonde Dekhengst TROMP staat 1 tot Dekking beschikbaar aau den Beerebij t bij (5414) H. WALKEB.,http://resolver.kb.nl/resolve?urn=ddd:010062518:mpeg21:a0052:ocr,7,ddd:010062518:mpeg21:p007,Het nieuws van den dag : kleine courant,719
4302870,1876/09/23 00:00:00,5015,MMSADB01:000007444:mpeg21:a0010,http://imageviewer.kb.nl/ImagingService/imagingService?id=MMSADB01:000007444:mpeg21:p002:image&x=2867&y=170&w=858&h=5015,MMSADB01:000007444:mpeg21,3725,5185,2867,170,8,"Advertentie 33e Notaris 111SM1 zal op Donderdag den 28 September e. k.  's morgens om 9 ure te beginnen voor en ten huize van den Heer J<a.N RUDOLPH BUDDEMEIJER te Boxty PUBLIEK VERKOKEN: EENEN GOED ONDERHOUDEN INBOEDEL waaronder /ene solide Pianino met palisairaerhouten Kast fraaie staande Kiok mas- t—- 1 ! sief en opgelegd Mahoniehouten {K gB MEUBELS ""XÜIl 6 Vederen Bodden met toebehooren solied Linnen en Pellen Tafelgoed Koper Tin IJzer Porcelsin Glas Kristal Aardewerk enz. De Goederen zijn daags vóór de Verkooping 's morgens van 10 tot 12 en 's namiddags van 2 /ot 4 ure te zien. Betaaldag 2 Februari e. k. mits stellende den/Notaris bekende borgen. M. Q. Van Kemenade Notaris te Gemert is voornemens te Verkoopen ten verzoeke der Erven CQI5NELIS TIELEMANS te Gemert ten herberge van JOH. ANT. ROOIJAKKERS pi/visioneet op Dinsdag 26 September/1876 en finaal op Dinsdag 10 Octobei- daaraanvolgende  's namiddags 5 mir : Twee schoone /. bouwhoeven/ gelegen onder de gemeenten Boelcel en Gemert met zeer goede Botiw- en Weilanden voorts nog enkele' afzonderlijke perceelea Weiland sampn groot 15 Bunders 14 ? Roeden 30 ? Ellen. Aan te/vaarden in 1877. Inlichtingen geeft genoemden Notaris. De Notaris BIJVOET te Berchem zal ten verzoeke der Wed. en Kinderen CORNELIS VAN DER ST j U^ PEN te Heetch in het openbaar '/ / VERKOOPEN: EEN ;huis met Erf Tuin Bouwen Weiland staande en gejégen te Berchem  in het Hei-eind bewoond/aoor den huurder ANTOON VAN ROSMALEN kadastraal bekend sectie C. Nos Jfó 66 en 57 te zamen groot 1.04.54. Te aanvaardefi: Bouwland onmiddellijk bij de toewmmig Tuin- en Weiland 15 Maart en Huis Pinksteren 1877. Deze Verknoping zal plaats hebben te Berchem ter/herberge van JOH. K ESSEN op Woensdag den 27 September bij inzet en op Woensdag den 11 October 1876 bij toeslag telkens des namiddags ten 5 ure. Voorioopigc Aankondiging. De Notaris DAAMEl^ te Tilburg zal in de maand November 1876 op nader te bepalen dag in liet OPENBAAR VERKOOPEN: Het van oud/ gunstig bekende KOFFIEH ÜIS de Looiersbeurs gelegen aan het schoone plein den Heuvel te Tilburg hebbende 'met Erf Tuin en aanhooren eene grootte van ruim 7 Aren. De ruime localiteiten bieden de gelegenheid aan tot het ontvingen van groote partijen zooals dan ook reeds sedert jaren het Muziekgezelschap /de Nieuwe Koninklijke Harmonie"" aldaar gevestigd is. Desverkiezende kan daarbij ook de geheele Inventaris tegen billijken prijs worden overgenomen. Inmiddels is de Huizinge c. a. uit de hand te koop en te bevragen bij den eigenaar den Heer F. J. GEELE of den Notaris DAAMEN voornoemd. AAR DAPPEL . Voor het 5e Regement Infantjüfie te 's-Bosch zal op Maandag 25 SepJ^mber 1876 des middags ten één ure n/ae Onderofficierseetzaal Tolbrug kazern/f worden AANBESTEED: De leverinjp/van AARDAPPELEN van Kleigrond voor de maand Octobér. De voorwaarden zijn ter lezing aan de wacht /an gemelde kazerne. De Voedings-Commissie. 't",http://resolver.kb.nl/resolve?urn=MMSADB01:000007444:mpeg21:a0010:ocr,2,MMSADB01:000007444:mpeg21:p002,Provinciale Noordbrabantsche en 's Hertogenbossche courant,858
1737725,1876/06/13 00:00:00,2225,ddd:011066198:mpeg21:a0035,http://imageviewer.kb.nl/ImagingService/imagingService?id=ddd:011066198:mpeg21:p004:image&x=3253&y=172&w=781&h=2225,ddd:011066198:mpeg21,4034,2397,3253,172,4,"Bij J. BIJLEVELD te Utrecht ziet het licht: DEWETOPHETHOOGEB ONDERWIJS. Uit de gewisselde stukken en de gebonden beraadslagen toegelicht. UITGEGEVEN DOOR Mr. B. J. L. DE «EER VAK JUTFAAS. Hoegleeraar aldaar. iste Aflevering (vel i—4) / 0.80. De omvang van het werk wordt op hoogstens 30 vel beraamd. (4970) Voor jonge Dames Huismoeders j| Modenaaisters en Magazijnen 1 p DAMES-MODEGIDS. I Hollandsche uitgave van het Fransche Tijdschrift »La Saison Journal des Dames.'1 Geïllustreerd tijdschrift voor Dames- en Kinderkleeding en Gandwerkcn. Prijs per kwartaal van II Nommers met © Patroonbladen ƒ1.40 idem met O gekleurde Modeplaten ƒ 8.3 O. De Dames-Modegids munt uit \ door groote verscheidenheid vanorigi- \ neele Fransche Modes en Handwerken ■. en levert voor elk seizoen de nieuwste \ modellen. De fraaie afbeeldingen vol- f' slagen patronen en nauwkeurige be- r schrijvingen maken het nawerken uiterst L gemakkelijk.Ookdeprachtigegekleurde X modelplaten worden te Parijs naar wer- Y keujko modellen geteekend. L'itge- \"" knipte patronen worden op aanvraag X geleverd. Men teekent met elk N\ in E bij alle Boekhandelaren en Postkanto- £ ren alsmede bij de Uitgevers P.NOORD- f HOFF & SMIT te Groningen. (4812) | Voor f 1 in plaats van f 2-25. Idealen en Afdwalingen. HERINNERINGEN UIT MIJNE JEUGD door Dr. KAKL 11.45 E. Deze hoogst belangrijke levensbeschrijving vnn den beroemden Duitschen Godgeleerde is tijdelij k tot bovengenoemden goedkoopen prijs verkrij». baar bij A. J. VAN IIUFFEL te Utrecht èii wordt tegen toezending van eenpostwissel j/jj franco door het geheel» Rijk veizonden. (48!.*",http://resolver.kb.nl/resolve?urn=ddd:011066198:mpeg21:a0035:ocr,4,ddd:011066198:mpeg21:p004,De standaard,781
2183230,1876/09/13 00:00:00,1598,ddd:010062653:mpeg21:a0033,http://imageviewer.kb.nl/ImagingService/imagingService?id=ddd:010062653:mpeg21:p004:image&x=1422&y=1009&w=1380&h=1598,ddd:010062653:mpeg21,2802,2607,1422,1009,4,"1000 GÏÏLDEÏÏ. Den 15n Augustus is verschenen het navolgende Nieuwe Premiepakket inhoudende: 10. Een der zoo gerenommeerde en fraai bewerkte Kinderboeken van W. F. OOSTVEEN met prettige lectuur en 14 bij uitstek fraai gekleurde platen. Nieuwe uitgave. Leiden 1875. 20. Een stel van 7 Wonderkaarten waardoor men op eens iemands gedachten 'raden kan; een kunstje ons door de Goden geleerd. 30. Een De Reis om de Werelddoor JULES VERNE. Nieuw leerzaam onderhoudend Gezelschapsspel met 80 plaatjes naar VERNES meesterwerk. Dit Pakket kost slechts 60 cents en wordt daarvoor franco geleverd door het geheele land. Wanneer men zoon Pakketje bestelt dat toch waarlijk goedkoop is kan men een BanHiiljet van OéüM Güen er bij Cadeau krijgen want in één der gesloten Envelopjes waarin 2 der WÓNDERKAARTJES hebben wij een Bon gelegd om gemelde som bij ons te ontvangen terwijl in nog 100 andere Envelopjes in ieder een bon is gelegd voor een Rotterdamsch Paardenlot welke loten mede door ons worden CADEAU gemaakt aan den vinder. Na afloop zullen wij opgeven wie de Bons gevonden en de Premiên cadeau gekregen nebben. Wie er lust in heeft en het bankje van duizend gulden kan gebruiken moet niet lang wachten maar dadelijk zijne bestelling doen. GEBROEDERS KOSTER Leliegracht Amsterdam. Wie 2 ol meer Pakjes bestelt krijgt ook alle verschillende Kinderboeken er bij. Betaling met Postwissels of blauwe Postzegels naar verkiezing. (2995) i In 't Lommer. Een en ander over Boomen Planten en Bloemen DOOR H. WITTE Hortulanus aan 's Rijks Akademieluin te Leiden. Een deel van ruim 400 blz. in geïll. omslag. Prijs ƒ1.90. ! Schetsen nlt het Plantenrïjk DOOR H. WITTE. Met 200 Afbeeldingen. Compleet in een fraai royaal 80. boekdeel van 526 blz. a / 3.90. Beide weHten zijn in de meeste Boekwinkels verkrijgbaar gesteld door den Uitgever G. L. FUNKE te Amsterdam. ïrWMT Amsterdam. Geldersche Kade 17. Onvervalschte Wijnen. Fijne Bieren. Prijscouranten franco. Repetitie Gala-Concert on Woensdag 13 September in het Lokaal »/>•# VEREENIGING"" Warmoesstraat^ (4262)",http://resolver.kb.nl/resolve?urn=ddd:010062653:mpeg21:a0033:ocr,4,ddd:010062653:mpeg21:p004,Het nieuws van den dag : kleine courant,1380
10138832,1876/05/21 00:00:00,5237,ddd:010972875:mpeg21:a0074,http://imageviewer.kb.nl/ImagingService/imagingService?id=ddd:010972875:mpeg21:p008:image&x=2042&y=1661&w=1936&h=5237,ddd:010972875:mpeg21,3978,6898,2042,1661,8,"VEILIGHEIDS PETROLEUM-LAMPEN DITO NACHTLICHTEN EN LANTAARNS die omvallende VAN ZELVE UITGAAN en dan ook GEENE OLIE UITLATEN zoowel voor Werkplaatsen iabn.ken Stallen Koetshuizen Hooizolders alsmede voor Huis- en Scheepsgebruik en Export zeer aanbevelen.waard. Alle vervaardigd naar ons stelse  zooals dat den 2-_ten October 1875 door het Departement lloferdam der Maatschappij van Nijverheid den EERSTEN PRIJS verwierf; met alle de daaraan gebrachte verbeteringen en uitbreidingen. Verkrijgbaar bij de uitvinders en vervaardigers D BATENBURG. & Co*5 ILI-II¥IIHAVJ_II W* lik 13? Instrumentmakers en Handelaren in Ankers Kettingen en verdere Scheepsbehoeften. HOOFD-AGENT VOOR NEDERLAND: de Meer I. A. MÏ_¥ï_K Meent _¥°. 13 Botterdani alwaar MONSTERS ter bezichtiging en PRIJ.-COÜBAN.EN op franco aanvragen uitsluitend verkrijgbaar zijn. (18545) NOG ENKELE EX ZIJ» TE BEKOMEN VAN i Mijn bezsoek aan Bismarck DOOR JOGHEM VAN OUDERE Psjpenfaörïkant en Onderling te Gouda. (Deventeb bij A. TER GUNNE). Prijs f 1.35. Geen werk heeft in den laatsten tyd zeker meer spraak en tegenspraak verwekt dan dit. Voor den Boekhandel: SN COMMISSIE WOKDT RET NIET MEER GEZONDEN. (18081 ♦>►( da GRIMAULT & C"". Apothekers te Parij» )-<<B> ]\ \l Dit nieuwe geneesmiddel 'wordt door de meeste Fransche en buitenlands che geneesheeren II \\ aanbevolen als een uitstekend middel tegen de verschillende aandoeningen der ademhalings li. t\\ organen. Het is voldoende de rook der cigaretten in te ademen om de hevigste aanvallen /Ijk y\ Tan asthma en hoest te doen bedaren. Ook is de einad.ming zeer aan te bevelen /|yl tegen heeschheid nevralgien in het aangezicht en beginselen yan longtering. g^vS^^-""""-»-. _»ej»o*« ii» «Jle geiette Mol.uti.». J.e ajto.Aer.eit. >_.—ll_yi _~* _-^^—_■.I■■■■MMMBMMBM__ar_________________________l__ ■■■!■■ —■ II _____■___—« __. M_.ll_ I I _ _. ... (239. ) Ü4 _Tlfi.__RT____..li_PPlJ „MDÏBIAND* ■—______ Regelmatige Maildienst des Zaterdags om de vier weken van Nk-uwediep in correspondentie rac-t den naraiddagtrein die te 12 u. 31 m. te Helder aankomt Naar PABANG BATAVIA BAMARANG en SOERABAJA zullen vertrekken: 10 JUNI PRINS VAN ©BANJIE  Kapt. T. J. AÜKES. 8 JOLI VOORWAARTS Kapt. J. T. ORAADT VAN ROGGEN. Adres voor PASSACE aan de Bureaus der DIRECTIE te AMSTERDAM en te NIEUWEDIEP en bij df onderstaande Agenten: AMSTERDAM »E VJRIES & C°. GRONINGEN.... WYNNE & BAREND». ARNHEM C. B ALCK. KAMPEN W. I. TOLSMA. BREDA S. E. f; ®E VAYNES VAN LEIDEN J. F. H. «(.BEL. MIDDELBURG..SPOORS & SPfI.EF.ftER. DELFT F. *°JL._t;*s' t__ttt._t._m H-UYPEM  VAN DAM & SMEER. DEVENTER ft. WESTENENK j*. ROTTERDAM... A< B IioRDWK. 's-GRAVENHAGE .... CRANS & C°. UTRECHT MULDER & VAN KALKEN. Adres voor LADING bij de Cargadoors DE VRIES & C . te Amsterdam KUYPER VAN DAM & SMEER te Rotterdam Pakjes naar alle plaatsen van den Indischen Archipel „orden tot laag Tarief aangenomen op alle Kantoron van VAN GEND & LOOS. De Vracht moet steeds vooruit betaald worden. BRIEVENVERVOER rolgens oontract met de Ned. Regeering aangekondigd door do Poat-Administratie. (3075) iiottërdamxonden. H»e stoomschepen dezer Maatschappij vertrekken geregeld als volgt: VAN ROTTERDAM: VAN LONDEN: De BATAVIER iederen Dinsdag voormiddags 11 nur. lederen Zaterdag 's middags 12 uur. De nOLLAND iederen Vrijdag 's namiddags 2 unr. lederen Woensdag voormiddags 10 uur. De MAASSTROOM iederen Zondag voormidd. 10 uur. lederen Donderdag 's middags 12 uur. (17522) Informatiën bij de Cargadoors D. A. VAN OORDT & C\ te Rotterdam; en P. N. DE JONG te Amsterdam. J& ROTTERMM.CHE LLOYD. £-~„__.___ Stoomvaart tusschen NEDERLAND en JAVA via SU EZ-K ANAAL. Naar PABANG BATAVIA SAMARANG en SOERABAJA zullen vertrekken: 20 MEI het Stoomschip TORRINGTON Kapitein R. J. BLACKLIN In JULI . 0 HAMPTON .. W. R. M. MONTREIJ. hebbende uitmuntende Inrichtingen voor Pfissagicrs. Goederen voor do TORRINGTON worden reeds in ontvangst genomen. Adres voor PASSAGE bij de onderstaande Agenten: AMSTERDAM ©OLGAAR»T & BRUINIER. GRONINGEN WYNNE & BARENDS. ARNHEAI C. BALCK. HAARLEM W. VOGEL. BREDA W. Jf. LEIDEN J. T. H. GÜBEL. DELFT jl. M. »E KIJVSER. ROTTERDAM RIITS & C"". s-GRAVENHAGE... CRANS & L . UTRECHT DE VOGEL & MOESMAN. Adres voor LADING bij de Cargadoors RUYS & C°. te Rotterdam OOLGAARDT & BRUINIER to Amsterdam. Pakjes naar alle plaatsen van den Indischen Archipel worden tot laag Tarief aanj.nomen. De Vracht moet stced vooruit betaald worden. (12776) GREAT EASTERN R4ILWAY COIPAN? Geregelde dagelijksche dienst tusschen VIA HARWICH VOOR PASSAGIERS GOEDEREN & ¥EE met snetvtffcnOe Ma&erstoomscltepetu VERTREf&_ IJ D* Van ROTTERDAM: dagelijks 's namiddags te 6 nar 15 min. Vw LORDOX dagelijks s avoads te . nur 30 min. per spoor via Harwicb. ZONDAGEN UITGEZONDERD. (154 HUDIG & PIETERS Agenten. mam STOOMBOOT tusschen KOTTSBWW-*-bi_i_sSf^_/SffinK__!_. V^ool*. BRADFOBD. LEEDS HALIFAX W___B__D_LD DEWSBURT. Ff_DD.NFn.L_>. LIVERPOOL etc. etc. via GRI.B_.f_Y. *""""*»> Vertrek van ROTTERDAM lederen Dl 3. SDA G en ZATERDAG. Adres bij de Agenten PUTS & CV (lgfij",http://resolver.kb.nl/resolve?urn=ddd:010972875:mpeg21:a0074:ocr,8,ddd:010972875:mpeg21:p008,Algemeen Handelsblad,1936
5346446,1876/03/29 00:00:00,5772,ddd:010486741:mpeg21:a0008,http://imageviewer.kb.nl/ImagingService/imagingService?id=ddd:010486741:mpeg21:p001:image&x=65&y=76&w=4020&h=5772,ddd:010486741:mpeg21,4085,5848,65,76,4,"Versche Z. I.KAZEN. Ronde Komijne KAASJES. 1197 DE LANGE & Co. Apotheek — Buitenzorg. Per Voorwaarts ontvangen: Een uitgezochte pariij iiahlla- Kollen. in de schoonste kleuren in pakjes van tien en vijf soorten a tien en vijf gulden per pak. DOOfeJES met BLOEMZADEN voor dit klimaat geachikt in twaalf soorten a ƒ 2.50 't doosje. Verder: i^:Eai_t____.__k.-Eri_^ bollen geschikt voor de bovenlanden a / 5— het pakje. Brieven franco. — Remise contant. 1255 W aar scha wing. Daar 't ondergeteekende gebleken is '""..' .SÈlfl' dat Chineezen hier ter plaatse WIJN wordt verkocht van zeer inferieure kwaliteit waarvan het ETIKET voorzien is van zijnen naam zoo neemt hij beleefd de vrijheid het publiek hierop attent te maken. WIJN van mij afkomstig draagt het merk : Importé par H. A. VERBURGT — Batavia de valsche daarentegen: Importé par H. A. VERBURGT — Bordeaux. H A. VERBURGT 1262 Wynhandelaar. Ontvangen : Dames en Heeren Glacé Handschoenen. BTOF voor GORDIJNEN en PORTIÈRES. GORDIJNHOUDERS voor Dito. GARNITUREN en LIJSTEN voor Dito. SPIEG-B X S in alle metingen. HERSTELLINGEN aan KASTEN ETAGÈBES BONHEUR DS JOUR enz enz Chromo-Lithografien. -L-ij-.ter_ . ronde vierkante zwarte en vergulde. 12.0 - ; ■ BAILLE. SNAREN voor «Ue sirpiiistrunienten. 49 W. H. VAN DER PUTTEN. Roode bü Witte Portwijn merk "" n."". 1806 CAVADINO k Co. Rook vleesch. 1207 CAVADINO _ Co. Worcesters*iire Sauce. 1208 .CAVADINO & Co. Ber-gaalsche OHUT'NOTT-1209 CAVADF O 8. Cc. Makansar Roode Visohjes 1210 CAVADINO .. ('o COBTADOS CAVITE. j HABANOS ld. 1211"" - CaVAI.INQ ï Co. Fijne. Manila Siga enkokers. 1918 CAVADINO fc Co.- Ontvangen: ïïl_MrOpe«_-«.40.1i«> 1 .'S r***v**f één en twéé persoons Ledekanieih gemakkelijk in en uit elkander te Zetten. 1267 JOHN HOPFF Gang Petjenongan. PÖI-mIÏD CEIENT KNIGHT BEVAN fc SffVRG® Vml . ■ rvaste Steenen (PICAT.DT.) Alp ii all Wilt in rollen. BBANDSPTJITSLANGm CENTBIEÜGE GAAS. 757 VAM VLEUTEN St COX. IJZ ERMEjNIE van KAMP & 80ETEN8 ie Tegelen bij f.».» bevattende 94% IJzeroxyde bekroond op de T.ïitooiiSieiiii'i:; t. Weenen en op de Internationale Maritime Tentoonstelling te Napels. 758 VA . VJ-gUTEN St COX. BIJTTJIGWIELEN. KABWIELEN. PEDATTIE ASSEN. 759 VAN VLEUTEN it- COX.",http://resolver.kb.nl/resolve?urn=ddd:010486741:mpeg21:a0008:ocr,1,ddd:010486741:mpeg21:p001,"Java-bode : nieuws, handels- en advertentieblad voor Nederlandsch-Indie",4020
19640,1876/03/29 00:00:00,40,ddd:010264071:mpeg21:a0002,http://imageviewer.kb.nl/ImagingService/imagingService?id=ddd:010264071:mpeg21:p003:image&x=2406&y=129&w=491&h=40,ddd:010264071:mpeg21,2897,169,2406,129,6,__DVERT£_-Tl__N.,http://resolver.kb.nl/resolve?urn=ddd:010264071:mpeg21:a0002:ocr,3,ddd:010264071:mpeg21:p003,De Tĳd : godsdienstig-staatkundig dagblad,491
4690944,1876/11/01 00:00:00,4581,ddd:011102131:mpeg21:a0020,http://imageviewer.kb.nl/ImagingService/imagingService?id=ddd:011102131:mpeg21:p004:image&x=48&y=1246&w=1024&h=4581,ddd:011102131:mpeg21,1072,5827,48,1246,4,"CHARTÉRED BANK OF INDIA AUSTRALIA & CHINA. Incorporated by Hoyal Charter. UOOFD-KAIIITOOK Uatton Couht ThBEAUNEEOI ESTIiEfcT LONDON IIAftHfKRSt . t  j I H°P® & Goic Amlerdam J & Goxnrtn. • Rotterdam De Róttehoausché Bark. • Lórt don — Th* Citt Bask. i|i Schotland — The National Bank of Scotland. te Parijn — I)b_ Cajsse Commercials ng Paris. Branches en Agentschappen. — Dombay Calcutta Akyab Hangoor* Singapore Batavia Hongkong Shanghae Hankow Manila. liet AGENTSCHAP BATAVIA geëll Wissels af op het HoofJ-Kantuoi en de Bankiers te Londen Schotland Amsterdam Rotterdam cn Parijs op alle Branches en Agent schappen alsmede op Amoy en Australië. Veiliaodelt en inkasseert Wissels. . Ileniiituprt gelden in eigen Wissels zonder berekening van kommissie cn belast zich met alle gewone Bankzaken. DEPOSITOS voor langer termyn en in Rekening-Courant worden aangenomen op voorwaarden nader by den ocdergeleckocde te vernemen. Alle brieven moeten geadresseerd en Remises betaalbaar gesteld worden aan The Chartered Bank op India AujTßalia & China. Tbos. L. Mnllins Agent te Batavia CORRESrONUENTEN : Te Samarang de lleeren McNeill & Co. » Soerabaya » » Fraseh Eaton <k Co -i * Makassar » » M. Ohl & Co. • Padang a> • Ponvis & Co. (191) Met refertè aan bovenstaande advertentie zijn de onder» geteekenden geroagligd Wissels af te geven op Londen Rotterdam & Parijs op de veischeidenc Branches & Agentschappen alsmede op Amoy op voorwaarden nader bij ben te vernemen. De Agenten te Padang der Charte>e<L Bank of India Australia <J- China runvis & co. I'adanc G Juuij 1873 (195) ———■—■—opwmmmmmmmmm I I ""I i Nederlandsqh-Indische JiKVENSV KHZEKERING & LIJFBKNTE MAATSCHAPPIJ. Deze Maatschappij is steeds bereid tot het aangaan van kontrakten voor Levensverzekering cn Lijfrente. Omtrent de steeds toenemende uitbreiding van haar «verkkring raadplege men de driemaandelijks in de Couranten voorkomende staten van deelname. Inlichtingen en Blanku's gratis verkrijgbaar: Batavia ten kantore der Maatschappij - » Soerakarla bij den Heer W. 11. Voute • Salatiga bij den lleir I). P. Eupbmxk. • Soerabaya bij de Uee.eu Akeuakt & Co. i Samarang bij den Heer J. B. A Buumstkede. j « Probolingo bij de lleeren van de Ven Larsjw i. Co. « Djokdjokarta bij den lieer J. van Gorkou. i Passaroeang bij de Heeren D. C. van der Hart & Co. « Cheribon. bij den lieer W. van Leuven. • Banda bij den lieer M. Lantzius. « f Bandong bij den lieer C. Meij BOOM. . • Tjilatjap bij dtn Hier K. A Rouwenhokm Mulder « Amboiua bij den lieer N. M. G. Renoult. • Padang bij den lieer F. L. Slaterus. • Pekatongan bij de Hecren llana Mullemeister & Co « Makassar bij den lieer J. P. G. Warnsïnck. (886) E. DOUWES DEKKER Direkleur. Uitkeeringsfonds I „LA CONSTANTE ET FIDÉLE."" lemand beneden de jaar verzekert door eene kontributie van f 2.50 'smaands aan zjjne weduwe - of kinderen / 1000.— Reglemcnt .op franko aanvraag gratis te verkrijgen Kommissdrissen van toezicht zijn de HH' G. L DORREPAAL Chef van de firma Dompaal Co. te Samarang. J. C. SPENGLER Agent der Javaschc Bank te Samarang. BESTUUR. J. M. ROSSKOPF Voorzitter. L. CL POLDERMAN Thesaurier. J. VERHEUL Sekretaris. (903) C. E. VAN RESTEREN) B. V. 110UTHUIJSEN ) AGENTEN. F. D. W. KRUTUOFFER te Soerabaya.  G. L. A. BRIëT „ Padang. j M. BURGERSDIJK „ Batavia. i J. U. PIJNACKER HORDIJK „ Djocjokarta. |",http://resolver.kb.nl/resolve?urn=ddd:011102131:mpeg21:a0020:ocr,4,ddd:011102131:mpeg21:p004,Sumatra-courant : nieuws- en advertentieblad,1024
751124,1876/04/16 00:00:00,794,ddd:010099979:mpeg21:a0024,http://imageviewer.kb.nl/ImagingService/imagingService?id=ddd:010099979:mpeg21:p004:image&x=1077&y=771&w=946&h=794,ddd:010099979:mpeg21,2023,1565,1077,771,8,"AVOND-BMLLEIV. GUDENDAG Gezichtknndige. (138) BRD_X_____¥ • etc. A. Jl. SCHOKKING Ju. (2596) GEZICHTKUNDIGE IN STR UMENTMAKER. ROKIN. OVER AETL ROKEN. SIGAREN ""merk PRINS HENDRIK (extra jfenrijr). €Hüßßg.van »_BJW__)i_RiaT«E_ff KAMPEN. Monsterkistjes verkrijgbaar bij onzen Agont den Heer A. BÜYS Jzn. Damrak G 6 Amsterdam. (13840)",http://resolver.kb.nl/resolve?urn=ddd:010099979:mpeg21:a0024:ocr,4,ddd:010099979:mpeg21:p004,Algemeen Handelsblad,946
1901830,1876/06/06 00:00:00,1883,ddd:010338798:mpeg21:a0011,http://imageviewer.kb.nl/ImagingService/imagingService?id=ddd:010338798:mpeg21:p004:image&x=80&y=2689&w=1010&h=1883,ddd:010338798:mpeg21,1090,4572,80,2689,4,"%£_»%__; k* 'A h_.' il '11 $u 11. k Oji den 14den Junij IS7Ü J Trouwen alhier: i (2X \\ Felicitalirn worden ontvangen f ""j.p Z oii(1 a (t il.n Un. Junij e. _ des (jv om /.«// w/il ure aan de Maa'j- . \denstraat. r $ Eenige Kennisgeving. \ Op den Sisten Junij 187 G Trouwen f k te Paramaribo: rt £ L J. Ëierlzberger *j * M. 11. D. Ilymans * è Strekkende deze M bijzondere en * algemeene kennisgeving. T",http://resolver.kb.nl/resolve?urn=ddd:010338798:mpeg21:a0011:ocr,4,ddd:010338798:mpeg21:p004,Suriname : koloniaal nieuws- en advertentieblad,1010
1613304,1876/10/21 00:00:00,2376,ddd:010062692:mpeg21:a0025,http://imageviewer.kb.nl/ImagingService/imagingService?id=ddd:010062692:mpeg21:p003:image&x=3491&y=77&w=679&h=2376,ddd:010062692:mpeg21,4170,2453,3491,77,4,"ADïBTENTIEN. 4S_ffl_-=S Hulponderw|fer.m Ruinerwold Hoofdonde.wy«ryM_ wordt gevraagd een HUj-Pou"" op eene jaarwedde van ƒ oou' ƒ4 per De vorige titularis had voor ƒ* week een goed kosthuis- . der vever¦ .Aangifte' en franco f *dober ei eischte stukken voor ol °P* ¦ rwoid. aan den Burgemeester van Rmnenw gDe Burgenieester voornoemd (5734) M. J. BOSMa. Ruinerwold 30 SeptjB76._ _ Aari7s*óor7oorgewoott^S""t A. wijs te MiddeHe (Noord-Holl^ gevraagd een Hulponderwijzer.0!' jaarwedde van ƒ6OO. ¦ ¦ en van De Schooluren zijn van 9 to. "" Za_ 12 tot 2 uren 's Woendagsmiddags e terdagsmiddags geen school. v Inzending van Stukken francoaan BurgemeestervóórofopdenlNo^effibere_ ""ffIÏLPÖ^RWTZBR.  In de Armen- en Tussehenschool t Purmerende is een Hulponderwljze"" plaats vacant. . .„ne Aan die betrekking is verbondeneen jaarwedde van ƒ6OO.- en by he• De' der Hoofdonderwijzersakte of aanteeKeu gen op de Hulponderwijzersakte van ƒ Sollicitanten behooren zich te adresse ren bij den Burgemeester van Purrnerei  vóór den len November 1876 met overleg ging der bij de wet gevorderde stukken. Burgemeester en Wethouders HOOFT HASSELAER. De Secretaris J. GEDIKING. Purmerend 9 October lÉSTb^^^Jol^J Een Loopjongen kan geplaatst worden bij J. H. & G..'Vp HETEREN Hartenstraat 21. (6700) Bij den Boekh. C. F. STEMLER Haarlemmerstraat hoek Singel wordt verlangd een LOOPJONGEN tegen vast weekgeld. Een goede hand schrijvende dient ter aanbeveling. (6654) Men vraagt om dadelijk in dienst te treden een Koffiehuis-Bediende P. G. niet beneden de 20 jaren. Brieven met 3153 aan het Internationaal Annoncen-Bureau Dam 15",http://resolver.kb.nl/resolve?urn=ddd:010062692:mpeg21:a0025:ocr,3,ddd:010062692:mpeg21:p003,Het nieuws van den dag : kleine courant,679
1825832,1876/09/28 00:00:00,1353,ddd:010062669:mpeg21:a0032,http://imageviewer.kb.nl/ImagingService/imagingService?id=ddd:010062669:mpeg21:p004:image&x=2838&y=81&w=1365&h=1353,ddd:010062669:mpeg21,4203,1434,2838,81,10,Art. el AiiÉiae. TEJJTOOÏÏSTELLIN. VAN AQUARELLEN. Nieuwe stndiën naar de natuur op het eiland Corsica vervaardigd door den Heer C. W. M. VAN DE VELDE. Opening Woensdag 4. October. Bepaalde sluiting Zondag 8 Oot. Dagelijks te bezichtigen van 10 tot 4 uur te gen betaling van 25 Cent de Persoon. HH. Leden met hunne Dames hebben vrijen toegang. (5185) De Commissie Restuurderen der Kunstzalen. Maatschappij. De Secretaris De Secretaris 3. A. RUST. J H. RENNEFELD. American and Foreip Kepository ni Ageij C. E. BOELEI ÏïtrecMscliestiaat 85. De BAZAB wordt GEOPEND Zaterdag 30 September a. s. 's avonds te 7 uren. (5118) ¦BBEECHTVAJST-IRZBE' De Notaris VAN DER BIESEN te Zasolle; bericht dat het in eene vroegere annonce breeder omschreven HBEB-EN-LOGBMBN'T genaamd: y>het Mmstersche Post-' huis)) met STALLING te Zwolle is. INGEZET op ƒBBoo—. De Verkoop is bepaald op Dinsdag 3 October 1876. BE BÏÏIKSPOUE. Een Geïll. Verhaal JJIT DE JAARBOEKEN J>E_t RECHTSPLEGING wordt geregeld-.vervolgd IN BE HOLLAISCHE ILLUSTRATIE WEKELIJK_SCHE Geïllustreerde Courant. HET MEEST GELESENE EN HET MEEST GOEDBOOPE GEÏLLUSTREERDE BLAD. De Prijs per compleeten Jsrargang is slechts ƒ3.90. Prospectussen en Proefnonunera zijn alom verkrijgbaar.,http://resolver.kb.nl/resolve?urn=ddd:010062669:mpeg21:a0032:ocr,4,ddd:010062669:mpeg21:p004,Het nieuws van den dag : kleine courant,1365
2328191,1876/09/07 00:00:00,2383,ddd:010486878:mpeg21:a0010,http://imageviewer.kb.nl/ImagingService/imagingService?id=ddd:010486878:mpeg21:p001:image&x=3138&y=3454&w=977&h=2383,ddd:010486878:mpeg21,4115,5837,3138,3454,4,GOEDKOOPE ATLASSEN G. KOLFF & CO.' KALIE BAZAK. KAN en POSTHUMUS atlas der geheele aarde 22 Kaarten ƒ 1.50 VAN SANTEN'S idem idem. . 1.25 CAMPAGNES idem idem. „ 1.25 OTTO PETRI'S idem 9 Kaarten —.50 3517 Penhouders met plaatjes 30 cents 3518 bij G. KOLFF h Co. Seyffardt de Vestingoorlog ƒ 3.50 3519 bij G. KOLFF fc Co. SAMUEL SMILES LEVENSWIJSHEID EEN MIDDEL TOT GELUK ƒ 2 3520 bij G. KOLFF k Co. Og-er Frères Vient de recevoir de Paris: Drap noir et bleu etc. TRICOTS NOUVEAUTÉ. CHEMISES FAUX COLS. CHAUSSETTES CRAVATTES. CHAPEAUX FANTAISIE et HABILLÉ. CHAPEAUX DE COCHERS. BRODERIES OR et ARGENT. EPÉES CLAQUES DRAGONES etc. GANTS GLACÉS JOU VIN pour DAMES et MESSIEURS 3284 Chaussur es pour Dames. Thans verkrijgbaar: DE NIEUWE COGNOSSEMENTEN voor afscheep van goederen per STODMVAART MAATSCHAPPIJ NEDERLAND gedrukt op geel papier. 8437 H. M. VAN DORP & Co.,http://resolver.kb.nl/resolve?urn=ddd:010486878:mpeg21:a0010:ocr,1,ddd:010486878:mpeg21:p001,"Java-bode : nieuws, handels- en advertentieblad voor Nederlandsch-Indie",977
2011050,1876/02/04 00:00:00,1962,MMKB08:000114051:mpeg21:a0008,http://imageviewer.kb.nl/ImagingService/imagingService?id=MMKB08:000114051:mpeg21:p002:image&x=2223&y=3212&w=1025&h=1962,MMKB08:000114051:mpeg21,3248,5174,2223,3212,4,Advertentie Met toestemming van H H. Burgemeester en Wethouders dezer stad  zijn Armverzorgers der Evangelisch-Luthersche Gemeente alhier voornemens op Zondag 6 februari e. k. eene ALGEMEEN2 COLLECTE te houden aan de huizen der ingezetenen ten behoeve hunner Diakonie. In hope op een gunsligen uitslag nemen zij de vrijheid om de milddadigheid hunner Medeburgers teu dringendste in te roepen. Delft 28 Januarij 1876. Armverzorgers voornoemd A. KNETEMANN Voorzitter. F. W. GEBING Scriba. De Hooge Raad der Nederlanden heeft op den 21 Januari 1876 aan PIETER ADRIAAN LUIJTEN wonende in de gemeente Vrijenban alwaar hij op den 28n December 1855 is geboren uit het huwelijk van LaMBERTUS LUIJTEN met PETRONELLA VAN IJZENDOORN verleend venia aetatis of brieven van meerderjarig verklaring die na goedkeuring des Konings bij besluit van den 30 Januari 1876 n # . 4 van kracht zijn. en hem geven al de rechten bij de wet aan meerderjarigen toegekend behoudens de bepaling van art. 478 van het Burgerlijk Wetboek. EIJSSELL Procureur bij den Hoogen Raad. Delftsche Coöperatieve Winkelvereeniging. Het in ontvangst nemen der penningen zal plaats hebben Zondag 6 Februari a. s. vau ll'A tot 1 uur. Namens het Bestnur J. N. BEIJEN Secretaris.,http://resolver.kb.nl/resolve?urn=MMKB08:000114051:mpeg21:a0008:ocr,2,MMKB08:000114051:mpeg21:p002,Delftsche courant,1025
4267668,1876/11/11 00:00:00,5009,MMSADB01:000007535:mpeg21:a0015,http://imageviewer.kb.nl/ImagingService/imagingService?id=MMSADB01:000007535:mpeg21:p003:image&x=1021&y=118&w=852&h=5009,MMSADB01:000007535:mpeg21,1873,5127,1021,118,8,"Advertentie Aanbevolen door wijlen Monseigneur F. CT. ""VA.3ST VR^E Bisschop van Haa^knn. ra mi iinmi C. VON SCHMID 18 deelen met Platen geheel nieuw voor ZES GULDEN franco door het geheele Rijk. Afgehaald f5.50 bij KLEIN Ververstraat 't-Bosch. Briefschrijven onnoodig alleen Postwissel met motto // S chmid"". Boekhandel van W. C. VA2THEUSDEN Hinthamerstraat/A. 43. / LEESiplCHTING Hollandsche Ptfansche Hoogduitsclie en Engelsch^r Tijdschriften en Romans. De keuz^r der Tijdschriften is geheel vrij. Voor jonge Dames Huismoeder Modenaaisters en Magazijnen SUH91K Hollandsche uitgave van lyst Fransclie Tijdschrift //La Saison Jourokl des Dames.""i Geïllustreerd tijdschrift: voor Damesen Kinderkleeding en Handwerken. Prijs per kwartaal/van 6 Nommers /j met 6 Patroonbladen ƒ1.40 i idem met 6 gekleurde J u Modeplaten ƒ2.30. De Dames-Modegids munt uit door groote verscheidenheid /van origineele Fransche Modes en Handwerken en levert voor elk seizoen de nie/wste modellen. De fraaie ■ afbeeldingen/volslagen patronen en nauwkeurige beschrijvingen maken het nawerken uiterst gemakkelijk. Ook de prachtige gekleurde modeplaten worden te rarijs naar werkelijke modellen geteekend. Uitgeknipte patronen/worden op aanvraag geleverd. Men teekent jnet elk N in bij alle Boekhandelaren en Po/tkantoren alsmede bij de Uitgevers P. N'oordhofl' & M. Smit te Groningen. MUZIEKHANDEL van / IIEMtl MOS! achter het Stadhuis/A. 332 'S-HERTOGENB0SCH. If Is verschene. GaotantiMs Oriaiis Cscl Muziek van N. A. JANSSEN Pr. Hymne ter eere der H. C. ecii.ia  voor drie gelijke Stemmen met Orgelbegeleiding Latijnsche text. Pa/titur en Stemmen ongeveer f 1. VERSCHENEN: Missa Brevis et facilis tribus Vocibus et Organo Auctore L. H. C. SCHUTJES Sacerdote. Partitur f 2.50 Zangpartijen f 090. d' ARCHAMÉEAU  Mis N° 6 voor 3 Mannenstemmen en Orgel. Partitur en Stemmen f 2.25. LAMBINE /T Mis N 1 1 voor 3 Mannen stemmen en Orgel. Partitur en Stemmen f 2 25. F. A. SCfHMlDT 6 korte en gemakkelijke Mi fssen voor 4 Mannenstemmen en Orgel Iedere Mis Part. en Stemmen f 1.50. Verder voorhanden alle soorten van KerkMuziek Piano Zang en Piano. Liedertafel - Muziek Methoden Studiën Snaren Stemvorken Chromatieke Stemfluiten enz. enz.",http://resolver.kb.nl/resolve?urn=MMSADB01:000007535:mpeg21:a0015:ocr,3,MMSADB01:000007535:mpeg21:p003,Provinciale Noordbrabantsche en 's Hertogenbossche courant,852
1772301,1876/10/07 00:00:00,1767,ddd:010486904:mpeg21:a0004,http://imageviewer.kb.nl/ImagingService/imagingService?id=ddd:010486904:mpeg21:p001:image&x=2113&y=1205&w=1003&h=1767,ddd:010486904:mpeg21,3116,2972,2113,1205,6,Vendutie op Woensdag 11 October 1876 wegens vertrek voor het huis van den Wel Edelen Heer ANTHOJVIJS Pinioe-Hesie Gocnoeng-Saharie door W. L van Slooten van eenen netten I Ui B 0 E D E L PETROLEUM HANG- en TAFELLAMPEN SPIEGELS en SCHILDERIJKN PALEMBANGSCHE LUIJER- en WITSTOELEN ROTTING-AMEUBLEMENT TAFELS CONSOLES WASCHTAFELS KASTEN van DJATTIEHOUT IJZEREN 1 en 2 persoons en KINDERLELEKANTEN GLAZEN- en DISPENSKASTEN BUFFET PLEET- PORCELEIN- GLAS- en AARDEWERK MATTEN MARTEVANEN. T'ooris nog: I TENTWAGEN. 1 KINDERWAGEN. 2 DOS-a-DOS. 1 span ZWARTE SAVONESCHE PAARDEN. 2 DOS-a-DOS PAARDEN. 1 RIJPAARD. TUIGEN en 1 GADOGANG voor 6 paarden etc. 3988 Op bovenstaande Vendutie zal de ondergeteekende nog verkoopen: Eenige prachtige melkgevende en bezette JKDEUEN van Europeesch ras alsmede JONGE KOEIJEN toebehoorend e aan Mevrouw de Weduwe KROESE. W. L. VAN SLOOTEN. Geene Koeyen kunnen worden bijgebragt.. 3984,http://resolver.kb.nl/resolve?urn=ddd:010486904:mpeg21:a0004:ocr,1,ddd:010486904:mpeg21:p001,"Java-bode : nieuws, handels- en advertentieblad voor Nederlandsch-Indie",1003
1134639,1876/10/06 00:00:00,471,ddd:010586837:mpeg21:a0047,http://imageviewer.kb.nl/ImagingService/imagingService?id=ddd:010586837:mpeg21:p008:image&x=229&y=120&w=2409&h=471,ddd:010586837:mpeg21,2638,591,229,120,12,"KAGGHEL-iyiAGAZUN van Ti/L. 3"". R.BEKE3R.S ST. JACOBSTRAAT LEEUWARDEN is ruim voorzien van alle soorten KAGCHELS en HAARDEN. TURFBAKKEN enz.. tot welker levering hij zich minzaam aanbeveelt belovende eene soliede bediening.",http://resolver.kb.nl/resolve?urn=ddd:010586837:mpeg21:a0047:ocr,8,ddd:010586837:mpeg21:p008,Leeuwarder courant,2409
1187010,1876/08/27 00:00:00,1199,ddd:010972971:mpeg21:a0072,http://imageviewer.kb.nl/ImagingService/imagingService?id=ddd:010972971:mpeg21:p008:image&x=3017&y=1444&w=990&h=1199,ddd:010972971:mpeg21,4007,2643,3017,1444,8,Rotterdamsche j Door de Rolterdamscho Hand.lsveroaniging worden I' vóór of op den loden Saptemba* 1576 ton haren kan- j tore Boompjes N°. 49 aanbiedingen ingewacht: ¥_orde geheele of gedeeltelijke levering van 38CI _* MP.  bezaagd RE» UT___¥M©lJT voor de hintlagen en vloeren i van liet op Feijeiioord in aanbouw zijnde Entrepot- ; pakhuis. De voorwaarden van levering zijn van heden af ! verkrijgbaar tan Kantore voornoemd tegen betaling van ƒ 1. (31454) DE DIRECTIE. . MP HEIT. ~^l R. CASSANS Heu-Hiiiidler 8 Juven-lstreet Liver pool England wünscht Offerten ven bestem KLEE auch HEIT  — geliefert frei an Bord oder frei Quai-Liverpool. — Referenz: North & South-Wales Bank (North Braneh) Liverpool. (31302) (Act. 1672 (VIII) H.,http://resolver.kb.nl/resolve?urn=ddd:010972971:mpeg21:a0072:ocr,8,ddd:010972971:mpeg21:p008,Algemeen Handelsblad,990
560150,1876/06/15 00:00:00,659,MMKB04:000166694:mpeg21:a0014,http://imageviewer.kb.nl/ImagingService/imagingService?id=MMKB04:000166694:mpeg21:p004:image&x=83&y=1236&w=850&h=659,MMKB04:000166694:mpeg21,933,1895,83,1236,4,NIEUWE HARING. MIEU WE HA BIMa. Heden ontvaDgen de eerste puike NIEUWE SCHOTSCHE Maatjesharing alsmede te bekomen puike nieuwe KELEN en LIPPEN en ZOUTEVISCH in de Haring- en Vischpakkerij Kipstraat No. 65. «MO 6R0ENEWES & STAM,http://resolver.kb.nl/resolve?urn=MMKB04:000166694:mpeg21:a0014:ocr,4,MMKB04:000166694:mpeg21:p004,De Maasbode,850
6529055,1876/05/29 00:00:00,3280,ddd:010486791:mpeg21:a0010,http://imageviewer.kb.nl/ImagingService/imagingService?id=ddd:010486791:mpeg21:p002:image&x=2072&y=60&w=2016&h=3280,ddd:010486791:mpeg21,4088,3340,2072,60,4,"Hanseatische Feuer Versicheruugs Gcsellschatt. (Brand Assurantie-Maatschappij) gevestigd te Hamour-jsf. Maatschappelijk kapitaal Rmj 1500000. De ondergeteekenden tot GENERAAL AGENTEN dezer maatschappij benoemd nemen Brand JEfcisicOW aan op de gebruikeliike voorwaarden. REISS k Co. 41 00 Batariri.. Sner/tMia en MarifUtpr Slagterij Mr iiornelis. tf^fM^-r-p^ De SLAGTERÏJ van den Inlander ~^Ö ~~~ GOESTIE ABDÜL RAUF te Mr. Cor*qm**m*»i& ndi> i 8 ov.ergegaan 0p J H. PIETERB. De regeling blijft vooralsnog op denzelfden voet. Mr. Cornelis ] Junij 1876. . 2^65 a»y- t-^^ii-m»» e oadergtteekenden stellen zich voor jffi» om va-j «f Donderdag 1 i Juni a- &. zich to belasten met den IN- en VERKOOP van MEUBELEN Paarden K.i)tuigen enz het admiuisrreeren en VERHUREN vau WONINGEN en LANDERIJEN. Prospectussen op franco aanvrage gratis verkrijgbaar ten kantore Berendrechtslaan. DE BRUIJN k Co. 2061 Commissionairs JN ederlandscli-Indisciie SIRWEGJgSMIJ. Lijn JLSatiavi»—JJuiteuzorg BESTELGOEDEREN. BKBTELGOEDEREN. .--.■ „.■-. ü Bij deze wordt onder d;; aandacht van ?^si''*wr et Pub''e'c gebfagt» dat bestelgoederen allée'o dau aan huis worden bezorgd wanneer de adressant binnen l/j paal van het station van aankomst woonachtig is. Is die afstaad grooter dan moet het goed worden af gehaald tenzij het gefrankeerd is en op het adres vermeld staat „per koelie door te zenden."" In dit getal wordt het op kosten en risico van den adressant onmiddelijk doorgezonden. 2027 De Ch-f der Exploitatie. Chemisch Laboratorium te Amsterdam. ■SfflgggjjPaissi Ondergeteekeude SCHEIKUNDIGE voor p|Wy de SUIKERINDUSTRIE in Nederland be **""* last zich reehistreeks ot door tueschenkorust van zija hoo'dagent de Heer H. A. TOBI\S met hst le veren van alle Toestellen en Chemicaliën benoodigd voor htrt onderzoek vau suiker en de velschillende producten der Suikerindustrie. G LOTMAN Technitch Chemitt. 'oiïsF~ Met referte tot bovecstaanda gullen de volledigste inlichtingen op aanvrage door den ondergeteekeude gegeven wordeu. PRIJSCOURANTEN te verkrijgen bij 1128 H. A. TOBIAB {Cheribon.) I MEUTER & Q. recommanderen zich voc- alle soorten van Commissie». £ 2046 Het Photografisch Atelier zal den sdeu 6den en 7deu dunij gewloten zijn. 2032 "" WOODBUKÏ & PAGE. Gevraagd ter overname  eeuig goed onderhouden Djattiehouten Kantoormeubilair. Aanbiedmge;i No. 2042 Java-Bode. 2042 Eten Buiten 'shuis verkrijgbaar by Mevrouw CROLL 1695 Gano Patjenongan. Op zeer aaüütieuibi&i'e voorwaariieu wordt te koop aangeboden: Eene welbekiante Wageaverhourderij au ftloefsmederij gelegen op KEBON DJAEH (hoek Ksrkhoflaau) in eigen. dom toebaiioorende aan den orutergeseekeade en aldaar te bevragen. «27 G. VAN 't SCHIP. Te hoop: flet Wouiiiiuis op Kebon Sirie thans bewoond door Mr. G. VaN DER JA.GT. Te bevragen bij 1800 H. M. AMENT. ie koop of te huur dadelijk te aanvaarden : Het Huis in (lang Scott voorzien van GASLAMPEN enz. enz. laatstelijk bewoond door den HoogKd.G Heer VAN POLANEN PETEL. Informatien bij 533 Wa. DAUMILLER qq. Te huur af 100.—  dadelijk te aanvaarden: Een HUIS te Tjikemah laatst bewoond door den heer tJLUMER. Adres G. HALL Batavia. 1857 BRAUTiGAM Biiienzorg. Te huur met primo JULII 1876 : Het HUI& op Salemba ttuna bewoond donr Kolonel OCKiiRSE. Te bevragen bij den b'woner. 2067 Te huur met 1 Julij: ElEïlxr JEüTTXS aan h t Konmgspletn {Zuidzijde) vooiwea vau UiSLAMPEN en ZEILEN. Adres de firma H. M. VAN DORP k Co. 1975",http://resolver.kb.nl/resolve?urn=ddd:010486791:mpeg21:a0010:ocr,2,ddd:010486791:mpeg21:p002,"Java-bode : nieuws, handels- en advertentieblad voor Nederlandsch-Indie",2016
2998776,1876/05/28 00:00:00,3377,ddd:010972881:mpeg21:a0020,http://imageviewer.kb.nl/ImagingService/imagingService?id=ddd:010972881:mpeg21:p004:image&x=3948&y=73&w=888&h=3377,ddd:010972881:mpeg21,4836,3450,3948,73,10,"___-—-_*■"" lilwi'.scMlMvißEiiois ATEE-HtT GELDEN A DEPOSITO! Mei..n Mg ocW/i tejten e.ne rente ysn 2-V» F » ttew rfojen ■ # * . . * |V» • eine maand i **'**'- Sm » drie maanden opzegging of voor drie maan' den vast ep endossabele depositobewijten met vooruitbetaalde rente * * « Voor ééne maand VAST tegen de profongalteren* Amsterdamsche Beurs dus thans 3 pCi. "" ' ONTVANGT GELDEN - Deposito in sommen va» < en de veelvouden daarvan tegen de volgende Rente: ~ Met één dag to voren opvragens 2 V^f * tien dagen » // * '...2V2 '^ Gelden op langeren termijn worden tegen overeen te * Rente aangenomen. Ai Amsterdam-27 Mei 1876. DE DIREC»' ~__AS-VEREENI6I»_r MAANDELIJKSOHE STAAT opgemaakt den 26sten Mei 1876 des avonds- Kapitaal ƒ3500000 Reservefonds * i53£~7. Bedrag der Deposito's * 6767000 . - Disconto's » 679588° r 1 op Beleening en Prolongatie uitstaande Gelden » 996800 Saldo's van Crediteuren in Rek. Cour. . . n 2006950 Voorschotten in Rek. Cour. op Onderpand . » 2454560 Saldo in Kassa « 3949391 Namens de Directie: (20482) TESTAS Directeur-Secretar' MATROOS GEVRAAGD? op een Schippersschroefstoomboot de Zuiderzee ' rende. Adres franco Lett. N. R. Bureau Handels!) REIZIGER. ~"" Een MANCHESTERHDIS zoekt een GEROVTINE' REIZIGER in Manufacturen om Holland en Heb' ksreiien tegen HOOG SALARIS. De kennis der Dm«< Fransche Talen is noodzakelijk. Franco offerten ondel W. 0. Bireau Handelsblad. "" (2007» L. GIJSELMAN en J. W. J. PETERMANN Makel»» ÊgsgjgS zullen op Dinsdag 30 Mei 1896. des voormiddags te 32 uren ten ovc-rs+f.an van den $ D. VAN DIJK in het Lokaal van Publieke Verkoopiu. Mm SE O UT te Amsterdam verkoopen: TWEE VLOTSCDITI? groot 61 en 44 tonnen en DRIE DEKSCUUI^ groot 40 44 en 33 tinnen gediend hebbende tot uito^.1 van de Scbuitenvoerdersaffaire van wijlen Mejufirouw ™J BON Jr. welke vaartuigen ter bezichtiging zullen lbj£ den Singel vóór gemeld Lokaal. Zaterdag Zondag en l dag te voren alsmede op den dag van verkoop. Voorj len tegelijkertijd nog worden geveild: eenige PLEI*! en VRACRTVAARTIUIGEN liggende en te bezie voor genoemd lokaal i-°' CAFÉ L'HLUIIË JAQ KIEÜWENDIJK I lffO BIJ DE St. JACOBSTRAAT. 1 De ondergeteekende bovengenoemd CAFÉ op heden ©PEND hebbende heeft de eer te berichten dat » door het geven van lijne Consumptie nette Bediening» berekenen van billijke prijzen zien de gunst van bet ge Publiek zal trachten waardig te maken. Amsterdam „ _ DirTr_.S> 27 Mei 3876. (20136) r. #.«*.»■.■» - SLECHTS m Cts. HEDEN VERSCHIJNT BIJ E. F. EDEN MOLSTB® Het Proces JUT en CHRISTINA GOEDVOt met ALLE OFFICIEELE STUKKEN en Plei""( benevens alles wat het proces vooraf ging en geïllustre*1 twaalf plaatjes en vier portretten. Voor buiten de stad toezending van een Fostwissvl a 60 Cts. {""""'",http://resolver.kb.nl/resolve?urn=ddd:010972881:mpeg21:a0020:ocr,4,ddd:010972881:mpeg21:p004,Algemeen Handelsblad,888
3548583,1876/12/03 00:00:00,4509,ddd:010186940:mpeg21:a0034,http://imageviewer.kb.nl/ImagingService/imagingService?id=ddd:010186940:mpeg21:p006:image&x=2509&y=85&w=787&h=4509,ddd:010186940:mpeg21,3296,4594,2509,85,6,"Heuvelstraat Tilburg. FABRIEK VAN BEDDEN HATMSSEJ EN P E L T E R IJ E N. VOORHANDEN eene ruime keuze Idamesnioi'fen ia de nieuwste modelleu. MAGAZIJN VAN Tapijten en Ameublement. ' j 6/ E. SCHEEFHALS (1) /j~0& Behanger. ' Meuwe Erwten '/YSf en Boonen. /Sf. C. IV. BRESSERS in den Bijenkorf Tilburg. KOOLTEERr Aan de Gemeentelijke Gasfabriek *e Tilburg worden tot 6 HBeeeniwe»' e. ik. inschrijvingen ingewacht voor dei1 verkoop van het aan bovengenoemd fabriek gedurende 1877 voortgebragt0 kttoljeer. Inlichtingen omtrent de voorwaarden > enz. geeft de Ingenieur-Directeur oef Fabriek. [3] VAN DER BOON & Co^ Massïers Tïïlsbsb's  belasten zich met het inkasseren va Wissels het aan- en verkoopen va Effecten het inwisselen van Coupo""8 en het bezorgen van Assurantiën volge""9 Amsterdamsche en Rotterdamsche beu13' conditien. Y^/ j HS^f"" Kantoor Comediestraat. / Jj' WooeBloesden. Verkosnïheid' ' Rorsdaanrïoeningcn e«w.. is geen aangenamer en zekerder middel als alom bekende RIJNLANDSCHE Druiven-borst-honigvan W. H. ZICKENHEIMER te Maini' Geertje Krol van Tjalleberd prov. Fries!»""* verklaart dat de llunlandsche Druiven-bobS^ honig door haar bij N. Doruseiffeu te Heerev^ gehaald haar steeds bij hare borstaandoeniugf de grootste dienst heeft bewezen. jt>'*^T?\l. Bij .ongesteldheden waar Sei\ /V'J'^ ander middel baat zal men 'M I '**SSk ceilvoudig pu natuurlijk hu'* I 1^ »$ pil middel Dooit zonder truustig 'c.. I \ VtfAiftV./ 8 aanwenden. Elke flescn door een metalen capsule geslotfI'^ waar nevenstaand fabriekstempel moet ziju '"" gedrukt. ï)/s4O Verkrijgbaar a fl—- de flesch te Tilburg bij Henri Janssen-Mes (Ho(l.)j Boxtel L-'.i Visser; Breda A. J. Jansen Gz.; 's Bosch 11. J- '1 v. d. Bogaert Apoth. Markt en A. Kluijlmans ?iv' v Olifant""; Rosendaal Jos. van Gastel; Oosterhout H*i landers-Mossou; Heusden Gérard Malingré; Geertr"" denberg J. Boon; Oirschot Gez. Van den ü°jj Oisterwijk J. J. Blomjous; Dongen Erven C. van *| Wijden; Loonopzaud Gerlr. van der Sterren; nil' heuvel il. Musiers $• Zonen; Sprang A. G. G. 0° terling; Waalwijk O. A. Verwiel. Zalf Holloway* igi< De open wonden wonden veretteringen en _B J huidziekten worden door deze verzachtende en hcilz» Zalf genezen. Zij is de grootste loftuigingen w011l.(J geweest van menschen die jaren achtereen geleden he•> . aan kwade beenen en ettergezwellen zelfs dan wan"" alle hoop op genezing verdwenen was; slechts dc \'e^ sonen die de heilzame uitwerkingen van die Zalf °f dervouden hebben kunnen zich een denkbeeld |n* « van de verligting die zij geeft door de ontsteking. beperken en de pijnen te verligteu. De Zalf eens *i gewend zijude bewijst door zich zelve hare rl'^j eu wordt van dien oogenblik af ijverig gezocht ""''lo gemakkelijkste en heilzaamste geneesmiddel voor o' } etterende aandoeningen. Voor de zenuwsmarten / rhumatismen en de jicht zullen deze twee ger.eeL""J'  delen behoorlijk aangewend /cue wonderbare verlig aanbrengen. f\ £? c-f~l/ De prijzefzijn als volgt: Doosjes Pillen en potjes Zalf 080 f 185 f*""""! f 675 f 1350 f 2050. fl) Zijn op franco aanvraag a contant te bek""l"" bij alle Apothekers in Nederland alsmede HOLLOWAY's ÉTABLISSEMENT te Lo»ae' 533 Oxfordstreet vroeger 244 Strand. Snelpersdruk van N. Luuten Tilburg.",http://resolver.kb.nl/resolve?urn=ddd:010186940:mpeg21:a0034:ocr,6,ddd:010186940:mpeg21:p006,Tilburgsche courant,787
646536,1881/01/25 00:00:00,744,ddd:010587821:mpeg21:a0003,http://imageviewer.kb.nl/ImagingService/imagingService?id=ddd:010587821:mpeg21:p003:image&x=1890&y=569&w=869&h=744,ddd:010587821:mpeg21,2759,1313,1890,569,6,Voorloopig berigt. Op nader te bepalen tijd en plaats zal spöe* dig publiek worden verkocht: Eene hechte  welbetimmerde zeer logeable en onlangs veel verbeterde lIEERENHUIZINOE met ERF en TUINTJE staande en gelegen bij de Put te Leeuwarden letter M no. 12 bevattende onderscheidene ruime Woonkamers en verdere Vertrekken waaronder twee thans tot Kantoren ingerigt met afzonderlijken ingang aan de Straat voorts groote Keuken beschoten Zolder en meerdere conimoditeiten. Inmiddels uit de hand TE KOOP. Conditiën te vernemen en inlichtingen te bekomen ten kantore van den Notaris J. de WAL te Leeuwarden.,http://resolver.kb.nl/resolve?urn=ddd:010587821:mpeg21:a0003:ocr,3,ddd:010587821:mpeg21:p003,Leeuwarder courant,869
3245315,1881/08/12 00:00:00,4087,ddd:010063505:mpeg21:a0025,http://imageviewer.kb.nl/ImagingService/imagingService?id=ddd:010063505:mpeg21:p008:image&x=2360&y=168&w=1131&h=4087,ddd:010063505:mpeg21,3491,4255,2360,168,8,"Door verandering van woonplaats ter overname aangeboden: een welbeklante Zaak in Koomenijs- Kruideniers- en Grutterswaren op een der netste standen. Verdienste ƒl5 per week. Huur van het Huis ƒ4 per week. Koopsom ƒ4OO. Te'bevragen bij F. BAKKER' Boven 68 Quellijustraat Pl.m. 25000 vierk. Meter Bouwterrein in de onmiddellijke nabijheid van Amsterdam aan een druk Vaarwater gelegen met daarop staande Gebouwen en hoog opgaand Geboomte tegen een zeer billijken prijs te Koopaanfeboden. — Informatiën bij de akelaars H. BERGER en C. W. STALKNEGT Frans Halsstraat 19. Rijpaard. Te Koop gevraagd: Een afgericht 6-jarig Rijpaard groote taille geschikt voor een Cavalerie-Officier. Opgaaf van prijs in franco brieven met No. 1386 Bureau Woning-Gids Rembrandtplein 17. NIEUW M.Ffw.E!i Kaasstrerasel werkt zeker en spoedig de Flesch ƒl. Verkrijgbaar bij H. H. ULOTH & Co. Apothekers te Amsterdam Zeedijk. (6928) Men-CreÈ LOTEN. Trekking .6 Augustus. . (6962) „ r .. 1 a fl. 50.000. HoofApruzen: i:: ?:888: Te Koop voor f 75; Een Solide BRANDKAST met Binnenkast. Te bezichtigen: Egelantiersgracht Nó. 16i Amsterdam. Verloren op Vrijdag 5 Augustus des namiddags op den Dam eena GRANATEN BRACELET die door eene Dame bij Tram-wagen No. 28 is gevonden. De eerlijke vindster wordt beleefd verzocht die wel te willen terugbezorgen aan dep Kantoorboekhandel BLIK* MAN & SARTORIUS. Rokin 17 alhier. ' (7308) Verlopen Donderdag een massief Gouden Armband waarop «Souvenir in kleine Pareltjes gaande langs Kloveniersburgwal Hoogstraat Damstraat tot den Dam. Aangifte bij Politie is gedaan. De Vinder krijgt goede Eeiooning en gelieve terug te bezorgen bij den Boekh. R VAN DER LAND Kalverstraat 124 te Amsterdam. Alom bestelbaar en aan de Kiosken te Amsterdam terstond verkrijohbaar: HAKKEN en DOUWEN door Dr. 11. E. TOE LAER. Antwoord aan eenige Inteekenaars op liet Woordenboek (Slot}. Rechfeof lichtvaardige Benoemingen door den Amsterdamschen Gemeenteraad. Prijs voor Amsterdam 10 Cts voor buiten de stad 11 Cts. MTDHULE WEDSTRIJD TK LEEUWARDEN Juli en Augustus. VERLOTING- van VOORWERPEN ingezonden voor den Nationalen Wedstrijd op het gebierf van Nijverheid te Leeuwarden. De Loten zijn verkrijgbaar voo* 50 Cent per stuk en voor f 5 de 11 stuks bij de HH. ERVEN P. DE VRIES Pz. Kassiers en Comr missionnairs in Effecten bij het Stadhuis te Leeuwarden. (7338) TREKKING 5 Sept. e. k. HOOFDPRIJS: GARNITUUR bestaande uit Pendule en twea Candelabres (Cuivre poll). ""*_. WÜ De Haagsche -f- Ho* Margarine-Boterfa""=*H briek levert prima injMr <^~-v Qualiteit' gegarandeerd Tan3^X~Th ItfÓU^ONr i Alleen prima qualiteit draagt het gedeponeerde Fabrieksmerk in de Boter. (2350) Villa DALÏÏÖE Dalweg BAARN. Aangenaam gelegen met fraaieD Tuin en Localiteit ingericht voor alle feesten. Dagelijks gelegenheid tot Dineeren en het gebruik van Ververschingen. Zondags Table d'Höte 5 uur. ƒ2.50. C. F. ZEILER (6188) Cuisinier-Patissier. fiAKfi _»ATJr_-_.O]*«SA*T bevat ruime en luchtige Kamers is zeer aan te bevelen bij het reizend publiek alsook voor familiën. Matige Prijzen. Abonnementen. (5.80) Rij de ERVEN F. ROHN te Haarlem is compleet verschenen: WET tot reielii ra den Mliaaiel in sterken drank en tot tóeieliiii m optae flronienschap- Met toelichtende^aanteekeningen bewerkt door H. G. HARTMAN Jz. Secretaris der gemeente Goes. Prijs ƒ0.75. (711 U",http://resolver.kb.nl/resolve?urn=ddd:010063505:mpeg21:a0025:ocr,8,ddd:010063505:mpeg21:p008,Het nieuws van den dag : kleine courant,1131
1405726,1881/11/24 00:00:00,1271,ddd:010063609:mpeg21:a0014,http://imageviewer.kb.nl/ImagingService/imagingService?id=ddd:010063609:mpeg21:p004:image&x=107&y=494&w=1106&h=1271,ddd:010063609:mpeg21,1213,1765,107,494,10,"WEL WEL WEL WEL. Daar sla ik de handen van in elkander. Lees ik goed? 10 deelen voor f 1.90? en voor iedereen van klein tot groot geschikt P Dus niet f 1.90 per deel? Nee volstrekt niet ge leestgoed ALLE TIEN DEELEN KOSTEN TE ZAMEN SLECHTS ƒ 1.90. SM. Lotgevallen van Geno- N°. 6. Abellino de gevreesde t*eva van Brabant. Keurig ge- Bandiet. Keurig gedrukt met fraai drukt met fraai gekleurde Platen gekleurde Platen en in mooien en in mooien Omslag. Omslag. N°. 2. Zeereizen en Avontu- N°. 7. Ali-Baba en de veerren van de nieuwe Bobinson. tig Boovers. Keurig gedrukt met Keurig gedrukt met fraai gekleurde fraai gekleurde Platen en mooien Platen en in mooien Omslag. Omslag. N°. 3. Geschiedenis van de N°. 8. Portunatus zijn Tooschoone Magelona. Keurig ge- verhoedje en Geluksbeurs. drukt met fraai gekleurde Platen Keurig gedrukt met fraai gekleurde en in mooien Omslag. Platen en in mooien Omslag. N°.4. Thijl Uilenspiegel zijne No. 9. Gaston van Frankrijk grappige invallen en streken.* of de Man met het IJzeren Keurig gedrukt met fraai gekleurde Masker. Keurig gedrukt met fraai Platen en in mooien Omslag. gekl. Platen en in mooien Omslag N°. 5. De Historie vande N°. 10. De Hut van Oom Torn Maagd van Orleans. Keurig ge- of het Slavenleven in Ame;trakt met fraai gekleurde Platen rika. Keurig gedrukt met fraa sn in mooien Omslag. gëkl: Platenen in mooien Omslag Wij hebben ons ten taak gesteld daarvan 3000 stel te verkoopen twijfel er niet aan want dat gebeurt; waarschijnlijk zullen er veel ontzaglijk veel meer stellen gevraagd worden omdat ze zoo extra modi en geschikt zijn voor ST. NICOLAAS voor de ""Winteravonden enz. enz. maar meer stellen kunnen we'niet leveren. Wie deze 10 buitengewoon goedkoope Boeken wil hebben wij zenden ze franco voor ƒ 1.90 overal heen; in ernst raden wij spoed aan met ƒ1.90 per Postwissel te zenden en daarop te zetten: 10 der mooiste Boeken bij GEBB. E. & M. COHEN Magazijn van Goedkoope Boeken te Arnhem en te Nijmegen.",http://resolver.kb.nl/resolve?urn=ddd:010063609:mpeg21:a0014:ocr,4,ddd:010063609:mpeg21:p004,Het nieuws van den dag : kleine courant,1106
2977596,1881/10/02 00:00:00,3092,ddd:010101795:mpeg21:a0045,http://imageviewer.kb.nl/ImagingService/imagingService?id=ddd:010101795:mpeg21:p008:image&x=2014&y=622&w=963&h=3092,ddd:010101795:mpeg21,2977,3714,2014,622,8,ROOSJESSLIJPEK. WORDT GEVRAAGD een bekwamen KNECHT binnenshuis die grondig met het VAK bekovd is in hot klein. Brieven franco Lett. G L Bnreau Handelsblad. (37757) SPECIALITEIT van Rathenower KRISTAL BRILLEN. J. A. J. SCHOHKING R^jksleveroncier en Hofleverancier van wijlen Z. K. H. Prins Hendrik der Nederlanden. GEZICHTKUNDIGE. SPEB 18. '318) Eenig DEPOT: KALVERSTRAAT a/d. N.-Z. Kapel. GRAHAM BROOD. Wïd. J. DE JONGE O. Z. Voorburgwal 22. TELEPHOONNUMMER 165. (33250) c. j. boeïTalöonT SIGARENHANDÜL. VIJGSNDAS TEIEPHOOIÜMER 495 REMBRANDTPLEIN „ 333. (31735) OUD PAPER &K-_IEGRACH_r Opgericht 1804. ALLERHOOGSTE PRIJZEN. (11) MACHINALE VERNIETIGING. /pondeova!e_vierkanfi\ K « /Jjolpen 8e voe.enM *| M —-7114 ■_——»^_P • _3wedirvtrkoop«ri ribilh.^-i oo Amiterdam. (85148) wii¥ïijo]__r 's Zondags TABLE D'HOTE. ZEEBADEN tot NOVEMBER; BINNENBADEN den geheelen WINTER verkrijgbaar. Oe IgOTItSL» en het _A¥_-K_S_'AEHANT ziin gedurende het GEHEELE JAAR geopend. OMNIBESDIENST op BEVERWIJK tot 15 Mei 1882; Qp don aanJcomentUp Trein vMunu. 1f1.3». (vertrek van Amsterdam 9.35) 's Zondags bhvendi'eh 's middags 1.58 Jvertrek van Amsterdam 1 uur)^ op den vertrekkendon Trein 's namiddags 4.15 (aankomst te Amsterdam 5.12). (37743) STALLING voor PA AKSEN ÜUTESGEN steeds VERKRIJGBAAR.,http://resolver.kb.nl/resolve?urn=ddd:010101795:mpeg21:a0045:ocr,8,ddd:010101795:mpeg21:p008,Algemeen Handelsblad,963
579067,1881/05/23 00:00:00,359,ddd:010290154:mpeg21:a0033,http://imageviewer.kb.nl/ImagingService/imagingService?id=ddd:010290154:mpeg21:p003:image&x=2552&y=141&w=1613&h=359,ddd:010290154:mpeg21,4165,500,2552,141,4,Photogra)-Ifo_-Ateller 4SOS VAN BAJRTH EN TAGGESELL Java Hotel Tawang Baaremkff ffaopead 7—ll ure»,http://resolver.kb.nl/resolve?urn=ddd:010290154:mpeg21:a0033:ocr,3,ddd:010290154:mpeg21:p003,De locomotief : Samarangsch handels- en advertentie-blad,1613
1690864,1881/07/25 00:00:00,1948,ddd:010587974:mpeg21:a0036,http://imageviewer.kb.nl/ImagingService/imagingService?id=ddd:010587974:mpeg21:p006:image&x=1044&y=3618&w=868&h=1948,ddd:010587974:mpeg21,1912,5566,1044,3618,8,GEXDLEEIVIIVG. BURGEMEESTER n WETHOUDERS van GAASTERLAND brengen ter algemeene kennis dat ten kantore van den Gemeente-Ontvanger van Gaasterland te Balk is opengesteld de inschrijving aan den meestbiedende op eene GELDLEENLV t fIO.OOO ten behoeve dier Gemeente rentende 4Vs pet 'sjaars en wel gedurende de maand Augustus e.k. iederen Woensdag en Zaturdag 's voormiddags van 9 tot 12 en 's namiddags van 2 tot 4 uur. Het plan van Leening ligt ter inzage ten kantore van genoemden Ontvanger. De tijd van storting is bepaald op 1 October 1881  in één termijn. De inschrijvingsbilletten worden ingewacht vóór of op Vrijdag 2 September 1881. (^patenteerde Makelaars en Commissionairs in Effecten genieten >A pet. voor de inschrijvingen door hunne tusschenkomst bewerkstelligd. Balk 20 Julij 1881. Burgemeester en Wethouder» voornoemd van SWINDEREN. De Secretaris D. WIJMA. O n d e r w ij s. BUK' ■KM EEBTEH kn WETHOUDERS vai GAASTERLAND nnodigen uit bevoegde belangstellenden in de betrekking van ONDERWIJZER aan de Openbare School te Oudemirdum om hunne stukken vrachtvrij aan den Burgemeester in te zenden vóór den 8 Augustus e.k. De jaarwedde bedraagt ƒOOO. Bulk  'J 0 Julij 1881. Bwftmêmter m Wethouders voornoemd van SWINDEREN. De Secretaris i 1). WIJMA.,http://resolver.kb.nl/resolve?urn=ddd:010587974:mpeg21:a0036:ocr,6,ddd:010587974:mpeg21:p006,Leeuwarder courant,868
6165376,1881/08/01 00:00:00,3932,ddd:011007104:mpeg21:a0048,http://imageviewer.kb.nl/ImagingService/imagingService?id=ddd:011007104:mpeg21:p008:image&x=1723&y=151&w=1568&h=3932,ddd:011007104:mpeg21,3291,4083,1723,151,8,"STOOIVAARTfIPNOORWEGEN Het Stoomschip OLAF KYRRE Kapitein D. Ouwehand vertrekt Van BOTTER»AM naar BERGEN "" >;;. ""Donderdag-""--""''4 dés avonds. 1530* Adres: bij de Agenten D. BURGER & ZOOïf. ftÖTTERDAM^-RANGÖON met de Stoombooten der Glasgow. and Rotterdam Sieam Shipping Company van Rotterdam en verder I van Glasgois. met de Sfcoomschepen van P. Henderson & Co's line. . Het Stoomschip MARTARAN vertrekt van GE.ASGOW 18 Aug-ustus. GOEDEREN worden 9 en' 12 Augustusmët directe cognossementen naar Rangoon aangenomen! door-■.•■.■ V ■ ~ . 15305 de Agenten B. BURGER & ZOON. I Het Centraal 1 ■ ""'!' ' ::'h "": . - VAN;; t ; - 15297; I ■:. is AIiLEES gevestigd | IkORTE HOOOSTRAATI4 Rotterdam | -Ét tegenover deïPassage. ':i |1 I S| V der »og"" voorradige - ;H f voor Heeren m Jongeheerenü | ' ;hOFLEVERANCH3RSGEOCTROOIEERD DOOR Z. M. DEN KONING. ZILVEREN MEDAILLE Parijsche Wereldtentoonstelling 1878. •M.--i'(Eehige bekroning van dien aardkin hun vak voor\: Nederland. ■ .^ MeubelMrikMen; Bek | in Meubelstoffen en Tapijten. ||||f Speciaal ingericht voor de juiste toepassing-der verschillende stijlen.|jT# Stöömzagër'ij in ■ en ander „;r fijn Werkhout. Houtlaan len 3. \■■",http://resolver.kb.nl/resolve?urn=ddd:011007104:mpeg21:a0048:ocr,8,ddd:011007104:mpeg21:p008,Rotterdamsch nieuwsblad,1568
2659556,1881/12/29 00:00:00,4916,ddd:010063643:mpeg21:a0031,http://imageviewer.kb.nl/ImagingService/imagingService?id=ddd:010063643:mpeg21:p008:image&x=2953&y=156&w=541&h=4916,ddd:010063643:mpeg21,3494,5072,2953,156,10,"Overtuigt U van de buitengewone goodkoope maartevens zeer solide gemaakte HËERENKLEEDINGr in de Etalage van S. STOKVIS Heiligenweg 10 Amsterdam. (2856} ""f4OOO a -fsooo' HYPOTHEEK. Men zoekt bovenstaand bedrag als tweede Hypotheek op een perceel ter waarde van ƒ25000 staande op een der hoofdstraten dezer stad en waarop ƒ9OOO gevestigd is. Adr. fr0. lett. PG 375 N. vjd Dag. Het KANTOOR van~ F. A. L. DE GRUIJTER wordt met 1 Januari {1613} verplaatst naar de Leidschestraat 27. Weieloop of' pstÉß. Een wit met veel zwart doorgeslagen gladharige HOND (ReU) zonder Halsband luisterende naar den naam van MENTOR wordt vermist. Die hem terugbezorgt of aal»-» wijzing kan doen omtrent hem aan KüSTER's Adverterilie-Rur. Nieuwendijk hoek Oudebrugsteeg zal beloond worden. flO Cadeau. De oplosser van een JRaadsel voorkomende i n de Kran t voor Bet rekkingen van Woensdag 4 Januari ontvangt ƒ 10 Cadeau. Exemplaren worden franco door het geheele Rijk gezonden tegen inzending van 3 CtSr Postzegels. S. RUDESHEIM Uitgever Amsterd. Rembrandtplein 17. (1640) lEMAND in 't bezit eener Zaak tel waarde van 16000 Gld. vraagt voor 2 jaar ƒ 500 a 10 ""/„. Adreï franco letters 2 R D aan het Algei» Advertentie-Rureau van NIJGH Sb VAN DITMAR Kalverstraat 02. Heeren Mtókietere; Terstond gevraagd f 25.000 voor één maand tegen hooge rentd en premie. Adres fr. lett. JB. H 376 JM v/d Dag. J~ A Saksische Ka- JSjJH narievogels en OS*-» geleerde Goud'--<*?¦ vinken die Aria's J_____tsZ**- fluiten zijn gedu-w""""^** rende eenige dagen verkrijgbaar: tNieuwe. Wijnbergtt Warmoesstraat. KETJEN's Poiiifflgrans 20 Cent per fleschje. COLDER & Co- Singel bij de Warmoes» gracht 241. . Botcpfabpickcn. Prijsopgave gevraagd van Gekamde Melk zoete; minstens twee of drie. vaten per week te leveren franco Hoorn. Adres met franco brieven onder motto Melk aan den Roekh. P. GEERTS te Hoorn. VAN HOUTEN's zuivere oplosbare CACAO en Poeder in Bussen van ƒ1.60 85 en 45 ets. Te verkrijgen bij J. VAN WINSEN Jr. 28 Vijzelstraat 28. Depothouder. Een sedert jaren gevestigd Winkelier in Sigaren verscheidene Depots hebbende wenscht in een nieuw gereedzijnde Tabak- en Sigarenmagazijn drukke buurt gelegen aan te stellen een gehuwd Depothouder in staat zijnde in handen van zijn Patroon ƒ 2000 a 5 % rente als waarborg te storten aUes tegen vast Salaris procenten van den omzet vrije ¦ Woning enz. Adres met franco brieven onder motto Sigaren bij den Boekh. F. A. DE JONG Wolvenstraat 4 Amsterdam. Bij akte den 4n October 1881 voor den Notaris J. G. POUWJr. te Amsterdam verleden is tusschen de Heeren PIETER DE HAAN Junior Commissionnair in Effecten en CHRISTIAAN JOHANNES PETRUS VAN HENGEL Commissionnair in Assurantiën lieiden wonendele Amsterdam aangegaan eene Vennootschap tot uitoefening van den Commissiehandel in Eflecten en Assurantiën welke zal gevestigd zijn te Amsterdam en worden gedreven onder de Firma DE HAAN & COMPAGNIE tot teekening van welke Firma beide Vennooten gerechtigd zijn doch uitsluitend voor zaken de Vennootschap betreffende en niet tot het aangaan van leeningen en het stellen- van borgtochten waarvoor de teekening der beide Vennooten zal worden vereischt. De Vennootschap gaat in op den In Januari 1882 en is aangegaan voor den tijd van 5 jaren en vervolgens van jaar tot jaar tenzij de Vennooten elkander zes maanden te voren van het eindigen der Yennootschap mochten -hebben opzegging gedaan.",http://resolver.kb.nl/resolve?urn=ddd:010063643:mpeg21:a0031:ocr,8,ddd:010063643:mpeg21:p008,Het nieuws van den dag : kleine courant,541
4555782,1881/06/20 00:00:00,2394,ddd:010104055:mpeg21:a0023,http://imageviewer.kb.nl/ImagingService/imagingService?id=ddd:010104055:mpeg21:p004:image&x=2054&y=219&w=1903&h=2394,ddd:010104055:mpeg21,3957,2613,2054,219,4,"INTERNATIONALE CREDIET-EN HANDELS.EREENIGING 9.K OTTEBB A BI."" MAATSCHAPPELIJK KAPITAAL f 5000000. waarvan reeds uitgegeven: 2 SERIËN TE ZAMEN GROOT 40000 AANDEELEN ƒ 2500000. Meserve f 9500®0. VAN DE • (23856) 3de en 4de of laaf site Seriën ieder g-root 2®o®© Aandeelen a f «_g.so tot den Koers van 115 pCt. waarvan 100 pCt. op de Kapitaal Rekening* gebracht en 15 pCt. als aandeel in de bestaande Reserve bestemd worden krachtens besluit van de Algemeene Vergader»»}!: van Stemgerechtigde Deelhebbers dd. 14 dezer. INSCHRIJVINGEN worden aangenomen op 23 en 21 JUNI e. k. van 10 tot 4 uur bij de Heeren: GEBR. CHABOT ) JAN HAVEL VAR & ZOON (f Rotterdam R. MEES & ZOMEN ( te llotterdara» SCHAAY & LEDEBOER j GEBB. TEIXEIRA DE MATTOS ) i(k 1-^.. en DE ASSOCIATIE-CASSi fte Amsterdam' waar evenals bij hunne Correspondenten in de provinciën Prospectussen Inschrljvingsbiljetten en verdere inlichtingen te bekomen zijn. . *^ . g g GEEN BETER 4DKES VOOR ê9m I- ï KUNSTSCHRIFT & PENTEEKENINGEN JKtHxf § 3 !* dan bij den met 15 Medailles bekroonden Hof-Kalligraaf ANTONIE GREVENSTUK. -5-_£uai2Sß'£_-S! ? a ATELIER GRIMBURGWAL 7 AMSTERDAM. (24381) IS.BB worden opmerkzaam gemaakt op de NFEUWE VINDING van CUIUSTIATVI BALLOT.» en GASBRANDERS welke zeer veel licht geven weinig warmte geen aanslag groote besparing van GAS geheel stil en zonder glazen branden. Deze BALLONS van zeer ologantonvorm kunnen op alle door ing reed» geplaatste BRONNER PATENT GASBRANDERS gebruikt worden; zii worden geleverd en aangemaakt door Ed. VAN ROSSIJ-tl Langestraat 88 Amsterdam. PROEVEN KOSTELOOS. f 456) BABÏOÏT YIRWAEIINGTQESTILL BN NIEU WE COWSTMUCTIIG kunnen niet lek fg'estoökt worden* geven geen onaangenamo reuk of warmte kunnen elke 20 minuten warm gebruikt worden vereischen zeer weinig brandstof en zrjn zeer doelmatig om kinderen te baden; worden geleverd door JAN KLETON Fabrikant van Baden met en zonder verwarming Zitbaden Kinderbaden Sponsbaden Voetbaden Bidet» Douche-Baden enz. enz. (455) fialverstraat hoek Burgerweeshuis 90 Amsterdam. Filiaal Weteringschans viaavisdeMo&landMehefil asfab riek2Q*.",http://resolver.kb.nl/resolve?urn=ddd:010104055:mpeg21:a0023:ocr,4,ddd:010104055:mpeg21:p004,Algemeen Handelsblad,1903
2963310,1881/06/04 00:00:00,1442,ddd:011102780:mpeg21:a0019,http://imageviewer.kb.nl/ImagingService/imagingService?id=ddd:011102780:mpeg21:p004:image&x=2081&y=126&w=2055&h=1442,ddd:011102780:mpeg21,4136,1568,2081,126,6,"W \ /""Y MM :. ' r;sr'rrwi;r Ïhak a9l <o?c:t;Rcftfb b r#''d.oiok ;.'zlin MiCJpfriiir DBN'-®öwiw'-Gf.*|;;' !.•. •* .»••;.:• • pjajao. .FOMtT-DJE-JKOCK. FAJ*stIVGhFA3X>JfJUM. Levert alle soorten van militaire XJuiformen eirielambtelijke Costume» en purtiouliere Gardé-Robes. . ■' ! FANTA SIE-CO.S.TU.MEsi&<Mfi PABBFMEÜTE® Elll.mUlC OABKITUKEHi Bi KNOOPEN.; v; <»«0> AST Bestellingen op maai wordeu te Furi'de'Hock en > Mageßomëß' ra afgeleverd. i-.<- ' • • :• ■ ) ; lÜ.'iil/lijt tfÜM.lXlt ttill ijl'/* Bf < D» ondergtteekende beveelt tich bi} voortduring la*n'*9oor '■ *y""'' «• || "" tooxoel de füeintte al»-k grootste van alle Parijtehe enPransche twtikelent ép- \ Ut debillijlute voorwaarden. Aanneming van maandelijksche afbetalingen. »<:> <;*i < • (i'jltitiü'3 *. •./ |* •* • tl--.?'-. ïn'Ji iJ'i.'S-* E. ELSBACH • ■ • 1 »*v« U ' VmcfiBVWOORIIIOBBIOCR :UQUOta mi- ;  j »»wjihiu_",http://resolver.kb.nl/resolve?urn=ddd:011102780:mpeg21:a0019:ocr,4,ddd:011102780:mpeg21:p004,Sumatra-courant : nieuws- en advertentieblad,2055
3676265,1881/02/07 00:00:00,3239,ddd:010063323:mpeg21:a0038,http://imageviewer.kb.nl/ImagingService/imagingService?id=ddd:010063323:mpeg21:p008:image&x=2380&y=952&w=1135&h=3239,ddd:010063323:mpeg21,3515,4191,2380,952,12,"De Bijbelhandelaar A VAN ROSSUM Jr. Singel bij de Paleis- Straat te Amsterdam biedt zoo langde voorraad strekt welke niet groot meer is clen kostbaren BIJBEL met 100 Platen van GUSTAVE DORS aan voor slechts ƒ 15 geheel compleet in 100 alleveringen. Opdat nu ieder zich dit ware prachtwerk kan aanschaffen stel ik de inteekening open op 4 maandeiijksche gedeelten van 25 alleveringen met 25 Platen a ƒ3.75 per gedeelte zoociat men alsdan in 4 achtereenvolgende maanden den Bijbel geheel compleet ontvangt. Na ontvangst van Postwissel geschiedt cle toezending onmiddellijk. Les Marques renominées: CARTE BLANCHE & CARTE NOIRE se trouvent dans tous les premiers Restaurants. 1) iji [ ii D Agent-Général M. MEREES Amsterdam. (655) •» •-¦ *!« «• Daar leeft natuur opnieuw is uit haar graf verrezen En toch hoort men gemor om 't heuglijk oogenblik; Wie geeft ons thans een laars een schoen om vrij le wezen Van het doordringbaar vocht'? de Schoenfabriok zegt IK J Den Haag ""71 MjniiwQ|]fjji|f 7] Hoopd 18 Torenstraat 18. f JL IIIUU. >f UUUIf ü I 1.50 Groote Noord 50. FRANSCHE CORSETTEN. Ontvangen eene groote sorteering in de nieuwste modellen COR-» SETTEN""met echte Baleinen (geen hoorn). Corsetten van het vorige seizosn worden tegen verminderde prijzen opgeruimd. Nieuwendijk 189. N. WEILL. ""OESTERS (blank en groot) ƒ 8 de 100 stuks. Winkeliers. Koks en Reslauratiehouders groote korting. Zeeuwsche Aardakers ƒ 0.25 de i/s Kilo. Gekruide Guristiania Ansjovis per 'l/i Va Vi Vaatjes en yer dozijnen f 0.10; Per pot 12 gem. Haringen ƒ 1.25 6 gem. Haringen ƒ 0.7 Ó. G. Si-ÜB Hz Beestraat 4. 111 *I Y*li Dc coedkoopste en soliedste soorten HANDtrA mTÊm /-=*!'' en TRAPNAAIMACHINES zijn in ruime keu<-e voorradig hij W3$W A. LEWEISTEBf WARMOESSTRAAT o/d VISCHSÏEEG-. Tweedraads Hand-Machines van af ƒ2O. Beüiling kan per week of maand geschieden. Kosteloos onderricht. Deugdelijke garantie. Yöorjaars-Öpruimmg. Eene partij Tafelkleeden en Karpetten restanten van Tapijten en Loopers Lappen Meubelcliits Cretonnes Irlandaises; Wollen Rips en Damast Lappen Neteldoek en Vitrages zullen tegen zeer lage prijsen worden opgeruimd. .GESCHER & KEIPEB NIEUWENDIJK bij de_ DAM 206. De ondergeteekende .1. KOST Firma A. LANGEVELD Verhuurder van Rouw- en Statiekoetsen maakt aan zijne geachte Begunstiaers bekend dat het gerucht als zoude hij zijn Zaak aan de Naamlooze Vennootschap (Begrafenis Vereeniging) hebben overgedaan geheel bezijden de waarheid is en dientengevolge zich voortdurend blijft aanbevelen. J. KOST Firma A. LANGEVELD Stalhouder ï Haarlemmerplein 36 te Amsterdam. Scheermacïiines ~~~ Systeem FONTAINE stellen een ieder in staat zich zelven te scheren zelfs zonder gebruik van spiegel. Het snijden of verwonden is onmogelijk. Tegen inzending van een postwissel van onderstaand bedrag aan Qr. STOUT te Tiel ontvangt men de Scheermachine franco door geheel Nederland. SCHEERMACHINE No. la/ 3.50 met kartonnen doos. » No. 2 » » 4.50 mcl kartonnen doos en extra mes. (825) ï No. 3 » » 6.50 in étui met extra mes. en hooger tot » 15. HH. Wederverkoopers genieten bij bestelling van 6 of 12 stuks rabat",http://resolver.kb.nl/resolve?urn=ddd:010063323:mpeg21:a0038:ocr,8,ddd:010063323:mpeg21:p008,Het nieuws van den dag : kleine courant,1135
1186538,1881/12/18 00:00:00,1142,MMKB08:000163720:mpeg21:a0020,http://imageviewer.kb.nl/ImagingService/imagingService?id=MMKB08:000163720:mpeg21:p006:image&x=16&y=66&w=1039&h=1142,MMKB08:000163720:mpeg21,1055,1208,16,66,6,"Advertentie Nederlandsche GIST- EN SPIRITUSFABRIEK. SPOELING. De prijs der 8POELISG is Maandag 19 December ƒ 180. De Directeur J. C. VAN MAKKEN Ju. Fijne Gezondheids Roggebloem «ervaatdigd ii; dm Stoom Meelmoltn van A. PERK Jz. te DELÏT is in P::kj• s van  / 2 kilo i\ 20 ets  verkrijgbaar bij den Fabrikant en bij de lleeren : Ervtn I'. Eangman  Delft. Wed. A. J. de WeijercnZn 'i Ilage B Frankamp A. Z liïse "" B P. v. Stralen Maassluis P. Brokke",http://resolver.kb.nl/resolve?urn=MMKB08:000163720:mpeg21:a0020:ocr,6,MMKB08:000163720:mpeg21:p006,Delftsche courant,1039
2068186,1881/10/31 00:00:00,2006,ddd:110536775:mpeg21:a0009,http://imageviewer.kb.nl/ImagingService/imagingService?id=ddd:110536775:mpeg21:p002:image&x=2120&y=46&w=1031&h=2006,ddd:110536775:mpeg21,3151,2052,2120,46,4,Théatre de Batavia. Mardi l«r Novembre 18K1 a 8 heures l/g du Soir. Képrésentation DONNÉS PAR DE GRÉEF ET WENSINK* avee Ie co.iccurs bit uveillant de Mis. les amateura et i'oichesire du fctaf Musique lre Jt-*artie. 1. OUVERTURE ORCHESTRB. . Kaliwoda. 2. AIK de l'otn Sebaatien chanté par Mr De Greef Donnisetti. d RAPSODIE fciONGROISÜ pour piano par Mr. 6. T . Lizt 4 ME J «DIK char.té par Mr. De Greef. Plotow 5. Jagers-Luat 'HO KIJK . . ' . Otto iiine .fartie. FAUST opéra en 5 de Oounod. 1 !*♦* EAI'ST: Wknsink. — MEPHISTOF :LÈS: De Gre«f. — Choeurs La Juive (iraud opéra eu b actes; mus que Je Halévy. 4me A.etc Grrande sScène. LE JLTF KLE&ZAR: VVeusink. —Le (ardival BüO .M: De Grerf. — Choeurs. I'oute la partie d'opéra en costumes Loj-ea tl 5 Parterre et Araph théitrrt fl. 3. Galerie &■ I. On peut reten:? des places d'avance a partir de LUN'.)j de 8 a 11 heures du matin au théatre. .V e-oieurs It-a Ptndiaots du Gymrmso demi plaer) au ar ter re et AmphituetVre. 4016,http://resolver.kb.nl/resolve?urn=ddd:110536775:mpeg21:a0009:ocr,2,ddd:110536775:mpeg21:p002,Bataviaasch handelsblad,1031
728469,1881/03/07 00:00:00,651,ddd:010063351:mpeg21:a0027,http://imageviewer.kb.nl/ImagingService/imagingService?id=ddd:010063351:mpeg21:p008:image&x=1224&y=177&w=1119&h=651,ddd:010063351:mpeg21,2343,828,1224,177,12,AMSTERDAM. UTRECHT Kalverstr. b/d Heiligenweg 168. Oudegracht G 19. SPECIALMT in KEISTAL ffl PÖKSELEIK Magazijn van Huishoudelijke Artikelen in gewoon Glas- en Aardewerk courante en fijne artikelen voor huishouding en luxe. in Kristal en Porselein. Steeds groote sorteering Waschstellen Thee- en Dejeuner-Serviezen: complete stellen Kristallen Champagne- Wijn- Madera- Likeur- Bier- en Punchglazen Compotten Ka- AFZONDERLIJK LOKAAL VOOR TAF.ELSERVIEZEN Voor H.ll. Winkeliers: Engros-Magazijn Voetboogstraat 11.,http://resolver.kb.nl/resolve?urn=ddd:010063351:mpeg21:a0027:ocr,8,ddd:010063351:mpeg21:p008,Het nieuws van den dag : kleine courant,1119
3014480,1881/07/05 00:00:00,3076,ddd:010101707:mpeg21:a0013,http://imageviewer.kb.nl/ImagingService/imagingService?id=ddd:010101707:mpeg21:p003:image&x=2011&y=215&w=980&h=3076,ddd:010101707:mpeg21,2991,3291,2011,215,8,"De Makelaar?'J. P. A. KILSDONK zal op DINSDAG j 12 JUJUT'___;_ des voormiddags te half elf uur precies IN HET -BUIS aan .de _fi_è_Ke_*sgracl-t _¥°. 221 bij do Hartenstraat ten overstaan van den Notaris J. C. G. POLLONES verkoopen: uitmuntend onderhouden M_EITe_E_LE_l_9 waarbij voorkomen: Mahoniehouten Ledikanten met Matrassen; Garderobe- en Linnenkasten Schrijfbureaux Buffet Trek-Ecttafels Waschtafels met marmeren bladen Ledikantkastjes Mangel- en Linnenpers SALONGARHITUBEN gestoffeerd met bruin trijp Pianino van ERIRD Pendules en Candelabres vergulde on kristallen Gaskronen Bronzen Ornamenten SCMII__>I_ItïJ_E-¥ door P. TAAI SCHENDEL en L. DUSSARD fraaie Gravures in lijsten Spiegels Tapijten en Meubelgordijnen Bodden met toebohooren. Haarden on Kachels Eetservies Koperwerk enz. enz. KIJKDAGEN: Particulier: Vrijdag 8 Juli; Publiek: Zaterdag 9 on Maandag 11 Juli 1881 van 10 tot 3 uur. De Catalogus is te verkrijgen bij boyengenoemden Makelaar aan Het Oudezijds Heeren-Logement. (26574) NAAMLOOZE VENNOOTSCHAP BEGRAP-NISV-BE-NIGItiG te Amsterdam. Het Bureel der Vennootschap gevestigd DAMItIK IV0.93 Kamers 12 14 is aan het TELEPHOON-NET verbonden. Het is geopend van 's morgens 9 tot 31/3 uur en 's avoads van 6 tot 8 uur. Belanghebbenden worden uitgenoodigd tot het opdragen van Begrafenissen den Administrateur te ontbieden of wel: ten Huize van den Administrateur den Heer 91. SAX. Ej. elan tic rsgracht N°. 31 ten Huize van den Adjunot-Administrateur den Heer Jl. D. STRUIS Jbu Noorderstraat N. 39 bij den Conciërge Stadhouderskade X"". 2 of bij de Boekhandelaren BLIKMAN & SARTORIÜS Rokin N°. 17 en J. H. & G. VAN HETEREN Hartenstraat 21. Het Bestuur: A. W. VAN EEGHEN Dr. G. F. WESTERMAN. Voorzitter. Mr. F. HOOFT GRAAFLAND. A. CARAMELLI. C. J. W. RAMANN. Jhr. Mr. B. DE BOSCH F. J. W. H. SCHMITZ. KEMPER. Mr. LEONARD WOLTER- K. H. SCHADD. BEEK. WIE HELPT IffSJ! Nog eenmaal dit opschrift; maar nu om aan alle vriendelijke gevers in stad en land mijnen hartelijken dank te brengen voor de hulne mij verleend en medodeeling te doen van do ten behoeve der boproefde Weduwe en hare Zes Kinderen bij mij nog ingekomen Giften: van de Dames W. 2 B. B. aƒ 25 = ƒ 50 W. B. Jr. ƒ 10 V. H. / 2.50 A. M. W. ƒ2.50 N. N. ƒ2.50 J. D. L. ƒ2.50 X. Q. C. ƒ5. van Charles «n Willem ƒ 10 O v. d. L. te R. 1 °/„ der rek. ƒ 1.23 Piet Z ƒ 10 A. ƒ 1 voor de arme weduwe D. C. ƒ 5 M.K.en J. 2 Coup. a ƒ 1.485 = ƒ 2 97 A. P. ƒ 10 J. W. R. ƒ5 van eene Weduwe die ook haar penninkske offeren wilde ƒ 1 Marietje ƒl postwissel J. G. S. ƒ 5 N. N. ƒ 2.50 R. N. muntbiljot ƒ 10 postwissel J. S. to Z. ƒ 2.50 B. M. ƒ 2.50 James S. ƒ 10 W. B. 1 B.b. ƒ 25 Medehulp 4 rijksdaalders f 10 en J. C. 1 Coupon ƒ 3.96. ( ) Jl. JU. GLIKDERMAN. MËÜÏSD: Ej« van .Baliel Sv.9 HAKBLAAR naar de KEIZERSGRACHT BIJ DE LEIDSCHEGRACHT 470. (-26626)",http://resolver.kb.nl/resolve?urn=ddd:010101707:mpeg21:a0013:ocr,3,ddd:010101707:mpeg21:p003,Algemeen Handelsblad,980
541947,1881/01/25 00:00:00,591,ddd:011085768:mpeg21:a0012,http://imageviewer.kb.nl/ImagingService/imagingService?id=ddd:011085768:mpeg21:p003:image&x=91&y=91&w=917&h=591,ddd:011085768:mpeg21,1008,682,91,91,4,Ondt r het groote getal dargenen wien het gebruik Tas Lerertrn wordt aai. berden cemrn op iqn minst genomen drie tierden dit middel met tegensta in. Welk» huismoeder beeft els tij het een hare kinderen gaf de opmerking el wel niet bij cichtelve gemaakt dat men toch iete moeit trachten te vinden dat tulk een walgelijke medicijn met goed gerolg kon vervangen? Welnu dat alleiine natuurlijke verlangen ie thane volkomen verwesentlijkt door de Bikop si Baifokt loei van Gewault bt Co. welke •r met gunetig sneou voor ie de plaata ia getreden en waaromtrent de beroemdtte guneeaheeren van Parije de vleien ritte getuigeniksen afleggen.' 7664,http://resolver.kb.nl/resolve?urn=ddd:011085768:mpeg21:a0012:ocr,3,ddd:011085768:mpeg21:p003,Soerabaijasch handelsblad,917
3692118,1881/11/24 00:00:00,5282,ddd:011181722:mpeg21:a0005,http://imageviewer.kb.nl/ImagingService/imagingService?id=ddd:011181722:mpeg21:p002:image&x=3531&y=1667&w=699&h=5282,ddd:011181722:mpeg21,4230,6949,3531,1667,4,"PE'STAAT IOWA Door den Goerenmir. PrtalaiMtU btlitfhudt dam D«aM«| | Van ganse her harte vereenig ik nuij t mij met het Nationaal Uitvoerend bewind Jn de aanbeveling om "" i Donderdag den vieren twintigsten dag van No. vember A.D. 1881 waaiv tenemen als een dag van Dank en Lof voor de Weldaden en Zegeningen gedurende bet jaar. "" Indien onze vëldën~ni«t~ hebben beantwoord aan den arbeid van hen die den grond beploegden — de stroom van Natonale Staats en persoonlijke welvaart heeft niettemin nimmer opgehouden; en wij mogen gaan naar den dienst der dankzegging met dankbare harten voor allerlei stoffelijken welvaart Terwyl de Natie no» treurt over het verlies van haar gezagvoerend hoofd en de misdaad betreurt die hem wegrukte van zijn hoogen post beeft ze niettemin nog reden tot dank in de grootheid van karakter ontdekt in den verslagéne in de innerlijke en toegenegen belangstelling in zijn toestand door alle klassen des volks in alle deelén des Land* en in het medegevoel in onze nationale smart ons door de geheele wereld betoond; evenzeer als voor het nieuwe bewijs dat het leverde van de vastheid onzer instellingen eu de dikwijls herhaalde verzekering dat hoe ook door het volk geliefd zü zijn die weggaan de republiek - wordt bestendigd onveranderlijk voor gewelJ onbewogen door toeval.' """"""7 T Laat ona al '.0'j mot dankbare harten bijzonder op dien da? gedeuksn aan de armen en behoeftigen onder da kinderen der .aarde en aldus God op 't hoogst veroeren. In kennisgeving waarvan Ik hieronder plaats mijn handteokening en verorden ta worden gesteld het Groot-Zegel van den Staat lowa. Gedaan te Dos Moines dezen achstsn dag van November des jaars een duizend acht honderd een en tachtig van den Staat lowa het vijf en dertigste en van de onafhankelijkheid der Vereenigde Staten het honderd en z esde.  . Door den Gouverneur J.vo. H. GEAB J. A. T. Hull Sec. van Staat. Bij ""De Volksvriend"" is deze Proclamatie pas ontvangen d«n 19n November. GESCHIEDENIS DER HIKTELAJp 80*rs* Gellto|riph«tr<i riMM den Boekhandelaar D. J. Dooiuwnc te Grand Bapids is de inteekening geopend op do'Oetohitdtnii der Martelaren die om de getuigenis dar Evangelische' Waarheid hun bloed gestort . van Christus geboorte tot het jaar 1605 niet alleen in de Nederlanden maar ook in Frankryk Engeland 8chotland Spanje Italië Duitschland Amerika on andere laiidén met vele brieven en belijdeniweq alsmede een varhaal van den Moord te Parijs van den Moord ta Voltoline de ongehoorde wreedheden In Ierland' benevens cene schets van den verachrikkelijken moord van de Waldenzen in Piemont . en andere vervolgingen der geloovigen. ■ ""tafljaa van Uitgaaf. 7 Dit werk zal worden uitgegeven ia 20 of 22 afleveringen van . 48 Bladzijden elk klein folio formaat eu in tw*a kolommen gedrukt. Iedere Aflv. zal 4 platen bevatten zoodat het geheele werk sal prijken met 80of 84 zulke platen. De aflevering koet slechts 30 Ciwt soodat het geheele werk f #. of «.80 kosten zal. Telkens als er 5 Afleveringen verschenen zijn worden *y door mij franeo toegezonden ea over het bedrag van f 160 beschikt. Des verkiezende kan het by rp\j berusten tot het oompleet is. • Voor nette en goedkoops banden aal worden gezorgd. J. C. Vv» Schïxkuil UitgMtr. DrJ. DOORNINK IlKrfd Agent uoor Amtrika. P. 8. Plaatselijke AgtnUn. wordt* alom gnraagd 4 md. 8-1» De koninklijke van Europa zijn huripe pcrsoonly ke «uitrekke Uikheden grootendeels verschul4igd aan den invloed vaa Ayerti IJaar Vigor die het haar Arisch oq glanzend houdt.' BQ H. Hoff nabij Kqeri de JongVtste klompen voor groot eq klein.",http://resolver.kb.nl/resolve?urn=ddd:011181722:mpeg21:a0005:ocr,2,ddd:011181722:mpeg21:p002,De Volksvriend,699
1245456,1881/07/31 00:00:00,1488,ddd:010187420:mpeg21:a0029,http://imageviewer.kb.nl/ImagingService/imagingService?id=ddd:010187420:mpeg21:p004:image&x=2476&y=109&w=837&h=1488,ddd:010187420:mpeg21,3313,1597,2476,109,4,"FLINKE REIZIGERS 4s/{psi gevraagd /voor den verkoop van Naaimachines bij particulieren; diegenen die bekend zijn met de constructiën van alle soorten Naai- eu en Stik-Machines hebben de voorkeur. Persoonlijk zich te presenteeren aan het Magazijn Veldhoven K No 107 Tilburg. Machinale Bierbottelarij Prijzen der Bieren. Per flesch. buitenlandsche bieren Jong oud .... f 0.08 Per flesch. Oud bruin. ... - 0.09 Lambiek f 0.30 Gewoon Witlokx - 0.09 Diestersch. ... - 0.20 Dubbel gersten. - 0.10 Hillmann ale.. . - 0.16 Dubbel oud ... - 0.10 Hillm. ale. 1/2 fl. - 0.08 Wouwsch Bier . - 0.11 Extra stout DBS* - 0.35 Oranje Bier. .. - 0.12 Porter B. S* .. - 0.35 Dubbel Witlokx. - 0.15 Pale ale* .... - 0.35 Beiersch Bier. . - 0.16 Extra stout* .. - 0.35 Beiersch 1/2 fl. . - 0.08 Per kruik. * Halveflesschenll % et. Wit Baarschotsch 0.09 / / / J Wit Heusdenhouts - 0.09 #^ .ffy WWF"" Op a^e bovengenoemde bieren ivordt per 12 en per 24 flesschen rabat gegeven. Bestellingen binnen de stad worden franco aan huis bezorgd doch geen bieren zullen uit de kelders genomen worden vooraleer dezelve besteld zijn. H. R. RIELISSEN. Tilburg Heuvel.",http://resolver.kb.nl/resolve?urn=ddd:010187420:mpeg21:a0029:ocr,4,ddd:010187420:mpeg21:p004,Tilburgsche courant,837
1762696,1881/04/02 00:00:00,1994,MMKB08:000090142:mpeg21:a0019,http://imageviewer.kb.nl/ImagingService/imagingService?id=MMKB08:000090142:mpeg21:p004:image&x=2052&y=148&w=884&h=1994,MMKB08:000090142:mpeg21,2936,2142,2052,148,4,"Advertentie DE VR0UWENVEREENI8IKB in de Inwendige Zending is verzet van Maandag 4 April op Maandag 11 April. WELDADIG HËÏDSVOORST Ë LÜNGT De Voorstelling door de Israëlitische Vereeniging «GEZELLIGHEID"" is door ziekte uitgesteld tot Zondag lO April e. k. HET BESTUUR. Coilegie lüsis Saci UBi. Zondag 3 April 's avonds 7 1 2 uur DOOR HET KORPS STARïlUZIfclCANTEN VAN HET 8ste RESEIWENT INFANTERIE met medewerking van I lïeerea Meesters en Dilettanten onder directie van don Heer Jf. A. KWAST Jfr. Entrée voor Niet-Leden ƒ 0.75. Kinderen beneden de 14 jaar ƒ 0.50. De Ondernemer V. VERNIMMEN. Dringend verzocht Diploma's te vertoonen. Na afloop van het Concert staan Tl""IUI"" Wagens voor Velp en Buiten-Sonieteit gereed. Gevonden: E en Ciouden Armband. Franco Arnhem of nabij gelegen Stations leveren wij bij waggonladingen van ongeveer 5000 kilogr. Puik zwaar KlilüIHEOOI Puik zwaar HLATEKHOOI Groningen 30 Maart 1881. PRINS & ZWANENBURG.",http://resolver.kb.nl/resolve?urn=MMKB08:000090142:mpeg21:a0019:ocr,4,MMKB08:000090142:mpeg21:p004,Arnhemsche courant,884
219420,1881/11/10 00:00:00,318,ddd:010266065:mpeg21:a0035,http://imageviewer.kb.nl/ImagingService/imagingService?id=ddd:010266065:mpeg21:p004:image&x=86&y=4269&w=690&h=318,ddd:010266065:mpeg21,776,4587,86,4269,6,307' STAATSLOTERIJ. 5de klasse 10de lijst. Prijzen van ƒ 100 en daarboven. No. 10325 10672 en 18778 ieder f 1000 No. 5454 5775 10466 en 14655 4er/400 No. 6411 en 11214 ieder ƒ 200 No. 1734 7622 7742 8326 11083 14029 17355 en 18965 ieder ƒ 100. ' M29',http://resolver.kb.nl/resolve?urn=ddd:010266065:mpeg21:a0035:ocr,4,ddd:010266065:mpeg21:p004,De Tĳd : godsdienstig-staatkundig dagblad,690
1927968,1881/05/06 00:00:00,2128,ddd:011085850:mpeg21:a0027,http://imageviewer.kb.nl/ImagingService/imagingService?id=ddd:011085850:mpeg21:p004:image&x=115&y=141&w=906&h=2128,ddd:011085850:mpeg21,1021,2269,115,141,4,"EAU FiaAßO|n] Jrtreu f» Boulêvêrd Bonne-Nouvella Pari». ▼ tAU HHHHII 197 S lUrmlto rmnt*Ldl*M\M op ê» W- K 'Hl—HMwlrfTMi Hij » Ffctn<»nii iijj». |mt a— iniiw —fcn* E»a Figaro Imtinuné» mf tal ■ luil. li « eatln Figaro InNiU MakMltnliMi amKlßhiMd'iriiwMWMMMiitotWH aiiPßll Ttf J tr DRUKINKT VAN >! 3; CHARLES LOR ILLEUX . U MMM> i*f rut ■—er. T.wr » I / TY POfIRAPHIE — LITHOORAPHIE droos mnTorrcx -nnai» Inkt toot dagbladen. met werk TlniH« IwlM wd«lti rf Jt - COMimgl» — roWTMB Bestellingen te richten aan & Klabaeh 8 Eua Milten Parjjt. 7591 1T 6ÉDAL6E&Fns Ains 4 Rne da la Cbaaitéa-d'Antin 4 • - Hofleveranciers vair onderscheiden* vonten Fabriek van Hemden vólgens maatopgave. 4 l 'Dóór geheel Nederland en NeSerlandtch- n IndM beroemd Tan wege soliditeit en billijke » prfliea der artikelen i « \ * * ü \ ] ~ SpéetfcUMt vaa HJae <a«Manik«lMi T  Beiulhnfn u nctoen Dl M kmi ulfoflut t - . ""BOEKHANIÉt "" E "" )' VAN • '> E ÏÏWWffI. & ËQ)_ ""britmng1 jper' ""der Nederlanden : 'J. ' Geesintc.'' "" Galerij van NederL Kunstnijverheid op de Wereldtentoonstelling te Weenen. Mr.J. v. Lennep en J. teb Geocw. Het Boek dit Opschriften geül. 50 boekdrukteteen. Mr. J. v. Lennep en J.'teb Gkoijw. De uithangteekens geïll. SOO boekdruketsen. _ Compleete werken van den ouden' Heee Smits prachtig ingebonden 5 deelen. Van Coevej—Wiebsbitzky De Tachtigjarige oorlog; ( deelen.",http://resolver.kb.nl/resolve?urn=ddd:011085850:mpeg21:a0027:ocr,4,ddd:011085850:mpeg21:p004,Soerabaijasch handelsblad,906
2876097,1881/12/17 00:00:00,3171,ddd:011086037:mpeg21:a0013,http://imageviewer.kb.nl/ImagingService/imagingService?id=ddd:011086037:mpeg21:p003:image&x=1939&y=56&w=907&h=3171,ddd:011086037:mpeg21,2846,3227,1939,56,6,"station; bebouwd met een Woonhiis en bijgebouwen stal voor 2 Paarden enz. olies van Djatihout op sleenen fundatie en met pannen gedekt Het ERF is groot 1U54.3S Q Meters en beplant met 5G mcht drugende Klappert tomen. ; Inmiddels uit de hand te koop en te bevragen bn de agenten te Kertosono Modjokcrto en Soerabaia. 4097 1111 M llffiiOL"" TE SOERABAIA. Jaarlijkschc Algemeene Vergadering van Stemgerechtigden Maandag 19 dezer des avond» to 81 uur in het Schoolgebouw. 4524 Te Commissio van Toezicht. Societeit Üoncordia» ALGEMEENE VERGADERING op Dinsdag den 20 December Ter verkiezing van 6 Directeuren. Namens de Directie. De Becretaris 4343 C. KOOL. Societeit Concordia rvp de ALGEMEENE VEiiGADE RING van gisteren werd BESLO 'I'EN om geheime Stemming in tevoeren. Den leden zal vóór de aunstaande ALGEMEENE VERGADERING op nieuw een bTEMBILJET worden toegezonden met 2 ENVELOPFES. Het STEMBILJET moet iu de eene enveloppe en deze in de tweede worden gedaan. Op de buitenste moet duidelijk de naam en hondtcekening van den Steaimer worden geschreven. Tengevolge van de verkiezing van den heer Jhr. J. C. ""Van DER WiJCK tot President der Societeit zullen op 20 December dsnu vijf Directeuren moeten worden gekozen. Namens de Directie. Secretaris 4542 C. KOOL. Societeit Concordia. B1^""e8 van geneeskundigen heeft SMÏSmm de Directie besloten om dit juar op Kerstmis geen Kinderfeest te geven.— 4582 DE DIRECTIE. miiiiffl air £r-<iu.4tiibuanteu uü .c Uer Boerubtiasche Schutterij worden bij ntze herinnerd u«u de aanzuivering hunner cantributie vóór primo Januari 1882 over het 2e Semester 1881 kunnende dezelvo worden voldaan dagelijks ten kantore van den ondergeteekende bij de firma ERASER EATON & Co. De kapt.-kwartiermeester 446 S lt Mc. NEILL. e. en JONGME>3CH van goeden JCI huize zijue werkzaamheden buiten's huis hebbende zoekt kost en inwoning bij . eei.e faiLiile to Soerabaia. Brieven met opgave van wijk en voorwaarden in te zenlen aan het postkantoor te Maaioen onder letter E. B. 4562",http://resolver.kb.nl/resolve?urn=ddd:011086037:mpeg21:a0013:ocr,3,ddd:011086037:mpeg21:p003,Soerabaijasch handelsblad,907
1991910,1881/05/23 00:00:00,1982,ddd:010497670:mpeg21:a0021,http://imageviewer.kb.nl/ImagingService/imagingService?id=ddd:010497670:mpeg21:p003:image&x=1058&y=4023&w=1005&h=1982,ddd:010497670:mpeg21,2063,6005,1058,4023,6,""""""" '"""""" *"""" ' ■ ~._..... Nog is de inteekening opengesteld op DE Indo-Nederlandsche Wetgeving-. Staatsbladen van Nederlandsch-Indië bewerkt en met aanteekeningen voorzien door J. Boudewijnse en G. H. van Soest 1816-1877. Prijs compleet in 5 deelen met register gebonden ƒ 100.— Tier deelen (1816-69) zijn thans yoorhanden. Het geheele werk zal in 1881 voltooid agn. Buiten Batavia met verhooging der kosten. ffl[h**&19 en m<*be thans nog van de gelegen- VmmKj^m heid gebruik om inteteekenen voer den prijs van 100 de 5 deelen daar het iverlc na de uitgave tot en met 1877 gereed zijnde compleet ƒ 125 kost. Leze verzameling zal nadat de onderneming voltooid is geregeld jaarlijks worden voortgezet. 1684 H. M. VAN DQfIP k Co. Ontvangen: Camera Otiscura van Hüdebrand in prts.btb. nd vergold op si.êe. Prijs f 6.— fr. p. p. f 7.— de Sturler Landbouw in IMed. Indië. H. Conscience valentijn.i 1912 H. M. VAN DORP k Go.",http://resolver.kb.nl/resolve?urn=ddd:010497670:mpeg21:a0021:ocr,3,ddd:010497670:mpeg21:p003,"Java-bode : nieuws, handels- en advertentieblad voor Nederlandsch-Indie",1005
2482497,1881/11/05 00:00:00,2441,ddd:110536780:mpeg21:a0014,http://imageviewer.kb.nl/ImagingService/imagingService?id=ddd:110536780:mpeg21:p003:image&x=2125&y=3837&w=1017&h=2441,ddd:110536780:mpeg21,3142,6278,2125,3837,8,J. E. DAVID & CO ünlvm ■en: Fijne Vanille Chocolade in stukken ca in pjcler. 3i83 Billarcllaken prima kwaliteit. 2829 J. B. DvViD & Co. Ontpakt: Mooie SCHILDERIJEN met Vergulde en zwarte Lijsten. •<B3O J. E. DAVID & Co. J. E. DAVID~&CöT Passar Pisang. Ontvingen: een kleine factnar Echte Havana Sigaren fin Hik « GROOTE SORTEERING Duitsclie Groenten merk Fusch Parn**witz & Co. I«i'«k»U* ttoelerrins Holfandsclie GROENTEN merk Gebroeders Schalekamp. PILSINBR KIER. HBINEKEN HIER. PORTWIJN (roode eu witte) gebr. Stfub. LIKEUREN geassorteerd- Wuxakd & Toe kik o. Meet en Clundon en Louis Rosderer. COGNAC Bipqu t Dtbjüchb öt. Co. Zeer soiiede Brandkasten uit do gorenomiuerdo Fabriek SCHLETTER Birmingham. Groote sorteering goedkoope PETROLEUM- HANG- en MUURLAMPEN. 3820 i,http://resolver.kb.nl/resolve?urn=ddd:110536780:mpeg21:a0014:ocr,3,ddd:110536780:mpeg21:p003,Bataviaasch handelsblad,1017
3688608,1881/10/01 00:00:00,3696,ddd:010101794:mpeg21:a0025,http://imageviewer.kb.nl/ImagingService/imagingService?id=ddd:010101794:mpeg21:p004:image&x=1022&y=3219&w=998&h=3696,ddd:010101794:mpeg21,2020,6915,1022,3219,8,"-IACHI-iES en GEREEDSCHAPPEN ter bewerking van BLIR KOPER ZINK EN PLAATIJZER in alle vormen. COMPLETE INRICHTING van METAAL- en EMAILWAREN-FABRIEKEN en ter vervaardiging Tan CONSERVE- BOTER- en CHOCOLADE BUSSEN. Schoensmeer- Monster- Pillendoosjes enz. E. P. de Jong.e MAGAZIJN: Prinsengracht by het Molenpad (22185) N°. 655 Amsterdam. fl ILLuSTfoRLAMP. 1 m fel §_ I*mp brandt zonder cylindor geeft B k een aangenaam licht vervangt volkomen BI wm het gas en behoeft daarbij toch weinig H V;§ ■./' petroleum. Haar liclitkracht staat gely'k E Wm «Éls met die van 25 kaarsan.—Ontploffingen _9 _Baaff_3__ onmff. e lijk. Monsterboek van Tafel- W yjj£%gr' Wand- en Hanglampen enz. franco KI SCHUUÉRT & SORGE Uitmuntende Artikelen voor exportatie. B GEBROEDERS SGOEUER. AMSTERDAM. BABUIP Expediteurs en Cargadoors. AGENTEN Stoomvaart HÜLL (Vertrek van Amsterdam eiken Woensdag en Zaterdag) NEWYORK (wekely'ks) HAVANA. (weke lijks) MIDDELLANDSCHE en ZWARTE ZEEËN (elke 14 dagen). GENERAAL - AGENTEN der Hollandsche IJzeren Spoorwegmaatschappij en AGENTEN der Maats tot Eipl. van Staats-spoorwegen. SAMENLADING voor Goederen bestemd naar de voornaamste Handelssteden van België Frankrijk Duitschland Oostenryk en Zwitserland. GOEDEREN te Land of te Water aangebracht van en bestemd naar het Binnen- of Buitenland worden tegen een zeer matig tarief ontvangen en verzonden. (36488) . —_ . ■—■— — ■ BOUPPE VAIf DER VOORT & LEWIN 's-Hertogenbos c. FABRIKANTEN van CAPSULES voor flesschen potten kruiken etc. in alle afmetingen kleuren en merken. BLADTIN chemisch zuiver zilvermat en hoog brillant. Minste prijzen goede en spoedige uitvoering. Laatste bekroningen S YDNEYIB7tT-MELBOURNE ISBI. Eerste prijzen. (235) BERGMANN S (12898) ZOMERSPKOETEN ZEEP tot volkomen verwijdering der ZOMERSPROETEN verkrijgbaar per etn. a 45 Ct. bij F. VAN WINDHEIM & C. Verkoophuis. HÜIIE DI SITONI recomma»---ert *""* bij voortduring als het voornaamste en het voortre_e_Jtei_ middel tegen alle soorten van HAARZIEKTEN. Word. me. _mc.cs_bij den Ondergeteekende en de bekende 6© Depothouders Wf_W a ƒ 1 per Flacon; zg zyn met Handteekeningen voorzien. Amsterdam ETIENNE Coijfeur Parfumeur (177) Kalvorstraat E 271. lIHBt I MMIS EK fl .. r: I o COBJN». IL__D_3_IAIIEK *pi Bovenstaand KINABITTER is bij den Heer J. RADEMAKER Spuistraat F 245 te A_i_ter_m; by heele en halve vrijnflesseben ook verkrrjgbaar. (179)",http://resolver.kb.nl/resolve?urn=ddd:010101794:mpeg21:a0025:ocr,4,ddd:010101794:mpeg21:p004,Algemeen Handelsblad,998
2943234,1881/10/17 00:00:00,3337,ddd:010588046:mpeg21:a0010,http://imageviewer.kb.nl/ImagingService/imagingService?id=ddd:010588046:mpeg21:p004:image&x=102&y=115&w=882&h=3337,ddd:010588046:mpeg21,984,3452,102,115,10,AAMBESTEDING. Ten Gemeentenuize van Leeuwarden zal op | Zaturdag den 22 October 18S1 .namiddi ten 12'/; uur worden aanbesteed het doen j van eenige vorandoringon aan de WO- | NLNG achter liet Hulpziekenhuis. De voorwaarden ziju verkrijgbaar bij den ] DIRECTEUR der Gemeentewerken terwijl de op zegel gesebreven inschrijviugsbilletten moeten zijn bezorgd ter GEMEENTE-SECRETARIE op Vrijdag 21 October e.k. vóór 's avonds aebt uur. D. C. HOEKSTEIN Deurwaarder te Leeuwarden  zal op Vrijdag 21 October 1881 T/m. 10 uur bij Gasfabriek aldaar a contant  verkoopen: EIKEN PLANKEN en POSTEN afkomstig van een gestrande en gesloopte Tjalk zeer geschikt voor Krui- en Dongplanken Hekken en Damleggers. Te bezigtigen ter plaatse van den verkoop. leder die iets te vorderen heeft van of verschuldigd is aan de Nalatenschap van DOETJE van dek MARK gewoond hebbende te Leeuwarden in leven Weduwe van Jacou Dbinbha  wordt verzocht daarvan opgaaf of betaling te doen vóór of op Woensdag 19 October 1881 ten kantore van den Notaris P. ZEPER Dz. te Leeuwarden. /0.50. Wat een geluki /uao. Daar heb ik aangekocht den geheelen voorraad van het wereldberoemde Reuzenwerk De Geschiedenis van liet Consulaat en hot Keizerrijk 5 zware deelen gr. imp. formaat plus minus 3000 bl_. bver 2 kolommen gedrukt beschreven door den Heer A. Tiiiees in leven President der Fransche Republiek. De tocht naar Egypte Italië Oostenrijk. Pruisen Spanje Nederland Rusland het verblijf in ballingschap op Elba en St. Helena alles alles heeft men hier bijeen in vijf groote zware Boeken. Wonderen ja wonderen gebeuren er met de Boeken; dit werk van naam geschreven door den Heer Thiers waarin al de daden en oorlogen van Napoleon waarin het meest bewogen tijdvak van Frankrijles Geschiedenis bied ik aan in vijf smaakvolle Prachtbanden voor den spotprijs van ƒ9.50 in plaats van ƒ25; onheiToepelijk stellig vasten zeker wordt de prijs later belangrijk verhoogd; :t is alleen omdat ik er zoon massa Exemplaren van heb gekocht; 't is alleen omdat mijne zolders zoo vol als mud zijn dat ik genoodzaakt ben een gedeelte van den voorraad zoo verre zeer verre onder de waarde op te ruimen. Wie nu een prachtig een wereldberoemd Werk tegen den prijs der banden wil hebben zende ten spoedigste een Postwissel van ƒ9.50 waarbij staat Consulaat en Keizerrijk aan D. BOLLE Bazaar van goedkoope Boeken Hang bij de Vischmarkt te Rotterdam.,http://resolver.kb.nl/resolve?urn=ddd:010588046:mpeg21:a0010:ocr,4,ddd:010588046:mpeg21:p004,Leeuwarder courant,882
1876838,1881/10/19 00:00:00,2557,ddd:010266047:mpeg21:a0050,http://imageviewer.kb.nl/ImagingService/imagingService?id=ddd:010266047:mpeg21:p004:image&x=2278&y=109&w=734&h=2557,ddd:010266047:mpeg21,3012,2666,2278,109,4,"MANUFACTUREN.  1° Januari worden te 's-Gravenhage e verlangd: een R. K. BEDIENDE volko- i men met het vak bekend. Eigenhan- j dige opgaaf van ouderdom hoe lang | en bij wien werkzaam en TWEE R. K. JUFFROUWEN waar- . van dezelfde opgaaf wordt verlangd. | Brieven franco onder N"". 271 adres:  Advertentie-Bureau Noordeinde 98 ; aldaar. (7549) | j§§|& Met November ÏHÊSEÊ^wordt gevraagd een bekwame SPEKSLA6ERSKNECHT tegen hoog loon van goede getuigen voorzien. Adres aan den Boekhandelaar B. Lenfring Hoogstraat 384 Rotterdam. (7541) HUISHOUDSTER. Een R. K. Juffrouw zag zich gaarne geplaatst als HUISHOUDSTER. De beste referentiön uit vroegere betrekkingen staan haar ten dienste. Adres franco brieven onder lett. 11. 8. aan den Boekhandelaar J. J. tan Mastrigt te Arnhem. (7540) HH. BIERBROUWERS. Een fatsoenlijk R. K. JONGMENSCH oud 29 jaar verlangt óf een Brouwerij over te nemen öf zich met een Brouwer te associeeren ofwel als Brouwmeester geplaatst te worden. Adres franc» onder het motto Rier aan het Bureau dezer Courant. (7543) ABSHAUBBINS of Anti-RtamatisÉe latten. Zeker en onfeilbaar middel tegen alle Rheumatische aandoeningen door koude ontstaan kramp aangezichtspijn kiespijn verstijving in de leden enz. alsook huidziekte van eiken aard. Zij nemen dadelijk alle scherpe deelen uit vleesch en bloed weg zonder eenig orgaan stoornis toe te brengen. Prijs 30 cent per pakje. Verkrijgbaar bij den Hoofddepothouder A. BREETVELT Az. te Delft en verder bij:",http://resolver.kb.nl/resolve?urn=ddd:010266047:mpeg21:a0050:ocr,4,ddd:010266047:mpeg21:p004,De Tĳd : godsdienstig-staatkundig dagblad,734
3702454,1881/03/24 00:00:00,4123,ddd:011085814:mpeg21:a0020,http://imageviewer.kb.nl/ImagingService/imagingService?id=ddd:011085814:mpeg21:p004:image&x=1942&y=48&w=898&h=4123,ddd:011085814:mpeg21,2840,4171,1942,48,4,"Geldloterij VANv v ' Kli tMIBIiSISCIÏ' TOIIS 'IE 50EIAMIA  ... EI DJiTIGfaTICai -'IK - BiMli-.K Dete^Loterij'bestaat' vit Loten. ■» 1 DB .PJtOZKN ZIJN «V L- i Een raii' iOO.OOO-1—- guldëri/' h Tr.'/.i®? M I 9 • . . » 5000.-— Vyfi » t • • » "" l|oooi— Tien s 500»-— Twéé honderd ».• * » 100.— D« Lot in lijn op franko aanvrage tegen kontante bctalinfc >an / 10*- verkrijgbaar: Te Batavia bij het Beitnur van het Djatigeatieht . 1 '. n den Notaris H. J. Mimiwb.  w de Hoeren Ddxlop fc Co.'  >v    H.M. v. Dom fcOo.  « • f f""» Eunf fc Co. t Buiteniorg * den Notarii B. Wibix. t Bahdong i > Heer B. B. Bkoibs. . Oheribon i i i H. F. Diunm. » Tegul i i i A/F. A. Höemb.  i iii D. J.H.r. d. Dras» t Gionovn». » Foerworedjo * f Notaris Th B. tak 8o«st. r tUgelang i » O. J. Bi Haim. • Sbmarang t t » J. A. vak Hahil.  de Heeren DlGaoorKoLrrkCo. r ~   « SoISKAN fc Co.  Salatiga » den Heer Pk. T. Voobnmuk.' * Rembang i i Notarii F. O- Hukam.  Soerabaia . . » A L Ökoüc* Hu* eaoMJi   . i Heer F. Vadï*.   de Heeren Chs. Kooxin k Co. t   t t Gebr . Gmma jrOo  „ tii Tmaa fc Co.. w  tii sn WrrSoHippia kCo „•  de ik Chinees Tan Tjoin Qwan i » » Heer B. Rubens. r Modjokerto t i Notaris J. E« Lanqbtkid. t: Sumanap » » Heer D. tas Dwsi » . Pasoeroean » # T': 'H. G. Kltodbb    Notaris A.vanßijokavomil 't' Malang . > > B. A. Babkit. t Probolinggo» de Heeren O* Maabsohalk k Cv t Beioeki *Il'1l' i den ' Notarii tA. B* TA* PILT- » t Bondowósso* » Heer J. A* Bbbkhout. • Kediri » » Notaris O. H. Blankbn. i Madioen i » . A. J. Woltbiahp. » Tjilatjap  » Heer P. J. do Fbbbo*. i Soerakarta t de Heeren Sobiium k Co. i Djokjakarta* * » Soisiiah. k Co» t i i Mev. da Wed; Koori». i Fading i den Heer H. A. Kbuoskak. . Bittir ""• > » « M. Bohaawb. ... c r Peismbong i i i A. W KHBM  Makaiar i i ' Notarii H. F. F. Humkak. * Banda . . Heer aJ. . . Bandjarm. . » Notaris G. M. Sohoübiiak. Bn rerdor bjj de agenten Tan het Djatigestioht. I Aeht dagen na de trekking inUen honden tib winnende Loten o*er de hnn toekomende gelden kunnen beichikken ten kantore ran de Nederlandieh Indische Eacomplo-Maatschappij te Batavia of ten kantore Tan den Notarii A. L Snouck Humbonji te Soerabaia tegen vertoon en onder intrekking der afncevene Loterijbilletten. Indien by de trekking al de loten niet *yn rerkooht ial het bedrag der prijien verminderd worden in evenredigheid van het bedrag der onverkoohte loten. | 'te trekking geiohiedt ten overstaan van genoemden Notaris A. L Ssouok Hubobonïb of diens vervanger opi deselfde wijse als bjj de vroegere Loterij voor hot Djatigestioht te Batavia is vastgesteld. i Prusen waarover binnen Drie jaren m den dag der trekking niet is beschikt geworden komen ten voordeele van beide instellingen. i t Het Bestaar van het Protestantsche Weeshui» te Soerabaia  BNOTJCK HUBGRONJE Preiident. ' J. O. 80HAQEN VAN 80ELEN Sekretaris. c Het Bestuur van het Djatigeatieht te Batavi» 9XOB KROBBBN President a: O. BAKHUIZEN VAN DEN BRINK. Sekretaris",http://resolver.kb.nl/resolve?urn=ddd:011085814:mpeg21:a0020:ocr,4,ddd:011085814:mpeg21:p004,Soerabaijasch handelsblad,898
1180910,1881/07/26 00:00:00,1345,MMHCO01:000074692:mpeg21:a0024,http://imageviewer.kb.nl/ImagingService/imagingService?id=MMHCO01:000074692:mpeg21:p004:image&x=2898&y=2057&w=878&h=1345,MMHCO01:000074692:mpeg21,3776,3402,2898,2057,4,Advertentie Ce rus Grandiflora (Nacht-cactus) zal heden avond bloeien in de kweekerij van J. WIND Jr. Liefhebbers worden uitgenoodigd om te komen zien. Puike zoetemelksche graskaas a 40 ct. de 5 ons bij de 10 stuks minder. Te verkrijgen bij J. W. DARTELS Nieuwstad. W. WILLEMSEN Deventerstraat Zwolle vraagt vier schildcrskncchtcn. Voor het dames- confectie vak kunnen tegen Augustus nog eenige nette leerlingen geplaatst worden. Adres letter A. bij den Boekhandelaar J. M. W. WAANDERS. In een burgergezin op een stil dorp wordt een nette DIENSTBODE gevraagd. Brieven franco onder letter S. bij den Boekhandelaar B. BERGIIUIJS te Kampen.,http://resolver.kb.nl/resolve?urn=MMHCO01:000074692:mpeg21:a0024:ocr,4,MMHCO01:000074692:mpeg21:p004,Provinciale Overijsselsche en Zwolsche courant,878
3012823,1881/05/06 00:00:00,3467,ddd:010587907:mpeg21:a0004,http://imageviewer.kb.nl/ImagingService/imagingService?id=ddd:010587907:mpeg21:p003:image&x=2789&y=2107&w=869&h=3467,ddd:010587907:mpeg21,3658,5574,2789,2107,12,"Publieke ITerkooping van den Amelandsdiin als Bouwterrein. Mr. HORAT. ALBARDA en A. OTTEMA; Notarissen te Leeuwarden zullen op Woensdag 11 Mei 1881 des avonds 6 uur bij de Wed. Looijenga  aan de Zuiderstraat te Leeuwarden  finaal publiek verkoopen : A. De* AMELANDSTUIN liggende achter het „Heer van Amelandshuis"" te Leeuwarden met uitgang door de Hillemasteeg naar de Voorstreek en met eene in het verlengde van de Hillemasteeg regt doorloopende geprojecteerde Straat uitkomende aan de Nieuwe Kade (Baljéebuurt) benevens de in dezen Tuin staande WOONHUIZINGE ca. gekw. no. 284 alles te zamen kadastraal groot 50 v. roeden en 78 v. ellen te veilen in perceelen en onderdeden uitnemend geschikt voor het bouwen van afzonderlijke en rijen Woningen alles zooals in verkoopboekjes met kaarten nader is omschreven; geb. over 't geheel: lepere. le onderdeel ƒ 1381 en voorts per vierk. el op: perc. 1 ond. 2 ƒ2.50 ond. 3 ƒ 1.96 ond. 4 ƒ1.52; perc. 2 ƒ 1.13 perc. ƒ31.10 perc. 4 ƒl.lO perc. 5 in onderdeden  ƒ 1.09  ƒ 1.11 ƒ 1.14 ƒ 1.17 f 1.21 ƒl.lB ƒ3.01 ƒ5.75 ƒ5.75 perc. 6 in onderdeden  ƒ4.65  ƒ2.51 ƒ2.60  ƒ2.50  ƒ2.50 ƒ 1.70 ƒ 1.61 ƒ4.- ƒ1.97 ƒ1.63 ƒ1.90 ƒ2.50 en ƒ2.50. Aanvaarding terstond na de finale toewijzing. B. Twee hechte HUIZEN gekiv. nos. 9 en 11 aan den noordkant van de Amelandsstraat te Leeuwarden het eerste in huur bij A. Wolda te aanvaarden 12 Mei 1881 en het tweede bij J. T. J. Heibers voor ƒ 104 in het jaar te aanvaarden den 12 Mei 1882 of eerder; geb.: lepere. ƒ 725 2e perc. ƒ866. Bezigtiging van den Tuin dagelijks en aanwijzing aldaar op den verkoopdag van des voormiddags 11 tot des namiddags 4 uur doch de beide Huizen sub B alsdan van I—4 uur. Verkoopboekjes met kaarten te bekomen ten kantore van de Notarissen. Boelgoed te Minnertsga. De Notaris P. ZEPER Dz. te Leeuwarden zal op Woensdag den 11 Mei 1881 voormiddags 11 uur ten huize laatst bewoond geweest door Dooitze Gabes de Jong te Minnertsga tegen contante betaling publiek verkoopen : MEUBELEN en HUISRAAD. Boclyoed le Twijzel. De Notaris POSTHUMUS to Buitenpost zal op Woensdag den 11 Mei 1881 des middags 12 uur ten huizo van do ErvenTjeerd E. Rispens in de Witte Kannen te Twijzel publiek  bij budgoed Legen contante betaling  verknopen : Een bruin merriepaard  1 kalve en 1 melke koe 2 boerewagens  1 kapwagen 1 egge gereiden en verder paardetuig groote vuurpot niet drievoet bindtstokkfti en verder boeregereedßchap 1 kabinet 1 chiffonnière 1 pulpituiu  klok groote schuiftafel en andere tafels  schilderijen  spiegels  hanglainpen  een partij stoelen  romers en glazen ; voorts een ouderwetsche eikenhouten kleerkast eene groote staton-bijbel en een partij koper tin gier lood glae en aardewerk enhetgeei) imjer zal wordtüi aangeboden.",http://resolver.kb.nl/resolve?urn=ddd:010587907:mpeg21:a0004:ocr,3,ddd:010587907:mpeg21:p003,Leeuwarder courant,869
5653900,1881/11/29 00:00:00,4925,ddd:010063614:mpeg21:a0053,http://imageviewer.kb.nl/ImagingService/imagingService?id=ddd:010063614:mpeg21:p010:image&x=2407&y=172&w=1148&h=4925,ddd:010063614:mpeg21,3555,5097,2407,172,10,"H. G. KACKS 128 lieuwendijk 147. heeft de eer zijne geachte Clientelle te berichten dé ontvangst van eene groote sorteering FRANSCHE JEN-. GELSCHE en DUITSCHE NOUVEAUTÉS bijzonder geschikt voor SINT-NICOLAAS-CADEAUX waarvoor hij het geëerde Publiek en zijne geachte Begunstigers in het bijzonder beleefdelijk üïtnoodigt de ETALAGE in de beide Magazijnen tijdig te komen bezichtigen. (713) CMPAGNE GÖSTMTGIBEÜ Les Marques renommées: CARTE BLANCHE & CARTE AUXMEDAILLES se trouvent dans tous les premiers Restaurants.TJ üfIJ CJ Agent-Général M. MERENS Amsterdam. (655) sAhl lil St Uitgave van H. PIJTTERSEN Tz. te Sneek. ' Alom verkrijgbaar de Iste Aflevering van ONTMASKERD. Toespraken van Dr. T. DE WITT TALMAG E Vertaald door C. S. ADAMA VAN SCHELTEJ&IA. Compleet in 12 Afleveringen ƒ 3. — Na de verschijning van Aflevering 12 wordt de prijs verhoogif. Wij vestigen aller aandacht vooral van Ouders en Voogden op deze Toespraken. (770) """"ëILDLEEIIIG7^ GROOT f 1500000.-- RENTEJNDE 4-/2 7» 's JAARS. TEN LASTE DER NAAMLOOZE VENNOOTSCHAP: AMSTERDAMSGHE OMMS-MAATSCHAPPIJg De Inschrijving voorloopig op ƒ 500000.— tegen pari is geopend op den 29en NOVEMBER 1881 tot 's namiddags 4 uur ten Kantore van de Heeren: LANGERHUIZ N & Co. KERKHOVEN & Co. GEBr. VAN WIJCK en CRAMERUS & VOJRSTIUS. allen te Amsterdam alwaar tevens Prospectussen en Inschrijvingsbiljet*ten verkrijgbaar zijn. Amsterdam 15 November 1881. (3Ï2} -""¦¦-""¦¦' —' "" ~——~ ¦ ¦'¦ "" '¦-¦ '¦ ¦ ¦ —-*? STOOMVAARMAATSGIIAPPIJ Hmu^^-igi -w—-% -""§-»•*»« ""Vmi-V *-S™ JL -""S& ¦¥?» i'»Sa-»W 9 111 ¦ ""jl ' E JS | #11 B*. ¦ W B""-S a g-""3 ffm&^ JLjA I*b e H *Bmwd Ja\^ v JLJ? a Maildienst op Neder).-Indië via Napels Eerstvolgende Expedities van Amsterdam: 8 Dec. Stoomschip PRINSES MARIE Kapt. R. J. WEBER. 17 Dec. Stoomschip MADURA Kapt. W. ADRIANI. NB. Het Stoomschip Prinses Marie zal op de uitreis Padang aandoen Adres voor Passage: aan het Kantoor der Directie Prins Hendrikkade 160 en bij de Agenten der Maatschappij. Voor Lading bij de Cargadoors: te Amsterdam DE VRIES & Co.: te Rotterdam KÜYPER VAN DAM & SMEER voor de Prinses Marie HUDIG & BLOKHUIJZEN voor de Madura. (489) HST* Laatste Laaddag te Amsterdam Donderdag voor het vertrek. De Stoomsehepen vertrekken te 10 uren 's morgens. Ziedaar de laatste exemplaren hebben wij voor St Nicolaas bewaard. Spoed! Spoed! Spoed! Dicïlw erken. TKRÏÏ!. Dicüiieriei Het fraaiste prachtwerk in de laatste jaren versclieneE. Voor ƒ 12.50 in 2 rijke folio prachtb. In plaats ƒ 34.60. De groote fraaie folio uitgave van BERNARD TER HAAR Dichtwerken door wijlen den Heer D. A. THIEME in zoon kostbare fraaie uitgave bezorgd is thans ons eigendom geworden en bieden wij thans voor een ongekenden en zeldzamen spotprijs aan. BERNARD TEJR HAAR's Dichtwerken in 2 groot folio rijk vergulde prachtbanden vervat geïllustreerd door onze voornaamste Schilders bevattende de fraaie platen naar oorspronkelijke teekeningen van J. ISRAËLS TAANMAN Ch. ROCHUSEN VAN BORSELEN MESKER enz. enz. welker onderneming zoo globaal circa ƒ 25000 aan wijlen den Uitgever kostte en waarvan zeker kan worden beweerd dat er geen fraaier prachtwerk zoowel wat papier druk platen als bindwerk aangaat in de laatste jaren in Nederland verschenen is voor den spotprijs van slechts ƒ12.50 in plaats van ƒ 34.60- Vast en zeker is 't dat dit prachtwerk let hier op! in 2 rijke groot folio JPrachtbanden met fraaie platen voor den spotprijs van ƒ 12.50 een koopje is zooals zich dit nooit bepaald nooit meer voordoet en ieder die dit kostbare werk voor ƒ12.50 koopt zich verheugen zal zoon pronkstuk want dit is het in den volsten zin van het woord te hebben besteld. Zoo pas is de beroemde Dichter wij mogen zeggen eenige Dichter ontslapen en wij zijn in de gelegenheid om zoolang de voorraad strekt dit extra fraaie werk voor zulk een uiterst geringen prijs aan te bieden. Wanneer wij alleen wijzen op den geliefkoosden zanger van Huibert en Klaartje den dichter van de St. Paulusrots JÉliza's Vlucht en Abd-eï-Kader dan weet men wat te verwachten is welke overheerlijke poëzy men aantreft in deze 2 groot fol. prachtbanden. Eene zeldzame gelegenheid is deze ontegenzeggelijk om een zoo kostbaar werk voor zoon uiterst geringen prijs aan te schaffen. Wij hebben dan ook de volle overtuiging dat zij die deze ƒ 12.50 franco inzenden de handen in elkaar slaan over het onbegrijpelijk goedkoope over het uiterst fraai en over de veel meer dan de waarde houdende Boeken. Het siert de Bibliotheek en de Salontafel het strekt den bezitter tot eer en groot genoegen. Hier kunnen wij gerust zeggen dat we geen woorden genoeg hebben om al het fraaie zoowel van de Dichtwerken zelven de fijn bewerkte platen naar teekeningen van onze eerste Meesters het papier den overheerlijken druk en de zeer smaakvolle prachtbanden te doen uitkomen; wij kunnen gerust zeggen iedereen bepaald iedereen moet hiervan beweren alles is even fraai als keurig het strekt de verkoopers tot eer zulk een werk zoo uitgevoerd voor dergelijken prijs (slechts ƒ12.50) te leveren. Daarvan ten volle bewust durven we dit dan ook openlijk en tot aanbevebng van het werk vermelden. I POC rlïf nn<r vnni»'ll Wie het werk Sekocht! franco ontvangen IiCLS UU HU» YUUIdI en b6taai(j heeft en het voldoet niet zende het eenvoudig terug en wij zenden onmiddellijk het geld per postwissel. Aanvrage met postwissel van ƒ 12.50 waarop: DICHTWERKEN TER HAAR in twee folio prachtbanden bij GEBRs. E. & M. COHEN Magazijnen van Goedkoope Boeken te Arnhem en te Nijmegen. IVOW ÏPK ' ie ze-»er wil zijn dat deze twee folio prachtbanden •'""n «vlo • (alhoewel wij toch ook voor goede verpakking zorgen) rijk en nieuw zooals ze zijn op de plaats van bestemming komen zende ons 25 Cent extra en de verpakking heeft plaats tusschen planken of zwaar carton.",http://resolver.kb.nl/resolve?urn=ddd:010063614:mpeg21:a0053:ocr,10,ddd:010063614:mpeg21:p010,Het nieuws van den dag : kleine courant,1148
999252,1881/11/03 00:00:00,1476,ddd:011181719:mpeg21:a0033,http://imageviewer.kb.nl/ImagingService/imagingService?id=ddd:011181719:mpeg21:p004:image&x=3480&y=5382&w=677&h=1476,ddd:011181719:mpeg21,4157,6858,3480,5382,4,"""NIEUWE WINEL • TB Sioux Centre. 7an Beeï & Zaon maken bij deze hunne landgenoten be'.ond dat zij te SIOUX CENTRE een winkel geopend hebben waar rij KRUIDENIER» WAREN; ELLEWAREN NOTIONS GLAS-EN AARDEWERK LEPELS VORKEN "" MESSEN_ SPIJKERS LAARZEN ENRCIIOENEN . : en eene menigte andere gcedown 100 goedkoop als elders te koop ihebbea. Bezoekt hen. ijl tikBEEK& ZOON.",http://resolver.kb.nl/resolve?urn=ddd:011181719:mpeg21:a0033:ocr,4,ddd:011181719:mpeg21:p004,De Volksvriend,677
7350377,1881/07/16 00:00:00,3637,ddd:011102798:mpeg21:a0023,http://imageviewer.kb.nl/ImagingService/imagingService?id=ddd:011102798:mpeg21:p004:image&x=48&y=182&w=2021&h=3637,ddd:011102798:mpeg21,2069,3819,48,182,4,"v- - f•< T7XT • • ïllfïi Fao ÜL : xuu i Wv 'Ay (hoopman. ftl .ftO<».•:■ föOlf»l.v yM^^c'I^NÓ-T^LIL.L.BIJR..)>. 1 f.V.U|'"" i'» 3' ||j GEOCTR O Y E E R D DOOK ZIJ N:MA JE S T EIT DE NKON IN tijjï* gfemSgQ -jtmmßsr» .i\ ■' t'•. JFOMIT-DE-MCOCK» m «f t 1 Leyert/ alle soorten yan militaire Uniformen oivïelambtelijke Costumes en particuliere Garde-Robes. W \ .™f ■ FA NT A SIK-CO ST ÜM ES. ' M ■ ftji» •>!< ;.i -i p^gg^ÉlTEli• MILITAIRE GARNITUREN u ShLNOOPEN. (290) Bestellingen op mant worden ie ï]ort-de-Kock en P»tl»nf-Pan(U«n| aangeoomenne afgeleverd'. "" ""' . ' ; 1 IW "" M* m ' ' . mmm Mhm J*' - ' {A - L' - "" I*'"" ' Saris CLIN & C gans I < W\ /V"" «<sHt*!f~ss2sÊs.« •• -*•:Ïi'*i;■»; • _ _ . psi! >1/ de onderstaandel geneesmiddelen zijn bereid onder toezicht van Dr Cun _ _l| _ aan wien de Medische Faculteit te Parijs de groote onderscheiding heeft toegekend van den ■ ' ' ' _ PRIJS MONTYON. & TViiOMSIfI. Capsules Wlpey-Gaylus.e^tl^^ verklaard dat de Capsules Mathey-Caylus de voörkear verdienenboven alle andere; ■ middelen ter. Spoedige genezing zoowel van Verouderde als van pas'l' onstaneGeheimeZiekten de.hardnekkigste Vloeingenen alle ziekten-m d» Blaas.) I' :•> Dagelijks 9of 10 Capsules Mathey-Caylus te nemen; \"" 'Ws°ê I • : De Capsules Mathey-Caylus veroorzaken nooit maagpijn en kunnen door dezwakste I gestellen verdragen worden.„ >.. .. - -■ i-iMiü i [-•' Aandoening der Zenuwen: l - met het beste succes gebruikt bij. zenuw-aandoeningen in het algemeen en bij de I ' 1' volgende ziekten inhet b\]tonder:ZenuwpijnenHoofdpijnSchele Hoofdpijn Asihma ■: - Hartkwalen en Gebreken in de Ademhalincjs-werktuigen Zenuw-hoest Krampen I ; Kinkhoest Slapeloosheid Vallende Ziekte. Zenuw-hartkloppingen Verlamming met I Beving Zenuwachtige Aangezichtspijn Verwarring vun het zenuwstelsel Herzenziek- I ten Dronkaards-waanzin Stuipen Duizelingen Verdoovingen Hallucinaties en I Opgewondenheid van allerlei aard. . H Dagelijks 4 tot 6 Capsules van Dr CLIN te o I ; » Jlimßß BRÏ De Japansche Druppels van Mathey-Caylus I v.. • | ANairlltra> stillen en genezen onmiddelijk de hevigste Kiespijn I en voorkomen den terugkeer daarvan door het bederf te doen ophouden.. f t_. ■ Eene eenvoudige indruppeling in de zieke tand doet dé Pijn onmiddelijk ophouden. I . • ' ''' ZEER GEMAKKELIJK 'Eft AANGENAAM IN HET ÖEBRUIK. I Belangrijk Bericht;— De artikelen van het Huis Glin & Gio te Parijs blijven overal ■•' > i'T "" en in elke luchtgesteldheid goed; en dragen ' I W-' als fabrieksmerk de handteekening CLIN& Cie en de medaillevande Prix Monthyon.W - "" BATAVIA bij Houtrijve êt C>« : Waitz & Co.—te SAMARANG bij Wannée en van Aalst.^^ ~ te SOERABAYA bij G. Ellinger. en bij J. E. Kautz • ■ \^r-' ■ (Q\o\ en verder bij alle apothekers van Ned. Indien. * ' Depot te Padang t>ij R. ""Van Muijen. .r /> /y- t/. VA RB PI B M De Japansche Druppels van Mathey-Caylus I BmHö flul stillen en genezen onmiddelijk de hevigste ■->' ■ en voorkomen den terugkeer daarvan door het bederf .te doen ophouden. : :<j Eene eenvoudige indruppeling in de zieke tand doet de Pijn onmiddelijk ophouden. ZEER GEMAKKELIJK EN AANGENAAM IN HET GEBRUIK. i S Belangrijk Bericht.—De artikelen van het Huis Clin & Cie te Parijs blijven overal ~ en in elke luchtgesteldheid goed; en dragen f' als fabrieksmerk de handteekening CLIN& Cie en de medaille vande.Prix Monthyon.i te BATAVIA bij Houtrijve ft C'«: Waitz & C°. — te SAMARANG bij Wannéo en van Aalst. te SOERABAYA bij O. Ellinger. en bij J. E. Kaut*. ""> ». V - v v <?s . : en verder bij alle apotheker» van Ned. Indien. | . -1»* «'r. i",http://resolver.kb.nl/resolve?urn=ddd:011102798:mpeg21:a0023:ocr,4,ddd:011102798:mpeg21:p004,Sumatra-courant : nieuws- en advertentieblad,2021
4395032,1881/06/18 00:00:00,1565,MMRHCE01:000036531:mpeg21:a0030,http://imageviewer.kb.nl/ImagingService/imagingService?id=MMRHCE01:000036531:mpeg21:p004:image&x=1081&y=4531&w=2296&h=1565,MMRHCE01:000036531:mpeg21,3377,6096,1081,4531,4,Advertentie P.J.YAiV DIJK Osjessluis 133 Amsterdam i van ItOEKDIlUKKEIiSH HEIMALEN. SPECIALE INRICHTING r ê teemt lint». Pii,http://resolver.kb.nl/resolve?urn=MMRHCE01:000036531:mpeg21:a0030:ocr,4,MMRHCE01:000036531:mpeg21:p004,De Zuid-Willemsvaart,2296
1818624,1881/04/15 00:00:00,2048,ddd:010342783:mpeg21:a0016,http://imageviewer.kb.nl/ImagingService/imagingService?id=ddd:010342783:mpeg21:p003:image&x=79&y=2705&w=888&h=2048,ddd:010342783:mpeg21,967,4753,79,2705,4,"TBCjrjrrJßr"" w «-a b «-':■£«. «□»«» »?» van BORDUURSELS  Linten fömfc» en alle voorradige Manufacturen $• Modewaren. Z. M. KA Z E N ii f 120 per Kg. SARDINES van Philippe et Canaud eu ordinaire DIT <) in lL en */4 blikjes. JÉfcï WAREN in blik. VRUCHTEN op demi-sirop. PR ÜIM E DANTEN iv üesschen en blikken vau 1 2 en 2/2 Ko. SUIKEROOED (Bont .& Leijten) gesorteerd per flescli en in liet klein. Renaalt en Hennesy Brandy Guignolct Wijuand Fockinck's Liqueur  Chartreuse Rorter Aie Bier Onversneden Bordeaux iv vaten kisten eu per dozijn. Port- Sherry- Malaga- eu Champagnewijncu (exquise merken. PARFUMERIES (geporteerd) etc. etc. g. COROKEL. Tir^e¥rscks jVXo73steeneii  j\nlk en Cement en veel meer andere Bouw-Materialen H-w-* -n L SAiVIÜÈLS. i 'l l. tNIIAKEERSGRA CU T.",http://resolver.kb.nl/resolve?urn=ddd:010342783:mpeg21:a0016:ocr,3,ddd:010342783:mpeg21:p003,Suriname : koloniaal nieuws- en advertentieblad,888
5817195,1881/10/19 00:00:00,3855,ddd:011067825:mpeg21:a0055,http://imageviewer.kb.nl/ImagingService/imagingService?id=ddd:011067825:mpeg21:p004:image&x=2348&y=1950&w=1509&h=3855,ddd:011067825:mpeg21,3857,5805,2348,1950,4,Aan de onderstaande en vorder bekende Depöthouders is verzonden eene nieuwe bezending van alle TÏÏIISÖOBTIN nit het magazijn van VAN HOUWENLNGE & VISSER welke zich zoowel door goede qualiteit als lagen prijs bijzonder aanbevelen. Afgewogen in verzegelde pakjes van vjjf twee en een half- en één ons waarop het nummer en de prijs zijn vermeld. Bij hoeveelheden van minstens 15 Ned. ponden worden dezelve desverkiezende in met lood bekleede kistjes afgeleverd. Prijs-Couranten zijn gratis verkrijgbaar. Op plaatsen waar nog geen Depots gevestigd zjjn worden Depöthouders gevraagd. Ongefrankeerde brieven worden niet aangenomen. (6791) AMSTERDAM. Wed. ƒ. H. BOGENUOLTZ & ZOON Utrechtschestraat No. 89. B. TRANSWA Westerstraat tcsschen de Iste en 2de dwarsstraat No. 106. IL E. SPEELMAN Nieuwendijk hoek Haringpakkerij. J. A. STFITIKENKAMP Lanrierdwarsstraat No. 386. IL v. d. VELDEN Weesperstraat N». 121. Arnhem Joseph J. Paddenburg. Hilversum Wed. P. W.Lammen. Oss J. J. de Louw. c A. Pleimes.' Hooi o C. Schuit. Oisterwijk Blomjous Canters. Amerongen D. van den Berg. Harlingen J. Bok. Oirschot H. Kuypersv. d. Heuve Amersfoort. L. Rooke. Harderwijk B. J. Stronkhorst. Purmerend T. J. de Wolff Cz. t 'melo Wed. G. J Leus. Hoogeveen J. Zwiers Johz. Pekel A (Oude) J. P. Scherpbier Appingadam Wed. J. W. Mekel- Heerenreen Wed. J. Braaksma. Putten a/d. Veluwe F. van Dam Veerkade. Hengelo A. Joh. Bonefaes. - Prinsland Wed. L Vroon. Assen Van Gorcum & Co. Hoog Carspel C. Davidson. Piershil E. A. Kleijnenbery. A vereest W. ten Kate Rz. Haastrecht E. P. van Achthoven. Rotterdam T. Franchimon » II Dorgelo. Haierswoivle J. Gaarkeuken. » S. J. G. VVulff. Alkmaar Bruinvis & Bakker. Hontcnisse C. Fassaert. Roermond R. Simts. Anualand (St.) P. Kuijper. Hellevoetsluis A. de Groot. » Schmits van Eupen. Axel Wed. Joh. Veenhuizen. » Wed. C. Hooghart » P. H. Smits. Andelst P. de Haas. » Wed. F. Hoftijzer. Roozendaal Joh. van Gastel. 's-Bosch A J. H. van Baër. Hoeven (bij Oudenbosch) M. J. RaamsdoLk J. Vonk. » A. Quaadvliet van Bree. Coopmans » C. van Drongelen. Breda W. Nissen de Bruio. Hcusdca de Erven G. Veerman. Ridderkerk W. G. Nugteren. Berlicum P. F. J. v. Ove'rstraaten. Helmond II. H. van WilL Raalte J. II. Schrader. Berkel G. Kamps. Heiningen Kind. M. C. Sonneveld. Schiedam D. Heokemans. Boxmeer J. L. A. Koek. Helvoirt L. v. d. Ven. Sluis J. C. A. Mets. Boxtel S. van den Donk. Hillegom P. van Slijpe. Steenbergen A. Kluit Bommel (Zalt) S. M. HogerzeU. Hallem bij Bolsward Y. II. van Sneek W. Reinouts van Haga. Barendrecht ƒ. J. Huijzer. der Meuten. Smilde E. A. Polak. Brouwershaven J. W. v. Braband. f Teerenberg Wed. C. Rademaker. Stadskanaal B. T. Rebenscheidt. Beierland (Oud-) J. T. v. Schaik. Hees (bij Nijmegen) P. F. J. Sommelsdijk H. A. Meijer. • Brielle A. van Oudgaarden. van Overstraten. Soestdijk J. Q Ubbink. Baarn Wed. P. de Ruiter. Kampen J. G. van Riemsdijk. Sliediecht Joh. Visser. Buren J. Bulens. Koevorden J. R. Koek. ■ » K. P. Kalis. Bodegraven II. Rollman. Koog a/d. Zaan P. Blees. » J. Klein. Brammen G. D. Uittien. Krommenie J. Heinis. Schoonhoven J. Nobel. Boscoop C. Verkade. Kockengen H. Reuser. Soetermeer J. van Dorp. Besoijen L. v. d. Hamme. Kolijnsplaat J. J. Kooman. Spijkenisse J. de Baan. » A. Van Delft Heinsbergen. Klundert P. Loose. Scheveningen M. I lammer. ' Bennebroek T. Frank. » Mej. M. Loose. Tilburg M. C. N. Bressen. Berg en Dal P. T. II. Hamer Kaatsheuvel W. v. d. Wee. Tiel Wed. J. Jager. Barneveld A. Heineman. Leerdam J. J. Drooglever . Tholen M. P. Bierens. Blokzijl H. Wilmes. » J. Ranwert. Udenhout Corn. Rats. Bergen-op-Zoom Ph. van Reije- » Wed. W. van Arktl. Uden 1'. J. Watzin. Asselbergs. Leiden J. Roodenburg. Uitgeest J. Starreveld. Culenborg Wed. C. C. Sterk. Leeuwarden Herm Roling. Urk K. Koffieman. » M. Bron Verkerk. Lisse C. W. v. d. Mark. Utrecht F. W. J. v. d. Burcht van Deventer Wed. A. J. Bos. Loosduinen J. W. IL Lemckert. Lichtenbergh. Delden. T. II. Wasteneeker. Loenen a/d. Vecht G. Uit den Venlo Ch. Gudden Levrs. Dragten J. Posthuma Sz. Boogaard. » J. A. Beek. Doesburg A. T. Overmaat Lith C. van Oirsouw. Vaals (Limburg) Kobert Delhans Driebergen II. van Oostveen. Maastricht A. van Engelshoven. Vught M. W v. d. Heijden • Dreumel G. J. van Wely. ' Megen M. A. Banke. Veghel A. P. van Hout. » P. van Oirschot. Middelburg H. L. J. Goethals. Vrijhoeve G. Both. Druten J. G. Sengers. » J. P. v. d. Heuvel. Vreeswijk C. van Vellhuijzen. Doorn G. van Setten. Monnikendam Wed. P. Stam. Vlaardingen Wouter Pleijzier. Delft Erve Wed. P. Tangroan. Middelharnis H. v. d. Rovaart Voorburg J. P. F. Ligthelm. Delfshaven P. Klerks. Medemblik Wed. J. Drost Veenendaal J. II. Jansen. Dlrksland M. v. d. Vliet Az. Moordrecht G. H. Post. Vaassen C. T. Herberts. Drimmelen A. van Herwijnen. » Jac. Verburgt. Veendam J. A. Muntendam. Doornenburg Mej. H. Hengard. Montfoort J. A. Jacobi. Velp G. Rutgers. Enschedé IL Maseland. » T. Tromp. Voorschoten P. d Bruin Jz. Elburg J. Wijnne. Maassluis Corn. J. van Leeuwen. Valkenswaard II. Maas-Leen. Epe P. L. Wagenaar. Monster II. Verbeek. Vlissingen J. Broek. Edam P. van Brederode. Meteren Wed. G. van Oostrum. Warmond G. van Duijker. Enkhuijzen Mej. M. A. de Haan. Meppel B. van Dijk. Wateringen (in het Westland; A. Eindhoven J. II. van Hees. Nijmegen J. W. Maurits. de Groot » L. v. d. Sluijs. Nieuwerkerk A. C. Pinkse. Wageningen G. Hijnekamp. Fijnaart S. Maris. Numansdorp M. C. van Dis. Woerden N. C. v. d. Kas. 's Gravenhage J. M. v. d. I Iarst. Nieuwe Tonge A. van Eesteren Bz. Wijk bij Duurstede Wed. C. Zorr. » L. A. v. Tetterode Tz. Nieuwe Niedorp G. Half. Wamel H. van Beers. Groningen W. E. A. Holst. Neuzen (Ter) J. C van Sprang. Weesp Jacob Brunt Jz. Gorredijk S. G. Zwart. Nunspeet Wed. C. Klomp. Wijhe. B. G. Elfrinck. Genemuiden II. Groothuis. Naarden W. Thuring. Willemstad A. P. Tlromers. Goor Joh. ten Dofschate. Nijkerk .1. D. van kamshorst. Waspik Wed. Schorten. Gouda W. B. van Stranten. Nigtever.ht W. van Groen. » G. Boom. Geldermalsem J. C. vao Doorn. Noordwijk II. Sam. > A. Boom. Gennip J. D. J. Hermscn. Oldenzaal B. van Engenkoek. Waalwijk T. A. van Wijk. Gemert J. II. Corstens. Oosterbeek N. Gerritsen. » Wed. J. Kleijt-erg. Grave W.IIanssen. Ouderkerk a/d. Usel Wed. C. IJsselstein Wed. P. van Dorssen Geertruidenberg D. van Tol. Goudriaan. Zutfen Mej. J. C. Schultz. » J. Boon. Cudewater J. van Liefland. Zeist Schtttz & Co. s-Cravenmoer bij Dongen G. Bijl. Oude Tonge H. J. van der Snoek. Zevens ar C H. Wessar. s-Gravendeel Wed. J. L. Naakt- Ooltgensplaat P. v. d. Vliet. Zevenhoven J. G. v. d. Wolde. geboren. Overveen C. II. van Looij. Zuid-Beijerland [. J. Dam. » Klaas de Best. Overschie W. Nolte. Zevenbergen I. van Geel. Goedereede Gez. Oreille. Oudenbosch A. Sep. » \. van Tester. Goes G. A. Weide. » Jonker Maas. Zierikzee Jac Ochtman Jr. Haarlem Y. R. Hoeksema. Oosterhout. Wed. J. IL Smeets. Zonnemaire J. Everwijn Jz. HaarlemmermeerJ. Beijersbergen. Ootmarsum Th. II. Weeling. Zwolle A. Borgman. GïdrU'tt iet KÖTJINKttn:» STOoMDltÜKKVorr \t'«Mi(oesstr«»t ie*. Ara-Vrd',http://resolver.kb.nl/resolve?urn=ddd:011067825:mpeg21:a0055:ocr,4,ddd:011067825:mpeg21:p004,De standaard,1509
440202,1881/06/20 00:00:00,446,MMDA03:000097235:mpeg21:a0016,http://imageviewer.kb.nl/ImagingService/imagingService?id=MMDA03:000097235:mpeg21:p003:image&x=2900&y=556&w=987&h=446,MMDA03:000097235:mpeg21,3887,1002,2900,556,6,Drie Brandschuiten Drie Brandscliuiten te koop 9 allen voor drie jaren nieuw gebouwd ieder groot 8 ton waarvan twee met houten bevloering en één met vóóronder. Te bevragen bij M. ROBAARD Mzn. te Hoogeveen.,http://resolver.kb.nl/resolve?urn=MMDA03:000097235:mpeg21:a0016:ocr,3,MMDA03:000097235:mpeg21:p003,Provinciale Drentsche en Asser courant,987
6443970,1881/09/23 00:00:00,3198,ddd:010497492:mpeg21:a0016,http://imageviewer.kb.nl/ImagingService/imagingService?id=ddd:010497492:mpeg21:p002:image&x=2074&y=2800&w=2015&h=3198,ddd:010497492:mpeg21,4089,5998,2074,2800,4,"STOOMVAART im-SLfeSUHD HUI 14-daagrsche Maildienst «a NAPELS naar^ AMSTERDAM. VAARBEURTEN DEK BTOOMBCHEPEN. VERTKEK VAN BATAVIA. 18 8 1 84 Sept. . . . KONING NEDERLANDEN. 19 Nor. . . . VOORWAARTS. 22 o°t ""' * iïïïHï MAEIB' *6 » '' ' PJIINBBB AMALIA. k v *- * Ï^ÏÏr£;„ 8 Deo' •• • KONINGIN EMMA. 6 Nov. . . . PRINS VAN ORANJE. „ ... PRINS ALEXANDER. 3I „ ... CONRAD. jP-jfiP* PASSAGE wordt verleend naar MARSEILLE MET OVERBCHEPING TE NAPELS. TV .  ""Viermaal '» weeks vertrekt een stoomschip van NAPELB naar MARSMLLE. J^SS ™bli>f * NAi>BLB. moeten P»»«gie» aan den wal logeren en in hun eigen onderhoud voorden. De rASSAGE bedraagt per persoon: le klasse S 65° naar NAPELS of naar MARSEILLE via NAPELS*. uasM f 800 AMSTBJiI)AM# Se klasse ' 880 ' NAPELS. Klasse $ 4g() § AMSTERDAM. Lading wordt aangenomen voor bijna alle havent* tan de MLDDELLANDSCHE ZEE Noordelijk EUROPA benevens AMERIKA waarvoor directe Cognossementen worden afgegeven. Voor VRACHT en PASSAGE gelieve men lieh te wenden tot De Agenten J. DAENDELS & Cd. Patavia Ramarang Soe^hxia. pfflffl «111 hwa 1 mm QÜEENSLAND ROYAL MAIL LINE. Maandelijksche Maildienst van Batavia direct via Aden en Suez naar Londen en van Batavia naar Brisbane en andere Queenslandsche havens. De vermoedeiyke vertrek dagen der booten zB*a 1881. Naar LONDON .MERKARA"" 1 October. \A' »ROMA"" 29 w Id- »ALMORA"" 26 November. H' »CHÏEBABBA"" 24 Dec«mber. Naar B RIS BA N E „ALMORA"" 9 October. Id- .CHYEBABBA"" 6 November. 1(1 • .DORUNDA"" 4 December De boo«en Mjn alle UITMUNTEND ingericht voor Passagiers eoowel eerste als tweede klasse. Aan boord vau elk stoomschip berindt zich een geëxamineerd geneesheer. _ _ „ Iste klasse 2de klasse. Paseat?ege:d naar LONDON / 700 — / 476 1 BRISBANE „ nov_ \ 16()-__ KINDEREN heneden 10 j„ar fcettlee half ~;:; *ÊEN KINU beneden Bjaar: vr^; TWEE KINDEREN-*ei*ede* 8 jear: een vrij één: een kwart d«r passKgegeldei*.. leder eerste ktaese passagier wordt 600 Eng « gedicht voor bagage vrij fcwesta-n twerde klasse 300 Eng. ft Zware b-*ghge kan aaa boord blijveH ter dooreendiug van LONDON na»r ! ÖLLA^D of elderst™w£ hi '? *fSohet!etB r'xTnr?«i!'al sd'op de voordeeien die dtte lijn aanbie.it voer den DISEKTIN AFSOHEKP van Lading naar LONDON en AUSTRALIË. De Agenten MACLAINE- WATSON & Go. Batavia. Mc. NEILL & Go. Samarang 3449 FRASER EATON & Go. Soerabaia.",http://resolver.kb.nl/resolve?urn=ddd:010497492:mpeg21:a0016:ocr,2,ddd:010497492:mpeg21:p002,"Java-bode : nieuws, handels- en advertentieblad voor Nederlandsch-Indie",2015
2283900,1881/03/01 00:00:00,3972,ddd:110620046:mpeg21:a0016,http://imageviewer.kb.nl/ImagingService/imagingService?id=ddd:110620046:mpeg21:p003:image&x=3619&y=2268&w=575&h=3972,ddd:110620046:mpeg21,4194,6240,3619,2268,4,| iUIILLEX enz. tc koopen is bij | H. Wijkhuizen. 1 Men rtn er tegenwoordig een grooj>n Toorraad I J 7 ILNIIJIiELINK. j Eigenaar van een Livn » STABLK (Huur-gta • vaar elk uur van den dag zullen te huur zijn j ;oede Paarduuen allerlei Rijtuigen ingrrigl • net alle he( j je eerd publiek Prijzen billijk en goede behandeling i De plaat'iis in'Jde Straat tus«cken Kivereu : Vlarket Sti uit • R ScMTfiü PloepD & Herzapn zoo goedkoop doen als ergens elders WERKMAN. VAN AKK.' NAJAAR-bii wintêrinslag van alle soorten van Bli L E WA REN • . . 'f ■ ..>» ■ «* U thans bij Wtyhebbtn ontvangen: Wollen- en Katoen Flanel GEBLEEKTen ONGEBLEEKT KATOEN Vrouwen en Mannen Ondergoed Japoostotlen als: Jlerjnos Casimirs Delaines. Calicos ene. Dames Kraagjes; Linten -en Triuinüng Silk. / . GINGHAMS xx NOTIONS. HOEDEN & PETTEN. Ook hehhen »i| ten allan lijd* voorhanden «en gruote» voorraad ran KHIIIDIiNIKRiIWABSN. fiL.I#F.X I.IIIDHWHBK Die wij zuo goedkoop ala iemand verkoopen OT Kom een Komt «liep en orertuift uielven. Holland. Uich. 13 1889. ■ ' • ' ' * ' ' 'fc' • r' 'y*,http://resolver.kb.nl/resolve?urn=ddd:110620046:mpeg21:a0016:ocr,3,ddd:110620046:mpeg21:p003,De grondwet,575
1824480,1881/07/10 00:00:00,2172,ddd:010510515:mpeg21:a0021,http://imageviewer.kb.nl/ImagingService/imagingService?id=ddd:010510515:mpeg21:p003:image&x=2680&y=46&w=840&h=2172,ddd:010510515:mpeg21,3520,2218,2680,46,4,"HYPOTHEEK' -■steeds OEI/O ESF te' bekomen t. le. hypotheek ten kantore > van den Notaris CABELL. JOSÉ R 01)11. GUES df Co. hebben per H. M. TORSTER ontvafi Extra BLOM. dito ZOUT VLEESCH S F EK enz. enz. enz.  . Ut——' .— . C3r3rOOt3 iS'pannselie Olijven aJ' £.00 per halve kilogram bij ASSER SAMUELS. Hollowa'ys Pills are. securitids ol' health to all nations of whatever clinee. They have hope relief and comfort lo milüons. In irritalion and dobility  generaled by excesses o: any kind or in genera! prostration of the syslem their effect is rapidl-y soothing rei -  and restorative. They rapidly drive from l the mortal cause of ailmenl . jn th« frame its prisline animation heaitl They greatly increase the app< the stoinach assisl the digestion .and ü elasticity to the spirits their irculapon and carried through its eene*-. exerls its clcansing power over every""organ In the lungs they nffe< f most strikir.j .ha converting the impure venous info pure arteria blood by which the Avhole frame is recruited",http://resolver.kb.nl/resolve?urn=ddd:010510515:mpeg21:a0021:ocr,3,ddd:010510515:mpeg21:p003,De West-Indiër : dagblad toegewĳd aan de belangen van Nederlandsch Guyana,840
94850,1881/05/18 00:00:00,175,ddd:010063422:mpeg21:a0030,http://imageviewer.kb.nl/ImagingService/imagingService?id=ddd:010063422:mpeg21:p004:image&x=2910&y=424&w=542&h=175,ddd:010063422:mpeg21,3452,599,2910,424,8,KRUTVATEN ? voor =t 200 Kilo. wonlen ingekocni aan deStoommaalderij van g(lul'e ¦en o-ewasschen Krijt. Houttuin» 100/104. B C. .1. LIEVEGÜEU.j3gg,http://resolver.kb.nl/resolve?urn=ddd:010063422:mpeg21:a0030:ocr,4,ddd:010063422:mpeg21:p004,Het nieuws van den dag : kleine courant,542
4221009,1881/10/28 00:00:00,5031,ddd:010860835:mpeg21:a0015,http://imageviewer.kb.nl/ImagingService/imagingService?id=ddd:010860835:mpeg21:p003:image&x=56&y=125&w=839&h=5031,ddd:010860835:mpeg21,895,5156,56,125,6,"De Oiidtigeteekande verzoekt de kiezers voor den Kerkeraad der Ned. Israël. Hoofdsynagoge om bij de Verkiezing op Zondag a.s. hun stem niet op hem uit te brengen daar hij eene herbenoeming NIET kan aanvaarden. (486) M. I. LOB. WILIAMa IL KALVERSTRAAT 55 -A- S 1"" ______ZE2 H> ._£_. 2>v_r CHSMISMBS Ons „CLMËRHEffID"" onovertreffehjk in coupe wordt binnen zeer *or*en tijd op maat vervaardigd dech is steeds in alle afmetingen in ons Magazijn verkrijgbaar : Met Linnen Borst Boord en Manchetten fl' 4 fl. 450 fl. 5 fl 550 fl. 6 fl. 650 per stuk. PARAPLUIES tut de meest gerenommeerde Fransche en Eqgelsche Fabrieken : HEERENSOORTEN fl. 350 fl 450 fl. 550 fl 7 fl. 8 fl. 9. DAMESSOORTEN fl- 350 fl. 450 fl. 525 fl. 650 fl. 725. f 1.850. Articles d@ Luxe 2eer geschikt voor St. Nicolaas Cadeaux in groote keuze tegen lage prijzen. mmwmsMw Z£er elegant bewerkt kunnen na gebruik in den zak gestoken worden : fl. 15 fl. 16 fl. 17 fl. 18 per stuk. Outütters & Shirtmakers 55 KALVERSTRAAT 55 JuUtNVtnVuLulNb IN RUSLAND. Lijst van ingekomen giften. 6e OPGAVE. Ingekomen bij den Heer dr. J. 11. DüNNER: Gecollecteerd te Utrecht door den heer M. de Leeuw op het 25jarig huwelijksfeest van den heer Veilekoper f 1185 gecollecteerd te Helder door den hh. Beek en M. A. Grunwald f 2950 afgezonden door den heer Cohen uit Assen namens het bestuur f 4786 (opbrengst eener collecte gehouden bij de godsdienstoefening in de Hervormde kerk f 2086 ; van idem bij de godsdienstoefening der vereeniging ter bevordering van Christen belangen f 1750 van eenige Israëlieten te Assen nog f 950 te zamen f 4786.) Gecollecteerd door de hh. J. Elzas en M. S. Heijmans in de gemeente Winterswijk bij de verschillende gezindten f 14115 gecollecteerd door het kerkbestuur de Israël g.meente te Hoorn f 3130 uit Leeuwarden i 11 totaal met vorige opgave f 15525 Lrael. Nieuwsbode f 250 door den heer mr. Kiek te Groningen gecollecteerd bij eenige logees f 10 uit Veghel van NN f 3 NN uit Almeloo f 090 door tusschenkomst van den eerw. heer Rood uit Gouda fl. Totaal f 29006. In de vorige opgave was foutief opgegeven : gecollecteerd door den heer M. de Leeuw ter gelegenheid der besnijdenis bij den heer A. de Leeuw f 1185 moet zijn f 9 dus af f 285. Totaal f 28721. Bij den Heer ALEX. DANIELS: Van comité te Almeloo (Twenthe) f5O Job f 250 kerkbestuur Elburg f 7250 idem Doefnchem f 11291. Totaal f 23791.",http://resolver.kb.nl/resolve?urn=ddd:010860835:mpeg21:a0015:ocr,3,ddd:010860835:mpeg21:p003,Nieuw Israelietisch weekblad,839
665620,1881/03/25 00:00:00,230,ddd:010103973:mpeg21:a0053,http://imageviewer.kb.nl/ImagingService/imagingService?id=ddd:010103973:mpeg21:p010:image&x=2000&y=206&w=2894&h=230,ddd:010103973:mpeg21,4894,436,2000,206,10,None,http://resolver.kb.nl/resolve?urn=ddd:010103973:mpeg21:a0053:ocr,10,ddd:010103973:mpeg21:p010,Algemeen Handelsblad,2894
2598255,1881/02/28 00:00:00,2871,ddd:011085793:mpeg21:a0030,http://imageviewer.kb.nl/ImagingService/imagingService?id=ddd:011085793:mpeg21:p005:image&x=1946&y=59&w=905&h=2871,ddd:011085793:mpeg21,2851,2930,1946,59,6,"QOTOoeaa pop"" 'Hüktóté1 JStoött-v fceilgelegen-' ■/e'""y'l ' 'fcedfri ï' I W/J&itóflt Fino's aJ&ffil&M}■-U Mahonit houten Kieerka»teiL>/»' I .ift .Toiletten te?eM-WaechUfels W-mct ""H"".. ' Bareaux;de ministere j • mare n Draaiorgels £KHarmonica'». Mn»ioVM®y9V -x w/-ü PapjflT* tTOiw.ïit . Prachtige. Spiegtla. en Schilderden •k I I 4?child«rij-lij«*fi% u.Lo <*'.) ■-*. Stoot# «a cm»»- der tcebehooreo (Eng./ xi fcL/jO 1/.0 »i; W Yèdrféf T *1 ""3 Potfr&ri Bibs met bijbehoorende franje» Wn «hik - 'biiAdr <v .«iutgMJi""""""""! <■""*""' x . Fijn wit Linnen en üoubJttipuTOW kaejfti *OT» >«""• ; pLlTnenJo*kdo^eD •""'* i j 'i""f' *; * * * OiMmintWfci^oSV""^!nde liif vuSi>iii/M oJyl I J Q3V»fiV'B^'Uir •' »fc™.-a w-Jffa J *i 'V«dér: .„ j^¥erJkrttgbiWff.J.:.' iÉlWÉ'ifc c2:?Sïttrab»ia! BT»AteBWtM'»HBL-IN[IE ..y^fnnp«Kditio« en aanwijiig der verandering». Jaarg. 1816/1875. "" 'i * / Vfritr iün aftonderlijk tt rfcaKMien de . f -Witst * . \ r ..f i",http://resolver.kb.nl/resolve?urn=ddd:011085793:mpeg21:a0030:ocr,5,ddd:011085793:mpeg21:p005,Soerabaijasch handelsblad,905
4032024,1881/07/04 00:00:00,3907,ddd:110583331:mpeg21:a0015,http://imageviewer.kb.nl/ImagingService/imagingService?id=ddd:110583331:mpeg21:p003:image&x=1094&y=53&w=1032&h=3907,ddd:110583331:mpeg21,2126,3960,1094,53,6,"Oade Boekhandel en Boekbiaderij van _?\ _El_ :E__E*^OOlNr> Mvilenvliet hoek Kampontr Djawa. (lOj typ _..cg g;g - g ) jyaeyo !3S C - - ""Joya<?vr> ii LEESBIBLIOTHEEK te IVoordwijlf. ui - m DAGELIJKS GEO PEND. Jfö II j. groeneveld j{s fjjjl (530) over het Ja v a-H ote 1. i|s I _ | LflO]lizntxmiii..nullimu""Uiöultniin.rii rïTö trSri «£ V GSSs&l4ê3sci'ës<iSol9tSciS?""j: Si oriöeia siseO Liet Groote Bloedzuiverings Middel! BRISTOL'S SARSAPARILLA EN PILLEN Opgericht in 1832. Gegarandeerd als een onfeiloaar geneesmiddel voor de ergste klier- en kropgezwellen hardnekkige ingewortelde Zweeren Svphiles. zoowel in het primaire secundaire als tertiaire stadium Gezwellen builen verouderde Zweeren hhumattek en alle ziekten door slecht bloed of ziekelijkheid van gestel veroorzaakt. BKbTÜL'S versuikerde pillen genezen tevens alle leverziekten. Te verkrijgen bij alle drogisten en kleinhandelaars in medieijneu. Hool'ddepöt bij EN9ELHABD k Co. tiatavta. (75) Onvergankelijke Geur O MUVRAY & LANMAN'S. PLORIDA WATER aller parl'unicjiin voor (!i. zakdoek Verkrijgbaar bM alle Parfum*"" ra Drogisten en in dttailzakcn. Hooi'd-Depui Lij ENGELHARIi & Co.- i'-üana. (54) TSCBTTE H. k S. EAU DE COLOGNE. De ondergeteekende. eeltige Fabriekant van de Echte H. Ac S. Kan <le CJolotpne geeft bij deze kennis _n het publiek dat de Hwrun ENG E L H AR D _ Co. te Batavi_ d« eunige IMPORTEUR.S v_tqja FAEHICAAT «ijn. De KISTJES dragtu behalve bet Fabriei._«rk 4_Ste«p.l/ft & g\ /V _._ *\ en tijn zegel ba —AE afdrukt (4«8) FRANgOIS MARIA FARINA Kue de la Cloche a Celogm No. -4r7lA<",http://resolver.kb.nl/resolve?urn=ddd:110583331:mpeg21:a0015:ocr,3,ddd:110583331:mpeg21:p003,Bataviaasch handelsblad,1032
3870816,1881/01/24 00:00:00,3966,ddd:010103914:mpeg21:a0012,http://imageviewer.kb.nl/ImagingService/imagingService?id=ddd:010103914:mpeg21:p003:image&x=2955&y=204&w=976&h=3966,ddd:010103914:mpeg21,3931,4170,2955,204,4,"NIEUWE SCHOUWBURG VAN LEER Plantage Fransche laan. Maandag 24 Januari. Buitengewone Afscheids en Benefiet- ■ Voorstelling van den wereldberoemden Kunstschilder SIGNOR J CARLO welke voor ditmaal jn 15 minuten zichtbaar voor het publiek eenprachtvol schilderij inolievarf zal schilderen voorstellende BE GOLF VAN NAPELS BIJT MAANLICHT j (Door het Duitsche personeel) BIE SCHONE GALA- j THEE FORTUNIO'S LIEB. Gewone prijzen. Aanv. 8 Uur. _ } ?!^Rg^_aat* Verwacht eerstdaags Buitengewone Voorstelling ] «UW»? ten voordeele van Mejuffrouw MARIANNE FEHRINGER Eerste Operettenzangeres. Eene eerste opvoering j van: BIE LETZTEN M©Ha_It.ANER Nieuwe Operette -<J in 3 bedrijyen. Muziek van Richard Genée. (Componist van der Seccadet) SCHOUWBURG FRASCATI Plantago Middellaan. Directio G. PROT & ZOON. MAANDAG 24 JANUARI IOOIE IIC0L1S! l operette in 3 bedrijven van A. Vanloo. & E. Loterrier door Sales. .Muziek vanP. Lacome. (Nooit vertoond.) Nieuwe decors van Gustave Prot & Zoon; nieuwe Costumes van A. Serné &Zn Gewone prijzen. Aanvang 8 uur. —r "" 't '■■ —- '1 SALON BES VARIÉTÉS Amstelstraat. Directie: G. PROT & ZOON. MAANDAG 24 JANUARI: ÖICK MALTON OF DE ONSCHULDIG VEROORDEELDE ( Drama in 8 tafercelen naar aanleiding van de novelle: «Lot- ! gevallen van een ontslagen Galeiboef"" door W. J. van Zuijlen en J. Speijer Klerk. Entree 8© Cts. Aanvang 8 uur. 3QT"" Dinsdag 25 Januari: FROU FROU. THEATER TIVOLI. Directie W PIERRE DE BOER. Blaandag 24 Januari (8 uur)- Gastvoorstelling van Blevr. VAN GEUTEN-BEEK (SOPHIE SPOOR.) BE ROSÉ BOIÏIO'S nieuw blijspel in 3 bedr. van dajla Cour enHennequin. EEN VROUWTJE ZONBËR 'WEERGA l blijspel met Zang in een bedrijf. Donderdag v. s. tor benefice van mevr. KEIJSSER JONATHAN. PALHs^oirmKsrajT. MAANBAG 24 JANUARI 1881. VOLKS¥OORSTELLIIS Vau DE S!VI!DSDOCHTER VAN NAARDEN. GROOT HISTORISCH BALLET door W. N. PEVPERS. Gemonteerd door den Balletmeester E. WITT. Decoratiën van J. D. G. GROOTVELD. Muziek van JOH. 81. COENEN. - Nieuwe Costumes. Entree 25 Cent. Aanvang 8 uur. Plaatsen zijn te bespreken. Tentoonstelling: der ingezonden Voorwerpen voor het SARPIIATI-MONUMENT doorloopend geopend. Binncnamstel f___fe.4 Schutsluizen bij de flwl? K°« 123. KONINKLIJK 888 NEDERL. ■ Cïfcïis Oscar Cai*ré« MAANDAG 34 JANUARI 8 uur. BR.LLANTE VOORSTELLING. Optreden der dsbuteerende Kunstenaars en Kunstenaressen. Tot slot voor de eerste maal: BDWEIUiSKAUIirnTEH. groote Arlequinade met Ballet. Dagelijks voorstelling 's avonds 8 uur. KALVERSTRAAT Ingang: BEGIJNENSTEEG 123. JOB&G & C°. KEIIIiöMTffiMAN. AMSTEJ. MAST HET CIRCUS OSCAR CARRÉ van 'smorg. 1 tot 'snamidd. 4 en 's avonds van 7 tot 2 uur. Entree 49 Cent. Kinderen 25 Cent. DE DIRECTIE.1! Café C&nt§nemtai9 (EERSTE WIENER CAFÉ.) BILJART. SARPHATISTRAAT. (TTOrrLras tegenover het Amstel-Hotel) De beroemde WIENER MELANGE is dagelijks verkrijgbaar. Specialiteit in ENGELSCHE BIEREN.",http://resolver.kb.nl/resolve?urn=ddd:010103914:mpeg21:a0012:ocr,3,ddd:010103914:mpeg21:p003,Algemeen Handelsblad,976
2547534,1881/11/05 00:00:00,2662,ddd:010101829:mpeg21:a0017,http://imageviewer.kb.nl/ImagingService/imagingService?id=ddd:010101829:mpeg21:p003:image&x=85&y=226&w=957&h=2662,ddd:010101829:mpeg21,1042,2888,85,226,8,"BANDELS- EOABÜffIiT /^^%\ den ondergeteekende FREDERIK ERNST DAMMERS Vojpj ur '* Amsterdam als bg behoorlijk geregistreerde pILLet ?9machti«d door den Heer ALBERT ISMAËL tigiju . • en Apotheker te Parijs als eenig gerech?««n».v ¥' fabrikaat BISCUITS REPARATIES (zui« ter i°-!Ses) *n andere fabrikaten van Doctor OLLITIER ï'derge]  der Arrondissementsrechtbank te Amsterdam *&at 3on ••'1?* handelsmerk waarmede bovengenoemd fabrii^nde • *'""' PrinciPilill 'n den handel wordt gebracht bee"" biiif1"" een rond cachet afgedrukt in rood lak tusschen «ven- en binnencirkel staat: «a ifhTHODE DIJ Dr' OLLIVÏER M PARIS ""et middenvlak de in elkander loopende letters D( A. F. O. Vordt v u^e 9n alyo doosjes van blik waarin het fabrikaat toorzien r ' TerPa^' 'n (?roen papier wordt in de leDgte aieh h« -Tan e*n strook geel papier aan de zijde van dewelke eene dikke en dunne zwarte rand waarop de eindil.nrt""S van OLLIVIER DE PARIS staat in een ovaal cecAÏj e 'n krullen welke strook met bovenomschreven Dej« ""j* verzegeld IN ROOD LAK. 25 U»; ?|?derlegglng geschiedt ter voldoening aan de Wet van *M 1880 SM. u\ 85. f.0„x W. E. DAMMERS Procureur. v ÏHLBHMfI DUWAÏN. *UlleAlï VIIJMM * HEUKEKSFELDT Makelaars dinsdag- 8 en Woensdag: 9 h Wovember 1881 tet *InSenoemd Lokaal aan den Singel bü de Paleisstraat Ye*kon rBtaa"" Tan de Notarissen EOUFFAEK en MARIENS UoPen: eene groote partij moderne in . nraußEijinv katii«f8c'I1''lïnde fijne Houtsoorten bewerkt en waarbij Slaap- BnffiJ^neublement Ledckanten  Linnen- en Boekenkasten Thee? ' Kapspiegels Bonheurs do Jour Schrijftafels Eet- Allea~ ®o Salontafels Werktafeltjcs enz.; Canapés en Stoelen. ""fkomstig van de Magazijnen van de Heeren M H. F. JANSEN & ZONEN bejj0'I'wordende ten gevolge van den plaats gehad heb""'hou f aDd I"" do Bozenbnomsteeg alhier. Voorts eenige *H C tendo Pendules Kandelabers Zaal- en Kamerspiegols jOTJrnamenten. ■Sm/.» Notitie is a 10 ccr-ts voor de armen aan het Lokaal de £an te bekomen. Ö^JKDAGEN: ZATERDAG te voren particulier. ZON- K^^nMAANDAG publiek van 10 tot 3Va uur. (41977)",http://resolver.kb.nl/resolve?urn=ddd:010101829:mpeg21:a0017:ocr,3,ddd:010101829:mpeg21:p003,Algemeen Handelsblad,957
2229694,1881/05/18 00:00:00,2146,MMKB08:000154956:mpeg21:a0016,http://imageviewer.kb.nl/ImagingService/imagingService?id=MMKB08:000154956:mpeg21:p004:image&x=1136&y=1957&w=1039&h=2146,MMKB08:000154956:mpeg21,2175,4103,1136,1957,4,"Advertentie VERHUISD: van de Westerdwarsstraat naar de Buitenwatersloot Jfo. 205 J. VAN DER KAADM Gz. Huisschilder. Wegens sterfgeval finale uitverkoop lot den 20 dezer maand ver beneden fabrieksprijs van eene groote partij Dames-e. Kinderschoenen MANS- & VROUWEHP £ NTOFFELS behoorende tot den boedel van wijlen den lieer BAJL.AES genaamd BOUSSU in de Papenstraat n°. 2 alhier. Die vau dien boedel nog iets te vorderen hebben of daaraan verschuldigd zijn worden verzocht vóór dien datum opgave of betaling te doen ten kantore van den Notaris Mr. J. S. VAN VRIJBERGHE DE CONINGH te Delft. Te koop: groote volslagen TWEE-SLAAFS VEEREN BEDDEN met Peluw en Iiussens ƒ40 dito kleiner soort  . » 35 dito mindere qualiteit . . . . . « 15 Crin Végétal Bedden « 12 Zeegras dito ""8 KLUS Verversdijk 19. Nederlandsche GIST- EN SPIRITUSFABRIEK. SPOELING. De prijs der SPOEIilK® is Woensdag 18 Mei ƒ 080. — De prijs voor Donderdag 19 Mei zal des morgeus aan de Fabriek worden bekend gemaakt. De Directeur J. C. VAN MARKEN Ju.",http://resolver.kb.nl/resolve?urn=MMKB08:000154956:mpeg21:a0016:ocr,4,MMKB08:000154956:mpeg21:p004,Delftsche courant,1039
4188156,1881/09/30 00:00:00,4098,ddd:010497501:mpeg21:a0035,http://imageviewer.kb.nl/ImagingService/imagingService?id=ddd:010497501:mpeg21:p004:image&x=3096&y=93&w=1022&h=4098,ddd:010497501:mpeg21,4118,4191,3096,93,6,"Dr. Dominicus is VEMTJISD naar MOLENYLIET-OOST 2de huis van ; de WEESKAMER. 4496 y». Hen die iets te vorderen hebben van of versehul_Cjl> digd zijn aan den boedel van wijlen den Heer C. M J. Keoemek gelieven binnen een maand opgaven of betalingen te doen aan: Den gemachtigde van de executrice testamentair J. SCHEURLEER.  Djocjocabta 26 September 1881. 4495 dTheer lautier gewezen beheerder van de Toko van den Heer TAR* BOURICH toebehoorende aan den Heer DUFFOJRC kleermaker heeft de eer bekend te maken dat hij met le October a. s te Passar Sentn in het gebouw < vroeger geoccupeerd door de firma AHRENS * Co een kapperswinkel zal opecen. Prijzen zijn de navolgende; Voor het HAARSNIJDEN alleen / 0.50. „ „ SCHOONMAKEN van het hoofd » 0.85. Abonnementen voor het HAARSNIJDEN en SCHEEREN enz. per maand f 4.— POSTICHES in groote verscheidenheid. Het opmaken van VLECHTEN / 2.60. PARFUMEKIEN van de beste merken. BORSTELWERK HAARKAMMEN SCHEERMESSEN enz  tegen zeer billijke prijzen. 4451 SCHULDEISCHERS en AANDEELHOUDERS van de vroegere vereeniging .UeilOOgen z'_ Ons doel"" te 1 Oeloe Merak worden verzoekt hunne vorderingen en aandeelen voor 15 October 1881 franco aan ondergeteekende toetezendeo daar op dien datum de zaken der sinds lang uitgestorven vereeniging sullen worden vereffend. J. DE BOOIJ 4493 Eerstaanw. Ing te Mon-k. Crediteuren in den boedel van wijlen M. DEMETRIUS overleden te Cheribon op 80 Augustus 1880 worden uitgenoodigd om io persoon oF iemand daartoe gemachtigd op Dinsdag 11 October 1881 ten overstaan van den fungerend Notaris J. H. W. GRAAF VAN DEN BOSCH te Koeningan (Res. Cheribon) inzage te nemen van de rekening en verantwoording van boyengenoemden boedel. Wed. M. DEMETRIUS Oalistan. Cheuibon 86 September 1881. 4488 Attentie s. v. pi.! Een Ambachtsman jaufait in IJZER- en HOUTWERKZAAMHEDEN het voeren van ADMINISTRATIE en verder alles wat tot het SMID - en TIMMERMANSVAK behoort zoett plaatsing. 4428 Adres: H. P. bureau Indisch Vaderland Samarang. Bij EEN ONDEBWUZEIt in de nabijheid van het GIJMNASIUM W. 111. bestaat gelegenheid tot KOST en INWONING voor een of twee LEERLINGEN aan goenoemde school. Brieven franco onder letter C. aan de Boekhandelaren VISBER k Co. 4478 Te Koop: Twee tearhouwen. Adres: inlander ENDER nabij Djembatan Mera Goenoeng Sarie. 4469 Te koop: Een prachtige Europeesche Hond Te bevragen MARINE HOTEL kamer No. 27. 4478 iTE HUIfU: Een HUIS c aan de DEFENSIELIJN VAN DEN BOSCH. 1897 \ Adres: VAN GENT Goenong Sarie.",http://resolver.kb.nl/resolve?urn=ddd:010497501:mpeg21:a0035:ocr,4,ddd:010497501:mpeg21:p004,"Java-bode : nieuws, handels- en advertentieblad voor Nederlandsch-Indie",1022
3052845,1881/11/29 00:00:00,3411,ddd:011086021:mpeg21:a0023,http://imageviewer.kb.nl/ImagingService/imagingService?id=ddd:011086021:mpeg21:p004:image&x=3749&y=3269&w=895&h=3411,ddd:011086021:mpeg21,4644,6680,3749,3269,6,ürcote sortering van het nieuwste soort Speelgoed. Hobbel duw trek en Stokpaarden. Vclocipèiles en duwwagens. Krui wapens en Tuingereedschappen Bromtollen en Melkkurren. Tramwaijs en Spoorwagens. Circuß a la VVilson. Poedelhonden en Geiten (geluidgevend). Naar de laatste smaak geklecde Poppen. Groote sortering Badpoppen met en zonder haar. Badkuipen en Poppenwagens. Elegante doozen met Poppen met garde robe. Geweren Sabelt Trompetten en trommels. Springtouwen en Werpspelen. Buss. Billarten en andere spelen Arke Noach Blokdoozen. Fröbels methodes: Kegeldoozen. Zeer groote Yerwdoozen en Legdoozen. Doozen met elegante Meubels. Eet- en Theeserviesje!» Fornuisen. Groots Keukens Stallen Kamers Pakhuizen en Badkamers. Doozen met blikken Speelgoed enz. enz. Tokohouders genieten en groot Rabat 4)02 LADAN & C°. ONTVINGEN^ Een factuur overheerlijke iiolL SIGABEN waaronder do zeer gewilde: UPMANN. G ENER \AL PEL. EBIKA. LA DIOSA. 4103 NOG- OJNTVIJMO-lEJJM: nasaa a ea. De zeer gewilde echt Jouvin glacé handschoenen met 1 2 3 en 6 knoopjes tegen concurrereende prijzen. Mitaines in verschillende kleuren Zeer' sterke Ilecren en Jongen» Sokken. Geripte Meisjes kousen. id en a Jour Kinder sokjes. Fil d'Ecoïse en a Jour D'mes Kousen. H-.ercn Vlccschkleurige Borstrokken en Pantalon* met ' voetstukken. Hecren Flanellen onderhemden. Groote sorteering extra fijne hceren overhemden met Linnen borsten t-n Manchetten. Echte Singer en Saxonia Naaimachines met elecrante Kastjes. 4104 ©Ü SWASBïtt LADAN. & CO. Echte Saccoma-naaima' | clunes «nnkurreeiende priiien met GAUANTIE ' Af » •' i. >'1 ■ *,http://resolver.kb.nl/resolve?urn=ddd:011086021:mpeg21:a0023:ocr,4,ddd:011086021:mpeg21:p004,Soerabaijasch handelsblad,895
2999220,1881/07/06 00:00:00,3860,ddd:011007082:mpeg21:a0042,http://imageviewer.kb.nl/ImagingService/imagingService?id=ddd:011007082:mpeg21:p004:image&x=3335&y=181&w=777&h=3860,ddd:011007082:mpeg21,4112,4041,3335,181,4,"De Haagsefee Margariiiev' :jp '% Boter-Fabriek y/s^S levert prima ?*' liteit v -rJ/C Alleen"" prim qnalite!<- V* deponeerde M»| ;V;>*-^^i«^>»/rabrieksmerk .in^b^T~sl j£gs2 Boter.; <•. ;.. | ggpft] Agent voor Rotterdam W.H.V. LEEUWEN""' Haringvliet 52.' v 10211 HUWELIJKS CIRCULAIRES ™n .f /""1.50 tot ƒ5 pèr 100. Modellen ter inzage. Het adres is: Snolpersdrukkerij van JAN HEUEBS. Wijnsstraat 136. ;.'■;■■ •.•■ .;.--■ «14917 [•LIEFHEBBERS van Toio- en Plantkunde. ' : ■ ■;. „ Extra Koopje. ... t I.' Dr. MORITZ WILLKOMM Atlas voor de - Plantkunde . met 400 afbeeldingen op 31 prachtige platen oblong folio formaat met vorklarenden tekst bewerkt door Dr. D. J. COSTER. In plaats ƒ 4.50 voor slechts ƒ 1.75. '~.. '.'.-""'-' 2. Het prachtige boek van WITTE. In 't Lommer. Een en ander over Boomen Gras Bloemen Vergiftige Windende en Klimmende Planten Onkruid enz. enz. Dat „Een en ander"" bevat ruim 400 blz. druks. Dat „Een en ander"" is geschreven  met talent tot lezen dwingende zelfs voor de oningewijden. Dat' „Een en ander"" bevat veel schoons en veel nuttigs. In plaats ƒ 8.90 voor slechts ƒ 1.35. - 3. HEINRICH HEIN. Het drogen en verven van bloemen en gras» sen tot vervaardiging van gedroogde bouquetten. In plaats ƒ 0.55 voor ƒ 0.30. Deze drie fraaie Werken te zamen genomen voor slechts ƒ 5.90 is plaats f 835. Op. den te zenden postwissel te zetten 3 werken voor Tuin- en Plantkunde ontvangt men die direct franco van GEBRs. E. «$s 3ML COHEN Magazijnen van Goedkoope Boeken te Arnhem of te Nijmegen. FEESTGEBOUW. .. Directie ALBERT DE LEUR. (No. 25 van het Abonnement) WOENSDAG 6y JULI 1881: Das Orientalisclie Fest Grosses phantastisches Ballet in 1 Act tod OTTO THD3ME. Mnsik von verschiedenen Componisten. d WACHTER""^ Chansonnettenzangeres. . Eerste optreden van M. BRAHIM BEN liAHOTJSSIR the African wonder from Sanger's great royal English Circus. Eerste optreden van Signor PELUCCHI en Signora GALLI Italiaansche duettisten. En verdere medewerking van nieuwe Artisten. Aanvang 'Sl/» uur- : Entree f 0.49. Abonnement tot. ultimo April 1882 vooi een Heer en Dame f ÏO. ''*■-■ >v Abonnementskaarten en Diploma's geldig. TOEGANGSKAARTEN voor bovengenoemde voorstelling zijn verkrijgbaar aan alle Kiosken en aan de Inrichting voor publiciteit Hoogstraat hoek Spoorwegviaduct tegen denzelfden prijs als aan het Peestgebouw • maar wordt gemakshalve daaraan kosteloos toegevoegd een Tramkaartje. .-■.;",http://resolver.kb.nl/resolve?urn=ddd:011007082:mpeg21:a0042:ocr,4,ddd:011007082:mpeg21:p004,Rotterdamsch nieuwsblad,777
4605085,1881/03/08 00:00:00,5066,ddd:010063352:mpeg21:a0026,http://imageviewer.kb.nl/ImagingService/imagingService?id=ddd:010063352:mpeg21:p008:image&x=633&y=164&w=1136&h=5066,ddd:010063352:mpeg21,1769,5230,633,164,8,"Dankbetuiging. De Ondergeteekenden achten zich tot plicht hunnen oprechten en innigen dank te betuigen voor de hartelijke en onbekrompen wijze waarop de gedenkwaardige dag der 50-jarige Echtvereeniging door onze Ouders is herdacht en verder in het algemeen aan allen zoowel hier als elders die van hunne belangstelling hebhen blijk gegeven. P. KONING. B. KONING—BRINKMAN. Jb. KOOIJ. T. KOOIJ—BRINKMAN. S. KATER. N. KATER-BRINKMAN. Schagerwaard gem. Haringcarspel. Voor de vele bewijzen van deelneming zoo van hier als van elders ontvangen bij het overlijden van mijne geliefde Zuster M. J. L. TERHOEVEN betuig ik mijnen hartelijken dank. AV. E. TERHOEVEN. 'sGraveland 4 Maart '81. (1923) Voor de vele bewijzen van deelneming ondervonden bij onze Vijf-en-twintigjarige Echtvereeniging betuigen wij door dezen onzen hartelijken^dank. J. VAN WILLES en Echtgenoote. Voor de vele bewijzen van deelneming en belangstelling ondervonden bij het overlijden van onzen geliefden ' Vader en Behuwdvader den lieer G. .1. VAN HOOLWERFF betuig ik ook namens de familie den lïartelijksten dank. G. H. VAN HOOLWERFF. Hoorn 4 Maart 1881. (2010) Voor de vele en hartelijke bewijzen van deelneming ondervonden bij het overlijden van mijnen geliefden Echtgenoot betuig ik ook namens mijne Kinderen mijnen oprechten dank. AVed. M. J. RAADMAN— OOSTMEIJER. Almelo 6 Maart 1881. Voor de bewijzen van belangstelling ondervonden bij de geboorte onzer Dochter betuigen wij onzen hartelijken dank. Nieuwer-Amstel 7 Maart. Fr. DEKKER. M. C. DEKKER—JACOBS. Visite wordt afgewaclit Donderdag 10 Maart. Voor de vele bewijzen van deelneming ondervonden bij het overlijden onzer geliefde Moeder en Behüwdmoeder'Mejuffrouw CATHARINA 808. Wed. den Heer SIMON MOLL betuigen de Kinderen en Behuwdkinderen hunnen hartelijken en welmeenenden dank. Tiel 5 Maart 1831. Voor de vele blijken van belangstelling zoo van hier als van elders ondervonden bij het overlijden van onze Dochter betuigen wij door deze onzen hartelijken dank. B. F. REUTER. M. REüTER-BLOKHÜIS. Kujdrecht 8 Maart 1881. Voor de vele bewijzen van deelneming bij het overlijden van onze geliefde Moeder en Behüwdmoeder Gr. VAN DER MOLEN Wed. P. C. KOS betuigen wij onzen innigen dank. (2065) CORN. KOS Pz. M. KOS—DE GRAAF. W&lder l 5 Maart 1881. Da Heer en Mevrouw TEDING VAN BERKHOUT—DES TOMBE betuigen hun dank voor de bewijzen van belangstelling bij de geboorte hunner Dochter ondervonden. Haarlem 28 Febr. 1881. (1985) Öe Heer en Mevrouw WERTHEIM—HERTZVELD betuigen hunnen hartelijken dank voor de vele bewijzen van belangstelling ondervonden bij de geboorte hunner Dochter. Wageningen 7 Maart 1881. "" FEESTVIERIM van 18 Februari 1881. De Ondergeteekenden penningmeesters van bovengenoemde Feestviering verzoeken allen die nog iets verschuldigd zijn aan of te vorderen hebben van het Comité van Uitvoering zoowel als van de Sub-Commissies daarvan opgave te doen voor 12 Maart e. k. aan het adres van den eerst ondergeteekende Voudelstraat No. 2. C. E. DE BORDES. JOAN 11. SCHMITZ. Bij akte op den lsten Maart 1881 voor den Notaris C. VAN OLST Jr. 'te Amsterdam verleden is tusschen de Heeren JACOB HENDRIKS Wijnhandelaar wonende te Amsterdam en JOHANNES JOSEPHUS HERENS Wijnhandelaar wonende te 's Gravenhage eene Vennootschap aangegaan ten doel hebbende om den Handel in Wijnen door den Heer JACOB HENDRIKS onder de Firma «Weduwe KORFF & Co.« uitgeoefend voor gemeenschappelijke rekening onder die firma voort te zetten. Deze Vennootschap is gevestigd te Amsterdam en te 's Gravenhage heeft aanvang genomen 1 Februari 1881 en is aangegaan voor onbepaalden tijd. Beide vennooten zijn gerechtigd de firma te teekenen doch alleen voor zaken de Vennootschap direct aangaande en tot geen ander einde hoegenaamd. Het Vaderland van 24 Februari deelde mede: Het is bekend dat de GEBRs. COHEN te Nijmegen en Arnhem van tijd tot tijd tal van meerendeels uitstekende zoowel Letterkundige als Wetenschappelijke ""Werken voor geringen prijs te koop aanbieden; menigeen die zich anders het genot van het aanschaffen van zulke Werken moest ontzeggen werd daardoor in de gelegenheid gesteld aan zijn kooplust te voldoen. Thans zijn de GEBRs. COHEN Eigenaars geworden van een Prachtwerk zooais er tot heden weinig in Nederland worden uitgegeven namelijk de Dichtwerken van BERNARD TER HAAR in twee fraaie Banden voor ƒ12.50 met teekeningen van ISRAËLS ROCHUSSEN VAN BORSELEN enz. De in dit nummer voorkomende Adverlentie deelt nadere bijzonderheden mêe. Wij houden ons overtuigd dat velen van deze gunstige gelegenheid gebruik zullen maken. Aan deze uitgave werd indertijd noch zorg noch kosten gespaard. (2073) Twee Civiel Ingenieurs of twee bekwame Opzichters kunnen tijdelijk geplaatst worden bij den Provincialen Waterstaat in Drenthe voor Terrein- en Bureauwerk. Gegadigden vervoegen zich zoo spoedig mogelijk in persoon of met franco brieven en met overlegging van hunne Certi- . ficaten op het Bureau van den Provincialen Ingenieur van Drenthe te Assen. Op een nette Sigarenfabriek wordt plaatsing gezocht voor een fatsoenlijk Jongeling 18 jaar oud. reeds 2 jaar in het vak werkzaam. Reflecteerenden gelieven te adresseeren lett. B bij den Boekh. C. E. HUETINK te Amersfoort. HOENDEBPARK. Een Jongmensch van fatsoenlijke familie P. G. Ongehuwd zoekt iemand met eenig kapitaal en genegen met hem een Hoenderpark op te richten of hem als Directeur daarover aan te stellen. Adres fr0. lett. VP Nieuws v/d Dag Onderwijzeressen. Aan de Openbare Lagere School te Noordwijk-binnen worden ten spoedigste gevraagd: Twee Onderwijzeressen ook voor de Nuttige Handwerken. NB. Het bezit eener speciale akte voor de Nuttige Handwerken is geen vereischte. Jaarwedde ƒ 600. Stukken in te zenden aan den Burgemeester van Noordwijk (Z.-H.). (2053) Aan cle Openbare School te 's Graveland wordt gevraagd eene llulpondepwijzeres met Akte voor Nuttige Handwerken op eene jaarwedde van ƒ 600. Op zegel geschreven aanvragen worden ingewacht bij den Burgem. Wordt gevraagd aan de Openb. Lagere School te Scherpenzeel (Gelderl.) eene Onderwijzeres met akte voor Nuttige Handwerken op eene jaarwedde van ƒ 500. Brieven franco aan den Burgemeester dier gemeente. Keukenmeid. In een klein deftig gezin te Weesp wordt met Mei a. s. verlangd tegen hoog loon eene alleszins bekwame Keukenmeid van den P. G. van goede getuigen voorzien. Adres met franco brieven onder letters S W. bijden Boekhandelaar J. C. SCHR'ÖDKR Kalverstraat 174.",http://resolver.kb.nl/resolve?urn=ddd:010063352:mpeg21:a0026:ocr,8,ddd:010063352:mpeg21:p008,Het nieuws van den dag : kleine courant,1136
1849428,1881/03/18 00:00:00,2583,ddd:010265721:mpeg21:a0045,http://imageviewer.kb.nl/ImagingService/imagingService?id=ddd:010265721:mpeg21:p004:image&x=2303&y=120&w=716&h=2583,ddd:010265721:mpeg21,3019,2703,2303,120,6,WAARSCHUWING. - Door noodzakelijke vertimmering aan het huis Nieuwendijk 128 over de Oudebrugsteeg waardoor alle Goederen eenige weken uit den Winkel moeten ontruimd worden worden alle voorhanden Galanterieën en Bijouterieën ook Letle_waren tot eiken prijs verkocht. De verkoop voor dat doel begint van af heden tot § April a. s. (2049) Nieuwendijk 128. SI. «. KACKS. Een Geldersche Dienstbode R. K. biedt zich tegen Mei aan voor WERKof KEUKENMEID van beide betrekkingen de beste getuigen kunnende overleggen. Franco brieven onder lett. A. *~ Hulpkantoor Breukelen. (2095) Een jonge Duitsche. 17 jaar oud bekend met de moderne talen sedert eenigen tijd ep een kantoor werkzaam zoekt plaatsing als LEERLINfi in een Manufactuurzaak of op een Kantoor. Adres met franco brieven lett. ___~ bij den Boekhandelaar J. M. W. Waanders Rotterdam. (2096) Winkeldochter gevraagd. Tegen Mei a. s. wordt gevraagd in een Grutterswinkel een fatsoenlijke WINKELDOCHTER van goede getuigen voorzien. Franco brieven onder lett. H. 8. bij den Boekh.J. S. de Haas Paleisstraat 14. (2104) Op een Buiten in den omtrek van Driebergen wordt gevraagd een SHeid-aUëeo R- K. goed kunnende koken en huiswerk verrichten ouderdom 35 a 40 jaren. Loon naar bekwaamheid. Zonder goede getuigen onnoodig zich aan te melden. Brieven franco onder _¥« 9 Bureau de/er C_u_-n_ (2093) Te Hunr pvraanfl plüsiqinns f3OO bij R. K. Lieden een Ongemeiibileerde VOORKAMER benevens een Zolder ol andere Kamer. Aires met franco brieven N° 24|73 Bureau 3e__r Courant. (2072),http://resolver.kb.nl/resolve?urn=ddd:010265721:mpeg21:a0045:ocr,4,ddd:010265721:mpeg21:p004,De Tĳd : godsdienstig-staatkundig dagblad,716
3306967,1881/02/01 00:00:00,3337,ddd:010497612:mpeg21:a0027,http://imageviewer.kb.nl/ImagingService/imagingService?id=ddd:010497612:mpeg21:p004:image&x=74&y=2683&w=991&h=3337,ddd:010497612:mpeg21,1065,6020,74,2683,6,"Nieuwste Kinderwerkjes. Aimard De kaperkapitein 2 dln. ia rood lianen prachtband ƒ 7.50 Cella Drie in een vertellingen geb. . <« 2.50 Aflt L. de Rop De knop van den wandelstok geb. » 3.— Bulwer Harold de laatste der Saksische koningen * 3.— Idem Naoht en morgen . . • • » 3.— Melati van Java Kijkjes in onze Oost met 8 gekleurde platen ' '5n P. Louwerse Bello een hondenleven . . » 1.50 'B. ter Haar Bz. Bijkdom en Armoede . 1.60 Vernet De levensloop vaa een paard . . 1.50 Agatha Kleine Bengels . . . . » LJO Panny Willemine en hare tweede moeder . r —.75 Idem Het vogelnestje . . . • » — .75 Idem Vaders verjaardag .  . . * —«75 Idem Willems straf » —-75 Idem Sint-Nicolaasavond . . _ . . » — .75 Idem De geschiedenis van eene bij . . « —.75 Buiten Batavia met verhooging van port. $348 H. M. VAN DORP k Co. BUITENGEWOON GOEDKOOPE AANBIEDING OSZB WOONPLAATS Isa lootbookjo voor de middelst» klasse ƒ — .»5 Looistof voor ds vorstgevorderde iMrliagsa. . „ — .»6 T-mQOSÏ en M LOOS Leerkoek der schoikande. lo dt«l Niot-motslt*. . „ I.— 2* „ Mtuloi I.— Beido deslw goismeatlijk 1.50 Dr BOSSCHA Leerboek der Hstnarkaads 4» al. S« st. „ —.75 TEIBXET Choi» ds leetnns ot do diotéo» Fr_j__a_ses. M —.75 IDt latrstioas (uniliors . » 1-— MAATJES Beemeil littéraire *•— PLOETZ Maaul de la littérataro ?raay__t> 8 v«L .. 7.— MEIDIHGEI Heogdnitsche •pnskkaast. . . » l-*0 MULLEX Hoogdvitiche ipnakkust le deel. . „ I.— £D.t id. id. *» dool. . „ I.— JABSSX-VS YoUstindiger Cmsbs dor Heokdoatsekoa sokrift. . • • • » -|0 MAATJES fcgolteko vertsaloefeHiagea. -•— Baitea Batavia met vorfcoogiag van port. un% H. M. TAM DORP h Co. _■_«_-—^^^^mmmmmm_.____--——__.___———•—. Oeldloterlien VEBZOBGD.GS GESTICHT te SOERAKABTA en MABINE SOCIËTEIT sMODDERLUST"" te Soeraiaia Protestaatsch Weeshuis te Soerabaia en Djatiegesticht te Batavia. Batav. Schouwburg en Prot. Weeshuis te Semarang. LOTEN l f io.— Contant. i 10.20 * franco en aangeteekend per post H. M. VAN DORP fc Co. m.____.____^mmWmmm—ml*mmmm^^-mm^-^-*.~^*~~*-*~^-™m-m--m**^-^*mÊ Bestellingen worden aangenomen op The Australasian Sketcher een prachtig geillnstreerd weekblad. Jaarlijks 58 nummers inclusief alle supplementen per jaargang f 85.— The Illustrated Sydney News and NEW SOUTH WALES AGBICULTUBIST and GBAZIER. Jaarlijks 18 nummers per jaargang f 20.*- Een paar nummers ligg»? tei «""ge. ft JJ P . &M. VAN DOBP fc Co.",http://resolver.kb.nl/resolve?urn=ddd:010497612:mpeg21:a0027:ocr,4,ddd:010497612:mpeg21:p004,"Java-bode : nieuws, handels- en advertentieblad voor Nederlandsch-Indie",991
2963318,1881/10/04 00:00:00,2833,ddd:011102832:mpeg21:a0022,http://imageviewer.kb.nl/ImagingService/imagingService?id=ddd:011102832:mpeg21:p004:image&x=3077&y=77&w=1046&h=2833,ddd:011102832:mpeg21,4123,2910,3077,77,6,"BEKENDMAKING. De Neri.lnd. Stoom vaart-ülaatscliapirtf maakt t het reizend publiek •'andermaal bekend'■•oat Pasiagicrigoed steeds moet - vooriien rijn' viin dennaam des elgeiiaars' en 'der'bestem* ■nlngsplaals cn zooveel mogelijk ' een dag1 voor liet vertrek aan boord'dient bezorgd te \vo(den\ opdat de stuurman er re(u over kunne afgeven. Wordt aan het bovenstaande niet voldaan;: dan kan de Maatschappij zich ingeval van. wegraking .nimmer voor schadevergoeding aansprakelijk stellen. De Marine Suf er-lntendent der Ned.-lnd. Stoomvaart Maatschappij (176) It. C. I)E JOIQ. c' Tve ondergeteekenden AGENTEN fler - IMPERIAL FIRE INSURANCE COMPANY te Londen. /-.ai • :.! Ti f: ;;u; ; ; VERZEKERING-MAAfSCHAPPIJ te Amsterdam ■ • ..;>>?* .v- KOLONIALE ZEE- EN BR AND-ASSURANTIEMAATSCHAPPIJ te Batavia . -L. ZEE EN BRAND ASSURANTIE-MAATSCHAPPIJ „DE OOSTERL I N G 7 te Batacia i i » BRAND-A>SURANTIE-MAATSCHAPPIJ „INSULINDE"" le Batavia zijn gemachtigd tol het aanemen van ASSURANTIE op STEEiNEN GEBOUWEN met PANNEN gedekt op HOUTEN GEBOUWEN met ATAP gedekt en de daarin geborgen GOEDEREN; alsmede tot het sluiten van ZEE-VERZEKERINGEN. V % - —j. f: VAN LEEUWEN & Co. (1244 j Padang. DIEMONT & G°. :'PADANG. V ' '' en Prauwraart van Padang naar de Reede en Foeloe-Pisang en omgekeerd. Agentschap Stoomvaart Maatschappij „Ne derland"". / Agentschap der beide te Zatphea gevestigde Assaraatie-Maatschap> pijen tegen brandschade. (620) NED.-IND. LEVENSVERZEKERING EN LIJFRENTE MAATSCHAPPIJ. "" Deze Maatschappij is steeds bereid tot het. aangaan van KONTRAKTEN van LEVENSVERZEKERING en LIJFRENTE. Tarieven Inlichtingen en Blankoos voor aanvragen van verschillende takken van verzekering alsmede voor gezondheids- en andere 'verklaringen -rijn-bij den Heer F. L. Slaterus Agent'' (Correspondent/ie Padang als ook op het Hoofdkantoor te Batavia óp franko aanvraag veikrijgbaar. •':.\; \' </. * .V; De Maatschappij voornoemd: (1004) E. DOUWES DEKKER Dirtkleur. •",http://resolver.kb.nl/resolve?urn=ddd:011102832:mpeg21:a0022:ocr,4,ddd:011102832:mpeg21:p004,Sumatra-courant : nieuws- en advertentieblad,1046
6082005,1881/12/15 00:00:00,4209,ddd:010266095:mpeg21:a0048,http://imageviewer.kb.nl/ImagingService/imagingService?id=ddd:010266095:mpeg21:p004:image&x=3022&y=1591&w=1445&h=4209,ddd:010266095:mpeg21,4467,5800,3022,1591,4,"GROOTE OPRMN6 TOT SPOTPRIJZEN*' VAN ALLE VOORHANDEN ARTIKELEN wegens vergevorderd seizoen. HESUIERS «ft WEIXMANHr Nieuwendijk heek Vrouwensieeg 169-171. NB. Waarbij nog een prachtige collectie WINTER- e» RECJENMANTEI.S. (8747) Specialiteit in het maken van élégante en moderne HËEREN-OVERHEMDEN op maat. let volmaakt goed passen wordt onder alle omstandigheden gewaarborgd. (87/>5) Amsterdam Eokin 164. WEGENS VERTIIüIERINe ~ o* contant te beginnen DSKDERDAG 15 OECEË3EB. ™ niiÉileii lIEWEIDIII. ' Groate laai „D'BEELYIICK"" Singel over .de Maant. VRIJDAG ZATERBAS en ZONDAG IS 17 en 13 DECEMBER des avonds 8 uur: 1. BE OTBMKEMHEMÈIv. De loop der ZON MAAN der AARDE en overige Planeten door h Hemelruim —de wenteling der aarde om hare as — volle en nieuwe maan eb vloed en springgetijden — de jaargetijden — hemelgtoepen of sterre beelden aan het uitspansel — enz. enz. in ongeveer 30 deels beweegbar Sideraal lichtbeelden met voor ieder duidelijke en bevattelijke verklaring. 2 Te zien en door het geheele Lokaal te hooren de groote de zich zelf regelende PHONOCURAAF. Toegangsprijs 99 Gt (8744) MA JU. lO l>eelen de mooiste Boeken voor ƒ1.95. Prachtige Roeken allen niet gekleurde Platen. lO Beelen te zamen voor ƒ1.95 franco. VERBAZEND WAREN OE AANVRAGEN om de tien mooie Doeken. Wij kunnen geen enkel stel meer leveren. MAAR TER VERGOEDING hebben wij thans een nieuw stel vau 10 dcc'en prachtige Boeken voor slechts ƒ1.95. Bedenkt u niet en laat ze spoedig komen. Ze zijn spotprijs en ge kunt ze in handen geven aan groeten en kleinen? 't zijn boeken voor eiken leeftijd. i. Reizen en Avonturen van Robinson. t>. Hendrik van Eichenfels of de won-2. Préciosa. Het Zigeunermeisje. derbare wegen Gods. 3. Rosa van Dennenburg. Zegepraal der 7. Jozef Zwartmantel.het Huzarenkind. Kinderliefde. 8. De Goudsmid van Parijs. 4. Geschiedenis der schoone Hirianda. 9. Willem Teil of de eedgenooten van 5. Kaatje van Heilbron en Frederik von den Rmli. Stralenburg. 40. Avonturen in den Nieuwjaarsnacht. Al deze 10 deelen zien er prachtig uit met fraai gekleurde platen elk deel in keurigen omslag. Men zende een Postwissel van ƒ1.95 waarop staat: 10 nieuwe deelen en de toezending geschiedt onmiddellijk franco overal heen door GEBR. E. & fifi. GOHES Maarazijnen van Goedkoope Boeken te Arnhem en te Nijmegen. (g7ü4)",http://resolver.kb.nl/resolve?urn=ddd:010266095:mpeg21:a0048:ocr,4,ddd:010266095:mpeg21:p004,De Tĳd : godsdienstig-staatkundig dagblad,1445
5294616,1881/05/08 00:00:00,2732,ddd:010104015:mpeg21:a0028,http://imageviewer.kb.nl/ImagingService/imagingService?id=ddd:010104015:mpeg21:p004:image&x=56&y=4166&w=1938&h=2732,ddd:010104015:mpeg21,1994,6898,56,4166,10,"Onder onze mime sorteering van allerhande TOILET-ARTIKELEN bevelen wy IsÉjzojii.er aan: DE ECHTE TANDZEEP van Dr. SUIN DE BOUTEMABD; zij maakt de Tanden zuiver wit zonder het émail aan te doen bewaart ze voor ziekelijke aandoeningen en houdt den mond frisch. Het stuk kost 40 Cts. en is toereikende voor een half jaar. DE ECHTE De. RORCHARDT'.s ZEEP is samengesteld nit fijns aromatische en etherische OliSa en delfstoffelijke bestanddeelen verwijdert puisten schubben lovervlekken zonnebrand sproeten en geeft aan do Huid door alïe jaargetijden dat fluweelige veerkraentigo en frissclio voorkomen dat de schoonheid zoo zoer verhoogt. Men gebruikt ze met een wollen lapje waarmede men de hnid een of tweemaal daags wascht. De prijs is 40 Cents. GEBRs. LEDER'S BALSASBISCHË AARDNOOT-OLaE-ZEEP die de huid reinigt zonder stramming en veroorzaken haar zachtheid en lenigheid geeft en voor den invloed der weêrsveranderingen beveiligt ala koude hitto Wind ena. Hot stuk kost 20 Cents. Dr. RARTÜNÖ'S H.RIIIDENPDMMADE versterkt den groei van het haar en werkt zoo voordeelig dat de laatste levenskiem in den knobbel wodor ontwikkeld wordt on oen nieuwe wasdom begint. Zij verhindert het uitvallen en ontijdig grijs worden maakt het krachtig glanzend en golvend. Het glazen potje is 75 Cents. DE KINA-OLIE van Dr. HARTÜNG werkt zeer weldadig op het haar en is vooral bij kinderen zeer nuttig daar zij het buitengewoon dicht en fijn als zijde maakt. Aan den baard geeft zi] oene zachte buigzaamheid terwijl zij zich bijzonder onder"" ocheidt door do eigenschap dat zijaan de haren een schoonen glans te geven. De flacon kost 75 Cents. Dn. BERINGUMER _ AROMATISCHE KRONENGEIST een van de nieuwste producten der Scheikunde is een kostelijk opwekkend en versterkend Reuk- en Waschwater. De flacon f 1. Dn. BERINGUIER's I_RXïJTER-W__IZEL ©EL tot onderhouding en verfraaiing van het Hoofd- en Baardhaar. Pr ijs per flacon 60 Cents. (18497)> VEKKOÖPHWS ca de bekende Depots. SfFISDAI TUIT TC Al SJPI f_S iAL ! OL 1 L ALiflE.LU|lj^^^ I STOOMVERVERM van Wollen en Halfwollen Zijden en Halfzijden Japonnen Gordijnen Trijpt Tafelkleedon en | speciaal ïiig*ei_c!-t voor liet ver vesi van i MEUBEL- EN LEDIKANTGORDIJNEN 1 die zonder voor do gezondheid nadeelige bestanddeelen worden geverfd en als nieuw geappreteerd. Mantels en Heerenkleedingstukken wordon geheel in elkaar geverfd. CHEMISCHE WASSCHERLI | 9 van Japonnen HeoreokleodingstukKen  Gordijnen Tafolkleeden enz. JAPONNEN en MANTELS met welk Garueorsel hot ook zij zoomedo HEEEEN KLEEDINGSTUKKEN II I worden GEWASSCHEN zonder lostornon en zonder dat ze krimpen. _Kï MONSTEBBOEKEN  voorzien van de NIEUWSTE KLEUREN liggen ter inzage en PEIJSCOU- I I BANTEN en inlichtingen zijn te verkrijgen aan de onderstaande Depots vau waar do Goederen wekelijks naar I I de Pabriok worden opgezonden. $ I Depot te Amsterdam Vijzelstraat 53. Depot te Deventer D. J. v. d. SAAG. I i  ir Spuistraat 65. « « Dordrecht J. BUTTINK Voorstraat. 1  n . Haarlem Jacobijnenstraat 16. » » Groningen Steontilstraat 38.  . Rotterdam Hoogstraat 227. » ** Middelburg Bolstraat 45. „  's-Hage Yeenstra.it 46. ' "" Delft A. KOOLHOVEN Oude Delft. ro.«-„iV TK™rVt ai ii "" s-Bosch Fontei-straat 258. ' ' YSp-iSVtS"" ' ' Kampen F. C. v. GELDEB Oudestraat.  ' fi_hem EijnsüMt J 3 ~ Tilburg A. HAMERS Nieuwlandstraat. £jd . . Leeuwaiden lumen Jo __. ±. ~ *""Ir..„_ x>„ _i„__ c _ . Zwollo Diezerstraat 40. » ' Jl^w ATxT^mrlt e . Zutfen WILLEMSExN Spitaalstraat. ' "" bova»W. v.d. PALS MarW- I * • Hoorn LAKEMAN Muntstraat. ""' » Maastricht GEZ ROELAND^ Wolfstraat. B; . . Alkmaar Mej. SCHOUWENBURG Laat. I * « Schiedam J. C. OOSTHOF Broêrsvest. | ! HH. Winkeliers in Manufacturen maken wij opmerkzaam on onze inrichting tot het Verven van Zijden | I Wollen en half Wollen Japon- en Meubelstoffen dio verkleurd zijn of waarvan de kleur incourant is. Deze worden f I in do meeßt oourante kleuren geverfd en weer als nieuw geappreteerd. £(9851) É i",http://resolver.kb.nl/resolve?urn=ddd:010104015:mpeg21:a0028:ocr,4,ddd:010104015:mpeg21:p004,Algemeen Handelsblad,1938
2439944,1881/03/14 00:00:00,3236,ddd:010265717:mpeg21:a0060,http://imageviewer.kb.nl/ImagingService/imagingService?id=ddd:010265717:mpeg21:p006:image&x=1524&y=3102&w=754&h=3236,ddd:010265717:mpeg21,2278,6338,1524,3102,6,"WATERSNOOD. Zeventiende opgaaf van giften bij de Algemeene Vereenigde Commissie tot leniging van rampen door Watersnood ingekomen tnt n™A.<.*.J.As 10 Maart des namiddags te 3 uren. Ingekomen bij mr G. VAN TIENHOVEN : Van tooneelgezelsckap De Vreugde ta Ossendreeht ƒl5 uitvoering in Maison Stroueken door Chr. Zangvereeniging de Lofstem ƒ84.65 concert door Rederijkerakamer Oefening kweekt Kunst te Heusden f 29 J. A. Gr. f 10 commissie te Raalte nagek. giften ƒ15.62 gem. Haaksbergen ƒ145.13 opbr. voorstelling Rederijkerskamer de Vijf hoek aldaar ƒ23.80 door Ds J. H. F. B. te Hummeloo opbrengst collecte door een paar jonge dames ƒ171.50 opbrengst concert door de Harmonie tuterpe te Bommel ƒ165.13 burgem. |van Alkmaar ingek. giften ƒ42.85 burgenvan Maarssen en Maarseveen opbrengst eener verloting door Directrices Mejn. Tak en Nicolaï van het dames-instituut te Maarssen en hare pensionaires ƒBOO gem. Eibergen ƒ185.21 burgem. van 's-Hage opbrengst tooneelvoorstelling gegeven door de Vereeniging Tot Vriendschap vereenigd ƒ182.15 gem. Etten en Leur ƒ575.90 gem. St. Maarten ƒ40.20 van mij en tante Net ƒ25 opbrengst Assaut 2"" reg. infanterie te Grave in vereeniging met het Harmonie-Gezelschap aldaar ƒ74.52 gem. Leende ƒ40.65 burgem. te Epe ingezamelde giften ƒ 19.06 opbrengst Assaut gegeven door den Onder!. Amst. Schermcursus ƒ951.03 gem. Beemster ƒ842 gem. Jutfaas ƒ285 gem. Krommenie ƒ159.25 F. B. ƒlO gem. Waddinksveen en opbrengst eener tooneelvoorstelling door de Rederijkerskamer aldaar ƒ391.23'/!? E. C. H. van K. uit Nice ƒ25 burgem. van Zutfen nagekomen giften ƒ649.80 ingek. giften bij den uitgever der Spaamébode f 15.25 opbr. voorstelling Genoots. „Melpomene en Thalia"" te Haarl. ƒ89.05 gem. Arkel i2OO gemeente Übbergen ƒ258.59V9 van [evr. van der G. en de dorpen Ooy Lentz Kekerdom en Erlecom ƒ120.05 burgem. van 's-Hage opbrengst tooneelvoorstelling Stukadoors-Vereen; „Vriendschap zij ons doel"" ƒ65.92 gem. Vrijenban ƒ268.541/» burgem. te Gorssel opbrengst tooneelvoorstelling door kweekelingen der landbouw-kolonie Nederl. Mettray ƒ25 burgem. van Delfshaven nagekomen giften / 6.17 V»» adm. weekblad Gooi- en Eemlander te Hilversum ƒ10.87'/!) collecte Prot. kerk te Ossendreeht ƒ63.50 H. te Beemster ƒ5 gem. Heerabskerke ƒ30.57 Burgem. van Schoterland v. L. F. G. ƒlO Ds v. d. P-. te ""Wijdenes bij Hoorn opbrengst uitvoering zangschool ƒ7O burgem. Van Akersloot nagek. giften ƒBl Z. E. den min. van Buitenl. Zaken door tusschenkomst van Zr Ms gezant te Parijs nader ingekomen giften by den Nederl. consul te Bordeaux fre 1860 de elèves school mevr. Pareau te Baarn ƒ1374 saldo van vroeger bestaan hebbende vereeniging te Doet—ïchem ƒ12.45 burgem. van Maassluis van S. ƒlO G. v. B. ƒ2.50 J. B. ƒ2.50 kinderen der Zondagschool aldaar f 10.75 burgem. van lerseke in Zeeland postw. ƒ1.75 A. H. Predikant te Oosterlandop Wieringen opbr. tweede lezing ƒ 10--. Ingekomen bif Mr J. A. SILLÉM: Supplëm. collecte Ambt Vollenhoven ƒl E. A. E. ƒ3. Ingekomen bij Ds IL P. BERLAGE: : gecollect. 6 Maart Zuiderkerk ƒ2.50. Ingekomen bij den heer 11. VAN EEGHEN: Commissie te Middelburg paldo ingek. giften ƒ36.15. (1911) Totaal bedrag deur opgaaf /_ -S3»5lVï«",http://resolver.kb.nl/resolve?urn=ddd:010265717:mpeg21:a0060:ocr,6,ddd:010265717:mpeg21:p006,De Tĳd : godsdienstig-staatkundig dagblad,754
3105940,1881/07/22 00:00:00,3202,ddd:011085914:mpeg21:a0026,http://imageviewer.kb.nl/ImagingService/imagingService?id=ddd:011085914:mpeg21:p004:image&x=27&y=76&w=970&h=3202,ddd:011085914:mpeg21,997,3278,27,76,4,"Het Stoomschip ;hég' AUr Kapt. J. BLAKEB j -f vertrekt Tan SOIIU9AIA direct'naar SINGAPORE op den 28 Juli ljMl. Ag«iten(; i 2678 BO GOAN'fc-00. -* APOTHEEK IMDGINUI' Hoofddepót van Houtens Cacao 1/1 blikten f 3. * 1/2 id. f 1.80. HELLENDOORN.&Co. V - - ..Apotheek Jnsuünde. Dépositaires (voor den Oosthoek) des $ produits DE LA MAISON GKIMAÜLT.& Co. i Paris.;! Per Hampton ontvingen wij van genoemd huis. Fruit Julien. Phosphate de fer de Leras. Sirop d'hypophosphite de Chaux Pote Nafé d'Arabie. Capsules Mothes Savon de Qoudron. Savon & I'acide Phénique. Cigaretts Espic. id. Indiennes. PéLte de Guimauve Candie. P&te de Jujubes enz. HELLENDOORN & Co. Apotheek Insulinde. Pas ontvangen"" ttit d© Voorwaarts. Diverse brillen en Binocles regelregt van Paetz en Flohr Berlin unter den Linden no. 14. ledereen wachtej zich voor namaak al staat ook genoemde firma op de étui de daarover betrekkelijke correspondentie ligt bij ons ter in zage. 1 HELLENDOOBN & Co. MB MUM PAS ONTVANGEN. Uit de Hansen Love: Minerale zuren in kruiken. HELLENDOOBN Co»- apöïheE SBH AMEEIKAANSCHE ENGELSCHE en FEANSCHE DEPöT middelen Chemicaliën Stroopen politoer spiritus vuuilak 'enz. ' - Wijdmonda stop flesschen voor monsters suiker a f 180 per dozijn. 8611 HELLENDOOBN & Co. Norwich Union JFire Insurance Societ .Opgericht in 1821. Kapitaal £ 560.000. T~4e oadergeteekende sub agenten van JLF bovengenoemde maatschappij zijn gmachtigd verzekeringen ""te sluiten tegen brandgevaar op de gebruikelijke conditën. A ■ 8 WILLEQANS Co. -",http://resolver.kb.nl/resolve?urn=ddd:011085914:mpeg21:a0026:ocr,4,ddd:011085914:mpeg21:p004,Soerabaijasch handelsblad,970
2499840,1881/10/05 00:00:00,2520,ddd:010497505:mpeg21:a0002,http://imageviewer.kb.nl/ImagingService/imagingService?id=ddd:010497505:mpeg21:p001:image&x=93&y=2323&w=992&h=2520,ddd:010497505:mpeg21,1085,4843,93,2323,6,POSTKANTOOR. Slniting der Nederlandsche Mail. Trijdag 7 October Vrijdag 21 October des avonds ten 8 ure. Voor EUROPA ena. via NAPELS en NEDERLANecütstreeke. Slniting der Fransche Mail. Zondag 9 October Woensdag 26 October des avonds ten 8 nre. Voor EUROPA AMERIKA AFRIKA AUSTRALIË BBITBCH-TNDIE. CHINA en JAPAN eni. Slniting der Engelsche Mail. Maandag 17 October Maandag 31 October des avonds ten 8 are. Voor EUROPA AMERIKA AFRIKA AUSTRALIË BRITSCH-INDIË CHINA JAPAN enz. benevens voor BANKA PALEMBANG RIOUW DELI EDI BEGLI SAMALANGAN en ATJEH. Slniting der Rotterdamsche Lloyd. Vrpag 28 October des avonds ten 6 ure. Zecpost (per Utrecht). Voor NEDERLAND regtstreeks. Slniting der Pakketten op: Maandag 10 October voor: Telok-Betong Benkoelen Padang Analaboe en Atjeh. Vrijdag 14 October voor: Makabbeb de Molukken en 7 .mor. Vrijdag 14 October voor: Tjilatjap via Anjbb. Woensdag 19 October voor: Bawean en Bandjbbmasing Woensdag 19 October voor: B* NKA en Palembang. Maandag 24 October voor: Telok Betong Bekoelen I adang Analaboe en Atjeh. Maandag 81 October voor: Padang direot. De knfltbOOten vertrekken om de 5 dagen. Uren van Sluiting: In de Stad ten 4£ nre en 'e WMtevredes ten 6 ure 's namiddags. V__I*JL>«JTII_N. Donderdag 6 October. ■an pandg. Mr. Coroclia door Lim Soeijhian in het Venduloeaal. Voor de toko van John Pryce & Co. 't ivond» botkenvendutic in de Harmonie door F. B. Kroon. Viijaag 7 October. Purden-vendutie door W. L. van Slooten. Voor de toko van Van Vleuten _ Cox. Hontvendntie door H. W. Wijaman. Zaterdag 8 October. In het Vendnlocaai- ADVEBTEKTIEN,http://resolver.kb.nl/resolve?urn=ddd:010497505:mpeg21:a0002:ocr,1,ddd:010497505:mpeg21:p001,"Java-bode : nieuws, handels- en advertentieblad voor Nederlandsch-Indie",992
4231500,1881/10/29 00:00:00,4836,MMSADB01:000018899:mpeg21:a0062,http://imageviewer.kb.nl/ImagingService/imagingService?id=MMSADB01:000018899:mpeg21:p012:image&x=4602&y=226&w=875&h=4836,MMSADB01:000018899:mpeg21,5477,5062,4602,226,12,"Advertentie DAMESKINDÈRHOEDEN en toV het vak behoorende Noxiveautés. GEZ. DE LANG. Kerkstraat 126. TERSTO ter overname aangeboden ilERSAFFMRE^ waarin tevepa^ Sterke Dranken worden verkoohtj^vr */. AdwK met franco brieven onJrer letter»/ DyMt. aan het Bureau dezer Courant. •^""Door een sametóp van omstandigheden ter Overname eene Zaak in <£o/?ïij(^C to KAOT00RBEBp™%-. BN / eriën met een^ compleete ƒ/ boekbinderij die met goed sjreces gedreven wordt nieuwste Gereed schapiren voor een billijke prijs het Euis /te Huur of te Koop in een der steden y6n Noord-Brabant. Frajföo brieven aan 't Bureau dezer Courant (r letters A. A. ^ D«)r C. N. TEULINGS uitgever te 'S^ïTertogen bosch wordt met buitengewoon succes gedebiteerd: Schrijfoefeningen Volledige (Tebjinga Cabiers) van No 1 tot èH met No 9 ieder van 8 Oefeningen die vapsgewijzo in moeilijkheid toenemen. Aan tikt letter wordt \eene arffening gewijd om «icht op iedere letter te volgen de verbindingen van andere waarbij telkens eene ning gevoegd wordt van de te vorer letters. Prijs per Riem (van 860 Cahiers) / lO^voorti nog twee Cahiers Schrijfvoorbeelden. No 10 en 11 voor meer gevorderde leerling^ Prijs 30 Cents per Cahier. L\£ afzonderlijks geheele aanHierop letter met lingsoefeeleerdc \X Ontijdig: Verval. —V De onvoorzichtige en onnadenkende kan zichzelven/ïn de toekomst een zes van rampspoed besparen doo/eene spoedige toevlucht tot deze uitmuntende geneesmiddelen. Allo puisten waaruit ook voortvloeiende zwellingen der klieren waar ook gezeteld ontstoken wonden en verzwakkende ontlastingen kunnen veilig en zeker genezen worden door het gobruil/van Holloway's Zalf volgens de voorschriften die om iederen pot gewikkeld zijn. Qeen schroomvalligheid behoeft de zwakste terug te houden om deze herstellende middelen aan te wenden dio de drievoudige! hoedanigheden bezitten om te zuiveren te regelén en te herstellen zonder de maag in wanorde te brengen  het zenuwgestel te schokken of het noodzakelijk te maken om in hais te blgven. Holloway's medicamenten zullen de bron van menig# ziekte stuitciy; die indien veronachtzaamd duurzame ellende te weg brengen. Dooijas Pillen en Potjes Zalf f 0.80 f 1.8®» f8 f ƒ.75 f 18.50 f 80.50 zijn op franct aanvrage k contant te bekomen bij alle Apothekera An Nederland alsmede in Holloway's K' a "" bli^^a^nt t« Londen 488 Oxford Btreet.",http://resolver.kb.nl/resolve?urn=MMSADB01:000018899:mpeg21:a0062:ocr,12,MMSADB01:000018899:mpeg21:p012,Provinciale Noordbrabantsche en 's Hertogenbossche courant,875
5431265,1881/01/24 00:00:00,6716,ddd:010290054:mpeg21:a0047,http://imageviewer.kb.nl/ImagingService/imagingService?id=ddd:010290054:mpeg21:p004:image&x=2544&y=71&w=1655&h=6716,ddd:010290054:mpeg21,4199,6787,2544,71,6,"TOKO VAN BEMMEL. Opnieuw ontvangen: St. JULIEN MEDOC HAUT St. EMELION. 8957 TOKO VAN BEMMEL Mouselien Kristal Glaswerk met zilver gemonteerd. Mouselien Kristal Glaswerk in stellen. - ■ 8986 MO VIN BEMMEL Ontvangen: INDEUOUSfiN Hf SOIU Geldloterij Verzorgingsgestlcht en Modderlast. TREKKING ONHERROEPELIJK VASTGLSTELD 16 Maart 1881. 10 SNOUCK HURGRONJE. "" LOIERJ ten behoeve vanhet Protestantsche Weeshui te Soerabaja en hêt Djatti-Gesticht te Batavia. Loten zijn te bekomen aan het Bureau van dit blad a ƒ 10.— Contant. WMÊÊÊPfu» oor buiten de stad is 20 MÊWB6J* c^9a Port en aanteekenen ""■' noodig. 6060 G KOLFF l CO Te Batavia nemen tegen een vast commissieloon bestellingen aan op Boekwerken in Europa Britsch Indië Australië of elders verschenen. 5869 G. KOLFF & CO TE BATAVIA Nemen abonnementen aan op de GRACIEÜSE met modeplaten. De twee eerste nummers zijn dadelijk verkrijgbaar. Prijs ƒ 13— B'jaars. 6236 6. KOLFF en Co TE BATAVIA Ontvingen het eerste nommer voor 1881 van Voor tjonge Volkje een bijzonder fraai geïllustr. Kinder-tijdschrift onder redactie der beste Holl. Schrijvers. Abonnementsprijs voor een jaar f 6.90. 6235 INDISCHE POLICEIKEL. Geïllustreerd Humoristisch Weekblad / 8.50 per kwartaal M« BISSOHOJ? tom*wi ■ ■ ■ ui WH» ■ i . ii*_m_____wi_____ ta • » C__T =3 S-g l*_p»- "" » ö fl Ö 3 S 's *3 2 S- w -~ g*■___r g- ui _—-1 * '___ « ce «3 . s' e *-S £ S 1 •* S 2 S g wH O J o _ë dSs**! &3 S M J 2 _3 s 5 •«_: &. m pu ~~ ONVERGANKELIJKE"" $m\~-f\ ° KÜR. Murray & Lannian's ïfl Flï-ïk.  • ■■■ t""..'.!'• J'.-\ Het aangenaamste langil . % c-Hjvendc en toch fijnste ran KtULH 'rjhm D lEP a^fi teu kwciken voor deu ■j* ZAKDOKK hef TOILET en 'WS in het BAD verkwikkend en gezond in dn Ziekenkamors; aanbevelingswaardig in geval van uitputting vermoeienis zwakheid zenuwachtig!»* id en een remedie tegen hoofdpijn. Men neme zich in acht voor namaakscls en vrage steeda naar het FLORIDA WATER gefabriceerd door de eenige eigenaren de heeren LANMAN & KEMP te New-York. Verkrijgbaar bij de voornaamste apothekers drogisten paifunieurs en bij hot Hoofddepöt ENGiCLHA ltlV& Co. te B»t»v:«. 700 SAMARANG en SOLO CooimissieUandal. Hxgazijn vao Muziekinstrumenten eo Fiïoomakers-Jtlelief. Pianoen Vleugels van BERDEN DORNERen SC HIEDMALTER Directe importatis uit de respectieve fabrieken. Met garantie. Speeldoozen Orgels. Seraphines. Draaiorgels. Blaasinstrumenten per stuk en per stel. Strijkinstrumenten Snaren in soorten. Alle benoodigdheden en onderdeelen voor Muziekinstrumenten. 4914 P i a n o-D e p o t van  A.. OTT TE SaMAKANG is verplaatst in Dietrich's Salon voor Photographie 4913",http://resolver.kb.nl/resolve?urn=ddd:010290054:mpeg21:a0047:ocr,4,ddd:010290054:mpeg21:p004,De locomotief : Samarangsch handels- en advertentie-blad,1655
2627370,1881/10/06 00:00:00,2630,ddd:110536754:mpeg21:a0007,http://imageviewer.kb.nl/ImagingService/imagingService?id=ddd:110536754:mpeg21:p001:image&x=3120&y=1462&w=999&h=2630,ddd:110536754:mpeg21,4119,4092,3120,1462,8,"Toko-vendutie op WOENSDAG 12 October 188 J. A. G. Bosch & Co Koopmanschappen. Nader te» apeeifieeeren . 3706* vVoenadag lsi October 1&S1 tuis**chfti da gard >« en de hta; elplaat-» van DÜALÖP & Co. <.ioor W. L. van Slooten vun I.V«J __;i-«M»l<- <>ii votli- KARBOUWEN zesr geschikt voor L.iudbo iw en ijlachterijün pas va. Buu.bavvu per brik banoeJÏen an van baden af vojr een ieder te bexiehtigen. 3/U Bn_DTÖi~iAATSCH_ipPIJ. Dc vier volgende veilingen van liillihm tin zullen plaats Dinsdag 2.""> October 1881. iel. 27 December IB$L iel. 28 Februari 1882. iel. 25 April 1882. Gegadigden tot mededinging b.j de aai '.en: ding vo.r het Persooeo Geld Vee enz. ter reede OLBH-LEH van en me! Ie Juli IN-C tot •in m-t Ultimo Decombsr !_W6 worden verweiei naar de bctrekkelijne aankontligm- opgenomen io de J.i--vasche-'. ourant van den 4e Uetober ItrtJl en vogmdöD. I)« intentlint der Ie Aliluaire 3710 S.'.A AU:-.__.",http://resolver.kb.nl/resolve?urn=ddd:110536754:mpeg21:a0007:ocr,1,ddd:110536754:mpeg21:p001,Bataviaasch handelsblad,999
3163170,1881/06/19 00:00:00,3261,ddd:010104054:mpeg21:a0046,http://imageviewer.kb.nl/ImagingService/imagingService?id=ddd:010104054:mpeg21:p009:image&x=3933&y=230&w=970&h=3261,ddd:010104054:mpeg21,4903,3491,3933,230,10,"SPUI SfTl AAT BIJ DEPALEkSSTAAATIST. RESTAURATIE „DE BEURS."" DINERS A 10 CENT SOEP 2 VLEESCH 2 GROENTEN AARDAPPELEN DESSERT. DINERS A LA CARTE. (310) mivi-ftSo DINERS a 80 cent en dito A LA CARTE van 3 tot 6Vj uur N. 'L. Voorburgwal bij de Molsteeg 150. (19569) Jl. ""-.'IE DE «HOLD. Hotel Victoria* De ondergeteekende heeft de eer bij «len aanvang vau het seizoen van dit jaar zijn Hotel iv de herinnering vau he reizend publiek beleefdelijk aan te bevelen. MINERAAL WATERBADEN dio rechtstreeks worden voorzien van water uit de gulden bron. Reweinsche lersche en Russische &TOOMBADEN op de beste wijze ingericht de eenige welke te Wiesbaden verkrijgbaar zijn; wijders ZOET WATERBADEN Douches van allerlei soort euz. een volledige inrichting tot het houden eener Koudwaterkuur. Kamer vau 2 Mark en hooger per dag. (A.610441 (17739) J. HELBACH'Eigenaar. TgYvanoppehraayT ARTS Wagenstraat 124 's-Gravenhage. CONSULTATIE UITSLUITEND voor KEEL- NEUS- en OOR LME) I.RS dagelijks (uitgenomen Zouen Feestdagen) van I—3 uur. Kosteloozo Consultatie voor minvermogenden Dinsdag Donderdag en Zaterdag vau 'J —10 uur. (23910) DE MIWOORÏSCÜE BAD-COÜRAsF verschijnt VIERMAAL per week. Prijs voor het seizoen franco per post ƒ3. Afzonderlijke Nummers 5 Cent. Te bekomen aan de Kiosken. .23878) 11IV VERTROUWEN. Hij honderden komt men bij mij om HAARKLEURSEL  en dan zegt men : zonde t wel goed wezen 'f Dia Buitenl»nds.he Kleur middelen zyn mij met bevallen. Maar waarom uw geld gebracht bij Depothouders V Daar kunt u goen verhaal zoeken bij M IJ wel. Bevalt u mrju kleuriniddel niet dan geef ik uw geld terug. Heeft u Grijs of Rood haar of Baard franco aanvraag a ff 2 de Flacon in Blond Bruin en Zwart. Mr. TIIEOPHILE 32 Frederiksplein Amstordam. NB. Geheime verpakking den briet ontvangt men terug. 121230) BORST-PASTILLES"" worden met goed gevolg gebruikt tegen HOEST SCHOR. HEID KEEL. en BOHSTPIJIN. In zakjes a 15 ets. en in doosjes » 30 en 50 ets. KMNKH PAITI-LlKfl in doosjes met 50 Pastilles 50 ets. SLIJMMAAGPILLEN ia doosjes niet 50 Pillen 25 ets. TEERCAPSÜLfiS ia flacons met 60 Capsules 60 ets. Verkrijgbaar in tic Apotheken en de bekende Depots v. _ (380) H. VON GIMMORN te l_m.i__.iK. MEN VERLANGT voor een groote Zaak in KANTEN (een gesloten Huis) een EERSTE VERKOOPSTER die Fransch en Engelsch «preekt. Ruime verdiensten. Meu adresseero zich Rue de la Chancellerie 15 te Brussel. (N° 2375) (23174) ATTENTIE S. V. P. Men vraagt voor een JONGELING 13 jaar oud als VOLONTAIR plaatsing om voor den Handel grootgebracht te worden. Brieven met N* 1093 aan het Bureau van de Krant voor Betrekkingen iUmkkraadtylein 17. (23882)",http://resolver.kb.nl/resolve?urn=ddd:010104054:mpeg21:a0046:ocr,9,ddd:010104054:mpeg21:p009,Algemeen Handelsblad,970
1433010,1881/08/08 00:00:00,2204,ddd:010063501:mpeg21:a0025,http://imageviewer.kb.nl/ImagingService/imagingService?id=ddd:010063501:mpeg21:p006:image&x=1808&y=3005&w=1124&h=2204,ddd:010063501:mpeg21,2932,5209,1808,3005,12,"Er worden tegen 10. November verlangd: eene bekwame Keukenmeid ook genegen eenig Huiswerk te verrichten en eene Tweede-Meid die goed met de Wasch en Strijken kan omgaan beiden P. G. en niet beneden de 25 jaar oud. Onnoodig zonder goede getuigen zich aan te melden. Aanbiedingen in. persoon 's morgens vóór 2 uur: N. Heerengracht No I'_ te Amsterdam. [7073). BH.KOBi-e_BarilEa_i.FS. Een Eerste BEDIENDE zag zich gaarne met Sept. of Oct. geplaatst liefst daar waar gelegenheid is de Zaak later over tenemen. Brieven fr0. No. 698 bij de Boekh. A. VAN HOOGSTRATEN & ZOON Den Haag Compaguon gevpaagd met 18 a 20 Mille in een Zaak van Bouwmaterialen tot verdere uitbreiding vatbaar met toestemming tot plaatsing vaneen Stoommachine. Brieven franco onder motto Compagnon aan den Boekh. JOH. G. STEMLER Cz. Amsterdam. ""f!_l3ljfroiwp?raair tegen November e. I_ bij VAN DEN ANKER & VERBRöEK in Koloniale waren te Dordrecht. Eerlijkheid is eene eerste vereisehte. (7070) Men verlangt voor dadelijk eene fatsoenlijke Werkmeid . van middelbaren leeftijd tevens instaat zoo noodig een Burgerpot te koken. Adres met franco' brieven onder letter H aan den Ouden en Nieuwen Boekhandel van _ H. DUNK te Rotterdam. (7071) e evraagd in een klein gezin eene eenvoudige Dienstbode boven j de-25 jaar. zeer goed kunnende K_ken en Werken van goede getuigen voorzien. Loon f 100. Adres franco No. 884 bij den Boekh. A. VAN DORSTEN Jt. in de Lijnmarkt te Utrecht Eene Indische JUFFROUW steeds Kinderen verzorgd hebbende wenscht als zoodanig met eene Familie naar Indië to retourneeren. Zij heeft geen last van zeeziekte en is genegen een gedeelte der Passagekosten zelve te betalen. Adres franco brieven Overste DE GRAEFF Brugstraat Breda. VastiTnkomen!!! Wegens dubbele zaken wordt te Koop aangeboden: een voor vier jaren solied nieuwgebouwd Woonen Winkelhuis -allergunstigst gelegen voor Koffiehuis waarbij na eenige administratieve kennis nog een aanstelling kan verbonden worden van ƒ6OO. Adres met franco brieven lelt. E E aan KOOYKER's Centr. Adv.-Bureel te Leiden-",http://resolver.kb.nl/resolve?urn=ddd:010063501:mpeg21:a0025:ocr,6,ddd:010063501:mpeg21:p006,Het nieuws van den dag : kleine courant,1124
2873344,1881/03/08 00:00:00,3904,ddd:010265712:mpeg21:a0043,http://imageviewer.kb.nl/ImagingService/imagingService?id=ddd:010265712:mpeg21:p004:image&x=2293&y=217&w=736&h=3904,ddd:010265712:mpeg21,3029,4121,2293,217,6,"Bij de Wed. H. H. UYTTENBROECK te Venloo zijn verschenen: De _____ .Biecht. Geschenk aan de Lieve kinderen van een geestelijken Kindervriend. 2e druk 8 c. — 25 ex. ƒ175 —50 ex. ƒ3.25 —100 ex. ƒ6—. Die H. Beichte. Geschenk u. s. w. 9c — 25 ex. ƒ2.— — 50 ex. ƒ3.75. —100 ex. ƒ7.—. De eerste H. Communie. Geschenk enz. 12 c. —25 ex. ƒ2.75 50 ex. ƒ5.25 — 100 ex. ƒlo.—. Jfovene voor Minderen die zich waardig tot hunne eerste H. Communie wenschen voor te bereiden door G. 11. Leus 11° druk. 10 c. 25 ex. ƒ2.25 — 50 ex. ƒ4.25 — 100 ex. ƒB.—. Het _B_. Vormsel. Geschenk enz. 10 c. — 25 ex. ƒ2.25 — 50 ex. ƒ4.25 — 100 ex. ƒB.—. Mei liedjes op wijzen genomen uit »Choix de canliques a I'usage des élèves de Rolduc"" door een Oud- Professor. 6« druk. 10 c. — Bij 12 ex. wordt de «muziek"" gratis gegeven. Het Kind van bet H. Hart. Geschenk enz. 10 et. — 25 ex. ƒ2.25 — 50 ex. ƒ4.25 —100 ex. ƒB.—. De hcdendaagschc Dans door J. H. S. Priester. 15 c —25 ex. ƒ3.50 — 50 ex. ƒ6.50. Christelijk Huis- en Volksboek voor alle standen bevattende een breedvoerige verklaring von het H. Misoffer door M. von Gochem 3e dr. 90 c geb. ƒ1.20. Verhalen Voorbeelden en Gelijkenissen ten gebruike bij het onderwijs van den Catechismus oi de Christenleer tevens een handboek voor Christelijke huisgezinnen door H. Welters; compleet in p. m. 6 aflev. a 25 c. Afl. I—3 reeds verschenen. (727) Uitgave G. W. VAN BELLE te Rotterdam. Verschenen: SCHETS DER Algemeene fieschiedenis DOOR J. CHANTREL naar het Fran.ch DOOR J. W. THOIPSOX. Eerste Deel: Oude Geschiedenis. Kerkelijk goedgekeurd. Prijs ƒ0.75. Na ontvangst van een postwissel van ƒ0.85 of postzegels wordt dit werk cloor geheel het Rijk verzonden Getallen worden vraddvrij door geheel Nederland toegezonden. Dit werkje is een uittreksel uit het zoo algemeen gezochte M'andbock «ler Aigéitteerae Geschiedenis van Chantrel door den Vertaler bewerkt op verzoek van een aantal Directeuren van Pensionaten en Kweekscholen die de verzekering gegeven hebben de SCHETS onmiddellijk op hunne Inlichtingen te zullen invoeren. Het is geschikt rooi' de hoogste klassen der scholen en voor de kweekelingen die later hunne studiën iv het Handboek zullen voortzetten. (1779)",http://resolver.kb.nl/resolve?urn=ddd:010265712:mpeg21:a0043:ocr,4,ddd:010265712:mpeg21:p004,De Tĳd : godsdienstig-staatkundig dagblad,736
58394,1881/04/02 00:00:00,86,ddd:011148432:mpeg21:a0013,http://imageviewer.kb.nl/ImagingService/imagingService?id=ddd:011148432:mpeg21:p002:image&x=2878&y=346&w=679&h=86,ddd:011148432:mpeg21,3557,432,2878,346,4,ADVERTENTEÊN.,http://resolver.kb.nl/resolve?urn=ddd:011148432:mpeg21:a0013:ocr,2,ddd:011148432:mpeg21:p002,"De Graafschap-bode : nieuws- en advertentieblad voor stad- en ambt-Doetinchem, Hummelo en Keppel, Wehl, Zeddam, 's Heerenberg, Ulft, Gendringen, Sillevolde, Terborg, Varsseveld, Dinxperlo, Aalten, Breedevoorde, Lichtenvoorde, Groenlo, Neede, Eibergen, Bor",679
542400,1881/10/04 00:00:00,960,ddd:110620078:mpeg21:a0034,http://imageviewer.kb.nl/ImagingService/imagingService?id=ddd:110620078:mpeg21:p004:image&x=3006&y=5174&w=565&h=960,ddd:110620078:mpeg21,3571,6134,3006,5174,4,"J.Den HERDER DANKIK It /.BELAND - - - - MIC 11. iloud mij bereid tot hul leveren en inwiaite* lon van. Hankpapior of Dratts alftiacde lot het uit maken van wiiweU voor het binuen »n buitenlandal» ook hel collecteren van gelden en ftlft ;f. n * NOTARIS FUBLIC * tot luit uitmaken van allo wettige stuk kenaln itacds Mortgiigca' (Koopactcu & llvpolboekoii;CoiitractenTc«taiiienleuVolmaglciieux. Tickets voor de XEDERLANnSCIfE STOOMBOOTUJN luanchon HOTT2RDAM in NEW YOHX.iijn l»ij inij too goedkoop als ergonn eldcrate verkrijgen zoovel tickets {vm NHW' YORK naar ROTTERDAM ah» van ROTTERDAM naar NEW YORK. Ook tickets tegen vorminderde prijzen voor heen en terug. - IjfjjfiÊÏ ir OOK AOENT.TOOU »P. ""STATE LlNE'' welker prachtige en wol ingerichte liooten ïMflit tueacluu: N«ir York enCliwgow In Europa ledere week. < • "" Office sobuina tegenover de Unltr M iMn. - hérokr; Zeeland. Mlch . 9 Dee. 1880. VnlStf?",http://resolver.kb.nl/resolve?urn=ddd:110620078:mpeg21:a0034:ocr,4,ddd:110620078:mpeg21:p004,De grondwet,565
7261032,1881/06/11 00:00:00,4354,MMRHCE01:000036527:mpeg21:a0023,http://imageviewer.kb.nl/ImagingService/imagingService?id=MMRHCE01:000036527:mpeg21:p004:image&x=1777&y=1450&w=1542&h=4354,MMRHCE01:000036527:mpeg21,3319,5804,1777,1450,4,"Advertentie HELMOND. Op nienw ontvangen: SCHOONMAAKARTIKELEN. Illle soorten van Borstelwerk. Sponzen & Zeemleder Spoormandjes en Korven. GALANT KEIEN EN PARFÜMERIEN als: Tabak- & Sigarenpijpen Horlogieiettingea Sigarentokers m Verder puike Tabak & Sigaren. Dspót m Iet gchto Eau d'Anvsrs. r: M- Handels-1 Courant Snclpersdrukkorij g. &8&ÜTO Uelrnmê vervaardigen net en zeer spoedig: Prijscouranten 4 Facturen Quitantiën Rekeningen Circulaires Ke<?us Etiquetten Menu's Doelvellen Bidprentjes Biljetten Brochures Strooibriefjes Bruiloftszangen Visitekaartjes Adreskaarten Memorandums Nota's Wissels Brievenhoofden Boekwerken Catalogussen Prospectussen Adressen Trouwkaarten enz enz. m\ 9 Versehenen en verzonden: HET KATHOLIEKE STUWERS 9e Jaargang-. Aflevering 1. l\iaandschritt voor het Katholieke Nederlandsche Volk. onder eedactie van K. X. E. O. NAVDRANOEL met medewerking van vele Katholieke letterkundigen. Jaalijks verschijnen 12 afleveringen van 3 vel imp. 8"" met een aantal illustraties. Trijs per jaargang f 3.— franco per post f 4.— . Be eerste aflevering legt bij alle Boekhandelaren ter inzage en mag vrij worden opengesneden. D e U itgever L. F. VAN GENK 's- Bosch. i ■y inwin li b H LELOUP> llJ VAN J Ameidestraat Helmond HEEREN & KINOERHOEDEN ENZ. gtïweH €««3? 4® izMiekm* Emiïa« km&® ia &U« a^g^tejfe^ PETTEN zeawel rmv kmvm als vmf Msitsta «U«s s«lt«4 m$m gemaakt wmk t mt m MIMjk m grijs",http://resolver.kb.nl/resolve?urn=MMRHCE01:000036527:mpeg21:a0023:ocr,4,MMRHCE01:000036527:mpeg21:p004,De Zuid-Willemsvaart,1542
7108612,1881/04/12 00:00:00,6704,ddd:010103991:mpeg21:a0030,http://imageviewer.kb.nl/ImagingService/imagingService?id=ddd:010103991:mpeg21:p006:image&x=2989&y=249&w=1963&h=6704,ddd:010103991:mpeg21,4952,6953,2989,249,10,"SCHOUWBURGEN ENZ. STADSSCHOUWBURG. Directie: VAN OLLEPEN MOOR en VELTMAN. DINSDAG 12 APEIL. (Fransche Opéra enz.) (N*. 27 ran het Abonnement) GuiUaume Teti9 groote Opéra in 4 bedrijven van Rossini. Aanvang 7Vï nnr_WT' DINSDAG 19 APEIL. (Beneflcevoorstelling van Mw. LA VILLE PEKMINET en den Heer VITAUX. (N°. 28 van het Abonnement). Aanvang 7V_ uur. STADSSCHOUWBURG. Directie: VAN OLLEFEN MOOR en VELTMAN. j Woendag 13 Zaterdag 16 Zondag 17 en Maandag 18 April I Vier eerste Voorstellingen van: I DE KOERIER TAN LYON (DE ONSCHULDIG VEROORDEELDE) I geschiedkundig drama in 7 tafereelen naar het Fransen door I C. R. H. Spoor. I (Aanvang 71/. uur Zondag 8 uur.) I GRAND THEATRE Amstelstraat. I Dinsdag 12 April. Buitengewone Voorstelling ten voordeel» I van den Heer B. VAN LIER Bureaulist van het Grand-Theatre.l Eene wederopvoering van: CAGLIOSTRO. Groote Komiek»! Operette in 3 bedrijven. Muziek van Johann Strauss. De hoofd-I roilen zullen vervuld worden door de Dames Fehringer NitschJ Bender en de Heeren Korschen Wilhelmy Hermann enl Froneck. I Gewone prijzen. (8 uur.) I Woensdag 13 April. De Vereeniging Het Nederlandscht Tooneel: ZELFZUCHT Tooneelspel in 5 bedrijven of 61 tafereelen naar 't Fransch Montjoye van Octav» PeuilletJ door Arnold Ising. Gewone prijzen. I Om het publiek van buiten nog gelegenheid te geven meti de exra treinen te kunnen vertrekken zal de Voorstelling dit-| maal te 71/. uur aanvangen. I NIEUWE SCHOUWBURG TAN LIER I Plantage Fransche Laan. I Dinsdag 12 April. GEEN VOORSTELLING. I SCHOUWBURG ffRASCATI Plantage Middellaan.1 •»>-»-ri__._r_. ■s_i-_..#r_.__.<v*-'l»r. I DE MUSKETIERS I operette in 3 bedrijven. Muziek van Louis Varnev I Gewone Prnzen. Aanvang S uur. I SALON DES VARIÉTÉS Amstelstraat I Directie: G. PROT & ZOON. I Dinsdag 12 April: I £TE_LILA§ I DE DOCHTER VAN DEN STAATSGEVANGENE 1 _w «__ fedriJven en een Voorspel naar het Franseh. 1 Aanvang 8 uur. I T_^TtER TVOILI' directie W. PIERRE DE BOER.I _.!__5 AV0ND< aanv- 8 uur Variétés Voorstelling door hed INTERNATIONALE CONCERT- VAUDEVILLE- cil SPECIALITEITEN-GEZELSCHAP I ___^_^«ras au^rl-1 PATTY Jlastor WILSON M* LYCETT ?n!' Ml8ï K Immense succes de Mlle HELENE ROBERT I bhanteuse Comique excentrique et Mr GÉRAnfB anseur etc. eta Toegang 60 Cent ■ mÊbj^__.-___vm»i^r^.:^M^r^^fi-m--^ytit n ■■n — |i_-_______Z_^^_ _ ""• I PALEIS VÖO¥""mKSVLÏJT I DINSDAG 12 APRIL 1831 ■ De Paneelzag-ers I het Tooverïioek van Arlequin 1 Arlequinade in 9 Tafereelen. I tjemonteerd door den Balletmeester.E. Witt I Decor atign van J. D. G. Grootveld. ■ Ke SumeV. J°ïï' M' C°™ I Ke/z^rbespreken. km™* 8 « I Leden volgens reglement. H WOENSDAG 13 APRIL ■ VOLRSVOORSTELLING. I €Ül£TVOORST_E_LMl.O_EN I VAN I MM HADGK I K. K. Kammersiingerin en Prima-Donna aan I Her Majesty's Tlieatre te Londen met I haar Opera-Gezelschap. I De Eerste Voorstelling zal plaats hebben op I 1MIV&DAQ 19 APRIL. I ——— _* I Blnnenamstel &£!&* Schutsluizen I bU de »üH^ FF. 133. ■ ROMNKLIJR 915 1DERL I Circus l>jsear Carré. I Dinsdag 12 April des avonds te 8 uur: I BUITENGEWONE VOORSTELLING I net bijzonder gekozen programma onder medewerking van I iet geheele Kunstenaarspersoneel. Op vereerend verzoek- H DE 12 IJZEREN RIDDERS I root Hippologische Tornooi. Feestspelen uit den tijd van I .onrad III van Frankrijk in prachtige (origineele) uitrusting I Ecuyère inimitable Miss ZEPHORA. Les petits virtuoses I mtengewone Muzikale Voordrachten door de 3 GEBROEDERS* I AGELS. Het Schoolpaard Castor bereden door de Directrice I MALIA CARRÉ. Mr. EUGÈNE GARTNER in zijne uitste- I ande evolutiën als Jocky enz. Tot slot der Voorstelling: H DE NEVELINGEN (NIBELUNGEN.) ■ Groote gala-pantomime met levende beelden en ballet door jl i Dames. Mise-en-Scène door den Dirocteur O CAEBÉ. 1 >stumes Wapens Requisiten enz. in orgjneele en nieuwe I trusting. !■ Dagelijks Voorstelling. _M Vrijdag 15 April a. 8 GESLOTEN ■ PALEIS VOOR VOLKSVLIJT s MOMAATSCHAP. De-INSCHRIJVING voor de tweede helft van het Maatichappelijk jaar 1880/1881 met dadelijk recht van toegang san geschieden op alle werkdagen van 11—3 uur ten Kantore van piet Paleis voor Volksvlijt. Héiel Palais M&oyah* i (GRAND CAFÉ RESTAURANT.) PALEISSTRAAT OVER DEN DAM. Beurs-Thelephoon Post- en Telegraaf kantoren; 40 Kamers en Salons volgens tarief en pension. Tafel van 4 tot 7Vs uur ƒ2 met 1/2 fiesch Wijn. Tram- en Thelephoonverbinding. t.13756) __ €afé ConËimemtal3 (EERSTE WIENER CAFÉ.) BILJART. • SARPHATISTRAAT. (Tulpplein tegenover het Amstel-Hotel) De beroemde WIENER MÉLANGE is dagelijks verkrijgbaar. Specialiteit in ENGELSCHE BIEREN.  ( TOT BEVORDERING DER TOMNST. Afdeeling AMSTERDAM. ZATERDAG 28 APRIL 1881  des avonds 7*/2 Uur in het Paleis voor Volksvlijt ten bate van het KUNSTEN AARSFONDS. ELIAS Oratorium van F. MENDELSSOH** KARTHOLDV- Onder leiding van den Heer JOH. J. H. VERHITLST. SOLISTEN: Mejuffrouw LOUISE PYCK uit Londen Sopraan. // ADÈLE ASSMANN uit Berlijn Alt.' - ■ De Heer HENRICK WESTBERG uit Stockholm Tenor. // * MAK FRIEDLANDER uit Londen Baryton. Voorwaarden van toegang zijn: Leden der Maatschappij vrij. Dames en Kinderen Deneden de zestien jaar f 9.50. Niet-Leden der Maatschapppij » 3.—. Bespreekgeld 25 Cents per plaats. Plaatsen te bekomen en te oespreken bij J. H. en G. VAl> HETEREN Hartenstraat 21 alwaar de platte grond derZa» te zien is en Tekstboekjes te bekomen zijn. ~""",http://resolver.kb.nl/resolve?urn=ddd:010103991:mpeg21:a0030:ocr,6,ddd:010103991:mpeg21:p006,Algemeen Handelsblad,1963
1354244,1881/02/26 00:00:00,1957,ddd:011148427:mpeg21:a0020,http://imageviewer.kb.nl/ImagingService/imagingService?id=ddd:011148427:mpeg21:p003:image&x=801&y=64&w=692&h=1957,ddd:011148427:mpeg21,1493,2021,801,64,5,HODTVMOOP. De Notaris VAN EVERDINGEN te Terborgh zal op Dinsdag den 8 Maart 1881 des voormiddags 11 uur aan' de Wiemelink in den Slangenborg onder Ambt-Doetinchem VERKOOPEN: Voor den Heer J. .Semmeliuk. liggend SLAGHOUT DENNEN voor Zaagblokken Ribben en Latten ALSMEDE DENNEN voor Rikkens alles op den Stoltenborg en in■: het bosch afkomstig van Labbers aldaar; aanwijzers G.' J. STOLTENBORG en W. MEIJERMAN. Een aantal perceelen ELSHOUT op het Ellegoor aan te wijzen door FRITS BULTEN. Voor den Heer H. Semmelink. Een aantal perceelen ELSHOUT en DENNEN voor Rikkens in de Wijborgsheide. Aanwijzer G. J. VELDHORST.,http://resolver.kb.nl/resolve?urn=ddd:011148427:mpeg21:a0020:ocr,3,ddd:011148427:mpeg21:p003,"De Graafschap-bode : nieuws- en advertentieblad voor stad- en ambt-Doetinchem, Hummelo en Keppel, Wehl, Zeddam, 's Heerenberg, Ulft, Gendringen, Sillevolde, Terborg, Varsseveld, Dinxperlo, Aalten, Breedevoorde, Lichtenvoorde, Groenlo, Neede, Eibergen, Bor",692
1563660,1881/03/21 00:00:00,1533,MMKB08:000090131:mpeg21:a0003,http://imageviewer.kb.nl/ImagingService/imagingService?id=MMKB08:000090131:mpeg21:p001:image&x=2776&y=1751&w=1020&h=1533,MMKB08:000090131:mpeg21,3796,3284,2776,1751,12,Advertentie Tliéatre dit* iilieMi. iLcaudi 31 Mars ISS1 7 l / 2 heures a la Demande Générale UNE REPRÉSENTATION DE M me lyA&MOFF des Théatres de Paris et du Théatre Impéria de Saint-Pétersbourg avec le concours de M. DIVOOR du Théatre du Chatelet; M. BRELET du Théatre de 1'Ambigu ; M. ROY du Théatre de la Porte-Saint-Martin ; Mme LAURENTY du Théatre de 1'Odéon ; Mlle BL. QUETY du Théatre du Chatelet; M. FRANCIS du Théatre des Variétés ; M. POUCTAL  du Théatre des Nations; Mlle GUERARD  du Théatre des Folies-Dramatiques. JeanBaudry Pièce en Quatre actes de M. AUGUSTE VACQUERIE Mme D'ASKOFF remplira le röle D'ANORÉE LE SPECTACLE COMMEWCERA 3?AR LE ROMAN D'PE HEURE Comédie en un acte de M. HOFFMANN. PRIX DES PLACES: lre Rang  Loges Stalles et Baignoires ƒ 2.—. lre Rang 2e Gal. et Parquet ƒ1.50. 2e Rang ƒ1.10. 3e Rang ƒ0.50. 4e Rang ƒ0.30.,http://resolver.kb.nl/resolve?urn=MMKB08:000090131:mpeg21:a0003:ocr,1,MMKB08:000090131:mpeg21:p001,Arnhemsche courant,1020
3141432,1881/05/28 00:00:00,2898,ddd:110536334:mpeg21:a0044,http://imageviewer.kb.nl/ImagingService/imagingService?id=ddd:110536334:mpeg21:p006:image&x=3120&y=21&w=1084&h=2898,ddd:110536334:mpeg21,4204,2919,3120,21,10,"Chartcred-Bank of India Australia & China. Incorporated by .""""'tul Charter. I apitaal ' .' £ .^OOOOO. 1 eservefonds » 20 '000. HOOFD-KANTOOR Matton Cócrt T !IRE iDNEEDI.ES RF.ET I.ON"">ON. BAN KIERS: (ilOPü & 'o. Ds Nedkrundschk Uandelmaat SCHAP? J. ' MSTERDAMSCHK B.\.NK. W'kRTHSIM v (tOMPERTS. • Rotterdam — Vi Hank. < lari/s CaIISSK l OMMERCI.YLE DE I'aUIS. ■ tlOßtburg _J. EREnBERU ""OSSLER v-- Co. Breaten—JoI. Langs . oax's Wwe. s** Co. • Losduit — The '~\t\ Bank Lm iv Schotiani — Thb national oank of Schotland I'R.NCHBS EN' AGESTSCHAIPrfN — HowthaiJ Col m'<o l'a.cntta Akt/ab Batgoom l'auitg Singapore I etana Soerat.ai/T. Hongkong khangJiae. ltokohauiu. Kankotc Afani/u. Het •GE v P BA TA ■• IA geeft Wissels af op het Hoofd-h'antoof en de r ankiers te AmkSterdaet Rot. lerdvm Parij. Hamburg hremen. l.ondon ScJtoll.nd en alle l'ranches. 'gentschappen alsmede op Abiob en .liistraïte. Verhandelt en inkasseert Wissels. Remitteert gelden in eigen Wissels zonder berekening van to ni missie en belast zich met alle gewone I ankzaken. DEPOSITO'S voor langer termijn en in i.ekening Courant worden aangenomen op voorwaarden nader bij den ondergeteekende te vernemen. Alle briefje* moe-ten geadresseerd eu Remises betaalbaar gesteld worden aan Ihe Chakteked Hank of Indio >. USTHALIA &£ I'H.NA. A. GKAY Agent te Batavia. 1 '-KKttsPOVDESTEN' : Te Savaraug de Heeren van dkn Hruek k V'e ckins. • Malta tor . . J. F. van 1 eeuwkn & (o. < atiting .  .1. F. van 1 kkcwen & Co. ..at *■**■. r*.- s - *"" ~2.S^ea.SWtVat^«VP7^^W*ff3Bt^bV*i*KMr Hanseatische Feuer Versicherungs Gesellschaft „Hamburg"" Queen Insurance Company De aganten van 1 BKAND-ASSURIN- TIE-iIAATSCHAPPUEN sluiten - aRZEEERING'ïN tegen gebruikelijke premiën. REiSS & Co. •>*» '-t-nr.ia.. Sottrciiiaya «n Mar.mtnr.",http://resolver.kb.nl/resolve?urn=ddd:110536334:mpeg21:a0044:ocr,6,ddd:110536334:mpeg21:p006,Bataviaasch handelsblad,1084
177870,1881/05/09 00:00:00,330,ddd:010063413:mpeg21:a0040,http://imageviewer.kb.nl/ImagingService/imagingService?id=ddd:010063413:mpeg21:p008:image&x=1825&y=146&w=539&h=330,ddd:010063413:mpeg21,2364,476,1825,146,12,NU IS het de beste tijd voor broeden. Verzuimt dns vooral niet de BROEDEIEEEN te bestellen bij HALVEUHOUT & CO. Groot Hoenderpark Soest. Nog verkrijgbaar Prijscouranten No. 30. (3724),http://resolver.kb.nl/resolve?urn=ddd:010063413:mpeg21:a0040:ocr,8,ddd:010063413:mpeg21:p008,Het nieuws van den dag : kleine courant,539
3241680,1881/09/14 00:00:00,3120,ddd:110536736:mpeg21:a0019,http://imageviewer.kb.nl/ImagingService/imagingService?id=ddd:110536736:mpeg21:p003:image&x=1111&y=3165&w=1039&h=3120,ddd:110536736:mpeg21,2150,6285,1111,3165,6,"EL & S. EAU DE COLOGNE I>c . ] abriekant van de Echte il- «feta». Ea.u deColognegeeft by drtie kennis aan bet publiek dat de Heerex BN 0 ELH ARD * Cc. te Batavia i* MBge IMPORTEURS vaaajja ?AURJCAAT nieo. Pt KISTJES dragen behalve het Fabri-akemsirk ca iyn segel Joi ""in «^gedrukt! (4*B) FRAN<?OIS MARIA FABINA. jjul om nf ' Ctltgtat No. ""«sVTIJU Onvergaii !eur MUI BAY & LANMAÏPS FLORIDA WATER ï'c br?fc duurzaamste en fijnst* *■''"" Pa't'!iii<'i(n \(.(>i (it- zabiork |!rvNtlA cc toic!al~ll*' Pn ■"" badkamers. i'oerliJli vfifcpf-cliriKl lüj \cii. **$*!•&• ~iS' :ilm;1'H* ""-eui.i\\a.']iiinl:-i.l u 8c KFjVPS FLORIDA VVA© Verkrijgbaar bü alle Parfum*' rs Drogistea en ia délailz.aken. Hwofd-Depól bij ENGELHARD '. Co.. Batavia. (64) De ondergetekenden benoemd tot AGENTEN~ van de Hamburg-Magdeburger Feuerverscheirungs Gesellschaft in HAMIiUTRaU-. njn bereid tot het sluiten van VERZEKERINGEN 'eegen BRANDGKVA-YR op hier gebruikelijke voor vaarden. 3354' BfiSlNO BCHB6DKB fc Co. isLa Foncière"" gevestigd <«- i*nr\\%. Knnitiial 25 millioen francs. De ondcrgc'tckc.icli;.! nemen bov-ngenoemde Maatschappij % erzekeriil»e;<»ii /)>(■-gevaar aan tot de «ehriiikelüke premiën naar alle deelen der wereld. J. F. VAN LEEUWEN k Co. (876) Agenten.",http://resolver.kb.nl/resolve?urn=ddd:110536736:mpeg21:a0019:ocr,3,ddd:110536736:mpeg21:p003,Bataviaasch handelsblad,1039
2387943,1881/03/10 00:00:00,2627,ddd:011085802:mpeg21:a0016,http://imageviewer.kb.nl/ImagingService/imagingService?id=ddd:011085802:mpeg21:p003:image&x=2838&y=4130&w=909&h=2627,ddd:011085802:mpeg21,3747,6757,2838,4130,4,Attentie! MEVR. KOENS «irnigos ïuinsoharen. Groote ScLaren. Middensoort Scharen. Kinderscharen. Nagelsoharen. Borduursoharen. Lampcnsoiiarea. jUikkdnichartn. Plooucharen. Tafelmessen. lsessertmesaen. Voorsnijmessen en Vorken. Zakmessen. Tornmejes. Ekstseroogenmesje». Hakmessen. k ardappe len-Mesjes. Berlijn tiWtren Lepels en Vorken van Jont h Go. iJerliu Niekellen Kurkentrekkers. AUMBDn; Spritsen Spuiten. Bieren-Klutsen. Biebtukhamers. 669 Dcegrollen en». en» De echt heerlijke Deensche Boter VAN p £. EaBENSEW COPENHAGM Uasaas.jiia» ***** * 09') op nieuw ontvangen in een twee en nerponds blikken. By Tan Tjoen Gwab Idem Swie Hing & Co. Oei Moo Liem & Go. verdere tokohonden 1 IM«,http://resolver.kb.nl/resolve?urn=ddd:011085802:mpeg21:a0016:ocr,3,ddd:011085802:mpeg21:p003,Soerabaijasch handelsblad,909
3122688,1881/03/26 00:00:00,3424,ddd:011085816:mpeg21:a0033,http://imageviewer.kb.nl/ImagingService/imagingService?id=ddd:011085816:mpeg21:p004:image&x=2844&y=3343&w=912&h=3424,ddd:011085816:mpeg21,3756,6767,2844,3343,6,"ECHT P&Süftßft 818 Kaiser Brewery Tia B E C Hl & Co; yrwKBIJGBAAH BIJ _ S W VA.N DUÏM b 00. | M §4pa» •ÉT «* -ff hifi» v eOTIRè la la L/tenscfae kwaliteit in blikken van i e"" ' pond |iiJi.K.ltOOr)l> Of ALLü vvEKiOuUIiNTOONdTÜLLiMtiiiN waarby gekowrtateeid werd dat blikken van ± 4 jaren uudcrtkm uy opening niet» ie wenaehun overlieten wat unaak kltur en ttevtgc .*bitanttc Mrctf.  . l>e*e Boter tcnuj in haar loori ia en détail verkrijgbaar gesteld uy alle tokohouder». IIUUüJiBLIK. ia VOUiUIEN VaM i»JS HAN|>. iifiüKiNLNÜ VAN i>üiN ÜÜ-ÜU f. W. HEÏMAM loomede van een 1> Ci-iiTii) IüAAÏ door i'.peren KKOHXKKti op de UKiiüXDliWfUOiN. aiXLLiAü TE i'iilLAilüLi' Üia uitgereut vaar op wij bet publiek ijjectaai attent maken. Voor uen VJUiKOOF &N (iiiOa vurvoege men ticb tot de Agenten voor SoerabaiaJl «o _ VAA DPYM <fe Co. Portland-Cement prima kwaliteit. Goedkoop verkrijgbaar bij 7« VAN ÜUYM k 00. De echte prima kwaliteit MIJ m GOLOGNB. mm MARIA FARITII dem Altenmarkt Köln is te Soerabaia uilsluitend yerkryghaar bij de ilriiia T   vin ixiïM & Co. «•f » t 9 u.®» Ir t/'r Wi \ I",http://resolver.kb.nl/resolve?urn=ddd:011085816:mpeg21:a0033:ocr,4,ddd:011085816:mpeg21:p004,Soerabaijasch handelsblad,912
2413114,1881/07/15 00:00:00,2761,ddd:010587966:mpeg21:a0035,http://imageviewer.kb.nl/ImagingService/imagingService?id=ddd:010587966:mpeg21:p004:image&x=2803&y=2820&w=874&h=2761,ddd:010587966:mpeg21,3677,5581,2803,2820,12,Een SMIDSKNECHT met het Kagclielmaken bekend kau terstond geplaatst worden bij H. HAMMING te Holwerd. Een SMIDSKNECHT kan terstond vast werk bekomen bij GEBRs. v. d. MEER te Berlikum. J ELZINGA te Tjummarum verlangt ten . spoedigste 2 TIMMER- en METSELA ARSKNECHTEN een met Molenwerk bekend. Een Kamer disponibel. Mfetselaars. De Aannemer J. 11. VOS vraagt tegen hoog loon flinke METSELAARS voor een uitgebreid Bouwwerk te Kampen; welk werk eerst in 18S3 zal voltooid zijn Adres aldaar. Bekwame TIMMERKNECHTEN gev7aagd te Amsterdam door D. GERLIJN&Zk. en A. J. de HAAN. Adres P. J. v. n. MEER Caté Panorama Plantaadje Middellaan Amsterdam. Tegen hoog loon kunnen direct geplaatst worden flinke METSELAARS aan <h Schelen te Noordwijk binnen en builen nabij Leiden. Aanmelding bij den Aannemer T. BOONSTRA te Noordwijk. 2WAGENMAKERSKNECHTEN H. G. ten deele hun werk verstaande 1 met Rijtuigwerk bekend kunnen dadelijk werk bekomen bij J. W. de BOER te Franeker. Brieven franco. Niet op Zondag te spreken. Twee VERWERSKNECHTEN kunnen direct werk bekomen bij D. HOITSMA te Cornjum. Een KOPEfiSÊAGERSKNECHT zijn .■.© grondig verstaande kan tegen boog loon dadelijk geplaatst worden bij A. FABER te Blokzijl. Agenten gevraagd voor den verkoop van BONS'tegen hooge provisie en billijke voorwaarden. Franco brieven met ingesloten postzegel voor antwoord aan den Heer J. v. n. BERG Dz te Franek.-r. Dienstbode gevraagd te Rotterdam  met primo September goed kunnende werken en ecu burgerpot kunnende koken van goede getuigen voorzien. Hoog loon naar bekwaamheid en goede behandeling. Adres met franco brieven onder lelt. C P P  Alg. Adv.-Bureau van NIJGH k vak DITMAR Rotterdam.,http://resolver.kb.nl/resolve?urn=ddd:010587966:mpeg21:a0035:ocr,4,ddd:010587966:mpeg21:p004,Leeuwarder courant,874
1783080,1881/10/22 00:00:00,1143,ddd:011148461:mpeg21:a0021,http://imageviewer.kb.nl/ImagingService/imagingService?id=ddd:011148461:mpeg21:p004:image&x=47&y=3001&w=1560&h=1143,ddd:011148461:mpeg21,1607,4144,47,3001,4,VQQK OBM WINTIR. Ontvangen: Eene ruime keuze SAIJET in alle kleuren hfl a. J. LINDENHOYIUS té Aalten. STALHOUDERIJ. Ooesbergh Zandbergstraat. B. T. ROODING. §|||| Leesinricbting van Dag- en Weekbladen VAN JT. JE». V.AJV CAPPELLE t© Doetinehem. Voor hen die nog niet van deze Leesinrichting gebruik maken bestaat dagelijks gelegenheid om zich aan te melden voor de lectuur van een of meer der onderstaande Couranten / tegen billijke conditiën. Nieuwe Rotterdamsche Courant. — Handelsblad. Haarlemsche Courant. — : Het Vaderland. — Nieuws van den Dag. — Arnhemsche Courant. — Zntphensche Courant. >— Uilenspiegel. — Eotterdamsch Nieuwsblad.,http://resolver.kb.nl/resolve?urn=ddd:011148461:mpeg21:a0021:ocr,4,ddd:011148461:mpeg21:p004,"De Graafschap-bode : nieuws- en advertentieblad voor stad- en ambt-Doetinchem, Hummelo en Keppel, Wehl, Zeddam, 's Heerenberg, Ulft, Gendringen, Sillevolde, Terborg, Varsseveld, Dinxperlo, Aalten, Breedevoorde, Lichtenvoorde, Groenlo, Neede, Eibergen, Bor",1560
1212960,1881/06/29 00:00:00,1520,ddd:010187411:mpeg21:a0019,http://imageviewer.kb.nl/ImagingService/imagingService?id=ddd:010187411:mpeg21:p004:image&x=882&y=3306&w=798&h=1520,ddd:010187411:mpeg21,1680,4826,882,3306,4,"DoelplaatjesJ? ten dienste van Kruisbooggilden voorhanden bij den Uitgever dezer Courant. Per dozijn op gewoon papier S 5 ets. v v „ wit kaartpapier 2a ets. ¦ fffWl?TFßiiMtlllHlll'llll»llllllllil iIILIU I nWMIUWMma ÈJÉfö Qjiina Laroche ?J§rffiH^«v\ en IJzerhoudende lÊß^W]^ LAROCHE KIIAEPELIEN en HOLM Apothekers te Zeist door tal van Geneeskundigen aanbevolen Opwekkend Versterkend Koortswerend het middel bij uitnemendheid om na ziekten of ander lijden de gezonken krachten op te heffen. De IJzerhoudende Quina Laroche is in het bijzonder aan te bevelen bij Bleekzucht Bloedarmoede  enz. Let wel! ledere flesch uit onze fabriek is op den omslag en etiquette met de handteekening „KEAEPELIEN & HOLM"" voorzien; in flesschen van ƒl.OO en ƒ1.90. Verkrijgbaar te Tilburg bij den Heer E. MAETENS en verder in de bekende Depots.",http://resolver.kb.nl/resolve?urn=ddd:010187411:mpeg21:a0019:ocr,4,ddd:010187411:mpeg21:p004,Tilburgsche courant,798
3260816,1881/07/12 00:00:00,3341,ddd:010101714:mpeg21:a0032,http://imageviewer.kb.nl/ImagingService/imagingService?id=ddd:010101714:mpeg21:p004:image&x=3977&y=3561&w=976&h=3341,ddd:010101714:mpeg21,4953,6902,3977,3561,8,"OÖDPAPIER LELIEOBACRT Opgericht 1894. ALLERHOOGSTE PRIJZEN. (11) MACHINALE VERNIETIGING. r^^ =~==n ! Fransche Maatschappij vanLevensverzekerin?. Maatschappelijk kapitaal TWAALF MILLIOEN. Bijzonder voordeeligo combinatiën voor verzekering bjj Overlyden Voor Schenkingen en Bruidschatten. EijfrentenTerzekerinjr. Jaariijksche Winstverdeeling. Particuliere Directie voor De Maatschappij onder- België Nederland en het werpt zich bij mogelijke ge- Gr.-Herlogd. Luxemburg. schilleu aan do uitspraak der Te BRUSSEL rechtbanker.in Nederland _    . . ' België en hot Groot-Her- Madeleiliestraat 56a. toJfom Luxemburg. Bankiers voor Nederland: de Heeren VAN HEEKEREN & Cie. Amsterdam. Hoofdagent te Amsterdam de Heer ABm. HEEMSKERK^ BOTIHFABRIEK. Door vertrek naar elders wordt TE KOOP aangebodeö voor uiterst billijken prijs: Een geheel nieuwe complete _ op het nieuwst met ijssysteem ingerichte BOTERf* BRIEfi met eene Stoomkern van 1000 liters. Allerg'l^ stigst gelegen in een vriendelijk stadje aan water en spo»f' weg. Adres mot franco brieven onder lett CLA aan ""f Algemeen Advertentie-Bureau van NIJGH & VAN Dl*' MAR Rotterdam. (26920) Een te Amsterdam woonachtig solied PERSOON met &' peditie grondig bekend wenscht bij genoegzame deelnem1""* een Kantoor te openen tot het koopen en verzenden a ren?' bours van artikelen van dagolijksche consumptie als Kolonie Waren versche Zee- en Riviervisch Fruit Kunstboter en 2-' enz. onder overlegging der origineele facteurs alleen tegflß vergoeding eener billijke provisie en der verschotten. Zij die hiervan geregeld wenschen gebruik te maken kuD nen met franco brieven onder het motto Consumptie nad""r inlichtingen aan het Algemeen Advertentie-Bureau NIJGH & VAN DITMAR Kalverstraat 62 alhier bekome0  (27159) f IgSpedition Getreidecommission & Consi g-naüonH Rnïirort aia Rliein || FEINBTE BANKREFERENZEN. B bij bejaarde en jonge Mannen wordt duurzaam en onder £* rantie genezen door het gebruik van de wereldberoemde Bfiraculo-Pracparaten van den Oberstabarzt Dr. MÜLLEK» . | Zn horgeven aan het verzwakte lichaam de kracht der ]oW Depot bij KARL KREIKENBAUM te Braunschweig-  (B. ag. Braunschw. 267/364.) (1260*^. : Üffl WAIIffIERTEN Wil JACQUINAIR FILS Zuiver aars van Gebouwd' GEBREVETEEED ALS le UITVïKöER. . Dagelijks te spreken of te ontbieden als vroeger. (16°^ Oude Waal 30 en Kerkstraat 297. ~Door plaatsgebrek z\jn vrij genoodzaakt tel"" Advertentlën tot ecu volgend Mommer to latou lij?*?^ ""gedrukt bij oTa. spiïTlzööS^. '",http://resolver.kb.nl/resolve?urn=ddd:010101714:mpeg21:a0032:ocr,4,ddd:010101714:mpeg21:p004,Algemeen Handelsblad,976
2861292,1881/12/27 00:00:00,2962,ddd:011086044:mpeg21:a0040,http://imageviewer.kb.nl/ImagingService/imagingService?id=ddd:011086044:mpeg21:p006:image&x=6&y=2733&w=966&h=2962,ddd:011086044:mpeg21,972,5695,6,2733,6,"The Merchant'» Marine Insurance Company Limited vastgesteld bij »de Compftüieß Ista 162 &nd 167"" KAPITAAL £ IO&ttGGQ: STEMJI6 Directeuren: ETH ABBATOON APCAB Esq. PETER LUTSCHEB Esq. JAME Mc. GBEGOB Esq. WILLIAM THOMAS MAKTEN Esq. JOHN THOMSON RENNIE Esq. JAMES ALISON STEEL Esq. EDMUND WALTER WINGBOTE. Biiakiers: NATIONAL BANK of SCOTLAND LONDON. Advüc ftSen; De Heeren ABGLES en RAWLIN Secrot&ria BOBSON Esq. ' Dè bovengenoemde Maatschappij neemt risico'iTOor Zeegevaar aan tot de gewone premiên. n: c i -j De Agenten Sg MARTIN DÏCE b Co. •DDB ®n * W Coiffeurs & Parfumeurs. Hebben Tan de eerste Huizen in Europa ontvangen eene groote verscheidenheid Parfumeriën en Toilet 1 benoodigdheden. Borstels en Haarkammen in alle soorten. Handschoenen van le kwaliteit met 1 tot 6 knoopen. Horologe Kettingen van Niekel Manchetknoopen Scheermessen Da» Bingen Porte's Monntüe Tabaksdooien etc. Toilet Sponzen en Bijtuig dito. r' Hemden Dassen en Verschillende soorten boorden. ' Witte en Gekleurde Zakdoeken. • Poudre di Biz en Veloutine in diverse kleuren. ' Salon pour la coupe de Cheveux. grósse Mécanique en Schompoing. Speciaal Salon voor het verwen van haar en baard. Atelier voor aanmank en in orde brengen tan allerlei i'oort van Kapsels Abonnementen roor Haar- en . baard Knippen worden aangenomen^ tiini è ƒ 16.— per vat. 4478 W. VAN SOMEREN OBÉVW fc Co. STEEDS TOO&nAIUDEH : ï CareUbader Sprudelsalz. i% Bii &Jra'to ïMU*.",http://resolver.kb.nl/resolve?urn=ddd:011086044:mpeg21:a0040:ocr,6,ddd:011086044:mpeg21:p006,Soerabaijasch handelsblad,966
2138850,1881/12/03 00:00:00,2450,ddd:010588087:mpeg21:a0003,http://imageviewer.kb.nl/ImagingService/imagingService?id=ddd:010588087:mpeg21:p003:image&x=1887&y=2331&w=873&h=2450,ddd:010588087:mpeg21,2760,4781,1887,2331,4,LEEUWARDEN 1 Dec. 1881. IleJen morgen overleed ons eenigst geliefd Dochtertje THEKLA MARIA. Slechts vier en twintig dagen mogten v/ij ons iv haar bezit verheugen. J. C. OOSTERBAAN. C. OOSTERBAAN—Fransen. Voor de vele hartelijke bewijzen van deelneming ontvangen bij het overlijden van mijn Zoon JU. .D. ZIJLSTRA betuig ik mede namens mijne Kinderen oprechten dank. Harlingen 1 December 1881. Wed. Mr. P. A. ZIJLSTRA—Bahga. Be BURGEMEESTER van HARLINGEN roept bij deze Sollicitanten op naar de betrekking van HOOFDAGENT van POLITIE aldaar op eene jaarwedde van ƒ6OO en vrije Bovenkleeding. Sollicitatiën op zegel geschreven met opgave van ouderdom en getuigschriften van goed gedrag worden tot den 15 December e.k. franco bij hem ingewacht terwijl later zal worden opgegeven de dag waarop Sollicitanten zich in persoon kunnen aanmelden. Harlingen  den 30 November 1881. De Burgemeester voornoemd van HEEMSTRA. De BURGEMEESTER van HARLINGEN is voornemens op Woensdag 7 dezer te beginnen des voormiddags 11 uur publiek te verkoopen: 1. Aan de Stads Timmerschuur en voormalige Kazerne: 74 stuks oude Schoolbanken G looden Privaattrechters 1 id. Pomp en diverse stukken Lood  eenige Voor- en Tusschendeuren 5G oude Straatlantaarns diverse oude Schoolkagchels en een partijtje Brandhout. 2. Op het Terrein nabij de Loods van de Reddingmaatschappij : een oude Rcddingboot en 3. Als Strandvond in de Tonnenschuur: p. m. 45 Battings 2 Oostz. Balken 2 Noord dito en een Stomp. Alles te bezigtigen op Dingsdag te voren des voormiddags van 10—12 en 's namiddags van 2—4 uur. Harlingen 1 December 1881. van HEEMSTRA.,http://resolver.kb.nl/resolve?urn=ddd:010588087:mpeg21:a0003:ocr,3,ddd:010588087:mpeg21:p003,Leeuwarder courant,873
1940024,1881/10/11 00:00:00,1726,ddd:010063565:mpeg21:a0033,http://imageviewer.kb.nl/ImagingService/imagingService?id=ddd:010063565:mpeg21:p012:image&x=1258&y=3503&w=1124&h=1726,ddd:010063565:mpeg21,2382,5229,1258,3503,12,de reeds vermelde bons zijn er voor eenipre dagen weer gevonden o. a. een bon voor twee KAPITALE OLSOGRAPHIËN ieder in een Vergulden Lijst door den Heer P. PANNEKEET Kastelein te Hoogwoud nabij Hoorn een voor een fraaie STAALGRAVURE achter Glas door den Heer l. J. VAN DER VALK Prinsengracht 142 te 's Gravenhage. Het is te kostbaar allen te vermelden; na afloop van dit zaakje zal er een volledige lijst worden bekend gemaakt van al degenen die bons hebben gevonden. Nog niets heb ik vernomen van de bon voor nog een bankje van ƒ25 ook nog niets voor nog een muntje van ƒlO ook nog niet van die voor een Lot Milaan waarop men een burgerfortuin kan trekken evenmin van nog een aantal anderen. Er is dus nog heel wat te vinden!!! EEN GEK DING is het melde bons voor de Sarphati-Loten. Van niemand ontving ik daaromtrent nog eenig bericht en weet dus niet of ze reeds gevonden zijn of niet en daar er bij die loten kunnen zijn die er met een niet zijn uitgekomen zou de vinder dan teleurgesteld zijn. En dat heb ik niet graag. Wie dus zoo eeri bon.vindt zende die dan maar dadelijk op en ter vergoeding voor die loten die een Gulden hebben gekost en nu niets waard zijn zend ik dadelijk een RIJKSDAALDER. Dan heeft men toch wat wel niet veel dat is waar maar GOED uitgerekend is NIEMENDAL toch altijd nog minder. Men ziet: krenterig wordt met dat lachboekje niet gehandeld en dat mag ook niet waar het publiek zooveel blijken van ingenomenheid geeft want in den waren zin des woords er is geen rang stand of betrekking of er zijn bestellingen van ingekomen. Over een dag of wat reeds kan de Honderd Duizend er uit zijn en dan zal blijken wie der bezitters van J. OOLBROER 400 Anecdoten enz. enz. DUIZEND GULDEN cadeau krijgt want in lEDER Exemplaar is een genommerde bon vastgehecht. Wie znllen de vinders der oveiige bons zijn? VOOR 50 CENTS aan blauwe Postzegels of voor een Postwissel van 50 Cent met het woord nAnecdotenu er op wordt franco door het geheele Land het allergrappigste Boekje afgezonden door J. BOERS Groote Marlt 15 VGra?eÉap NB. Zorgvuldig wordt er op gelet dat geen Noromers die reeds uitgeloot zijn worden verzonden. NB. Wanneer de zending niet bevalt stuur die dan asjeblieft dadelijk terug franco krijgt ge uw geld weerom en de briefport er bij. NB. Lees nog eens goed na welke bons nog niet gevonden zijn!!!,http://resolver.kb.nl/resolve?urn=ddd:010063565:mpeg21:a0033:ocr,12,ddd:010063565:mpeg21:p012,Het nieuws van den dag : kleine courant,1124
726544,1881/05/26 00:00:00,722,MMGARO01:000168255:mpeg21:a0010,http://imageviewer.kb.nl/ImagingService/imagingService?id=MMGARO01:000168255:mpeg21:p003:image&x=2540&y=83&w=854&h=722,MMGARO01:000168255:mpeg21,3394,805,2540,83,4,Grands Magasins du Printemps De Dienst der Verzendingen van de % is weder hervat. Men gelieve even als vroeger alle brieven te adresseeren aan M. Jules JALUZOT Parijs.,http://resolver.kb.nl/resolve?urn=MMGARO01:000168255:mpeg21:a0010:ocr,3,MMGARO01:000168255:mpeg21:p003,De grondwet,854
5792908,1881/02/21 00:00:00,6028,ddd:010103941:mpeg21:a0018,http://imageviewer.kb.nl/ImagingService/imagingService?id=ddd:010103941:mpeg21:p004:image&x=1052&y=902&w=961&h=6028,ddd:010103941:mpeg21,2013,6930,1052,902,6,"» i ■■■■■■■ ' i' i — — - ■'. ; __. vèreeniging hulpbetoon aan eerlijke en Vlijtige armoede. Het BESTUUR heeft de eer aan belangstellenden te berichten dat de VERLOTING heeft plaats gehad op Donderdag en Vrijdag 17 en 18 Februari 1881 en dat de PRIJZEN op vertoon der Loten kunnen worden afgehaald alle werkdagen van af Maandag 21 Februari 1881 van 's morgens 10 tot 's namiddags 3 uur aan het Magazijn Binncn-Bantammerstraat 11. Amstekdam Namens het Bestnur 19 Februari 1881. ft. R. CROMMEUN. (6956) J. A. VAN EYK. Ja. "" ZVIGR UNSTTANBEN. Dagelijks Consultatie over het plaatsen van JBIJIOBkEJNST"" TANDEN en TANDHEELKUNDIGE OPERATIËN door COHEN Tand-Arts Kloveniersburgwal hoek Oudemanhuispoort B 80 te Amsterdam. (471) ISRAËLIETISCHE BOTERHAL. De prijs vau de ""itto Leidsche HOOIBOTER is met 5 Ct. per KG. verhoogd. ■ VAN SAXEN & C\ Amstebdait 20 Februari 1881. (7021) het""cëmtraliTbürëaü DEPv SïOOMVAARTLIJN (7003) AISTEIBM-AIIIIA >h mwww MS_attK_n 1 maasms/maaaa*g""b.ma*_*ti_a_waps is van af HEDEN gevestigd aan de NIEUWE VAART in de LOODS der KONINKLIJKE NE.DEBLANDSCHE STOOMBOOTMAATSCHAPPIJ (Kattenburgerloods) Oostzijde I VAN GILS & VAN DER MEER. | ROTTERDAM. AMSTERDAM. M Houttuin 37—39. Warmoesstraat lll.M Eenige Agenten voor Holland #• België van HERZ & CIE MW-ÏORI. uitvinders en gepatenteerde Fabrikanten van Threeply- K fineer-Zittingen Amerikaansche Stoelen Banken Wt Imtimiwi W-fsei.l •de meest gerenommeerde Fabrikanten van HIAS- W& SIEF GEBOGEN MEUBELEN. HH. Handelaren en Fabrikanten die Amerikaansche g Zittingen en Weener Meubelen enz. direct wenschen WM te betrekken gelieven zich voor Import en Export §§| uitsluitend aan ons te wenden. KANTOOR en MAGAZIJNEN te Rotterdam worden §§ met Maart a. s. verplaatst naar den OPPERT 151. É|| bloemzimd mv mm .tuin. _Eeuo VERZAMELING van 20 fraaie soorten BLOEMZAAD van éénjarige of Zomerplanten voor den VOLLEN «•ROND met AFBEELDINGEN eu met beschrijving van de wijze van R WEERING en BEHANDELING wordt afgeleverd a f \.— of franco toegezonden a ƒ1.15 na ontvangst van Postwissel of Postzegels. GROENE WEGI-ftr & CO. Bloemisten Zaadlumdelaars en Boomhweekers. KWEEKERIJEN: Linnaeusstraat 55; MAGAZIJN .-Keizersgracht bij de Spiegelstraat 521; DEPOT: Kalverstraat 75 Amsterdam. (6907) ""te ¥oöp amöebödsn"" DRIE MODERNE PERCEELEN in den omtrek van het Vondelpark en Leidschcplein. Koopsom 48 Mille. Te bevragen onder lett. M.JM Bureau Handelsblad. (6616) EEN DUÏTSCHER 22 JAArIuC wenscht in betrekking te komen als HUISKNECHT hier'of elders van beste getuigschriften voorzien. Adres onder lott. KIK Bureau Handelsblad. (6194) BOEliltOl DER. Tegen een aannemelijk salaris en goede vooruitzichten wordt voor de Administratie van eene uitgebreide Stoomboekdrukkerij in de Hoofdplaats eener provincie een BOEKHOUDER gevraagd die het Italiaansch Boekhouden reeds practisch heeft beoefend. Bekendheid met het vak en kennis van de Duit3che taal strekken tot aanbeveling. Gegadigden wenden zich met goede referentiën tot den Heer N.TETTERODE Lottergieter te Amsterdam. (6958) ~H_L STEÊNDRÜKKËRSTlemand bekend om met Hand- en Srielpers om te gaan zoekt een BETREKKING. Hij stelt zich ook disponibel om in de?.e als MEESTERKNECHT te fungeeren. Brieven franco onder letter A bij J. P. v. d. BOSCH Kantoorboekhandel Frans Halsstraat 44. (6951) ' HUWELIJESAANVRMG. lemand 26 jaar oud eigen zaken drijvende welke gunstio-e voordcelen afwerpen doch niet in de gelegenheid is om met Dames in aanraking te komen zoekt langs dezen weg na wederzijdscho goed vinding een HUWELIJK aan te gaan 1. bc. liefst met onbemiddeld doch geen vereischte met bijvoeging van portret. Geheimhouding wordt verzekerd Brieven franco onder motto //Goed"" bij J. P. v. d. BOSCH Kantoorboekhandel Frans Halsstraat 44. (6950) ' De Tandarts J. A. lIOFïMANN Amstelstraat 45' is dagelijks te raadplegen. Kunsttanden f 4 £ g Goud vullingen '.'.'„ 4 „ 7. Emailvullingen .„ 2 // 3. liet ontnemen van kiespijn zonder trekking..// 2. Het trekken van eon Kies of Tand »1. (6937) (bij den Patiënt aan huis). // 2. Het reinigen van Tanden n 2 a 4. OPRUIMING van een partij HEEREN- DAMES- en KINDERLAARZEN en PANTOFFELS ver beneden Fabrieksprijzen in het Schoen- en Laarze imagazijn van GEBRs. THIJSEN Utrechtschestraat I ij de Kerkstraat N°. 86. (6944) REPARATIE-IHTRïCHTIIie van alle NAAIMACHINES hoe defect ook MET DEUGIELIJKË GARANTIE. Xl-!zJel#raat O •*. v. d. ENGH Amstfkdam b.'d Singel Q (6957) Werktuigkudige. ™?7nrl"" RER»MK-MATTHES Vossiusste^Ts ViCAAUI tegen 1 Mei een fatsoenlijke KEIJK-EM9U-I-D die goed kan Koken en tevens Huiswerk verrichten wil. (6963) ""IAffIÊsTHHHËÏfn Wlltj?6«£e Advertentie plaatsen  in welk blad ook geeft die op: REMBRANDTPLEIN 17; alsdan wordt zê°gratis j overgenomen m .den nJVoninggkls"" of in ""De Krant"" v. Betrekkingen. Verkrijgbaar aan het Bureau en aan alle Kiosken. (6938) I I",http://resolver.kb.nl/resolve?urn=ddd:010103941:mpeg21:a0018:ocr,4,ddd:010103941:mpeg21:p004,Algemeen Handelsblad,961
2718237,1881/03/04 00:00:00,2811,ddd:010103952:mpeg21:a0045,http://imageviewer.kb.nl/ImagingService/imagingService?id=ddd:010103952:mpeg21:p008:image&x=96&y=215&w=967&h=2811,ddd:010103952:mpeg21,1063,3026,96,215,8,"NIEUWE SCHOUWBURG VAM LIER Plantage Fransche laan. Vrijdag 4 Maart: GEEN VOORSTELLING. Zaterdag 5 Maart. Door het operette-gezelschap LUCINDE VOn THEATER. ÏÏ0F"" Verwacht Woensdag 9 Maart: Buitengewone Voorstelling ten voordeele van den Heer RICHARD KORSCHEN Eerste Baryton van het Duitsche Gezelschap. Een wederopvoering van: BOCCACCIO Komische Opor in 3 Aufzügen van Franz von Suppé. (Met geheel nieuwe rolverdeeling.) Zaterdagö Maart. (Na afloop der Voorstelling te 12 uur) GROOT BAL MASQUÉ ET PARE met dubbel bezet orkest. In een der nevenzalen zal gelegenheid zijn zich te maskeren zijnde het prachtige magazijn van de Heeren Kreukniet en Sclmttero aldaar uitgepakt. Het Buffet zal van alle mogelijke ververschingen ruim voor» zien zijn. Entree voor één Heer fl voer een Heer en Dame ƒ3 meerdere Dames ƒl. Ongemaskerde Dames zonder geleide hebben geen toegang. SCHOUWBURG FRASCATI Plantage Middellaan. Directie G. PROT & ZOOM. Vrijdag 4 Maart: DE DOCHTER VAN DEN TAMBOER-MA JOOR operette in 4 tafercelen van Jacques Offenbach. Gewone prpzen. Aanvang 8 uur. DUT In studie: LORRET JE. (Nooit vertoond). SALON DES VARIÉTÉS Amstelstraat Directie: G. PROT & ZOON. Vrijdag 3 Maart: DE VALSCHE MUNTERS of Dejmderaardsche gewelven van 'i Kasteel van Valenza. Drama in 6 tafercelen naar 't Fransch. Entree 60 Cents. Aanvang 8 uur. BÉT"" Donderdag 10 Maart: Benefice-Voorstelling van den Heer EDUARD BAMBERG : DE ORGELDRAAIER EM ZIJN PLEEGDOCHTER. THEATER TIVOLI. Directie W. PIERRE DE BOER. Vrijdag 4 Maart te 8 Uur. Zeker laatste e* m mDE voorstelling van: 1/ »E FAMILIE HOORN vooraf: MIJNHEER VERWACHT MEVROUW blijspel in een bedrijf. ~ Toegaog 60 Ct Zaterdag 5 Maart. DE PATIEMTEM van Johan Gram. PALEIS VOOR VOLKSVLIJT. VRIJDAG 4 MAART 1881. DE SMIDSDOCHTER VAN NAARDEN. Entree 75 Cents. Aanvang 8 uur. Leden volgens Reglement. ZATERDAG 5 MAART 1881 des namiddags van 3—4 uur OROKLttESPELIKO. DES AVONDS: Afsclieidsvoorstelling door het Hoogduitsche Opera-Gezelschap. &ie ZauJberflöte* Aanvang 7V2 uur. Entree: Fauteuils d'Orchestre f 3. Verhooging « %. Parterre » 1. Leden hebben toegang op vertoon van hun diploma elk voor éen halven entreeprijs- Plaatsen zijn te bespreken Vrijdag en Zaterdag.",http://resolver.kb.nl/resolve?urn=ddd:010103952:mpeg21:a0045:ocr,8,ddd:010103952:mpeg21:p008,Algemeen Handelsblad,967
8734824,1881/03/26 00:00:00,4452,ddd:010497497:mpeg21:a0015,http://imageviewer.kb.nl/ImagingService/imagingService?id=ddd:010497497:mpeg21:p003:image&x=102&y=84&w=1962&h=4452,ddd:010497497:mpeg21,2064,4536,102,84,6,"L. PLATON Batavia. VINS EN BARRIQUES CÓTES de BOURG. CÓTES de ERONSAO. MACAU MEDOC. Tin* en C ais ses. . CÓTES de BOURG. CÓTES ERONSAC St. julien medoc. macatj medoc. haut-canon. Grand assortiment DE Vins fins de Bordeaux et de Bourgogne Vins du Bhin de D. Leiden Cologne Vins d'Ëntremets et de Dessert Liquenrs Spiritueux Sirops Fruits Conserves. Seul Importateur DE COGNAC Otard Dupuy & Co. CHAMPAGNE Theophile Roederer $• Cie. n Manuel éf Cie. (Médaille dor Paris 187(- BIÈRE JBOCK ALE de Grüber §f Reeb Sirasbourg. ©Ijjare® fins de la BavaMe» 272 J. GRUUTBR BATAVIA. SEUL IMPORTATEUR DES VINS ET COGNACS de Messieurs (IG 80110811 FrÖrBS & GO.  Bordeaux. ET DES CHAMPAGNES de Monsieur ÖUSISVB GÜ^lt Reims. Vins en caisses de 48 et 96/2 B""<*. St. EMILION. CHATEAU BOURRAN. HAUT TALENCE. St. ESTÜPHE MEDOC. HAUT CANON. » Grand assortiment de Vins fins de Bordeaux rouges et blancs. Port a Port do. Xères et Madère. COGNAC fine Champagne do. extra do. 1«r choix. OHAMPAQNES. DRY VEBZENAY. DRY CARTE BLANCHE. CARTE MÉDAILLES. GBAND CRÊMANT ROSÉ. GRAND CRÊMANT DU BOL Verkrijgbaar te Soerabaija bij den Heer A. WIJNVELDT. Samarang id. G. A. WERMUTH. 281 Pecalongan id. B. BARRUCH. Opgeloste Peru-Guano vervaardigd in de Fabrieken van de Heeren Ohlendorff & (0. te Rotterdam Loste Mtwerpen Hamburg Emmerik. Steeds voorradig bii de Hoofdagenten voor Nederlandsch-Indië C. BAHRE & G. KINDEB 8?7 Batavia.",http://resolver.kb.nl/resolve?urn=ddd:010497497:mpeg21:a0015:ocr,3,ddd:010497497:mpeg21:p003,"Java-bode : nieuws, handels- en advertentieblad voor Nederlandsch-Indie",1962
829124,1881/05/09 00:00:00,1513,ddd:010063413:mpeg21:a0015,http://imageviewer.kb.nl/ImagingService/imagingService?id=ddd:010063413:mpeg21:p003:image&x=1789&y=1611&w=548&h=1513,ddd:010063413:mpeg21,2337,3124,1789,1611,12,"NAAIMACHINES. #De soliedste en deugdzaamste HAND- en NAAIMACHINES voorzien met alle nieuwe verbeteringen en Zelfspoeler zijn tegen ongekend loge prijzen en zeer gemakkelijke Betalingsvoorwaarden verkrijgbaar bij A. LEWEWSTEIN Warmoesstr. 189 over de Visclisteeg AMSTERDAM. _ Deugdelijke' Guarantie en Kosteloos Onderricht. Tweedraads HAND-MACHINES van af / 2a (281-4) i Wa Rifenaker ? MAGNETISEUR. Dagelijks Consult van 12—1 unr. Uitgenomen des Zondags; voor behoeftigen Gra tis Overtoom 106. (5) ""fTTT""?^! voor sleditsj 8 bij eenige vv J.JSH in spanning door zei fonderricht in korten tijd Fransch -wil leeren schaffe zich aan de Methode van LAMBERT DELY onder toezicht van TACO 11. -DE BEER Leeraar te Amsterdam uitgegeven in 5:0 aü bij RLOM &. OLIVIERSE te Culemborg. Op aanvrage worden afl. franco ter inzage gezonden op conditie van franco terugzending bij nietinteekening. (3764)",http://resolver.kb.nl/resolve?urn=ddd:010063413:mpeg21:a0015:ocr,3,ddd:010063413:mpeg21:p003,Het nieuws van den dag : kleine courant,548
8182936,1881/04/05 00:00:00,6058,ddd:110620052:mpeg21:a0007,http://imageviewer.kb.nl/ImagingService/imagingService?id=ddd:110620052:mpeg21:p003:image&x=630&y=128&w=1742&h=6058,ddd:110620052:mpeg21,2372,6186,630,128,4,"pPUMJEKE JERKOOPINGX Op Dingrsda? <!cn 12dcn April itost. de* te 10 uur z«l lm huize VIM G. Ten iiu<ir &J. CNU te Jamestown tni|l ten wffti-n VRii de kerk ce»<e publieke vrrkoopitig g»houdt-n worden vs.n 4 werkpaarden («aarvan twee fi jaar oud en 1 vier jaar oud) 1 veulen .'I koeien 6 varken? 10 schapen ganzen kippen en eenden II wageu's 2 cutters en 1 groote ilede en barnessen ook ecu bondon kracht karn * landtionwgerefcdi>cliapp* u en «at er Verdtr zal worden gepre| Kr sal G maanden crcdict gegeven worden. Voor het Vee. I)e ondergeteekende maakt den hecrcn veehouders bekend/ dat hij lich te Fillmore gevestigd heeft als heel en verloskundige van het veo. llij geneest alle mogelijke ziekten en castreert « hengsten en Klieren. • Ten huize van Klaas Dijkstr?. W. J. BAKKER. Probate Order. — STATK OF MICHIüAN.) sg£3»9ÉLIPB| COCKTT or OTTAWA.' I Al a seaaion of the S Probate Court of the Countjr of Ottawe.holden et the ProliateOflice in the City of Grand Haven in eeid Connty on Wedneaday the Thirtieth daj of March in the year; one thousaad eigbt hundred -I and eighty one. PKESCKT: Samnel L. Tate Judg* of Probate. ■ln the Matter of the Entate • of DerkJ. Vork deceased. ' Y'r. JJ On readidg "" and filing the petilion duly verified.of Jacoh D. 'Vork 4 praying among 'othnr things for the Probate of an instrument in writing (ilrd. in this Court' purDorting lo l»e tho Last Will and Testament óf said Derk J. Vork Deceased and - thst administration thcreof ma v l»e granted to the persoo named therein es Thereupou it is Ordered That Wednetdsy the day [of April next at one o'clock in the afternoon»'! Be asnigned for the hearing of said Petition and tliat the heir j at law of the said deoeascd and ell other persons interested in said estateare required to appear at a seeaion of said Court then to be holden al tho probate office in( Grand! Haven in isld Couuty and show cause if anv th».re be why the prayer of the petitlonera should not be granted; And it is further Ordered that said petitioners give notice to the j per. sons interested 1 in said cstaie of the penden* cy of ssid petition and tho hearing thcreof hy causlnga oopy of this order tobo publUhed in DBGEOKDYTKT H oewspaper priuted aud cir.oulated In aai i Couuty of Ottawa for three sucoesslve weeks previous to said day of hearing. BAMUEL L. TATE. Lv A tm eopf (Atteit.J of PrvUet^ «K-MMj-iy BETROPWD;--.—J • »„• Uilrouwil doof Ret. Brooni KLAAS JONKER mei NEKLTJK VAN HEES. 'Kustland 111. S 9 Maart 1981. Door lUT. Meindara un do putorls ROLIENIS DEJONU ■ -mot GRIETJE NIEUWEHOF. Suuili Holland 111. 31 Maart. OYEHIEI)EN. •#* Tan dc acht kinderen ons getioren moef ten wij lieden oua jonaste Fraiiei*. na een i'ijulijk lijden van tweo «reken Is di-notideidom van G tuaandvn ril 19 dagen . niia»en. In ile smult. Irwjai ona da gedachte dat *'dersulkao hvl Koningrijk der hemelen i< JAIIES BRANDT JASE B HANDT «kD. Gbootkuaat Forreal Grove Mich.3l Maart. ltitJl. Aan ïnljae Vrienden e» Uefnnsllger*. Dewijl ik niet in stunt len met mijn fiiitk/wniltl alleen mijn huisgezin U; onderhouden too ben ik besloten om ook Okciki.s en Piano's te verkoop» n. Op eene vriendelijke eerlijks en billijke behandeling kau men rekenen. De instrumenten kunnen gezien worden bij uiij ann hui» ten luiden van llope - Ook wensch ik er opmerkzaam op te maken dat men bij mij alle soorten : van Boeken kan verkrijgen voor Huisgezin Kerk Gezelschappen enz. ■Do laatste uitgaaf van . den Staten Bijbel van. Ds. Dunner bezorg .ik vrij voor $13.0(1: Goed papier en de beste band. Ook DachseU Bijbelverklaring in half leer voor $30.00."" Ook wil ik ecuig boekwerk ontbieden uit Nederland. Xlurrcspondcntio wordt vriendelijk verzocht. . M. KIEKINTVELD.- nolland Mich 28 Maart 1881. ORGELS ORGELS Die een ' ORGEL"" begeert vervoege zich in den grooten en welgcvulden MEUBELWIXKEL van Meijer Brouwer Je Co. Zij verkoopen de BUSTE OLLGELS tegen zeer LAGE PKU BRILLEN. ' Do apotheker J. O. DOESBURG heeft een volledige verzameling van Brillen voorhanden voor oud en jong en van verschillende prijzen. De brillen zijn allen volgens het boste' stelsel vervaardigd en zijn dus niet zooals vele anderen schadelijk voor dc oogen maar bewaren en versterken hst gezicht. 7)JÏ /VX.IfA . MEIJER BEO UWER $ Co. zijn nu bereid om in alle begrafenis behoeften te voorzien voor Rijk en Arm. Zij hebben zoowel do lVnlnoten en ■net taken Bekleede ('askets als de meer goedkoopc doodkisten steeds voorhanden vuti allerlei maat eu kwaliteit. LIJKKLEEDEN' voor groot en in soorten. ' - Balsem om besmetting weg te namenen de Lijken cvoor bederf U bewaren ten allen tijde bij hen verkrijgbaar. TE UUUH.^BBH Een Goed Huis met 3 acres grond te huur 1 mijl ten westen van de stad. Op den grond staan GO vruchtdragende appelbooinen 150 wijnstokken en pecrcboonicn. Tc bevragen bij R. E. Werkman aan de I'hoenix Schaffabriek. VOOR ROSEÏAND ILL. LAARZEN en SCHOENEN worden door den ondergeteekende sterk en netjes gemaakt of gerepareerd naast den Boekwinkel van Mr. C. Keijzer. ESr ZEGT HET.VOORT. y-ii >- - C. VORST Jr. Roseland 111. VOoRJAAIW INSLAU. Mr. 15. Herold de welbekende fabr}'- kantcn verkooper van schoenen laarzen pantoffels enz. maakt bekend dat bij hem ontvangen zijn do goederen voor het voorjaar en den zomer. Deze goederen munten dit jaar boven andere jaren uit door sierlijkheid van vorm en deugdelijkheid terwijl de prijzen niet honger "" zijn dan anders. Wij kunnen den winkel van Mr. Herold gerust aanbevelen omdat men aldaar yoede waar kan koopen voor billijke prijzen. Do ontvangen vooijaars- eu zomer goederen omvatten een ruime keuze van allerlei. soort en Ï rijzen terwijl over het algemeen Mr. i.llerold goedkoopor verkoopt dan de winkeliers te Grand Rapids. Men geve hem een bezoek bezie zijne goederen en verneme zijne prijzen waardoor men zelf overtuigd zal worden. Marktprijzen te Chicago. De marktprijzen waren den lstcn April te Chicago als volgt: Voorjaars ferwi «I.o} @ll.ol}* April «1.07 (a. 1.07} Mei $1.07} @ 1.07} Juui en sl.oo} @ 1.07 Juli. Corn 38} @3B J c. April 42} @ 42} e. Mei 42}@ I2}c Juni en 43} @ 43} C. Juli."" Haver 31} @ 31}. April 35} @ 35} r Mei cc 34}@34}c. Juni. Rogge U.'> 2 (s 1.02} Mei. Gerst $1.05 No. 2en 85 e No. 3. Gezouten spek $15.02} @15.02 April $15.70 @15.72} Mei en $15.77 J @15.80 Juni. 1.3"" ■ Karktprijten te KewTort. Dc marktprijzen waren den lstor April to New York als volgt:'Flour. no 2 $3.10 @ $3.60; Wcstersche winter $4.90 @ . $O.-0. Tarwe no. 2. roode $1.24} @ 1.25; nov 2 witte $1.20} & 1.21. Corn 57} c. April' 54} e Mei Haver no.' 2 witte 40 c.' Gerst sl.l' voor no. 1 Cauada. Rogge $1.07. Marktprijzen te OetrSjt^Hß De waren t denMlifei April te Detroit als volgt: Tarwe no. 1 witte $1.07}' no. 2 witte $1.05}; no. roode ♦l.o9}^MBMmßMmÉB|[ Marktprijzen te Grand Rapids. i D«marktprijzen waren den4den Apri te Grand Rapids zooals zij worden opge geven en betaald - door > voorhis j&iCo. hoek Jlonrooit -N. Division straat al: volgt: Tarwe 92 @ 94 e/ Corn"" 46 (5 PLAATSELIJK HIÊUWS UITSLiU 15 ÏÊEXiXtfTOnSSHiP Suptrrlnor O Van Loo 276 ▲ Kiddering -  Van Loo 8 meerd Vl5 l'own*hlp Clerk J deu Hardet JTCfI A ltidüeriug 70 «•. - ; * Deo Herder'* meord. lüa rownMiip Traaaurer J Fut Sl9 J J Van Zoeren JIU F«»x'a meerd. 103 Ju»tic«*of Ibe r««c« \ ran Zovrca IC3 lOO Vnn Zoeren'* meerd. 'J Commiaaloner of lligltwa/a 8. de Hnop IS!) ~C. de Puttir ; 147 Ut ïToop'g meard 41 Superintendent of Schools. K. H«r.r 205 A. T. lluizii ga IttC Dorst'* meerd #5 School lu«pet-tor J G van Hees 33? I»e v«i kozt*ii konstables zfjn J D Everharc roet 111 J Hk/iji 15b 8 van der Aluer 140 en L lieins mit 160ateDinien.'*^Q T Da gehrele ateiu uit gebrscht ia . 337 waar* cao da UepubUkeiuacb* Staata Ticket er l'Jd UITSLA IJ IN TOWN FILLMORE. Supervisor JWGarVelink IJ Uendlik J Klomparena K Garvelink'a meerd 31erk Gerrit Garvelink 2J Jacob U Schepera - Garvelink'a meerd 1' rfnMitrJMpHMA Mathew Kotier lï K vau der Liude 't Notfrr'a meerd fuatice full term J W Ganelink J L Fairlanka Garvelink'a meerd. to tiil Vacancv. Albert S. Fait bank* Abel U Drink •• A S.Fahbank's meerd. 3ommi*sioner of Higtwaja IX rk Lenieia G S De Witt J Schaap T>erk Lenler'a meerd over belde Sup'i. ol Schoola sup t. ol bcboola J U Seheper* ' A U Strabbing 5Ï A O Msntinyh 103 ichool li.apeotor Gerin W. Moktna IW J W Garveliuk 105 alter"" ' 'JPWBPf G W. Mokma'a meerd. S« ■ De verkoten Constablea zi|n; M Harriügou J U Hoek Fred Re miukA Helleuthal. Voor Jutftlce * of the Supreme Court s#'J neerd. en da Circuit Judge 10:2. UITSLAG 15 HOLLAND TOWNSHÏP. Supervisor W Diekema 3-46 John Lahuia 70 Diekema'a meerd 270 Clerk J Marailje 324 A J Hillebraad* 91 Marsilj*'* meerd. 233 rreaaurer I D Jouker M Pelou 1» ** D Jonker'* meerd 142 >chnol Inapector lohu Tei» llate 33' J tl van Kijk 67 Ten ïlave'a meerd. 27a Superbitendent of Scboola K A Uijma 31!» A Lahuia 57 Hijma'a meerd 21f2 of Higwa/a T Dijkeen 214 G H Souter VU3 Dijkema'a meerd. II ) uuMce of the I'eace O Öi-hilleuun 2*27 H Venekhuiaen luu Schilleman meerd. 45 De rerkozen Conalabtea ziju A eau Dijk. mei 228 K de Haan met 210 D Warnera met 160 au Willem bacon met 153 «temmen. voor Rechter van het Hoogste Gerechlahof [aaac Marston rep. 197 A. G. liabJwin dem. 77 Üh.G. Hyde (Atsck) IJ# Hegenten Van de Unirersitelt. .TameaF. Joj. rep. 193 • ; ■- Toet Bezeerd. Corneli* Kuite toon van Mr. Leen Kuite. had heden hel ongeluk zijn voet aan de zaag in Fixler'a duigenfabriek \lhier te bezeeren. de hulp van dr. Wm. Van Putten werd iugeroepen Verdrookou. Mr. Jacob Loula heeft ftich gialeren. Maandag morgen in het Meer achter Kuite's ! alachthuia Zijn lijk werd dea middags opgehaald. Hij bad een bijl uit zijne woning meegenomen om eene opening iu het ija \te hakken I doch toen hij I reed* eene opening vond de bijl weer op deu 1 ""al gelegd. De man *ai 45 jaar oud en ongehuwd. Hij waa een zwager van Mr. Levl Johnaon vau Giand Rapid*. . m I e I m Verkiezing te Gr.' Haven. Mr. Arie Wollmau ia te Grand Haven tot Mar»hal gekozen. deu verderen uitalag hebben wij geen inlichting kunnen bekomen. MMflHßlii 3H9MBnnI^KnWnBHEBBHB ïST"" Nioawe Goederen juist ontTU- —-&OÊ n Star (lolhlor Home. Wij pluUea in dit nummer .» I ni.uwo MlTertcoti. | Tan h.t Sur Clolhing Uouic t. Crmnd KapiUl. Dit Hui. hetwelk gemaakt kleerea rerkoopt en klceren op d. Baat ■ maakt ia 11. wel bekend dan dat bet; veel aanbeveling vaa ; ona noodig heeft.  AtJ.cn willen . wij leggen dal in dtr.cn winkel ons. ' landgenoot Vaa drr Werp werkzaam ia xoodat ome landgenoottni a:lluneig e n J t a a I daar kunnen handelea en tekerer *raa rijn dat zi| fataornliik en errlijk behandeld t tallen worden .Het Star Clolbing ren een vertroewbara winkel waar duizendtn en duiaenden hanne goederen hebben gekocht zonder ooit bedrogen nittekoman. Men zia hunne prijzen in d. nieuwe advertentie in dit nummer om orertoigd Ie worden dat men daar goedkooper kan koopen dan argea» eldere. éNMÉHÉM • . - Nlenw» tm P Hop Bitter hetwelk In onze kolommen geadverteerd Is U een zeker geneesmiddel voor koude koorts galachtigheid enl nieren kwalen. Eiit die bet gebruiken kunnen niet zeggen dat het te veel wordt s aangeprezen.' Zii die lijden moesten het een eerlijke proef geven en zullen daardoor vol geeatdrift geraken  ia huuoen lof over desxelf* geneeskrachtige ei* geuscbuppcn.—Portland Ad. I; . Terwond.— Mr. Roelof Strik town bad verledm week het ongeluk zi|n | tom te bezetrta tutechea leg». - ■tó jf-E* -. -h ■ - ■■■  . ... r*. . L '.. -- 5 *",http://resolver.kb.nl/resolve?urn=ddd:110620052:mpeg21:a0007:ocr,3,ddd:110620052:mpeg21:p003,De grondwet,1742
2776774,1881/10/15 00:00:00,2774,ddd:010497520:mpeg21:a0027,http://imageviewer.kb.nl/ImagingService/imagingService?id=ddd:010497520:mpeg21:p004:image&x=1104&y=96&w=1001&h=2774,ddd:010497520:mpeg21,2105,2870,1104,96,6,"J. E. DAVID & Co. PASAB PISANG. Ontvingen: Een klein factuur ECHTE HAVANNA SIGAREN J in blik. Groote sorteeriog Duitsche Groenten Merk Rtjsch Babnbwitz & Co. sfruetg Hollandsche Groenten merk Gebroeders Schalekamp. PILBENEB BIEB. HEINEKEN . POBTWIJN (roode en witte) Gebr. Stbub. LIKEUREN (geassorteerd) Wijn and Fockini. CHAMPAGNE Moet & Chandon en Louis Bobdebek. COGNAC (Bisquit Dubouché"" & Co.) Zeer soliede Brandkasten uit de gerenommeerde fabriek SCHLETTEB Bibmihoham. Groote sorteering Goedkoope 4412 Petroleum Hang- en Mmirlampen. j. E. DAVID & Co. Ontvingen: Prachtige en Kleurhoudende Pleeten Lepels en Vorken. 4648 J. E. DAVID & Co. OntTioeen per Maddba : 4627 Puike Z. M. Raas in blik. J. E. DAVID & Co. Ontvingen: 452 t. PETROLEUM KOOKTOE&TKLLEN fijn afgewerkt met losse branders (nieuw BÜstenm) met en twee gutei.. J. E. DAVID & Go. Ontvingen: Hottche Sigaren en Sigaretten Concnreerende prijken. 4409 J. E. DAVID & Co. Ontvingen 4529 FRANSCHE MAIL STOELTJES. Ordpukt: MOOIE SCHILDERIJEN met VKKuULufc e» ZMAaliü LIJBÏEN. SpeeMoosen* HANDi>AAIMACHINES (Rhenania). 44(t7 J. E. DAVID fc Co.",http://resolver.kb.nl/resolve?urn=ddd:010497520:mpeg21:a0027:ocr,4,ddd:010497520:mpeg21:p004,"Java-bode : nieuws, handels- en advertentieblad voor Nederlandsch-Indie",1001
2224716,1881/04/26 00:00:00,2194,ddd:010342786:mpeg21:a0012,http://imageviewer.kb.nl/ImagingService/imagingService?id=ddd:010342786:mpeg21:p003:image&x=2226&y=2538&w=1014&h=2194,ddd:010342786:mpeg21,3240,4732,2226,2538,4,"VRIJDAG MORGEN FEBïMJ bij D. J. SIMONS. FIRE BRICKS JVToDsteenen 5 Kalk en Cement en veel meer andere Bouw-fialcrialeii A. SAMUELS. siehhbakkeiisghaciit. """" "" "" '"""""" .- i'  ■ .  Holloivaifs Pills.— Weak Stomachs.—■ The wisest cannot enumerate one quarter of the distressing symptoms a rising from enfeehled digestion  all of which might be readily dispeiled by these admirabie Pills. They remove all uiiyleasant tastes from the mouth fiatuleucy and eoiistipation. Holloway's Pills rouse the stomach liver and every other organ  heining digestion to that healtby tone which fully enables it to couvert all we eat and drink to tlie noutishmcnt of our bodies. Hence these Pills are the snrest strengtheners and tlie safest restoratives in nervousness wasting and ehronic debility. Holloway's Pills are intallible remedies"" tbr impaired appetite eructations and a multitude of other disagreeable symptons  which render ïuiseiable the lives of thousands. These Piils are approved by all classes.",http://resolver.kb.nl/resolve?urn=ddd:010342786:mpeg21:a0012:ocr,3,ddd:010342786:mpeg21:p003,Suriname : koloniaal nieuws- en advertentieblad,1014
3672445,1881/05/22 00:00:00,2317,ddd:010153565:mpeg21:a0023,http://imageviewer.kb.nl/ImagingService/imagingService?id=ddd:010153565:mpeg21:p004:image&x=919&y=361&w=1585&h=2317,ddd:010153565:mpeg21,2504,2678,919,361,4,"PRIJSCOURANT VAN WIJINI LIKEUREN VAN WARNDORFF-HENDRIKS. HEUVEL. TILBURO. DIVERSE WIJKEN. "" LIKEUREN. per Flesch. Per cA•Madera-dry ƒl.— *Dubbele fiine anisette .... f 0.90 * » -1-20 *  ' ...... -1.20 * » -l-40 * » > Curacao. . . . -0.90 •Port a Port -1.50 »  „ ».'...-1.20 * » -1-75 *  . Persico . . . . -0.90 Muscat Lunel -1.40 * „ _ >....-1.20 •Champagne -2.50 »   Pepermunt. . . -1.20 » _ ""_-_ a *Sirop de Punch a .... -1.20 Cognac fine Champagne - 1.40 Prambozen-Limonde - 1.40 » * ""H_ Citroen » .... -1.20 Jamaïca-Rhum. -1.10 •Oude Jamaïca-Rhum -l.Zb Oude 50 pCt. Jenever - 0.70 Pommeranzen f o.lb Ordinaire Brandewijn ...... 0.75 Boonekamp - 0.16 Barcelona » -1.10 De met een (*) geteekende soorten zijn ook per halve flesch verkrijgbaar. ••?•?•?•?•«•?•?••?•««?•?•?•?•?•• 5 UITVERKOOP. | ? Wegens het overlijden van den Heer £ l JOSEPH CATZ 3 % WORDT DE UITVERKOOP ? ! VOORTGEZET. | t Grebr. CATZ & Co. i • Tilburg  Mei 1881. X ? Wederverkoopers en pep stuk extra korting. | ••?•?•?•?•?•?•?••?•?•?•?•?•?•?••",http://resolver.kb.nl/resolve?urn=ddd:010153565:mpeg21:a0023:ocr,4,ddd:010153565:mpeg21:p004,Nieuwe Tilburgsche Courant,1585
2135973,1881/04/24 00:00:00,2521,MMKB04:000163442:mpeg21:a0032,http://imageviewer.kb.nl/ImagingService/imagingService?id=MMKB04:000163442:mpeg21:p006:image&x=2590&y=3039&w=813&h=2521,MMKB04:000163442:mpeg21,3403,5560,2590,3039,6,Advertentie WANDGEDIERTE Koninklijk geoctrooieerd. Eerste en eenige finale uitroeiers van WANDGEDIERTE zonder reuk of iets te beschadigen met 6 jaar garantie. Dagelijks door geheel Nederland (52) OAYIBSOtt & Co. te ontbieden. Adres 8. Weste Wagenstraat No. 94 Rotterdam. Mosaik-tegels voor Vloeren in KEKHEM WMUELÜ VESTIBULES COKUIDttï&g STOEPEN WARANIiË8| enz.) enz.; beklcedlng vnn maren* Uitsluitend Agentsohap voor Nederland en deszelfs Koloniën «. J. OOS firma ANT. DE WILD. Mr. Metselaar Scheepmakershaven No. 62 te Rotterdam . (44) Steiger 22 Oppert 157 E DE BOMT l ZCON BOEK- EN HANDELSSTOOMDRUKKERIJ Dinnen- en Buitenlandsche Bockhandel Pa pi kü- School- en Kantoorhaïtdel Binderij. Advertentie-Bureau UITGEVERS DER van Zwaamen's §• Thompson's Almanakken Week- en Dagbladen. Modejournalen. Plaatwerken. R. K. Kerkboeken. Perkament voor Kunstschilders Architecten en Boekbinders. Oet E. C. KEBKBERIGT van 's Gra11 venhage tevens Advertentieblad is het beste middel tot het plaatsen van Advertentiën boekaankondigingen enz. enz. voor den Haag en omstreken; het wordt in bijna drieduizend Catholieke gezinnen verspreid bijgevolg mag het lezend publiek veilig op tien duizend personen geschat worden. De prijs (10 cent per regel) is zoo billijk dat een ieder er gaarne gebruik vaa zal maken. De Uitqever (707) Jos. M. ROOZJSNBURG.,http://resolver.kb.nl/resolve?urn=MMKB04:000163442:mpeg21:a0032:ocr,6,MMKB04:000163442:mpeg21:p006,De Maasbode,813
2494536,1881/04/08 00:00:00,2904,ddd:010587884:mpeg21:a0049,http://imageviewer.kb.nl/ImagingService/imagingService?id=ddd:010587884:mpeg21:p010:image&x=1030&y=125&w=859&h=2904,ddd:010587884:mpeg21,1889,3029,1030,125,12,Boelgoed te Oenkerk. Mr. L. W. van KLEFFENS Notaris te Veenwouden zal Donderdag 14 April 1881 namiddags 2 uur ten huize en verzoeke van Jelle Tjipkes Biesma te Oenkerk bij boelgoed a contant verkoopen : MEUBELEN en. HUISRAAD bestaande in: 1 eikenhouten kabinet met 5 stellen en 2 sigarenbekers  staartstukklok kookkachel 11 stoelen spiegel met vergulde lijst tafel theegoed koperen doofpot scherm  tang matten en looper petroleumlamp  3 koperen ketels ijzeren pan  koperen handk^tel dito komfoortje  2 schilderijen  oud porcelein  winkelbussen 11 blauwe schotels (Delftsch pauwestaarten). BOEIiGOED. De Notaris POTTER van LOON zal op Zaturdag den 16 April 1881 's voorm. 10 uur ten huize van de Wed. Johannes Everts Siderius op het Nieuwbildt onder Vrouwenparochie tegen gereede betaling bij boelgoed verkoopen: LEVENDE HAVE bestaande in: 7 paarden waaronder 1 beste driejarige bruine merrie 1 dito zwarte mak en bereden 1 bruine vool merrie een zwarte merrie met veulen 1 zwarte ruin 1 bruine enter hengst en 1 bruine enter merrie 8 kalve melke en vare koeijen en rieren 6 hokkelingen eenige kalvers  10 schapen met en zonder lammeren en eenige kippen met 1 haan. BOEREGEREEDSCHAPPEN bestaande o.a. in: 1 kap wagen 4 hooiwagens 2 aardkarren 2 Amerikaansche ploegen 1 ondergrond- en 1 vorenploeg 7 eggen 1 landrol 2 wanmolens 1 Amerikaansche graan- en aardappelzeef 1 best roepelkleed 1 kam met koperen hoep 1 kleine kam  groote en kleine vaten  tonnen bakken kisten paardetuig  touwwerk  harken vorken grijpen  spaden enz. MEUBELEN en HUISRAAD waaronder: een eikenhouten kabinet 1 dito schuif- en 1 gewone tafel 1 kook- en 1 kolomkagchel 1 bed met toebehooren eenige stoelen en stoven  1 vuurscherm tobben emmers potten pannen koper tin glas en aardewerk. Verkooping te Oudebildtzijl. DEZELFDE zal op den dag van het vorenstaande boelgoed  des avonds 7 uur in de herberg bij F. Duhoux te Oudebildtzijl te koop veilen: 1. Een WINKELHUIS met CICHOREIFABRIEK en verdere Getimmerten op de Westelijke Hoogestreek te Oudebildtzijl groot 7 are 69 centiare thans bij den eigenaar Marten Jans Bokma in gebruik. 2. De kolft in een VEERSCHIP varende van Oudebildtzijl op Leeuwarden v.v. bij denzelfde in ei^en gebruik. Te aanvaarden 12 Mei 1881.,http://resolver.kb.nl/resolve?urn=ddd:010587884:mpeg21:a0049:ocr,10,ddd:010587884:mpeg21:p010,Leeuwarder courant,859
2575372,1881/10/07 00:00:00,2636,ddd:010101800:mpeg21:a0016,http://imageviewer.kb.nl/ImagingService/imagingService?id=ddd:010101800:mpeg21:p003:image&x=1035&y=206&w=977&h=2636,ddd:010101800:mpeg21,2012,2842,1035,206,8,"ADVERTENTIE-J Het BUIS dat op 3 OCTOBER is opgehouden staande Singel V (Stroomarkt) IS NU UIT DE HAND TE KOOP. Te bevragen Spiegelgracht 22. (38504 J Be TABAKMAATSCHAPPIJ ARMDSBURG te Rotterdam zal op OINSDAG 25 OCTOBER 1881 biedingen bij inschrijving afwachten op: 143 <* pakken iunialra-Taßmk 9 Hoofdmerk PvdA. Directe Aanvoer. (38489) KACTOORLOKAAL GEVRAAGD. Tot het houden van Kantoor wordt op of in den omtrek van de Prins-Hendrikkade van af Kamperhoofd tot Schippersgracht een HAMEK gezocht liefst met uitzicht naar buiten; te aanvaarden 1 November a.s. (38471) Brievon franco onder Ir. K bij de Kantoorboekverkoopers VAN TÜBERGEN & KRU ï.'SMULDE R Eokin 3 alhier. EEN JOi«OT BRILLANTSNUDER doch niet geroutineerd weuschte gaarno zijne Avonden alsmede Zondagen te beste d e n ten einde zich degelijk te bekwamen en wenschte zich derhalve met een BEKWAAÏH WERKMAN te VERSTAAN. Brievon ondor lett. NR Bureau Handelsblad. (38518) ""ATTENTIE S. V. P. 11! De ondergeteekende brengt hot geachte Publiek ter kennis dat de Advertentie voorkomende in hot Handelsblad van 5 en 6 dezer betreffende den AFSLAG van het Rund vleesch WIET door hem geplaatst ia en hier al zoo aan kwaadwilligheid moet worden gedacht. UEd. dw. Dienaar IH. BROER (38464) Rosmarijnsteeg b/d N. Z. Voorburgwal 4. nffiTWKKÏNS GEZOCHTT"" Een gehuwd PERSOON 33 jaren oud een nette hand schrijvende ZOEKT een BETREKKING onverschillig van welken aard welke hem wekelijks tien a twaalf gulden kan opleveren. Brievon hierop franco lett. FR Bureau Handelsblad. (38452) HEËRËOÖi7!» REIS-ARTÏRra. In een Fijne Zaak van bovengenoemd vak wordt terstond een BEDIENBE of VOLONTAIR gevraagd van de P. G. Brieven franco onder lett. RB. aan het Advortentic-Bureau van STENFERT KROESE & VAN DER ZANDE Boekh. to Arnhem. (38468) Voor de terugreis naar JAVA AANGEBODEN eone BABOE reeds meer dan twintig malen de reis gedaan hebbende vrij van zeeziekte en Hollandscli sprekende. Brieven franco onder letter B aan den Boekhandelaar P. B. NIEUWENHUIJS te Breda. (38502)",http://resolver.kb.nl/resolve?urn=ddd:010101800:mpeg21:a0016:ocr,3,ddd:010101800:mpeg21:p003,Algemeen Handelsblad,977
1071289,1881/03/14 00:00:00,1189,ddd:011085805:mpeg21:a0023,http://imageviewer.kb.nl/ImagingService/imagingService?id=ddd:011085805:mpeg21:p004:image&x=1032&y=1550&w=901&h=1189,ddd:011085805:mpeg21,1933,2739,1032,1550,4,flronlMjoul : Yerkrygbaar per pond:  TA.FKLAMANDELEN f 1.76 T AFELBOZIJNEN » 1.80 ZOETE en ZUBE APPELEN » I.— PIETJES ld. » I.— Nieuwe HIJNPEBEN » I.*® VIJGEN ' 1 — PEUIMEN » 1-M K.BENTSN » O-6® * SULTANE-BOZIJNEN » 0.60.. SUCCADE » IÏB VEBMICELLI » 0.90 MACABONI » 0.»0 GBIESMEEL » I.— Alkmaanohe GOBT » 0.60 VOGELZAAD » 0.75 Groene ERWTEN » 0.50 Bruine BOONEN « 0.50. Amaterdamaoh BOGGEN-BBOOD in blik » 1.50 Vèraoh id. id. » 0.76 ONTBIJTKOEK • ?er atnk * 1.50 ÊtrOCADEKOEK  » » 1.80 t POEDEB-CHOCOLADE per fl. » 0.50 | 10088,http://resolver.kb.nl/resolve?urn=ddd:011085805:mpeg21:a0023:ocr,4,ddd:011085805:mpeg21:p004,Soerabaijasch handelsblad,901
3903000,1881/11/05 00:00:00,3903,ddd:011102846:mpeg21:a0021,http://imageviewer.kb.nl/ImagingService/imagingService?id=ddd:011102846:mpeg21:p004:image&x=1045&y=48&w=1000&h=3903,ddd:011102846:mpeg21,2045,3951,1045,48,6,"Één iio'^^^i^Üu^örepccsct] naar 'den naam'.van nj I'TH""! hU'Usl li p.;# !/v Inlichtjhgen worden 'gaarnejinpwicht'op het bureau dezer 'denifledatteur.'<>iic)ii-r<'(449tb "" AÖENIAKERIJ; SMEDEKU)*^' tlau>;'»«i*iir lIMI  | iif;nw ) «!|( hl ""> I'n'i JI -|l«:pnd^get£^gdpiiK«r>:tuyfa<n(/ye^bcveiejtzicli -II !<] bele§fd jiu.xlpnJ kljet ;geacht ;pubUék I lü.i'fOd linaken s'. lierst^leHJau 1 <MJ alle. Yoorwjifp^n;.welke tot het jak.van j W r'eni ißopersla^ér'belioöreM; S zoomede tót het .repareeren van LampQU; Voor vlugge en nette bediening zatwrtden gezorgd. .vi ixSi\ X 7. li--JjJSCHAAP. (391)1111 «I '[ v Moeara naast T*? ;Si»ng ; NED.-IND.-LEVENSVHHZEKKRING EN-LIJFRENTE 1 .£iUar#""Ü^«üoaïaK Deze Maatschappij js steeds .bereid tot het aan gaan van KONTRAKTÉN van LEVENSVEBZEKEUING en' LÏJFRL'NTË Wdk? tegèdiW verminderde premie«.'iertckeribgeo 'vöop! Kapitaal' en overlijden zóridtfhaandèM -in' I Tarieven en iuliciitingen zijt>*l6if f.' L. i Slatervtr-Afent—(Gorfespondeitt}-4e-Padanf. -«Is ook i op het Hoofdkantoor te Batuvia op franco aanvraag «-«yr èms&ssst ms; HA i ""VooaegËUaagECö^Kter/S?""-^; .#ntr:u».»ri riiri*st Ji<« t >vjSteqds >pwradig[MH?lli •-IA^mM'SrWAIIE'N' * * in soeiienren verkrggbaar en gros enfeu détail. •Tl u jL •. J. JIH.rA. KRIJGSMAN. Alang-Lawa}. naast de Kerk cc. ut •ftiim\f  ' ~i.! n*> ■'.■ji'. iiv. i-j .""MI-M ! sWpÊ' <:\ rr?ö<:i H doh H HET PKOTMfSpeWEESHÜIS in r niY. a / tte söerabaia. vtïiilo r 8 •«♦«sar ƒ• ®wO4NWr*« iüimu >:3(UK3L£32ti«S:aZI2 rfcaKAH 2'lfi 1 Prijzen'; «Hóögstè >Priji f ïÏOO.OOO. . L°k° b«r t. wa&mavsmmsmm® Ainzienlijkcn' eh' Éerioien' e(iJ rjk-4fl Jrm li«sbeJ *V de middelen van"" H«llow»y gebruik gemaak) en uit erkeitelijkboid getuigd van demguMigcn u.lslag» .did hét fgcbruitf derzelycnhoeft gevolgd. Weinige ziekten kunnen de mnoschheid overkomen die teen veruebting terlicßiint'óf* genezing to'elïtca* «l bof deze hielende'i feriKbtendft en r«lferwH . Pa co(Pil(cq Ujbca in den lioogsten graad licilzaam en kan nimmer srhaden in uil- o inwendige- nekten:1' Do 'middelen' van Holloway • genettn \ iweren'etierbuilcPjl verstuiking-en diptberia borstziekten ongeregelde jpijjvciJering eu galziekten. In gevallen ra t griep broncuitis reborbeid lioest kïrta Jcmigheld"" cn* hartklnpplngrinoct-mwi -drze -Zaff *»eiid en iederen.morgep inwrjhen. -r ff- Deze FÏlted en Zlif woqden uitsluitend gefabriceerd'in bet établissement vUfi tion"" Professor HOLLOWAY 633 Oxford street. Londen en zgn verkrijgbaar bij öngèveèP.alle voornabae Apjotheker3 en ln'de'gebasie beschaafde -Wereld."" •' »ii'jatótr> t' li; iwiQi Auiqt» 1.1 L ... .I Jl I.' J.il t .",http://resolver.kb.nl/resolve?urn=ddd:011102846:mpeg21:a0021:ocr,4,ddd:011102846:mpeg21:p004,Sumatra-courant : nieuws- en advertentieblad,1000
2123550,1881/03/12 00:00:00,3025,ddd:110593995:mpeg21:a0022,http://imageviewer.kb.nl/ImagingService/imagingService?id=ddd:110593995:mpeg21:p003:image&x=2882&y=2469&w=702&h=3025,ddd:110593995:mpeg21,3584,5494,2882,2469,4,TE HUUR s •• Te bevragen bij den Notaris J. D. PASTEUR te Doetinchem. MerL Protestanten-Boni Afdeeling VAIiSSEVELD. i : ' ' ' Openbare Vergadering ZONDAG 13 MAART a. s. 's avonds 7 uur in het gewone lokaal. Spreker: Ds. Teldéhs van Steenbergen. Entree f 025. Leden en begunstigers volgens reglement. ondergeteekende bericht de ontyatagst eener gróóte collectie der NIEUWSTE SOORTEN Fransele Engelsche en Dictie BÜKSKINGS alsmede een RUIM ASSORTIMENT der \ Nisnwsts Japonstaffen FRlCÉlllil THIBET'S lerinosseii Moiré's Paarsche en gekleurde Katoenen OXFORD'S verschillende WITTE GOEDEREN enz. Tevens ontvangen een RUIME KEUZE 1 Heeren- en Damesstrikken Cols en Lavalières > IN ALLE GENRES.; teSen zeer Jaaggestelde doch tevens ;vaste prijzen!!! M. L. REICHENBER6ÈR * Hamburgerstraat.,http://resolver.kb.nl/resolve?urn=ddd:110593995:mpeg21:a0022:ocr,3,ddd:110593995:mpeg21:p003,"De Graafschap-bode : nieuws- en advertentieblad voor stad- en ambt-Doetinchem, Hummelo en Keppel, Wehl, Zeddam, 's Heerenberg, Ulft, Gendringen, Sillevolde, Terborg, Varsseveld, Dinxperlo, Aalten, Breedevoorde, Lichtenvoorde, Groenlo, Neede, Eibergen, Bor",702
3214596,1881/02/26 00:00:00,3234,ddd:010497644:mpeg21:a0023,http://imageviewer.kb.nl/ImagingService/imagingService?id=ddd:010497644:mpeg21:p003:image&x=4102&y=2816&w=994&h=3234,ddd:010497644:mpeg21,5096,6050,4102,2816,6,A VIS. Leß BoussignéB ayant été informés que des produits falsifié'sé'taientfrêqüemment importé's d'Europe ave» leurs marques et étiquettes ont I'honneur de provenu Ie pnblie que Meisieurs C. BAHB.E &G. KINDEB sont les seuls Agents et Importeurs directs des Eaux de vie de lenr marque dans les Inde* Nèerlandaiiet et qu'ili ne peuvent garantir la provenance que de celles vendues par les ausdits dont Ie nom est apposé sur chaque bouteille. 648 JULES ROBIN fe Co. F. A. bchüssler. Expediteur VENDUHOUDER COMMISSIONAIR üultenzorgr* VERPLAATS! naar RIJSWIJK nabij den weg van TANAH-ABANG het 8e hou van het KONINGSPLEIN. Batavia 28 December 1880. 5759 AHRENS & Oö. 1 IPHOTOGRAFISCH ATELIER I VAN PETZ & CO. I NOORD WIJK. 888 H. S. Pinkhof TANDARTS. Koningsplein hoek Citadelweg is DAGELIJKS uitgezonderd Zondag te Consulteeren 's morgens van 7—12 uur B. VAN LEEUWEN & Co. Batavia Soerabaia bevelen rich aan tot het leveren van MACHINERIËN ten dierste 'an FI'IKEBFABBIEKEN. RIETMOLENS. IJZVRWABFN GEREEDSCHAPPEN van S. 6 Freytag ud Sohn Sehteelm. PULSOMETRKB POMPEN en HANDSPUITEN va» W. Joh. 8c hu ir. ach er Cóln s/B. Filierperfen m.i. Wigdin e» Wnbner Faliev». SlOenibiandgpniten van MERhïWEATHER and SONS Londen. Beft* Prijsopgave en nadere inlichtingen worden gaarne verstrekt. Bl*,http://resolver.kb.nl/resolve?urn=ddd:010497644:mpeg21:a0023:ocr,3,ddd:010497644:mpeg21:p003,"Java-bode : nieuws, handels- en advertentieblad voor Nederlandsch-Indie",994
2335621,1881/09/19 00:00:00,2719,ddd:010588022:mpeg21:a0023,http://imageviewer.kb.nl/ImagingService/imagingService?id=ddd:010588022:mpeg21:p007:image&x=1002&y=2824&w=859&h=2719,ddd:010588022:mpeg21,1861,5543,1002,2824,8,Bölsward-Sneek-Joure. De STOOMBOOT EENDRACHT vaart Donderdag den 22 September smorgens 5 uur van BOLSWARD 7 uur van SNEEK aankomst te'JOURE BVa uur. Vertrek van JOURE des namiddags 8% uur. Voor Personen Goederen en Vee. Vriendelijk aanbevelend DE ONDERNEMERS. Stoombootl?l?^7Ï_. Ter gelegenheid der Jaarmarkt te Joure op Donderdag 22 September a.s. vertrekt de BERGUMER STOOMBOOT 'smorgens 4 uur van BERGUMERDAM naar de JOURE. De dienst op LEEUWARDEN zal dien dag NIET plaats hebben. Gedurende de maanden October en November vertrekt de STOOMBOOT eiken Dinsdag 's morgens 41/2 uur naar SNEEK. DE DIRECTIE. T^il^ De STOOMBOOT STAD ISSSIIr FRANEKER vertrekt Dins^_______^^t dags morgens in plaats van te 6 uui te 5.45 van FRANEKER naar SNEEK en Dinsdags namiddags van SNEEK in plaats van te 2.15 te 1.30. De Ondernemers v. d. WERF & GORTER. Misbruikmaken Sterken Drank. Wie van dit gebrek wil genezen worden vervoege zich te Amsterdam —in persoon of met brief — Binnen-Amstel no. 286 hoek Prinsengracht bij Erven Wed. ABBRING. Te spreken 's Maandags van 10—3 ure de overige werkdagen van I—3 ure. Extract-* Vonnis. Bij vonnis van de Arrondissements-Rechtbank te Leeuwarden van den dertigsten Juni 1800 een en tachtig is de ontbinding des huwelijks uitgesproken door middel van Echtscheiding  met al de gevolgen daaraan door de Wet verknocht tusschen BINNEUILKES BOUMA Daglooner te Dantumawoude gratis procedeerende krachtens beschikking van genoemde Rechtbank van den vier en twintigsten Maart 1800 een en tachtig en GRIETJE LOLLES HOEKSTRA zonder beroep eveneens verblijf houdende te Dantumawoude. De Procureur van den Eischer Mr. H. TRIP. KALKGRIIVD voorhanden aan de Kalkfabriek van Erven B. J. FEENSTRA te Sneek.,http://resolver.kb.nl/resolve?urn=ddd:010588022:mpeg21:a0023:ocr,7,ddd:010588022:mpeg21:p007,Leeuwarder courant,859
1695568,1881/09/07 00:00:00,1697,MMDA03:000097393:mpeg21:a0016,http://imageviewer.kb.nl/ImagingService/imagingService?id=MMDA03:000097393:mpeg21:p004:image&x=3041&y=206&w=906&h=1697,MMDA03:000097393:mpeg21,3947,1903,3041,206,4,Advertentie Stadsreiniging LEEUWARDEN. Ter bespoediging van de gereÜ PwPjy gelde afzending der STRAATi&aaW VUILNIS en IER is door de Directie der Stadsreiniging te Leeuwarden eene overeenkomst gesloten met eene Sleepboot-reederiJ om bij tegenwinden de Schepen die aan de Vuilnis verzamelplaats hebben geladen van daar tot Schuilenburg te slepen. Leeuwarden 2 September 1881. De Directeur der Stadsreiniging: SOUTENDAM. Te Inr voor ien liji van 3 jaren in de Velde onder Zwartsluis bestaande in Huis Schuur twee Hooibergen en verdere getimmerten Bot mgaard benevens circa 85 bectaren HOOI- en WEILAND thans in gebruik bij WESTRIK toebehoorende aan Mej. DE VRIESE te Zwartsluis. Te aanvaarden 1 Mei 1883. Aanwjjzing geschiedt door CASPER MONIS te Zwartsluis aan den Zomerdijk woonachtig. Nadere inlichtingen en conditiën zijn te vernemen bij Notaris VAN BEUSEKOM te Zwartsluis ten wiens kantore de inschrijvingsbilletten met opgave van twee soliede borgen moeten zijn ingeleverd vóór of op den 25sten September 1881.,http://resolver.kb.nl/resolve?urn=MMDA03:000097393:mpeg21:a0016:ocr,4,MMDA03:000097393:mpeg21:p004,Provinciale Drentsche en Asser courant,906
479906,1881/08/10 00:00:00,826,ddd:010510520:mpeg21:a0022,http://imageviewer.kb.nl/ImagingService/imagingService?id=ddd:010510520:mpeg21:p004:image&x=1730&y=3050&w=581&h=826,ddd:010510520:mpeg21,2311,3876,1730,3050,4,51 Brandverzekeringmaalschappij maalschappij le London.,http://resolver.kb.nl/resolve?urn=ddd:010510520:mpeg21:a0022:ocr,4,ddd:010510520:mpeg21:p004,De West-Indiër : dagblad toegewĳd aan de belangen van Nederlandsch Guyana,581
1548096,1881/09/15 00:00:00,2199,ddd:011181712:mpeg21:a0006,http://imageviewer.kb.nl/ImagingService/imagingService?id=ddd:011181712:mpeg21:p003:image&x=2047&y=4787&w=704&h=2199,ddd:011181712:mpeg21,2751,6986,2047,4787,4,"De VolKJSTriëiróii»* Simt N*<Verlartd renenden wij gefraudeerd een geheel jaar voor f 2.50.'' ' • ;-. r—i . KONINKLIJKE IfEKERLANDSCHE STOOMBOOT* MAASptfAfTIJN';' De lste.Jflliw Wootnéebcpeh' ï*m* Maat«.ha»p»J tp«ii**l ""fftëncht Voor. het verroer run 3de któacypafcugfér*- kunnen wat inriehting ""inelheid vei' ligheid ufo! en .uitêtckinde hebjuide- i xIOf-Méta EH**Of gVeoe.ijndere worden Ti]JJkVTO6lf''""»»in. hnnne .betrek' kingt^Pl^Sßj  weftpcjjcp te Benden ndiniafsiaf yan dei» lijn gei bruik te Preien. egnea'near Amiterdam £ .. _>~1.W.-.. ri -"" •' Jafw des «wljjitgaaVt* Ujtu*. '~ Adfea: ""ÉDtNBy..HOSPEftS . Bnb Agent. voor Bioux Couptjr losa • TKKOOPIr .-*_■. ""■' De boo schoon gelegen fimn Van I*.. Mo. wrr waaro» niet alleen «wed woonhjaie '. flink* echusr yard» ent.maar;eek een groot aantal appel» pruim- keraes.es bea' eenbnoraen. Sleehta wéinige Undhéefen th daxe kolonie wjn aoóped\ in orde ala dese. Nader* isfonnatltn bij den elite "" naar.~~~~™ "" •—-~""^-—• r/.f~7*~T'-""f'. iLßian n mantnöai' OKA3GE CITY. H XEMAEB. Gexkeb- Heei/- ss-YEaxoarcDTOijr/-1 . Ds. Baros is ateeditk«preken te rij■È nen huize tegenover h* woonhuia - tsn e den advocaat BslÜ Örange'City lowa. e . -■■ ' —. ... ..... —_.„-\ J Tisóor; 240 akker»prairie'tan öo« "" en Tan de poor farm: rrija f 0.50 de ak f '; er~ Te bcTragen-t«rr- kantore-Van i! / UifKY. WxAa.%. i",http://resolver.kb.nl/resolve?urn=ddd:011181712:mpeg21:a0006:ocr,3,ddd:011181712:mpeg21:p003,De Volksvriend,704
153260,1881/10/31 00:00:00,194,ddd:010290291:mpeg21:a0011,http://imageviewer.kb.nl/ImagingService/imagingService?id=ddd:010290291:mpeg21:p003:image&x=1680&y=93&w=790&h=194,ddd:010290291:mpeg21,2470,287,1680,93,4,- - B__l--_-______-MI»M___MWM--_---l Advertentien —i— .in. — ■■--. . ■ iiii.ii i m—mmnmm—n—*emmruae^Ê^^^mem,http://resolver.kb.nl/resolve?urn=ddd:010290291:mpeg21:a0011:ocr,3,ddd:010290291:mpeg21:p003,De locomotief : Samarangsch handels- en advertentie-blad,790
8102760,1881/03/21 00:00:00,2133,MMKB08:000090131:mpeg21:a0053,http://imageviewer.kb.nl/ImagingService/imagingService?id=MMKB08:000090131:mpeg21:p008:image&x=95&y=162&w=3776&h=2133,MMKB08:000090131:mpeg21,3871,2295,95,162,12,"Advertentie Stoomboot-Onderneming „Goncordia"". AANKONDIGING ingevolge Art. 2 3 en 10 der Wet van 23 April 1880 (Staatsblad no. 67). Dagelijksebe Stoomliootdienst tusselten 11IHEM—MJMEOI v.v. op Rijn en Waal langs HUISSEN LOOVEER PEPFELGRAAF  PANNERDEN LOBITH MILLINGEN HULHUIZEN GENT en GROENLANDE voor liet vervoer van Passagiers Goederen en Vee met de snelvarende Stoomboot concxïrdia III. HOOFDKANTOOR gevestigd te ARNHEM Rijnkade Directeur R. H. HABNTJB NS.  DIE^STBECrtlliiyCr aanvangende 15 APRIL 1881 of zooveel eerder als nader zal worden bekend gemaakt. Vertrek van Zondags. Vrijdags. Overige dagen. Vertrek van Zondags. Vrijdags. Overige dagen. Nijmegen V. M. 8 u. V. M. 6 u. V. M. 7 u. Arnhem. N. M. 4 u. N. M. 2 u. N. M. 3 u. Groenlanden . c.8.15 c a . 6.15 Ca. 7.15 Huissen. c.4.30 C .2.30 Ca. 3.30 Gent „ 8.30 „ 6.30 „ 7.30 Peppelgraaf . „ 4.50 „ 2.50 „ 3.50 Hulhuizen „ 9.„ 7— „ 8.Pannerden „ 5.„ 3—  4— Millingen „ 9.10 „ 7.10. „ 8.10 Lobith . „ 5.20 „ 3.20 „ 4.20 Lobith . „ 9.30 „ 7.30 „ 8.30 Millingen „ 5.30 „ 3.30 „ 4.30 Pannerden „ 9.45 „ 7.45 „ 8.45 Hulhuizen „ 5.40 „ 3.40 „ 4.40 Peppelgraaf . „ 9.50 „ 7.50 „ 8.50 Gent „ 5.55 „ 3.55 „ 4.55 Huissen. 10. 8.— 9— Groenlanden . „ 6.05 „ 4.05 „ 5.051 A. Arnhem. A. „10.1 A. „ 8.15 A. „ 9.15 A. Nijmegen A. „ 6.15 A. „ 4.15 A. „ 5.15J Tarief voor Passagiers en Bagage. Arnhem. 1 KL 30 40 50 60 60 70 70 2 KL 20 30 35 40 40 45 45 HuïssenLooveer. 1 KI. 30 40 50 50 60 70 2 Kl. 25 30 35 35 40 45 PeppelgraafPannerden. 1 Kl. 30 40 2 Kl. 25 30 40 50 30 35 60 I 40 Millingen. 1 Kl. 30 30 40 50 2 Kl. 25 25 30 35 Lobith. 1 Kl. 40 50 60 2 Kl. 30 35 40 Hulhuizen. 1 Kl. 30 40 2 KL 25 30 GentGroenlanden. 1 Kl. 30 2 Kl. 20 Nijmegen Basage tan 30 Kilogram 1 Cent per Kilop. Minima 10 Cent. 2 ««I 5 '3 = 5 — ■- • ■bé *9 m a % * ~ s f 1=1 5® 5 > $ 2 'ss« lüi ^ IH © « > - - 5 § « 0) Nijmegen Waalkade vroegere aanlegplaats der Stoomboot WILLEM III. Hulhuizen aan het Steiger van den Heer A. G. VAN LENT. Lobith » » » » » » d 'HARVANT. Aantal beschikbare passagiersplaatsen 150 s Pannerden aan het Steiger van den Heer REIJMERS. Huissen (Looveer) » » » » » » PUTTERS. Arnheill ligter der Stoomboot-Onderneming CONGORDIA. De Directeur.",http://resolver.kb.nl/resolve?urn=MMKB08:000090131:mpeg21:a0053:ocr,8,MMKB08:000090131:mpeg21:p008,Arnhemsche courant,3776
5667621,1881/07/05 00:00:00,5646,ddd:011102793:mpeg21:a0015,http://imageviewer.kb.nl/ImagingService/imagingService?id=ddd:011102793:mpeg21:p003:image&x=2100&y=171&w=2002&h=5646,ddd:011102793:mpeg21,4102,5817,2100,171,4,"P lIOIiLOGIEMAKERIJ. »»ï\| §MM .V * "".... ï l f£T iü&üm TV ondergeteekendc is steeds ruim JL9. icivoorzien . van Gouden . zil veren - en Alkkeleu II einontoirs. JtEGULATEUK- en AMEKIKAANSCHE K.LOKKM zoomede van alle artikelen die op hel vaktbetrekkints ""t_ i. 1 *hP*** . ** I-k O hebben.. „/ . ; ! t j ' Alle Keparatlëii aan Uurwerken worden solied"" en in den korlstmogelijken tijd onder waarborg afgeleverd r iï ; -•"" 'W'J V» ! H. MEIJER. t i? liMflNitóTIEK! Ouders en Voogden worden bij deze attent gemaakt op de alhier bestaande gelegenheid .totvhet nemen yan • f m.-c*.:. ■."" *k f - -- G YMNASÏIEK-LESSEN.. De kosten van het ocderwrjs bedragen 's maands. > Voor elk kind;. »♦;>*.. . f S.öO Boren do 2 kioderea uit hetzelfde gezia per kind „ L.50 Nadere informatiën te verkrijgen bij den Onderwüzer G. Bakker. ' ij j  ' ' .. hi . De' Commissie van Toezicht ; R. 11. VAN OS. (297; C. J. VAN -BÜEREN. VOOR DE SUMATRA-COURANT VVORDT GEVRAAGD: - Een Oorector tevens geschikt en genegen; om eenig redactiewerk te verrichten. r Adres: * Redacteur i 1 ' 1348) !>i fffrS ■ . :. ' : ' '■ ■ 'r ■. JjIJT ?:t' * 1 11' * . ' Achterstallige debiteuren aan de firma 11. A. Mess worden dringend ultgeiioodigd hun debet aan te zuiveren. i •-.1640) HA. MESS. • • *'t : ■ »• •• • ~VELIJN-PAPÏÈR ~ in verschillende soorten. ;m POSTPAPIER . in . groot en klein formaat . met bijbehoorende enrêloppen. / ; vv&Ht&j \inl»i •• i i- I i'l Echt Ollfauts Wit Cardocspapier. Schildpad-en Canarlsch' Marmerpapier. Ilest Engelsch Wit Vloel-Papier. 1A174)n * ; HA. MESS. : H. A. 341SSS te Padnng .j/ ■ Ontving: ' *Enkèle'exemplaren vnnx ■'T<vtóii'j-rr.'i A.'! NUMAft'S ciw'i O ) GENEES- en VERLOSKUNDE 1 HET 'VE E: '** s i3>i ti- Uitgave Wan BcmoHe Djokdjaiw/- Prijs;l-f ■ 7.SOi— franco per post i 8.35. i «nu-»*».*.i».u.i»i.ni „ ~m»mma ./CiVyiiïA'. .Coop.MA;^;!. CUIWEGSGHB.IUnP. jv olt 'ïïeivÈ^MibVËAD^^Ï^MÉsl . t'A M l' E N.' S I GAREN;"" h'e?. P^f^ige. collectie Heeren? en Dames-Schoenen en Laarzen. (345) Cblneesohe 'Kamp — Foudok. ji'tcH 'yc I-»ia< !/• . tyi (Jpnieuw ontvangen: Exquise roode en wilte PORTWIJN (Merk Oporto 1904; origineele verpakking).  v  - Hoineken's JExport Bier Amsterdumsch BeijèrschyJßier uit de Koninklijke Nederiandsche Beijerscli Bierbrouwerij te Amsterdam. (Bierbottelarij} van J. Roetcii »c ij er drfcoóiialdaar).-1-1 "" * :: ""'(347) j *'1 '* ... '»*. JS'"".*2 *-40|<UIT< !'[• * .«***o; "" loKo LIE JÜM'leng. ' ChiueeHoho Kamp — Poqdolt PH i \r3 M I'ALE-ALE i IIYOLI- BIER* \ BROWN-SÏOUTPORTER EXPORT KAISER-BIER; Metworst Ccrvilaat-Worst Leverin blikken. Pekel Saucijs Gerookt Spek.Alkmaarsche Gort Geparelde Gerst en Griesmeel op stopflesschen. Houten Tabakspijpen Havana Sigaren enz. enz. i. ;~i 3(318) ' ' - • - U . .-.1 I_i KJ * ' Ïokó Zeinoeddièn.1 | Ghlneesohe Kamp. T 1:1 Voorhanden' r? & l '■! ZEER-MOOIE . ÏÏEEREN/OVEKHEIDEN n prijzen goedkoop. ij t.; ? 321",http://resolver.kb.nl/resolve?urn=ddd:011102793:mpeg21:a0015:ocr,3,ddd:011102793:mpeg21:p003,Sumatra-courant : nieuws- en advertentieblad,2002
1989954,1881/09/24 00:00:00,2571,ddd:110594023:mpeg21:a0007,http://imageviewer.kb.nl/ImagingService/imagingService?id=ddd:110594023:mpeg21:p004:image&x=820&y=4&w=774&h=2571,ddd:110594023:mpeg21,1594,2575,820,4,4,2 Schildersknechts voor een geruimen tijd werk begeerende vervoegen zich ten spoedigste bij J. R. CROP Huis- en Rijtuigschilder te Rosendaal bij Arnhem. Wordt gevraagd: Een;'SPEKSLAGERSKNECHT die redelijk bekend is met het Vak. Zonder goede getuigen onnoodig zich aan te melden. Adres: W. J. DELGIJER Velp bij Arnhem. In eene DRUKKE GROSSIERDERIJ. -in Koloniale waren wordt gevraagd een geroutineerd REIZI GE R die volkomen met het vak bekend is en gewoon Overijssel en Gelderland te bereizen. Zonder goéde informatiën onnoodig zich aan te melden. '. Brieven franco lett. E. aan het Advertentie-Bureau van J. W. Thieine en Cie. M'B E P t -i Mej. G. SCHEPERS te Doesborgh Vraagt tegen 1 November een flinke Werkmeid Pi: 0. van goede getuigen voorzien. Dienstboden gevraagd. Mevrouw EICKHOEF—ten Kate te Amsterdam Singel 157 zoekt tegen primo November twee knappe Dienstboden eene .1 KEUKENMEID die prefect kan koken en werken alsmede eene nette < TWEEDE MEID die goed kan strijken met de wasch omgaan enz. Beste getuigen worden verlangd.,http://resolver.kb.nl/resolve?urn=ddd:110594023:mpeg21:a0007:ocr,4,ddd:110594023:mpeg21:p004,"De Graafschap-bode : nieuws- en advertentieblad voor stad- en ambt-Doetinchem, Hummelo en Keppel, Wehl, Zeddam, 's Heerenberg, Ulft, Gendringen, Sillevolde, Terborg, Varsseveld, Dinxperlo, Aalten, Breedevoorde, Lichtenvoorde, Groenlo, Neede, Eibergen, Bor",774
3612860,1881/10/14 00:00:00,3422,MMDA03:000097442:mpeg21:a0017,http://imageviewer.kb.nl/ImagingService/imagingService?id=MMDA03:000097442:mpeg21:p004:image&x=2967&y=112&w=944&h=3422,MMDA03:000097442:mpeg21,3911,3534,2967,112,4,Advertentie I EENE RUIME KEUZE Heeren Winter-Bottines Dames Winter-Laarsjes WIT SATIJN en GOUDLEEREN met Fransebe Bakken en Strikken in den Schoenwinkel bjj Firma Gebr. SCHUIL Assen. Stoomboot Zuidlaren - Groningen v v. Ingevolge art. 2 en 3 der Wet van 22 April 1880 (Staatsblad No. 67) brengt HILBRAND BAKEMA Stoombootkapitein te Hoogezand ter algemeene kennis dat hij met Si October 1881 een dienst zal openen met de Stoomboot ONDERNEMING ingerigt voor 60 personen en SOOOO kilo aan Goederen en Vee van Zuidlaren via Zuidlaarderveen Drentsche Diep en Winschoter Diep naar Groningen v. v. en wel eiken Dingsdag Woensdag en Vrijdag. Het Hoofdkantoor zal gevestigd zijn te Zuidlaren. Tot het in- en uitlaten van Passagiers en Goederen zal zooveel mogelijk aangehouden worden. Vertrek van Zuidlaren morg. 7 uur. Aankomst te Groningen morg. pl. m. 9 uur. Vertrek van Groningen midd. 2 x j k . Aankomst te Zuidlaren nam. pl. m. 4 1 /. TARIEF: Van Zuidlaren naar Groningen of omgekeerd per persoon le kaj. f 0.40 2e kaj. f 0.30. Passagiersgoederen 5 kilo vrij. Ieder 5 kilo of gedeelte daarboven f 0.10. Het BESTUUR der Drentsche Kanaal-Maatschappjj is voornemens bij inschrijving te verburen i Het Huis bij de Veenesluis te Hoogeveen  met achtergelegen TUIST en het ten zuiden van genoemde Woning gelegen WKI- en BOUWLAND. De voorwaarden van verhuring liggen van 15 October e.k. ter lezing bij K. VISSER Nz. te Hoogeveen. Inschrijvingsbilletten moeten vóór of op 25 October e.k. bezorgd worden bij den Directeur der Maatschappjj te Hoogeveen. De Directeur voornoemd: VAN DER LELIJ. aa I bëstediig van het graven van een gedeelte van een Kanaal in de Marke van Buinen te Nieuw-Buinen ten huize van H. HUISINGH op Maandag den 24sten October e.k. des voormiddags te elf uren. Bestek en lengteprofil liggen ter inzage in de Logementen van DIK en DOPPER te Nieuw-Buinen en Stadskanaal. Aanwijzing in loco op denzelfden dag des voormiddags te 9 uren. Zamenkomst bjj H. HUISINGH. Burgemeester en Wethouders van Borgtr: De Wethouder De Burgemeester H. BEULING. J. D. DIBBITS.,http://resolver.kb.nl/resolve?urn=MMDA03:000097442:mpeg21:a0017:ocr,4,MMDA03:000097442:mpeg21:p004,Provinciale Drentsche en Asser courant,944
1064130,1881/01/11 00:00:00,1185,ddd:010342756:mpeg21:a0007,http://imageviewer.kb.nl/ImagingService/imagingService?id=ddd:010342756:mpeg21:p002:image&x=1205&y=3517&w=898&h=1185,ddd:010342756:mpeg21,2103,4702,1205,3517,4,"___M____j__B________Wjß_jM.il II ""i ll—Ti— !—■—&—_■—■_■—____! lierv. (Jhr. (manieente WOENSDAG 12 Jan av. 1 u. Zaa„b„r-. J_iUN->_\X- lliJail Viü. öl/3 U- ZaA-B_'U.« UJail. a>. 7 U.UuQ-V_i_T. Miaer-aai Maatschappij kiuriüam . Aan TUI- aandeelhouder! die den reeds venenenen tweeden L rmijn nog niet betaald lubben wordt berieiit dat daait.»e de ge_t_ocuit_id o nog zal gegeven wordea tot _f«9 utZi't'i na vvelkedagt-oekeiitiigz.il toegepast worden liet vierde lid vaa art. 5 uer Statuten  luidende : Ingeval een uandeeliiouder in gebreke blijft de door hem verschuldigde storting op deu bepaalden .y« i. . uiducu  ia dn Directeur",http://resolver.kb.nl/resolve?urn=ddd:010342756:mpeg21:a0007:ocr,2,ddd:010342756:mpeg21:p002,Suriname : koloniaal nieuws- en advertentieblad,898
11031215,1881/05/22 00:00:00,5695,ddd:010104029:mpeg21:a0026,http://imageviewer.kb.nl/ImagingService/imagingService?id=ddd:010104029:mpeg21:p003:image&x=2940&y=1257&w=1937&h=5695,ddd:010104029:mpeg21,4877,6952,2940,1257,6,SPIESELFABRf EU en ISUNSTHANDEL J. J. Höpker Leliegracht 4 SPIEGELS ia alle vormen en afmetingen met en zonder ornament NIEUWSTE DESSINS. — GROOTS COLLECTIE nieuwe Fransche en Engelsche STA4LGRAVUREN — ENCADREEREN van Schilderstukken Teekeningen Gravures etc. IS ELK GENRE - FOELIËN en VERZILVEREN van Spiegelglas — VERGULDEN van Spiegel- en Schilderijlijsten MET ECHT GOUD. RE WERKING volgens de REST erkende methoden en PRIJZEN BILLIJK. TEERENINGEN van Spiegels worden FRANCO ter keuze gezonden. (20535) I WIEBOLS & GOOSMAM I recommandeeren zicli voor de levering van: Heeren- Jbiigeheeren- en I Hinderkleederen. ■ GOEDEREN NAAR MAAT! 1 worden ten spoedigste B I geëffectueerd* 1 131REGULIERSBREESTRAAT 311 I AMSTERDAM. I MONSHOÜ WER & C°. CHEMISIERS & TAILLEURS. - 118Salverstraat JLmsterdam. SMTELSIMfPuTËI 23 REGULIERSBREESTRAAT 23. Opnieuw ontvangen: een groot assortiment COSTUMES MANTEJLS in /Satijn Cachemir en verder in de nieuwste Stoffen. REIS- en REGENMANTELS STOFFEN voor ROBES met btfbehoorende garneering FRANSCHE PERCAItS EFFEN SA WIJNEN SATIJN OMBR.É in de nieuwste ' dessins en kleuren ItINGERIES BRORERIES en verdere [ NOUVEAUTÉS tot de minst mogelijke prUzen. (20623) I VOORLOOPIGE AANKONDIGING. 1 Het geachte Publiek wordt attent gemaakt op de vestiging van het COSrraCXIIS-MAGAZIJfir voor HKEBEaf- en HINDER MliEKlirtKßïïm1 van J. VAN GELDER & G. KALVERSTRAAT 174 1 waarvan de opening later zal worden bekend gemaakt. Door het vestigen van bovengenoemde zaak bericht de ondergeteekende' dat hij sinds 1 Mei jl. niet meer bij den Heer J. CAHEN Jr. Magazijn de Phenix werkzaam is. Voorloopig adres tot P°. Augustus a. s. KALVERSTRAAT 38 over het Hotel Adr ian. (20584) J. VAN GIXIKER. 1 VERKOOP VAN PIANMO S. Op veler verlangen heeft de Heer Fabrikant LEOPOLD KAHN te Stuttgart genoeg bekend door zijne voortreffelijke Instrumenten weder eenige zijner Pianino's hierheen gezonden dieeenige dagen aan het Leidsche Veem Prinsengracht bij het Moleupad zyn te bezichtigen. (30517) MANTELS. J. BEImImHH «& Go. 114 NIEUWENDIJK 114. 120505) S^nrÖÖR DAMES-COSTUMES. 'm Van af MAANDAG zullen wij beginnen te verkoopen een prach t i g e par t ij ZOMERSTOITEN VOOR COSTUMES a 45 Cent den Meter. DAMES NACIITPONNEN HEMDEN ROKKEN en PANTALONS (20547) *. HIRSCHFELR # COMP. Rokin 26.' ALSOOK EEN PARTIJ COUPONS ZWARE ZWARTE FRANSCHE ZIJDE ZEER GOEDKOOP.,http://resolver.kb.nl/resolve?urn=ddd:010104029:mpeg21:a0026:ocr,3,ddd:010104029:mpeg21:p003,Algemeen Handelsblad,1937
5388635,1881/11/22 00:00:00,5309,ddd:010497539:mpeg21:a0022,http://imageviewer.kb.nl/ImagingService/imagingService?id=ddd:010497539:mpeg21:p004:image&x=60&y=707&w=1015&h=5309,ddd:010497539:mpeg21,1075,6016,60,707,6,"Mevrouw Dnffowrc MODISTE IMOOROWIJK._ §mW Verkrijgbaar: ""fef Bruidscostumes van af ƒ 125.— en hooger. Rokken en Japonnen van ai ƒ 6 tot / 20. 50_0 Hf Si Nicolaas Feest1 4HF F. BIIBIT JH| Odiffeur Sluisbrug Oütving een groote partij lIIMII SPEELGOED en verteLilleride CADEAUX voor St. NI .OLAAS FEEST- Allen zeer goedkoop. B«6i ~ GOUDEN MEDAILLES % TCNTOONSTELUINQ VAN 1867 EN 4878 TAPIOCA-BOUILLON en Groenten soep met EXTRACT van RU NDVLEESCH _______a^Ma__. Deze twee artikelen geven eenige oogenblikken in zuiver water gekookt eene heerlijke en krachtige soep. Zij maken het gebruikt van soepvleesch overbodig daar zij dezelfde bestanddeelen bevatten. Wegens hunne voedende kracht en matige prijs zijn zij ten zeerste aan te bevelen. Wordt verkocht in fraaie stopflesschen. BÓuWi ER Fabrikant van alle soorten van Pales en Tapioca's Paris 54 rue de la Verrerie. en in alle Toko's van Neerlandsch Indie. M \lHHHa______B_&_____f Depothouders BATENBURG & Co. Batavia. 5692 A. (x. Bosch & _'o Ontvingen weder de zoo gunstig bekende FRANSCHE VELDSMIDSEN met WEBKBANK BANKSCHROEF enz. 534B 10 UK PMS Mi Pas ontpakt: Een ruim gesorteerd factuur J| Speelgoed 1^ waaronder: Winkels keukens poppen wagens paarden enz enz. Goedkoop van af ƒ I.— tot f o.— AIS OOk: Alle soorten dames Laarsjes. Stoffen en leeren] kinder Laasrjes. Kleine schoentjes a f 2. Gekleede Kbagen met Manchetten enz. 8069 Mevr. REMMERT. = BAOUB j MACAU MEDOC. DE LANGE & C°. BATAVIA. 4928 ' T. HTTIZER i in * PirlWlJH®! GEBR_. STEUR MAASSLUIS. 515 3 Adr<_: Btcmdrsrltelaan wijk 19 No. 39 toko Rusman. : ■WWWM^i»»*«i«iMW»W»a___M>M^MMl»l»«»l IJ ■■■«al I ____H_.ll.al lllaaMUllllllaW — Steeds voorhanden: #_leS»ls_de_a  en i Vloei Maden { tooi copieer pers. 8*33 H.M. VAN DORP & Co. f 3",http://resolver.kb.nl/resolve?urn=ddd:010497539:mpeg21:a0022:ocr,4,ddd:010497539:mpeg21:p004,"Java-bode : nieuws, handels- en advertentieblad voor Nederlandsch-Indie",1015
3576471,1881/09/19 00:00:00,2175,MMGASL01:000346012:mpeg21:a00015,http://imageviewer.kb.nl/ImagingService/imagingService?id=MMGASL01:000346012:mpeg21:p00002:image&x=2044&y=3637&w=1637&h=2175,MMGASL01:000346012:mpeg21:p,3681,5812,2044,3637,4,Advertentie BURGEMEESTER en WET' HOUDERS van OLDEMARKT zullen bij eahele InHdirijVing opSEatnirdag den 1 tUtatober a.s. des mam. vier uur in het Gemeentehuis aldaar Aanbesteden; Het bouwen van een Onderwijzerswoning met Schuurtje te Kalenberg met bijlevering van al het daartoe benoodigde. Aanwijzing op het terrein op den dag der besteding voorm. 11 uur. Bestekken en teekeningen worden op franco aanvraag tegen betaling van 50 cent van af den 20 dezer verzopden. Oldemarkt den 8 September 1881. Burgemeester en Wethouders voornoemd H. VISSCHER Burgemeester. H. VAN GUNST Wethouder. XX. V XXXI \JI XW tvj X J M OUllUUUOi Het Gemeentebestuiir van Mn *s v00rnemens °P Zatnrdag den 8 Oct. e.k- aan te besteden: De le vering der benoodigde TURF voor het wintersaisoen 1881182. De voorwaarden liggen van af heden (Zonen Feestdagen uitgezonderd) ter Secretarie ter lezing van v/m 10 tot n/m 1 uur. Best Eiken Bosjeslonl: de 100 1 gulden 30 cent 'l de 50 68 cent de 25 35 cent d per stuk 1^ cent u bij H. NAK d in de Neerwoldstraat. F STATIONSWEG. . Leerlooljerij I en Magazijn van Schoenen en Laarzen. : Leestklaar werk enz. J POOT l ZOON. JAS-KAARTBN‘ met donkere ruggen zware kwaliteit per dozijn f 1.- e: verkrijgbaar bij den Boekhandelaar A. L. LAND te Heerenveen. DAMES- en ÏÏEEREN- 4 COSTUMES worden ten spoedigste en tot iconcurreerende prijzen volgen» maat geleverd door R. SPIJKERVET Rz. * STALEI worden op franco j aanvrage direct verzonden. WAARSCHUWING! WAARSCHUWING! Zekere Apothekers in de Nederlanden bedriegen het Publiek grof door verkoop van zoogenoemde „ïïolioway’s Zalf en Pillen” r welke zij zelven fabriceeren en welke niet l alleen van onwaarde zijn maar ook schadelijk voor de gezondheid. I Iedere pot of Doosje het echte Medicijn  heeft op de gEtiquette het opschrift: 533 Oxford Street London; en draagt de stempel der Regering van Groot Brittanje met de daarin gegraveerde woorden- Holloway’s PlLLS AND OlNTMENT.,http://resolver.kb.nl/resolve?urn=MMGASL01:000346012:mpeg21:a00015:ocr,2,MMGASL01:000346012:mpeg21:p00002,Opregte Steenwijker courant,1637
4178030,1881/05/08 00:00:00,5083,ddd:010063412:mpeg21:a0025,http://imageviewer.kb.nl/ImagingService/imagingService?id=ddd:010063412:mpeg21:p004:image&x=71&y=97&w=1130&h=5083,ddd:010063412:mpeg21,1201,5180,71,97,4,"ADVERTENTIËN. van I—s regels /O 55 iedero regel meer 121/2 Cents. - mm MtvereeiiijÉ van mijne geliefde Ouders G. 11. TEPE en C. J. RILLEN. vötm ecnigste Dochter. C.3. TEPE. Amsterdam den Sen Mei 1881. Dc Holl. Hypotheekbank te AMSTERDAM (2310) leent gelden onder eerste hypothecair verband tegen 41/4 ii 5 pCt. Interest. De Aflossing geschiedt ter keuze van den geldnemer in eens in termijnen of in annuïteiten. De annuïteit is de som van interesten aflossing tot een jaarJijkscii onveranderlijk bedrag tot de geheele kwijting toe. Inlichtingen le bekomen ten Kantore der Bank en bij HII. Agenten. IjTöTijs; Puik liard lielder zoetwater Noorsch BLOKIJS i 3 tegen zeer billijken prijs bij ons verkrijgbaar. Bestellingen worden aan huis bezorgd ook aangenomen aan de Kiosken. Dadelijke en stipte uitvoering van orders. IJSCOMPAGNIE. Handelskade. Kantoor: CZAAR PETERSTRAAT. (3773) Eng-TOS-handel. Zelfstellende Amerikaansche en Engelsche Mnizenvallen zijn te bekomen aan de Fabriek van R. A WOLTERS X4'J te Groningen. (3913) Kamer-Muziek. 362 stukken voor Piano te zamen voor den spotprijs van 10 Mark (fr. 121/o'j le zamen! _2 der nieuwste Marehen. __ » » . Polk-i's. •15 » » Valsen. 11 • » » . Galoppen. . i) i) » Polka's Mazurka. 8 » » Redowas. 12 » » Rhinlandaises. 13 » » Tyrolicnncs. 40 prachtige Fantasten. 12 gevierde Co'mpositiën v.'Mozurl. li der meest gezochte Valsen van Chopin. 58 Liederen zonder woorden van Mendelssóhn. 148 der meest geliefde stukken uit cle schoonste opera's Alle deze 302 in prachtige 4o uilgaaf in G prachtige albums goede druli en mooi papier geheel nieuw compleet en zonder fouten te zamen voor 10 Mark. De orders.onder rembours ol'tegen vooruitbetaling worden franco en vrij van inkomende rechten door het Bestelhuis der muziek .1 D. POLACK te Hamburg. Ganzenmarkt 30/31 en Colonnade 61 uitgevoerd. IïEIIÖI Directe Communicatie met BROUWERSHAVEN. —o— Het Raderstoomschip SCHOUWEN LN DUIVEL AND (700 Personen 5(1.000 KG. gewicht) uitmuntend uitgerust voor liet vervoer van Passagiers Goederen en Vee vertrekt geregeld Van ROTTERDAM: ZONDAG . . . voorm. Bifo uren DINSDAG ...» 6 » WOENSDAG . . » . 8""_ » VRIJDAG ... -•» 81/2 ¦"".» Van ZIERIKZEE: MAANDAG. . . voorm. 7-k uren DINSDAG . . . nam. 2 » DONDERDAG. . voorm. 7V» » ZATERDAG . . ». .71/2 » Legt steeds voor HU. Passagiers aan te Dordrecht 's Gravendeel Willemsdorp. Willemstad (Hoofd) Dintelsas Steenbepgsohen Vliet Ooltgensplaat Zijpe (Rruinisse) Stavenisse. Buffetten rijkelijk voorzien en matige prijzen. 4 'Geïllustreerde Tijdschriften 9 Couranten en verdere Lectuur aan Boord.. Alles is ingericht voor een hoogst veilig en viug vervoer met solide behandeling.- (3034) Te Zierikzee wacht steeds een Rijtuig met 2 Paarden op de aankomst van het Stoomschip voor Passagiers naar Brouwershaven. STOOMREEDERIJ: «Sohouwcua on Ruiveland.» DR. J.L EöróïS PMenoYerïfatuur- EN Werktuigkniide. le Serie: No. 1 Brugbalans. No. 2en 3 Uurwerk. No. 4 Barometers (Metaal- en Kwikbarometer). No. 5 Luchtpomp. No. 6 Pompen (Zuig- en Perspomp). No. 7 Brandspuit. No. 8 Thermometers (Maximum- en Minimum-thermometers). No. g Locomotief. No. 10 Gasmeter 2e Serie: No. i Katrollen. No. 2 Lier. No. 3 Schroefpers. No. 4 Areomelers.No. 5 Hydraulische pers. No. 6 Bovenslags Waterrad. No. 7 Stoommachine van Watt. No. 8 Electriseermachine. Nö. 9 en 10 Telegraaf. WKKF"" Elke Serie is afzonderlijkverkrijgbaarvoor /5.—- enop stevig Bordpapier geplakt voor ƒ8.75. Geen Tandpijn meer* I 1000 Hark betalen wij dengenen welke bij | het gebruik van Goldmann's | Keizer-Tandwater ooit I weder Tandpijn heeft. Èenig I middel voor het behoud van 8 schoone witte en gezonde Tan- | den tot op den noogsten ouder- n dom. (3967) S. Gol&mann & Co. 1 Breslau Schuhbrücke 36. Te Amsterdam alleen echt 1 verkrijgbaar by A.W.GROOTE I Kalverstraat 43.",http://resolver.kb.nl/resolve?urn=ddd:010063412:mpeg21:a0025:ocr,4,ddd:010063412:mpeg21:p004,Het nieuws van den dag : kleine courant,1130
386628,1881/02/18 00:00:00,348,ddd:010063334:mpeg21:a0016,http://imageviewer.kb.nl/ImagingService/imagingService?id=ddd:010063334:mpeg21:p003:image&x=2373&y=1597&w=1111&h=348,ddd:010063334:mpeg21,3484,1945,2373,1597,8,llötel ca Café Oestaurant. Op een groot en aangenaam aan Spoor en Water gelegen Dorp nat* een voorname Provinciestad wordt TE KOOI' AANGEBODEN- Een florissant en gunstig bekend HOTEL en CAPÉ-KESTAU______--T. met annexe STALHOUDERIJ. De INVENTARIS kan desverkiezei»dè daarbij worden overgenomen. Met franco brieven onder lett. P L P. te bevragen aan het Algemeeo Advertentie-Bureau van NIJGH & VAN DITMAR te Rotterdam,http://resolver.kb.nl/resolve?urn=ddd:010063334:mpeg21:a0016:ocr,3,ddd:010063334:mpeg21:p003,Het nieuws van den dag : kleine courant,1111
2840079,1881/03/31 00:00:00,2901,ddd:011085820:mpeg21:a0028,http://imageviewer.kb.nl/ImagingService/imagingService?id=ddd:011085820:mpeg21:p004:image&x=3746&y=3834&w=979&h=2901,ddd:011085820:mpeg21,4725,6735,3746,3834,4,"FAbiUüH „Dü JJRüitfU"" t A si 0 ii it U K A N IJïSKJt- eu KOIMSHÜIüiTEBIJ BMJSDEÜLI upd. /AABDIGI ou IUSf ABTHUT alle Bootten van MA. UaiiNEitJliiS uil o i'OOM KJil ifiLa KOmH-MA. üdl;NJ*. UMKJSN IJAK.KN. Noem» verderft .(elyke riou «4 «au voor i'ebriekee bh Sjuroi». prijien. u ' Attentie a. v. p Yerscüti lioilandsche Groenten op  het I'engersehe gebergte geteeld. mttuuaü»y*#oh Abunucmjui varkrygbaar bii • h. W. 7AN ÜJÜB ZWAAN __________ Boomstraat  iondon and JProrincial Marine In' surance Conipany} l gevestigd te Loadou. Kapitaal * I.OUO.UUÜ. Sterling. ||o onilergeteeteiiüe aangesteld tot A«nl M* voor üexo plaats van de hierboven ge. noemde Maatschappij ü bereid voor hare rekeain* ioonsioos te teekenen op de tier gebruikelijke voor waarden. Internationale OredieU en Handelt Vereeniging „Rotterdam • De Agent te Soerabaia Juli 18ÏV SBO4 li. üJfiZOi.l DE Blü. mGütlEÊsCttti Aardappelen en Uien ' (i'muit) n V bfl KOPEBBEBG ' • t Froboliaggo. Atelier ÜALUIAAS Stoomhoutzagery. Magazijn Tan Machineriën. Stoom-hout bewerking Smedery '4 Ketelwerk. —Draaierij. L. O. VAN LAKEBVELD fc Go. 17 IwiKinn . gp«r? PAliTllfiS desirous of thoroughljr muteriag Engliah and other modern ianguages' «pply for inatroction to < - 1 E. VAN DEN (iHEYN Junior. ; "" Teacher wit* diploma.",http://resolver.kb.nl/resolve?urn=ddd:011085820:mpeg21:a0028:ocr,4,ddd:011085820:mpeg21:p004,Soerabaijasch handelsblad,979
2645368,1881/06/15 00:00:00,2614,ddd:110536348:mpeg21:a0022,http://imageviewer.kb.nl/ImagingService/imagingService?id=ddd:110536348:mpeg21:p003:image&x=3161&y=3567&w=1012&h=2614,ddd:110536348:mpeg21,4173,6181,3161,3567,6,Terugkeer van de Australische wonderen der Terugkeer vun Mitfiior 4 him mi % l»ruelitige en iiilur ml «sedresseerile volbloed paarden vun wereld beroemden iiaaiu. ÜT \otU bene. Wij maken de dames en het jonge volkje vooral oplettend op onze vier prachtige jonge tijgers pas drie weken oud geboren aan boord van het stoomschip ter hoogte van'penangterwijl de ireus troep op reis w*ts van Hombay naar Singapore. Ie moeder van deze jongen is de groote tijgerin in het hole. Pehalve de reeds genoemde telt de v.rzameling wilde dieren nog twee zwirte tijgers uit de wildernissen van Indie twee zwarte Oevers en een lapir uit het Himakya gebergte enz. Terugkeer van de prachtige Lilliputtersche Shetlandsche Hitten. I'edenk dat deze renzententoonstelling door Slti- NOtt CHI.AttINI na juren onvermueibare inspanning ondervinding en talent bijeenverzameld met het cog op hetgeen het publiek het meest behagen kan en ten koste van kolossale uitgaven slechts voor een korten tijd hier geopend zal z n. Opvoeringen nebben p.aats onder Mainmouth tenten. ■Intree gelden. Loges (zes stoelen) ƒ j^# _ Stoeien op den eersten ran'* . 3. Stalles (overtrokken banken) 1 '&.— Galerij  t'_ Kinderen onder de tien jaren halt geld behalve de Loges. Plaatsen kunnen besproken worden aÜe dagen vau 9 's morgens tot 4 uur 's namiddags. H. Alle dieren kunnen bezichtigd worden in de eerste tent vóór men in de hoofdtent komt. 2085,http://resolver.kb.nl/resolve?urn=ddd:110536348:mpeg21:a0022:ocr,3,ddd:110536348:mpeg21:p003,Bataviaasch handelsblad,1012
2891700,1881/12/13 00:00:00,2835,ddd:011102862:mpeg21:a0020,http://imageviewer.kb.nl/ImagingService/imagingService?id=ddd:011102862:mpeg21:p004:image&x=3141&y=107&w=1020&h=2835,ddd:011102862:mpeg21,4161,2942,3141,107,4,"■ I. u.l U J'J'.'U LWlli.U .:<*» NED.-IND. LEVENSVERZEKERIMrENncLIJFfiENTK ; ijiu «Jtilij y<s(j MAATSCHAPPIJ;*» »& soJI aiiiiqn i Deze Maatschappij ;is steeds '.bereidt.tol faetuautt gaan van KONTRAKTEN- van iLKVENSVEB«ZEKErl RING en LIJFRENTE ensluitthars ook tegen teel ttiminderde premtön-) verkckeringèn voorKépitaal én overlijden 2onder aandeel;in da Bonus-».:! Ni *r.h rvd l i jTarieven en inlichtingen; tjjn b|jldenPeer Slaterus Agcnt: oot| op. het Hoofdkantoor te Batavia'""óp'traiieo 'aanvraag' Verkrijgbaar. V* T7a""Ku"" •*» \ * i ' ' -De MaatSchaipn.\'oornotemd!11a'! ! (813/ 1 "" E.MJOUWES DKKIiE»f'o«V^eUr. ; 1 '• G.1 E. 'C.1 GUFFROIJ/ptóatitef». 'Directeif.' L_L i» ' ;»?. T. - j'ljiji).""•; > !■'■■ !<-> • li'.\ •*""»"" tnjj) Undergclcekende AGENT van de' BBANDWAARBORG-MAATBCHAPPIJBN f» JVeêrliiiidsclx-liKlië S 4! |1 I>e' Oódthbfelk; J uü. léf»* 'I>e;Westiidél4H&M I>© JXoordLlioelc' en w"" I.W* t l>è JÉ^lWmtos^ is gemachtigd tot het Sluiten van Verze Keringen op STEENEN en HOUTEN GEBOUWEN met GEGALVANISEËÜDIJZER PANNEN öf ATAPf GEDEKT; zoomede óp daarin geborgen GOEDEÜEN.' i 450 V . *""""• - SLATÉBUS.1 J '  ""K t. j .li _ nu: I«IJ •Rö onüergeteekenden ; X? AGBN T E NT aér i r *l# ' IMPEBIAL FIRE INSURANCE' COMPANY . 0 /iv \ q»tw«r J; j . VERZEKERING-MAA I'SCHAPPIJ Amsterdam «f qfto.'mct.i.v tbiu^ai-rs ! KOLONIALE ZEE- EN BHAND-ASSUBANTIE-i MAATSCHAPPIJ te Batavia * o.v.U nc* ZEE EN BRAND ASSURANTIE-^AT&HAPPIJ „D EOOST E R LIN G"" ; rfl DBAND-A>SUBANTIE-MAATSCHAIPji„INSULINDE'.te Batavia f-'V./'UV"""""""" - zijn gemachtigd tot het 'aanemen 'van ASSURANTIE! op STEENEN GEBOUWEN met PANNEN' gedekt' op' HOUTEN GEBOUWEN'tiiet ATAP gedekt ën da1 daarin geborgen GOEDEREN; alsméde tot htet'élèiten' van ZEE-VERZEKERINGEN. ' '""i Mmn-'s> io«l; «ijmïi • J. F. VAN LEEUWEN 4  i(1244j»i01 .io'ji ti 'j'.t b\ t v|i iw"".« 'th'Padangl] \ diemont I r ! ' r • P ADAN bil Qtoom- en Prauwvaurtiati'- IJ 'Padang' haar de Keedèren Poeloe-Pisftüg en' omgekeerd.'v.~~ ""l* c ' v;: 'Agentschap'' ' tsclia-ppij „N ed er I'a n d"". IV• <"" ""}/ '•! .. Agentschap der beide 'té Ziitp^eii'geves-1. tigde Assurautie-Maatscliappijen tegen .brandschade.'. ;- r1629> VCI •. . . .-iiiiiii xl",http://resolver.kb.nl/resolve?urn=ddd:011102862:mpeg21:a0020:ocr,4,ddd:011102862:mpeg21:p004,Sumatra-courant : nieuws- en advertentieblad,1020
2943765,1881/12/30 00:00:00,2817,ddd:110536826:mpeg21:a0013,http://imageviewer.kb.nl/ImagingService/imagingService?id=ddd:110536826:mpeg21:p002:image&x=3157&y=63&w=1045&h=2817,ddd:110536826:mpeg21,4202,2880,3157,63,4,& EEN HEER «raagt bi! erna FAMILIE te Buiteniorg een kleine GEAIEUBiLK RUE KAIG ii mei eenvoudige koat voor /60 —a 70.— 's niiand* Aanbiedingen uiet Franco bricvrn onder No 4928 aan uitgevers dezes. 4928 HOTEL BUITENZORG. Genoemd HOTrT. door de ondergeteekende overgenomen zijnde bevuilt zij zicb in de gunst van het publiek aan. Mevrouw de Wtd VOGELPOSL. Buitenzorg Dee. 188. 4844 Wegens ver.rek ti-r overneming aangeboden: Ken Europ. VIS a-VIS. Eene Pianino VAN .VCHKDMAYBH & ÏJOEHNE. Adres: Teupkeu (Hotel der Nederlanden). 4390 onder Waarborg f 12000.— a f 20.000.— Adres 999 bureau van d;t blad. 4932 Bij MöLLER & Co. Scheepsleveranciers. Een prach ige Uoiiandsche KOC a ƒ 550.— gevende ld KANNEN M•■ I K daag». 494. MöLLuB V Co Madhuisplein. Te koop aan^eboio;!: Chinchona Calisava Ledgeriana planten. Wordt voor de qu.iiteir gewaarborgd. Idies Java ' o'e \o. 6023: 4%3 Te koop: op billijke voorwaarden of Te Huur uiet 1 JaDuari UB2 HET HUIS (■[> l-'alemba Lewooud doar dm heerSCHRA.VI en toebetiuortoide aan den heer I. J. J&NSSRNS. 'I e b vragen bij ■«ti's BIIJNBT & VTNJU.,http://resolver.kb.nl/resolve?urn=ddd:110536826:mpeg21:a0013:ocr,2,ddd:110536826:mpeg21:p002,Bataviaasch handelsblad,1045
973674,1881/03/13 00:00:00,949,MMKB08:000152683:mpeg21:a0029,http://imageviewer.kb.nl/ImagingService/imagingService?id=MMKB08:000152683:mpeg21:p006:image&x=1125&y=4128&w=1026&h=949,MMKB08:000152683:mpeg21,2151,5077,1125,4128,8,Advertentie Te koop: Groen blijvende HEESTERGEWASSEN 8 & 4 meter hoog. Ta bevragen Laan van Overvest n\ 133. TE KOOP: Eene partij groote Vaten uitmuntend geschikt voor Spoelingkuipen. Te bevragen aan de Stoom-Olieslagerij «het Schaap 1 te Vrijenban bij Delft. Te koop gevraagd: ledige Wijnvaten. Adres met franco Brieven en opgaaf van prija aan het Bureau dezer Courant.,http://resolver.kb.nl/resolve?urn=MMKB08:000152683:mpeg21:a0029:ocr,6,MMKB08:000152683:mpeg21:p006,Delftsche courant,1026
689396,1881/08/27 00:00:00,893,ddd:011007112:mpeg21:a0025,http://imageviewer.kb.nl/ImagingService/imagingService?id=ddd:011007112:mpeg21:p004:image&x=116&y=3243&w=772&h=893,ddd:011007112:mpeg21,888,4136,116,3243,4,Taunus Mineraalwater. EIGENAAR Ï.FRIEDRICHH6teI duNord Keulen Dit Water munt uit door volkomen zuiverheid van alle kunstmatige of organische Stoffen is rijk aan Koolzuur en genezend voor Yïeke en goed voor gezonde menschen. Het is een dietetisclie drank. Met Wijn Cognac of andere dranken vermengd is het water verkwikkend en verkoelend. Hoofddepöt J. W. KRAEMER. 15431 Rotterdam Haringvliet NZ. 45. GEVRAAGD MET SEPTEMBER eene zindelijke KEUKENMEID P. G. een goeden burgerpot kunnende koken. Adres Wijnhaven N.Zijde No. 155. 15588,http://resolver.kb.nl/resolve?urn=ddd:011007112:mpeg21:a0025:ocr,4,ddd:011007112:mpeg21:p004,Rotterdamsch nieuwsblad,772
2822340,1881/11/25 00:00:00,2767,ddd:010497560:mpeg21:a0023,http://imageviewer.kb.nl/ImagingService/imagingService?id=ddd:010497560:mpeg21:p003:image&x=3066&y=77&w=1020&h=2767,ddd:010497560:mpeg21,4086,2844,3066,77,6,"Koloniale en Tweede Koloniale Zee- en faMarantie Maatschappij Maatschappelijk kapitaal van ieder / 3.000.000 Deze Maatschappijen sluiten verzekeringen tegen BBANDSCHADEN op: WOON- en PAKHUIZEN MEUBELEN KOOPMANSGOEDEBEN enz. Alsook op; BUIKEB- KOPPIJ- THEE- en TABAKS-ETABLISSEMENTEN. Namens het Bestuur 1785 fAg^ 1 »~~ „HELVETIA'' gevestigd te St. Ballen [Zwitserland). Sctiweizerisctie Feuer-Vereicberungs-BesellscbafL Algemeine VersicheruDgs-Eesellschaft De ondergeteekenden tot agenten van bovengenoemde Maatschappijen benoemd zijnde zijn gemagtigd Brand- en Zee-Risicos op de gewone Premiën en Voorwaarden aan te nemen. 592 PANDEL & BTIEHAUB NACHFOLGER ___w_____M__H__a__._____________. De ondergeteekenden benoemd tot AGENTEN van ei Hamburg Magdeburger Feuerversicherungs Gesellschaft in 110 ixiburg- zijn bereid tot het sluiten van VEBZEKEBINGEN tege BRANDGEVAAR op hier gebruikelijke voorwaarden. 871 S BüSING SCHRöDEB & Co. Fire Insurance Association (LIMITED) LONDON Hanseatische Feuer Versicherungs Gesellschaft „Hamburg"" en Queen Insurance Company „Liverpool"". De ondergeteekenden Agenten van bovengenoemde BRAND- ASSURANTIE ■ MAATBCHAPPIJEN sluiten verzekeringen tegen gebruikelijke premiën. REISS & OO* Batavia Soerabaija en Macassar. 4507",http://resolver.kb.nl/resolve?urn=ddd:010497560:mpeg21:a0023:ocr,3,ddd:010497560:mpeg21:p003,"Java-bode : nieuws, handels- en advertentieblad voor Nederlandsch-Indie",1020
3861930,1881/07/04 00:00:00,4002,ddd:010101706:mpeg21:a0007,http://imageviewer.kb.nl/ImagingService/imagingService?id=ddd:010101706:mpeg21:p003:image&x=3939&y=2907&w=965&h=4002,ddd:010101706:mpeg21,4904,6909,3939,2907,4,"De Ondergoteekende vraagt beleefdelijk de aandacht van het geachte publiek voor de volgende annonce. Do Heer J. C. BEBNTROP Keurmeester alhier en hem ondergeteekende door de commissio voor de keuring van voedingsmiddelen bijzonder aanbevolen is naar aanleiding van het door de autoriteiten uitgesproken en algemeen gemaakt manifest door hem aangesteld alle HAMMEN zoowel van inlandsche als vreemde herkomst wetenschappelijk te onderzoeken. Voornoemdo Heer Keurmeester geeft mits deze in de hier onmiddellijk volgende advertentie t algemeen kennis dat hij zich met 't hem vertrouwd mandaat volgaarne heeft willen belasten. J. VALK.. Nieuwendijk 55. Mij refereerende aan bovenstaande reclame van den Heer J. VALK Winkelier nan den Nieuwendijk 55 Amsterdam  vind ik gereedelijk aanleiding tot de volgende verklaring in het algemeen belang. Als deskundige tot het keuren van voedingsmiddelen ambtshalve aangewezen is mij door den Heer J. VALK MEEH SPECIAAL DE OPORICHT VERTROUWD  alle tot den verkoop bestemde HAMMEN aan een wetenschappelijk onderzoek (mikroskopisch) te onderwerpen. Als waarborg wordt genoemd artikel steeds van rood lak voorzien waarop mijn signatuur is afgedrukt. Ik vermeen door dit radicaal voorbehoedmiddel de affaire van den Heer VALK en speciaal den verkoop van HAM vriielijk te mogen aanbevelen. Jl. C. BEBNTROP (26483) Kourmeester. De Makelaars H. B. REESINCK C. WIEGAND J. J. EYROND P. A. 11. REESINCK S. W. VAN ROUENDAL W. N. J. VAN DER HULST en A. SLICHER zullen op WOENSDAG 97 JIULI 18S1  des Avond» na 6 uur in het Verkooplokaal HET OUDEZIJDS HEEREX-LOGEMEXT ten overstaan van den Notaris G. VERRIJN STUART in veiling brengen: 1"". Het zeer gunstig gelegen ep bijzon^fr sterk gebouwd HOO P]!IJ__MSHITIS9 met OPEN PLAATS ca ERVE staande en gelegen aan ac HEERENGRACHT tusschen de Gasthuismolen- en Roroeinsarmstegen n"". 267 kad. sectie F n"" 247 groot 51 Centiaren. 2°. Een daarachter gelegen HUIS en ERVE aan de TREEFSTEEG n\ 7 kad. sectie F n° 292 groot 25 Centiaren. Bezichtiginsrsdagen Dinsdag «n Donderdag alsmede op den verkoopdag van half 3 tot half 5 uur. De Perceelen 1 en 2 worden eerst ieder afzonderlijk opgeboden en afgeslagen en daarna gezamenlijk in slag gelegd. De bowijzen van eigendom en de veilconditiën zullen vier dagen vóór en op den verkoopdag des voormiddags ter inzage liggen ten kantore van den Notaris bovengenoemd Keizersgracht b/d Spiegelstraat n' 598 alhier. (26397) HET KANTOOR VAN 32 r. €. JS-UiJ- ADVOCAAT en PROCUREIR is gevestigd op de KEIZERSGRACHT BIJ DE PRINSENSTRAAT N"". 68. (26467) Er bestaat gelegenheid voor 1 of 2 Heeren bij nette lieden een GEMEUBILEEBDE VOORKAMER met ZIJKAMERTJE tegen billijke prijzen in het midden der stad half Juli of 1 Augustus. Franco brieven lett. VX Bureau Handelsblad. (26466) MEN VERLANGT met 1 Augustus a. s. tegen goed looa in een net Burger Gezin eene zindelijke DIENSTBODE die een burgerpot kan koken en flink werken'1 tevens kan daar een knap DAGMEISJE GEPLAATST worden van des morgens .7 tot 4 uur. Beiden voorzien van goede getuigen. Adres franco Lett. K bij den Boekhandelaar J. C. SCHRÖDER. Rokin 30. (26501) TERREIN TE HIM aan de WEESPERZIJDE voorbij Schollenbrug bij Arasterdam gelegen aan het water. Direct te aanvaarden. Brieven franco onder motto: Terrein aan den Kantoorboekhandel BLIKMAN & SARTORIÜS Rokin 17. (26338) rJT_E HïTlTfl * een UCIS bestaande in voor- en achterkamer alkoof konken plaats en tuin tegen ƒ4.50 per week gelegen lijnbaangracht bg de Palmgracht n° 14 .*■ (36315) _E_EM R_BIziGBR9~ geroutineerd in het SCHOENVAK wenscht verplaatsing om voor een solied huis Op to treden. Adres franco onder lett. B bij den Uitgever M. ROEST Mz. Jodenbrcestraat 37 • Amsterdam. .sg\ Tegen brimo Augustus of eerder wordt o» oen fatsoenlijken Stand alhier TE HUUR gevraagd voor eene bejaarde Dame met .Inftron'iy van Geietabap t ONGEMECB-I.ECBDE KAMERS met KEUKENTJE of ALKOOF voorzien zoo mogelijk van Kleiden en Gordijnen. Opjraven v.-wi prij». conditiën enz. worden ten spoedig»te ineewaeht onder de lett. X. Y. Z. bij den Boekhandelaar'T. KOU W_NAAJR KjJverstraat N"". 62 te Amsterdam. (2640..",http://resolver.kb.nl/resolve?urn=ddd:010101706:mpeg21:a0007:ocr,3,ddd:010101706:mpeg21:p003,Algemeen Handelsblad,965
2838660,1881/06/14 00:00:00,5060,ddd:010063447:mpeg21:a0015,http://imageviewer.kb.nl/ImagingService/imagingService?id=ddd:010063447:mpeg21:p003:image&x=2919&y=158&w=561&h=5060,ddd:010063447:mpeg21,3480,5218,2919,158,8,TE KOOP: 50 Kub. El Populieren Pl» ten mooi gaaf Hout in dikte* van 4 en 5 Amst. duimen. Prij» 18 per Kub. El. Brieven francq onder lett. B K K aan het Algemeen Advertentiebureau van NIJGH & VAN DITMAR Rotterdam.l(s369J PUBLIEKE VERKOOPING ten overstaan van denNotaris HONDIUS te Leerdam van eene sedert 60 ja»-ren bestaande en welbeklante TIM-' MERMANS-AFEAIRE bestaande in Timnierwinkel met Woning en Tuin Timmer- e» Molenmakersgereedseb appen en voorhanden zijnde Houtwaren en een afzonderlijk daarnaast staand Woonhuis en Schuur; eerst in '2 perceelen en daarna in massa waarvan de finale verkooping zal plaats hebben op Dinsdag den 14 Juni des namiddags leb ui en in de »Stadshorberg« te Asperert zijnde de Perceelen zonder Gereedschappen ou Houtwaren ingezeten verhoogd tot f 3100. Inmiddels uit de hand te Koop. (53M( -e Aanbesteding op Dinsdag 21 Jivni 18§1: Hel bouwen ran een WOOMHUTS op de Weteringschans bij de Spiegellirug Nadere inlichtingen en Bes!>  tegen betaling vaa ƒ1-— te bekomen ten kantore van de onder len: Prinsengracht No. 177 van 's morgens 10 tot 'snaojidclags 2 uren iiJENDAL & Co. Aanbesteding. Op Dinsdag 28 Juni 188 L des 12 uren. zal door Bur- en Wethouders van Loniuk; r. op bet Gemeentehuis in het openbaar worden aanbesteed: Het bouwen eener Onderwijserswoning op een terrein gelegen hij de School te Driene. gemeente Lonneber. Bestekken zijn van af Dinsdag 14. Juni e.k. a ƒ0.30 en Teekeningen a ƒ 0.30 op franco aanvrage verkrijgbaai meente-huis. Bej stok» en Teekening liggen van ai dien datum iv 't Logement >.7 Fo)<-tuint. ter inzage Nadere inlichting gen worden verstrekt door den Architect G. I.NH»:iiivIANS. Aanwijzing op b in loco op den dag der B oormidd.Muren. Bur on Wethouders voornoemd STORM VAN 'sGRAVESANDE. Ilurt-emeestcr VON BÖNNINGHAUSEX Secretaris. Lonnekcr. 7 Juni 1881. X JL Ju Xj Prosymß.asium. llet ei rete 'I'oelutii.igs-examen voor den nieuweo cursus za! gehou d omsin-eks half Juli. Inlichtingen Ktjn te bekomen bjj don Rector Dr. 1. G. SCHLLMMER. Iwëëwaaiiil te Leiita door iemand bekend met handelszaken een Winkeldepot onverschillig in welke artikelen. Brv. lett. VV bij den Boekh. 1. DL' PON Leiden. Kippenvoer Zuivere Tarweafval fl de 100 kilo bij S. CAMPHUIS Warmoesstraat 100. Amsterdam. Orders binnen Amsterdam gelieve men per briefkaart te doen. Is verschenen : Is het uw belang de Rijkspostspaarbank te kiezen boven eene particuliere? beantwoord door D. DEKKER Voor-.-Direct cur der Nu.'-spaarbank ie Helder. Prijs 25 Cent. ¦ Dit belangrijk geschrift dat op grondige wijze dc quaestie der Spaarbanken bespreekt is in eiken Boekhandel verkrijgbaar en na toezending van het bedrag bij da Uitgevers BEBKHOÜT & Co„ te Nieuwediep. (5366) DE JNIEUWE Ptirmependcp €oupant verschijnt eiken Woensdagavond en kost slechts per drie maanden GO Cts. franco per post. Advertentieprijs: is 10 Cts. per gewonen regel. Puniierende. ' L. G. POST & Col (5363) Uitgevers. döodaanTiT en zuivering van alle mogelijke soorten van Insecten door middel van 't Stucadooren. Geëerde orders worden s. v. pl. ingewacht bij Wed. MICHEL Prinsengracht b/d Noor-' dermarkt No. 18. .. • Heden verschijnt bij 11. D. TJEENK WILLINK te Haarlem: UIT EMERSON'S LAATSTE ESSAYS. Naar het Eng. door Augusta. Met een woord vanaanbeveling DOOR Dr M. A. ET. ROVERS. Prijs f 1.90. Boonetai of laatf üer hetwelk alle andere Bitters in geur overtreft de Magen versterkt en deu Eetlust bevordert wordt gefabriceerd en verkocht bij (42631 GEZUSTERS DUEOIS Exporteurs N. Z. Voorburgwal No. 148. Amsr Per -k Elesch a 55 Ct. Per Elesch. . a 110 » Per Liter . . & 125 *,http://resolver.kb.nl/resolve?urn=ddd:010063447:mpeg21:a0015:ocr,3,ddd:010063447:mpeg21:p003,Het nieuws van den dag : kleine courant,561
3854928,1881/04/30 00:00:00,4172,MMKB08:000090165:mpeg21:a0018,http://imageviewer.kb.nl/ImagingService/imagingService?id=MMKB08:000090165:mpeg21:p004:image&x=246&y=207&w=924&h=4172,MMKB08:000090165:mpeg21,1170,4379,246,207,4,Advertentie C. FRIKKERS Jr. Voorhanden : Tcrsclie Faling' in Gelei Cieheele Kreeften met sclutal in blik. Geconserveerde Garnalen. Oesters in blik. KolHjluiis CoslaiiiêuhooiD ook genaamd MARKUS. Ondergetetkende bovengenoemd Koffijhuis einde dezer maand verlatende brCESgt zijnen (lank aan zijne bezoekers gedurende de 6 jaren dat bij het t xploiteerde en betuigt inzonderheid zijnen dank aan diegenen die medewerkten voor de blijvende herinnering hem dezer dagen vereerd. P. D. I. JURRIËNS. DE mm Beschuit extra fijn en bros. E'ken dag- versch verkrijgbaar SBroerenstraat A 28. Gymiiustiek-Inrichting ROERMONDSPLEIN 81. De gymnastieklessen voor kleine jongen3 in de Gymnastiekschool Menthensteeg zullen worden gegeven des Maandags en Donderdags voorloopig van halfeen tot half twee en die voor kleine meisjes des ^Dinsdags en Vrijdags op hetzelfde uur. Aangifte van nieuwe leerlingen die daarvan gebruik zullen maken steeds ten mijnen huize. De heer VAN DER HELL die tijdens mijne ziekte een gedeelte der lessen voor mij heeft waargenomen treedt met p°. Mei a. s. als medeonderwijzer aan mijne inrichting op. Arnhem 29 April. E. MINKMAN. Let welT Een fatsoenlijk HEER van de P. Gr. middelbaren leeftijd en goed voorkomen  het grootste gedeelte van den dag vrij hebbende zoekt geplaatst te worden als Opzichter of iets dergelijks. Op salaris wordt volstrekt niet gelet. Franco brieven onder No. A 565 Bureau dezer Courant. Eerste Hulponderwijzeres aan Bewaarschool N°. 1 te Arnhem wordt gevraagd. Jaarwedde ƒ 400.— Adres franco aan den Burgemeester vóór 14 Mei 1881. Onderwijzeres 3e kiasse met aanteekening voor het onderwijs in de Nuttige Handwerken voor Meisjes voor het Lager Onderwijs jaarwedde ƒ65O wordt gevraagd te Arnhem. Adres franco en op zeg»l met de noodige bewijsstukken aan den Burgemeester vóór den 11 Mei 1881. Wordt ten spoedigste gevraagd : « Onderwijzeres geschiktheid bezittende om een jeugdig Kind eenige uren daags aangenaam en degelijk te kunnen bezig houden door het geven van grondig Lager Onderwijs in de beginselen van enkele Vakken. Brieven franco onder letter D Postkantoor te Velp. E ek OwSii KEUKENMEID ~ van de P. G. biedt zich terstond aan liefst te Arnhem of omstreken ; getuigschriften staan haar ten dienste; ook is zij niet ongenegen Huiswerk te verrigten. Brieven worden franco ingewacht onder letter L. bij den Boekhandelaar C. J. VORSTERMAN VAN OIJEN Jr. te Zwolle. Te Oosterbeek gevraagd tegen Augustus a. s. eene zindelijke KEUKJENMEIO  tegen hoog loon. Adres franco briefjes letter B of in persoon bij den Boekhandelaar G. ROMIJN aldaar.,http://resolver.kb.nl/resolve?urn=MMKB08:000090165:mpeg21:a0018:ocr,4,MMKB08:000090165:mpeg21:p004,Arnhemsche courant,924
3559800,1881/01/15 00:00:00,3490,ddd:110536222:mpeg21:a0020,http://imageviewer.kb.nl/ImagingService/imagingService?id=ddd:110536222:mpeg21:p003:image&x=2114&y=2670&w=1020&h=3490,ddd:110536222:mpeg21,3134,6160,2114,2670,8,Stoom vaart Maatschappij Nederland. <>!> Irnnro {ïnnvraiï»' GRATIS VERKRIJBAAR: MMLTABELLEN 1881. f 971 J. DAEM)ELS Sr Co. CHAMPAGNE v*-m Juie Mumm & Co. te Reims overal bekend als een der beste merken verkrijgbaar bij I/)A TO SKNG laskar Rarae TIO TJENG PO El id. JO BOK SKNG Glodok. %\Hr)t PISANG BATOE. van dood vee en gelegenheid tot STALLING van ZI *• K VKE in grasland. (•2630) Mandor MIOKN. Chartered Ifereantile Bank OF India London and China. Agentschap Batavia Eali-Besar West-Zijde. Ingelijfd bij Koninklijk Besluit. Hoofdkantoor: 6i < ld Broad ptreet london K. ('. Kap.taai £ 750.000.— Besmvbfokw £ f 0.04290 Branches & Subbranches Bombay Calcutta Madras Colombo 6alle Kamlv Matale Bangoon Penang Singapore Hongkong Shanghai en Jokohama. HAINKIERS. ... I Hope & Co. AniilerddM. i » e. i i o i f de Amsterdamsche Bank. Rotterdam de Rotterdamsche Bank. r ( the Bank of England \ the Londen Joint Stock Bank. Parijs Marcuard A ndré & ('o. Het agentschap te Batavia koopt en verkoopt Wissels op Ingeland Nederland Frankrijk Oost-Indië China Amerika Australië en alle BRANCHES; ven leent ('rediet-Frieven en (ircular rotes en doet in allin Indie gewone Bank-en Agentschapszaken op bij her Liireaii te vernemen voorwaarden. < >i. tviinyft Gelden in deposito voor een jaar tegen ïi°/n 's jaars. • /.es maanden • 3% « Men gelieve alle brieven te adresaeeren aan den agent KANTOOR URENT. Des Zatebuau's van 10 tot één uur. Pc Overige dagen • 10 i drie. A. F. WfiIGHT Agent. Correspondenten» Te Soerabaija. de Heeren FJRASER BATON Sc Co. i Samaratg « t MeN'EILL & ('o. '« Tadang ■ • DüMMLEB Sr. Co. | Bangkok t • I'ICKBNPACK TM ES & Co. 'm Saigon * « Wm G. H.\LE & ('o. i Amoy • • BOYD Sc ('o. i Fooc/iov. • * BUKDON At Co S Hmkov . « KOBt. ANDKKriON & Co. (1714),http://resolver.kb.nl/resolve?urn=ddd:110536222:mpeg21:a0020:ocr,3,ddd:110536222:mpeg21:p003,Bataviaasch handelsblad,1020
4245504,1881/12/23 00:00:00,4146,ddd:110536821:mpeg21:a0002,http://imageviewer.kb.nl/ImagingService/imagingService?id=ddd:110536821:mpeg21:p001:image&x=1082&y=2066&w=1024&h=4146,ddd:110536821:mpeg21,2106,6212,1082,2066,4,"Vendutie OP Di?<SDAG 21 DtCEWBER 1831 iloor A. G. BOSCH & Co. v«M eea-re lirlaiajËi'ijko partij DJATTIE HOUT. 4co] l)c publieke Verhuring van het land BA WA BOKAIJA op '27 dezer zal geen voortgang hebben. OP WOENSDAG 28 DECEMBER 1831 van «iiverse KOOPMANSCHAPPEN Dranken Provisica enz. enz. van vleuten & cox vaFvleutenlTcöx verkoopen nog tot sluiting van Kekeniig op 28 ries. r: 25 fraaie ENGBLSCHK PLATEN fa iet» we onderwerpen). 50 staven voor SCHILDERU LIJSTEN. 25 dozijn mooie Parijsche Overhemdenl I er haf dozijn op te vci'eo. 48G8 Van Vlcutcn&Cox zullen op hunne Toko vendutie v;n 28 dezer verkoopen : Voor Rekening vran vertrekkendij personen.: Diverse Meubelen waaronder: Groote SPIttGELS i CHILDEBUBtV IJZEREN 2 persoons LEDIKA..TEN. groote DIVANS PORCELKIN- GLAS-en PLEET WKIiK KASTLNenz.cnz. Verder : Ken BALLON KAR HANDWAGEN en TENTWAGEN. Ken Pr.ic'itirre ge;icdimnteeruo NEW FOUNDLANI) HOND. Twee Madureesc'ne bastaard HANEN (Pegiasar») Een d-*3Uw Weener Ameublement bestaande nit: CANAPÉ FAUTEUILS WIPSrUREEN VOETBANKJE TAFj£LS htNAPÜN CONSOLES BLOEMTAFEL BLOKMSTANDAAhD HOEDE: KAPSl'O'i met SPIEGEL enz. Een greote Partij Xli )ren als: HEiiüEN BROEKEN JASSEN NaCUTBEOëKKN KAbAIEN enz. Zoo £oed a's nieuwe WIATEK KLEEREN. 4070_ E. VASSALLO"" Batavia Noordwijk. ' Ontvangen per SS. Emirne : GEDHOOC!)E VIJGEN prr blik en per gewicht. VERSCHE AMANDELEN. ZIJ UK vsn Milaan. SATIJN. Glacé Handschoenen witte en gekleurde. 4:<iB ; Ontvangen: IVr ■*rïiïM*«» Aiuulia: Gecondenseerde Aipenmelk in flesschen. 4160 JOHN PRYCE & Co.",http://resolver.kb.nl/resolve?urn=ddd:110536821:mpeg21:a0002:ocr,1,ddd:110536821:mpeg21:p001,Bataviaasch handelsblad,1024
4065508,1881/09/28 00:00:00,3617,ddd:010063552:mpeg21:a0023,http://imageviewer.kb.nl/ImagingService/imagingService?id=ddd:010063552:mpeg21:p008:image&x=1245&y=1603&w=1124&h=3617,ddd:010063552:mpeg21,2369,5220,1245,1603,10,"AISTEKD. PIJP-GAS-COIPAGIIE Schans over de Elandstraat. Bekwame FITTERS voorzien van goede getui cschriften kunnen dadelijk geplaatst worden tegen een loon van 15 a 17 Ct. per uur. 27 September 1881. (88051 GOUD en ZILYeYIaYïïUII-SIELTÊRIJ Barendsplein 17 vroeger Bokkingham. Inkoop of Smelteri"" van Naaand Slijp Stofgoud Oude Spiegels of Schilderijliisten Phothografie-afval enz. tegen de HOOGSTE PRIJZEN bij Amsterdam. J. VAN DOBBENBURGH. Waarschuwing. Het Huis Frisia bericht zyn geachte clientèle dat zijn Agent D.M. VAN KELCKHOVEN vervangen is door den Heer W. J. VAN DOUWEN en dat zijn door Dr. N. v. d. WALL scheikundig onderzochte BOTER alleen te verkrijgen is in den winkel Paleisstraat hoek Singel 239 en gedekt moet zijn met papier voorzien van de handteekening van W. 3. VAN DOUWEN. NB- Deze advertentie moge een voldoende verklaring zijn van eenige in de laatsle weken ingekomen opmerkingen. (8310) Brand- en LeveesYerzekering. Bdjpscke laatstapsp wa Alpeene kmmln gevestigd te Brussel in 1824 en 1830. Verzekering tegen Brandschade. VERZEKERING IN GEVAL VAN OVERLIJDEN. GEMENGDE VERZEKERINGEN. VERZEKERING OP VASTEN TERMIJN. DADELIJK INGAANDE EN UITGESTELDE LIJFRENTEN. SPAARKASSEN TOT VESTIGING VAN KINDEREN. Men gelieve zich te wenden tot de Hoofdagenten te Amsterdam ¦ H. H. DE LEEUW Warmoesgracht No. 9 en DUNLOP & VAN ESSEN Singel No. 232. 'T BELANGRIJKE Amerikaansche Pakket No. 18. Thans een geheel nieuwe combinatie alles te zamen voor /1 25 Ten ie. Een keurige Zakmieroscoop om alle kleine voorwerpen 2500 maal te vergrooten een druppel regenwater een stukje spek of vleesch met trichine is belangrijk om te zien kaas. enfin alle artikelen waarin zich voor het bloote oog onzichtbare insecten bewegen kan men hiermee op zgn gemak beschouwen en leveren een interessant schouwspel op. Men plaatse den Microscoop voor het oog en zoo naar het daglicht zien. — Ten 2e. Een nieuw Zilveren Lucifersstandaard met Asehbakje nieuwste model. -. 't Aardigst van dit artikel is dat bet 's nachts of in het duister van zelf licht afgeeft omdat zich hierop de veel besproken lichtgevende verf bevindt 't is een curiositeit artikel. Men moet het overdag in het daglicht plaatsen wil het's avonds schijnen — Ten 3e. Een Schrijfinstrument reeds vroeger genaamd de Won- dervolle penhouder en met recht want het voorwerp dat gemakkelijk is om in den zak te dragen zit vol met doelmatige zaken als: Penhouder zwart Potlood rood Potlood blauw Potlood Griffel Gomelastiek Eng en Nederl. Ellemaat. — Ten 4e. Een nieuw Zilveren vestzak Lucifersdoosje voor Zweedsche lucifers 't nieuwste modeL — Ten se. Een Wonderspiraal dat is een amusant instrumentje om zelf een geheel gezelschap eenige oogenblikken aangenaam bezig te houden; de kwestie is om een koperen ring van een spiraalveer af te doen zonder ze te wringen ;de oplossing hiervan is dat menden ring links om draait; en ten 6e. Cadeau Een doos eoht supra fljn Eng. Postpapier met dito Enveloppen keurig keurig hjne kwaliteit. Zij die hiervoor liever een Amerikaansch Kooktoestelletje om in vijf minuten een ketel kokend water te hebben daarvoor in plaats verlangen kunnen dit mits het duidelijk wordt opgegeven ontvangen. Zij die het Papier en de Enveloppen netjes met twee of drie letters gestempeld wenschen betalen 10 Cents meer dns ƒ1.35 voor het geheele Pakket met duidelijke opgave van de letters die men verlangt. Voor buiten tegen toezending van Postwissel van ƒ 1.25 of f 1.35. De expeditie gaat zoo vlug mogelijk doch men moet in 't oog houden dat met verzenden en ontvangen van Postwissel altijd een paar dagen verloopt dit ter toelichting teneinde nutteloos geschrijf te voorkomen. E. F. EDEN Molsteeg 12 Amsterdam.",http://resolver.kb.nl/resolve?urn=ddd:010063552:mpeg21:a0023:ocr,8,ddd:010063552:mpeg21:p008,Het nieuws van den dag : kleine courant,1124
2337432,1881/04/06 00:00:00,2696,ddd:010587882:mpeg21:a0004,http://imageviewer.kb.nl/ImagingService/imagingService?id=ddd:010587882:mpeg21:p004:image&x=1011&y=390&w=867&h=2696,ddd:010587882:mpeg21,1878,3086,1011,390,4,AANBESTEDING. BURGEMEESTER en WETHOUDERS van HEMELUMER OLDEPHAERT en NOORDWOLDE zullen op Maandag den 18 April 1881 des middags ten 12 ure bij enkele inschrijving aanbesteden: Het afbreken der oude en het opbouwen eener nieuwe HOLTEN OPHAALBRUG over de Rijstervaart. Het bestek en de teekening liggen ter inzage ter Secretarie te Koudum alwaar tevens gedrukte bestekken zijn te bekomen tegen betaling van /0.75. De inschrijvingsbiljetten worden ingewacht ter Secretarie voornoemd vóór des middags 12 ure van den dag der aaubesteding. Koudum den 2 April 1881. Burgemeester en Wethouders voornoemd C. W. C. T. VISSER Fz. Dc Secretaris T. FABER f.-S. WATERSCHAP Kollumerland—Oostdeel. De VOORZITTER van het voorloopig Bestuur van voornoemd Waterschap convoceert de Ingelanden tot bijwoning der Vergadering op Zaturdag den 9 dezer des voormiddags ten tien ure in het logement de Roskam te Kollum  ten einde: 1. te benoemen vijf Leden van het Bestuur voor dit Waterschap; 2. te besluiten op voorstellen van het definitief Bestuur tot: a. het uitvoeren van Werken in dit Waterschap en hetgeen daarmede in betrekking staat; b. het aangaan eener Geldleening; c. het benoemen van een Secretaris-Ontvanger. Kollum den 2 April 1881. De Voorzitter voornoemd J. WITTEVEEN. Vernieuwing vaa Grafregister. KERKVOOGDEN der Hervormde Gemeente te Lekkum roepen bij deze alle Eigenaren van Graven op het Kerkhof aldaar op om vóór den eersten Mei 1881 aan den Heer K. VIS aldaar als Boekhouder dier Begraafplaats hunne eigendomsbewijzen over te leggen ter inboeking in een nieuw Grafregister en ter verwisseling daarvan tegen nieuwe bewijzen. Tot 1 Mei e.k. zal genoemde Boekhouder daartoe op eiken werkdag uitgenomen des Zaturdags vaceren van 11 tot 1 uur. Zoowel in koop als in huur zijn GRAVEN beschikbaar bij den Boekhouder. Namens Kerkvoogden voornoemd T. van HETTINGA TROMP.,http://resolver.kb.nl/resolve?urn=ddd:010587882:mpeg21:a0004:ocr,4,ddd:010587882:mpeg21:p004,Leeuwarder courant,867
263406,1881/10/08 00:00:00,286,MMSADB01:000018890:mpeg21:a0002,http://imageviewer.kb.nl/ImagingService/imagingService?id=MMSADB01:000018890:mpeg21:p001:image&x=75&y=1979&w=921&h=286,MMSADB01:000018890:mpeg21,996,2265,75,1979,10,Advertentie iraarvan do plaatsing driemaal is opgegeven worden slechts tweemaal »n rékminj gebracht Bij toezending gelieve men vooral duidelijk den naam der Uitgevers op het adres te stellen,http://resolver.kb.nl/resolve?urn=MMSADB01:000018890:mpeg21:a0002:ocr,1,MMSADB01:000018890:mpeg21:p001,Provinciale Noordbrabantsche en 's Hertogenbossche courant,921
2594844,1881/02/25 00:00:00,2942,ddd:010587848:mpeg21:a0022,http://imageviewer.kb.nl/ImagingService/imagingService?id=ddd:010587848:mpeg21:p005:image&x=1845&y=2578&w=882&h=2942,ddd:010587848:mpeg21,2727,5520,1845,2578,12,GECOMMITTEERDEN van den Mammer en Nijkerker Polder roepen volgens art. 47 van het Reglement de Eigenaren dier Landerijen op tot het bijwonen der jaarlijksche Algemeene Vergadering op Maandag 7 Maart 1881 des namiddags 2 uur ten huize van S. de Vries te Marrum ten einde de Rekening over 1880 na te zien de Begrooting' reeds door Gecommitteerden opgemaakt met of zouder veranderingen vast te stellen en te benoemen een Gecommitteerde voor H. Link die als zoodanig 12 Mei e.k. aftreedt. Namens Gecommitteerden A. J. ROORDA Boekhouder. VERKOOP • WIIELIIMGE TE JOURE. De Notaris MUNNIK te Joure zal op Maandag 28 Februari 1881 's av. 7 uur  bij Johs. Bosma aldaar in veiling brengen: Eene zeer ter neringstaande WINKELHUIZINGE  voorzien van ruimen Winkel Kamertje Achterkamer en verdere gerijfelijkheden  met Erf en Bleek Bak Put en daarachter staand HOK op het noordoosteinde der Midstraat te Joure eigen aan en bewoond door B. Brouwer. Aanvaarding 12 Mei 1881. Klij n verkooping. De Notarissen MUNNIK te Joure en BOSCHLOO te Heerenveen zullen op Maandag den 28 Februarij 1881 des nam. 3 uur in het Hotel Terwisga te Joure in publieke veiling bij voorloopige toewijzing verkoopen voor den H.W.Geb. Heer Jhr. Mr. P. J. van Beijma: 4 perceelen uitmuntende KLIJN in de kadastrale nommers 141 146 en 147 van sectie C gemeente Nijehaske gezamentlijk groot ongeveer 8 hectare 88 are 69 centiare. DEZELFDE NOTARISSEN zullen ten verzoeke van hunnen Ambtgenoot H. de KOE te Sexbierum alsdan tevens veilen voor den H.W.Geb. Heer Jhr. J. K. Vegelin van Claerbergen: 4 perceelen uitmuntende KLIJN aanwezig in het kadaster nommer 125 van sectie C gemeente Nijehaske te zamen groot ongeveer 5Va hectare. Alle perceelen gelegen aan de Geeuw. Breeder in de boekjes van den verkoop met kaartjes aangewezen verkrijgbaar ten kantore van gemelde Notarissen. Uit de hand te koop ofte huur op 12 Mei e. k. een flink BURGERHUIS waar thans een Winkel in Naaimachines wordt uitgeoefend en zeer geschikt is voor vele zaken staande op een besten stand bij een druk bezocht wordend Logement en schuins tegenover de R. C. Kerk. Brieven franco onder letter H bij den Boekh. O. FEENSTRA te Franeker.,http://resolver.kb.nl/resolve?urn=ddd:010587848:mpeg21:a0022:ocr,5,ddd:010587848:mpeg21:p005,Leeuwarder courant,882
2733456,1881/05/14 00:00:00,2728,ddd:010104021:mpeg21:a0021,http://imageviewer.kb.nl/ImagingService/imagingService?id=ddd:010104021:mpeg21:p004:image&x=104&y=185&w=1002&h=2728,ddd:010104021:mpeg21,1106,2913,104,185,8,D« Raad van Toezicht der Commercie-Compagnie te Middelburg brengt ter kennis van de DEELGENOOTEN IN DIE COMPAGNIE dat in de op 26 April 1881 gehouden Algemeene Vergadering van Stemgerechtigde Deelgenootenis besloten om over het boekjaar 1880 een IIITDEELING te doen van_ een half percent van het oorspronkelijk kapitaal en dat de uitbetaling daarvan zal geschieden ten kantore van den Boekhouder der Compagnie telkens des Woensdags en ] Zaterdags van des voormiddags 9 tot 12 uur te beginnen BI met Woensdags 18 Mei 1881. (17129) toe ■— • vo THE ST. PAUL MINNEAPOLIS AND * MANITOBA RAILWAï Clf i'ANY'S FIRST HORTGAGE SINKING FUND 7 PER CENT. LAND GR.LYT GOLD BONDS. Jj In conformity with the provisions of the mortga of trust securing the above bonds we the undersigned rustees hereby give notice that 71 bonds of % 100 eac 12 bonds of % 500 each and 225 bonds of % 1000 each ot the numbers specified below were this aay in our presence fairly and without preference or discrimination designated by lot | for redemption at 105 per cent and accrued interest payable ■ out of the moneys pledged to vs from proceeds of safes of lands and now available for that purpose. The bonds so drawn will be paid on presentation at the office of J. S. KEN- ■__ KEDY & C„ N°. 63 William-st New-York and «ac helders thereof are hereby notified that they should be presented on or before lst July nest as after that date interest will cease to accrue thereon. 71 BONDS OF DOLL. 100 EACH. E 60 \4U 745 928 1079 1248 1595 1777 114 425 746 959 1095 1364 1596 1837 204 442 747 967 1115 1377 1669 1853 225 468 757 969 1117 1382 1685 1913 227 470 806 981 1136 1441 1692 2006 248 501 859 997 1149 1513 1712 2079 264 524 877 1012 1182 1562 1730 2156 318 532 907 1016 1189 1579 1765 2186 329 623 924 1033 1210 1585 1769 13 BONDS OF DOLL. 500 EACH. 17 115 132 297 331 395 76 123 256 327 338 399 235 BONDS OF DOLL. 1000'EACH. 18 826 1816 2560 3424 4526 5576 6479 23 841 1841 2584 3477 4540 5578 6493 29 889 1882 2611 3501 4566 5627- 6529 74 922 1884 2627 3506 4602 5631 6574 140 965 2044 2644 3528 4633 5634 6581 157 969 2102 2668 3599 4678 5692 6605 158 1032 2104 2686 3600 4712 5694 6617 187 1049 2121 2691 3601 4777 5717 6650 195 1135 2145 2720 3659 4879 5841 6747 319 1194 2149 2758 3676 4887 5912 6765 343 1243 2255 2759 3734 4906 5988 6849 363 I^lB 2261 2824 3745 4907 6 033 6885 fij 423 1341 2322 2842 3772 4975 6062 6921 ■ 496 1344 2359 2867 3790 4976 6101 6993 ~__ 521 1359 2360 2914 3798 4987 6107 7032 523 1405 2382 2927 3849 5019 6109 7035 526 1413 2393 2973 3977 5035 6134 7128 538 1437 2407 3039 4006 5151 6202 7171 I 542 1440 2437 3045 4014 5172 6205 7177 550 1445 2467 3134 4091 5180 6224 7178 552 1456 2478 3155 4154 5225 6227 7237 < 562 1466 2493 3176 4201 5357 6263 7291 603 1474 2507. 3204 .4205 5404 6270 7377 624 1569 _5U 3218 4237 5419 6313 7378 i 647 1670 2522 3240 4238 5477 6347 7398 654 1671 2525 3255 4380 5491 6384 7544 678 1751 2540 3259 4407 5531 6420 7556 ( 782 1804 2546 3329 4496 5552 6436 7563 786 JOHN 8. KENNEDY- . . J. A. ROOSEVELT 'jTrustees. 1 New-Yokk April 14 1881. (16983) ___,http://resolver.kb.nl/resolve?urn=ddd:010104021:mpeg21:a0021:ocr,4,ddd:010104021:mpeg21:p004,Algemeen Handelsblad,1002
1158654,1881/08/14 00:00:00,1029,MMKB08:000155179:mpeg21:a0021,http://imageviewer.kb.nl/ImagingService/imagingService?id=MMKB08:000155179:mpeg21:p004:image&x=2147&y=122&w=1126&h=1029,MMKB08:000155179:mpeg21,3273,1151,2147,122,6,Advertentie Openbare Verkooping — om contant geld — Maandag 22 Augustus 1881 des voormiddags 9 uur in het Venduhuis aan de Voorstraat te Delft van Meubilaire en andere Goederen als: Bonheur du Jour Canapé's Ronde- Vierkanteen andere Tafels Stoelen Spiegels Schilderijen Waschtafels  Commode Ledikanten . Bedden Vloerkletden staande Klok Pianino Piano Secretaire Bureau Koffers. Kinderwagens een partijtje Boeken Mangel Koper- Glas- IJzer- en Aardewerk; voorts: 2 Antieke Kasten Schilderstukjes eenig Gouden Zilverwerk en hetgeen meer ter verkoop zal worden aangeboden. Te zien: Zaterdag 20 Augustus 1881 van 10 tot 3 uur.,http://resolver.kb.nl/resolve?urn=MMKB08:000155179:mpeg21:a0021:ocr,4,MMKB08:000155179:mpeg21:p004,Delftsche courant,1126
4474272,1881/01/25 00:00:00,4906,ddd:011085768:mpeg21:a0018,http://imageviewer.kb.nl/ImagingService/imagingService?id=ddd:011085768:mpeg21:p003:image&x=1920&y=1846&w=912&h=4906,ddd:011085768:mpeg21,2832,6752,1920,1846,4,"ttUEFROY /. i•» u » i . » * tü Eohtgenoote F. F. C. 376 Soeiabai» 25 Januari 1881. . „ Jj-ÊÜLS±~' lvr bei t>t rsor.lNWO■ü' NING met Kost in het midden ler «tal voor een* getrouwde familie tonder kinderen. Adrei no. 84 t oerabaiasoh Handelsblad. 84 ueyüaaud • 'nii f 'fïlii'""*' IV'ün JUFI UOUWin da binnenlanden I liefst P. Q. om drie jonge kinderen de eerste begiiisulen van ondnrwijs tl leeren Salaris f 5ü allea vrij.  Aim» tioerabaiMCh H*ndti*b!bd ouuur Na. 170. fcjiene Hoiiaunecbe DAM ij (weduwe) in Nederkndsct-Indiö als onder' wijïeica «irktaam geweeit lijnde en de lattsti vier jaren op de beate Engelaehe soholen onderwijl gegeven hebbende heeft te Londen een KÜSIdUHOOL geopend en beveelt tich ce.r aan tot het plaatien van eenige leerlingen. >'adere inlichtingen en Prospektua op franko aanvraag verkrijgbaar onder leter M.postkantoor Djokdjakarta. >88 IHF* Een perceel j WOESTE GIIONDEN voor Koffie gevraagd t Adres met omschrijving hoogte ligging em. en prijs nummer deaer advertentie. 181 »V ordt gevraagd:; U.u WEEGBEI/ö-GEËiIü.I'LÜÏEEKDE .onder ovorltguing van certiiikateu. Adres: Latter Z Proboiinggo. 841  Meeds voorhanden: Aaudeelen Soer -Courant ®Ug@a§>At&. t iuiS'biwiiff aS'ï; ' *■ VIU * : ___. 11 e onddrgeteekenden diatillateura te JJeltahuven maken hiarbq bekend u»t de Heeren BOS VAN MAANEN & l'o. Rotterdam de eenige nittenderi en de AaiNiacßtp ui INTSHTION4LB CkfDIIT' en H «NDILS VIMBXNIQINO * Bon ca dak"" te Batavia Sumarang eu Soerabaia de eenige ontvangers sjjn voor geaeel Neder! .udichlndié der door hen gefabriceerde WENEVEK merk >de Vaik • en Gekroonde Valk"" en dat geen paitjj voor echt wordt erkend die niet voorcijn ia van oun door hen geteekend en door den juigemeester van Delfshaven gelegaliseerd bewijs van Originaliteit. iiitaiien ia alle Genever van voornoemde merken waBTTau geen certifi aat kan geproduceerd worden inmaak. s F. KADEMAKER & Co. Delfshaven September 1880. 75 wmmisj Een nieuw soort Breukbanden van Celluloïde. 360 . ■ A. BTEUDEMANN fc Co  Ihe Marine lnsurauce Có ' The undersigned are prepared-to accept i Jak and issue police on behalf of the Mtrine Jisurance Cj. by anjr first class steamer M\BTIN DÏCE & Co. '! • 'Agents • 1 82 of the Marine Insurance Co of London Suikerpannen van de meest gewildo dimensies. (Verkrijgbaar bij m.' ■ 298 FBABEB EATON & Co Verkrijgbaar: Yersch Australisch gÖÏÏ'x'iïißEßön»  i 40 cent ;per kontar.t. A. DÜÏSHABT Jt. ' 844 » Kajoon. üagelyks verKrygbair: VersoHe Europeésche Koemelk. | Bij Mevr. A. HLAVET. 838 ten hulse van de Wed. A 80HMTD ■■I^Hede11 ontvingen wy eene ■. groote faktnnr diverse Horologie» r fV r; 394 VAW ARCKEIf & Co. - . - * ■.",http://resolver.kb.nl/resolve?urn=ddd:011085768:mpeg21:a0018:ocr,3,ddd:011085768:mpeg21:p003,Soerabaijasch handelsblad,912
1129744,1881/12/21 00:00:00,1441,ddd:010290335:mpeg21:a0024,http://imageviewer.kb.nl/ImagingService/imagingService?id=ddd:010290335:mpeg21:p003:image&x=921&y=5308&w=784&h=1441,ddd:010290335:mpeg21,1705,6749,921,5308,4,{Voor iet Land) Aanbesteding. Op Dinsdag den 17 Januari ISS2 des voonnkidags ten 10 ure zal ten kantore van den eerstaanwezend Ingenieur der Burgerlijke Openbare Werken te Samarang in het openbaar worden aanbesteed: Het bouwen van een depot voor 000 dwangarbeiders ter hoofdplaats Samarang. \ Maximum-aannemingssom ƒ 238.735.— Nadere inlichtingen zijn'te bekomen ten kantore voornoemd alwaar tevens de inschrijvirgsbiljetten moeten worden ingediend. De Hoofd-Ingenieur 2e kl. eerstaanwezend Ingenieur 6188 J. W. H. KENNIS. Muziek- en Pianohandel J. H. VAN DER YEIDE. Verwacht eerstdaags direct uit Parijs een nieuwe bezending pianino's uit de fabriek vau PLEIJEL WOLÏP en Co. 643 G. SCHILLER KLEERMAKER Para*eplem. Beveelt zich minzaamst aan. Prijzen billijk 6062,http://resolver.kb.nl/resolve?urn=ddd:010290335:mpeg21:a0024:ocr,3,ddd:010290335:mpeg21:p003,De locomotief : Samarangsch handels- en advertentie-blad,784
3064932,1881/08/11 00:00:00,6250,ddd:010265988:mpeg21:a0066,http://imageviewer.kb.nl/ImagingService/imagingService?id=ddd:010265988:mpeg21:p006:image&x=1515&y=90&w=1464&h=6250,ddd:010265988:mpeg21,2979,6340,1515,90,6,"THEE VAN E. BRANDSMA KALVERSTRAAT 158 AMSTERDAM. In het bijzonder wordt de aandacht gevestigd op: SOIJCHOJ. THEE & /_.30 Pc* 5 on». (5755) Pensionaat ONDER BESCHERMING VAN Z. D. Hw. den Bisschop van Luik. BESTUURD DOOR DE RELIGIEUSEN URSULINEN. TE I_A_TO_.T Belgisch-Limburg Spoorweg Antwerpen—Boermond. Grondige Godsdienstige en Wetenschappelijke Opvoeding. Jaarlijksch Kostgeld 340 Franc. Het Schooljaar begint den 4n October a. s. (5766) X_P__ L.ntwnrm onfeil- LllllWürill.baregeff f^pïl nezing door de Pillen e« \WÖ( crétan. In de hospitalen ö Jét™ PariJs geadopteerd.   r~ Hoofd-Dep. Secrétan Apoth. 37 Avenue Friedland Parijs. Te Atrisfefdatn Ghoote Drog. (4898) Eene onrustwekkende ziekte die eene talrijke Klasse kwelt 'v^~-j-^* r^f voel van matheidvan ■jd tot tijd"" met slaperigheid? Hebbeu de eogen een gele kleur? Heb ik's morgens ron dom de tanden en het tandvleesch een dikke kleverige slijm gepaard mit een onaangenamen smaak? 18 de tong beslagen? Heb ik pijn in de zijden of in den rug? Heb ik naar de rechterzijde een opzetting als of de lever grooter wordt ? Ben ik hardlijvig? Gevoel ik draaierigheid of duizeligheid wanneer ik eensklaps uit horizontale ligging opsta? Zijn de afscheidingen uit de nieren vullig en hoog gekleurd met een neerslag als men ze heeft laten staan? Begint het voedsel na het eten spoedig te gisten gepaard met opgelïlazenlieid en oprispingen uit de maag? Heb ik dikwijls hartkloppingen? Al deze verschijnselen zullen zich vrel niet te gelijk voordoen maar wanneer de treurige ziekte nadert kwellen zij den lijder beurtelings. Als het een geval van langdurig gelijken aard is komt er een droge stootende hoest na eenigen tijd gepaard met opgeven. Bij verder verloop krijgt de huid een vuil bruinachtige tint terwijl aan handen en voeten een koude klevrige uitwaseming komt. Terwijl lever en nieren steeds meer beginnen te lijden volgt er rheumatische pijn en de gewone behandeling blijkt ten eenemale onvoldoende tegen deze laatste kwelling. Het is dus van het hoogste belang de ziekte spoedig en op geschikte wijze te behandelen in haren eersten graad wanneer een klein medicament genezing zal teweegbrengen. En zelfs wanneer er eene vaste werking Is moet het ware middel worden volgehouden tot ieder spoor der ziekte verdwenen de eetlust teruggekomen is inde verteriogsorganen tot een gezonden toestand zijn gebracht. Deze ziekte heet leverzickte. Het zekerste en meest afdoende middel er tegen is Seigel's Geneeskrachtige Siroop een plantaardig preparaat vervaardigd in Amerika en te koop bij A. J. While 21Farringdon Road London E. C. Deze Siroop tast de ziekte in den grond aan en verdrijft haar met wortel en tak uit het lichaam. Breda : van de Goorbergh generaaldepot voor Holland ook verkrijgbaar bij alle Apothekers in Holland Java en Koloniën. Prijs van de Siroop /1.75 van de Pillen/'. 0.75. Te Amsterdam bij CLÉBAN & C°. Drogist Heiligen weg. (4902)",http://resolver.kb.nl/resolve?urn=ddd:010265988:mpeg21:a0066:ocr,6,ddd:010265988:mpeg21:p006,De Tĳd : godsdienstig-staatkundig dagblad,1464
428400,1881/04/02 00:00:00,476,ddd:011195200:mpeg21:a0009,http://imageviewer.kb.nl/ImagingService/imagingService?id=ddd:011195200:mpeg21:p003:image&x=58&y=4406&w=900&h=476,ddd:011195200:mpeg21,958,4882,58,4406,4,A DVEIi TEN TIE S. Evangr Luth. Gemeente. Ooilsdiciistoëreiiing' op Zo». das Jen 3 April des morgens orfi halJt.nc(jei% uur.,http://resolver.kb.nl/resolve?urn=ddd:011195200:mpeg21:a0009:ocr,3,ddd:011195200:mpeg21:p003,Surinaamsche courant en Gouvernements advertentie blad,900
1965488,1881/05/13 00:00:00,2576,ddd:011007039:mpeg21:a0017,http://imageviewer.kb.nl/ImagingService/imagingService?id=ddd:011007039:mpeg21:p003:image&x=3291&y=3118&w=763&h=2576,ddd:011007039:mpeg21,4054,5694,3291,3118,4,"-v» Talrijke'<? certificaten- vari: Geneeshè^rèn•!'•■' . Bewijzen; dat- geen .enkel -geneesmiddel zoö■'• '- ■ heilzaam werkt.terbestrijding dezer kwa-- - v-len als dé' '..""' \ V.. '-.■_.';._. ■-■.?■•.;' -~-; -/_ 'Ben enkele Pastille brengt reeds verlichting aan. Zij bevatten noch Opiunv.wioca ■ Morphine;nog eenigander sterk wérkend . bestanddeel en door de zwakste ' gestellen verdragen i.worden. '<■ £§«1 ■■i ' «Hetpubliek gelieve vooral telettetföpnde3 woorden : Kcating's Congh Lozcnges. ! door het Erigelsche gouvernement op het Jroode cachet >• afgedrukt en zonder hetwelk /""'geen een doos echt is. r *j& DffabriekanU THOMAS MBATMxkZ '■ „h i-ChéiAisl te Londen'■ ~' 'l Verkrijgbaar te Rott. bij F. E. Van Santen Kolfffte VHage bij T.JL. F. C. Snabilié. Machines voor Metsêlstëénen i -;r (en Dakpannen g jgg; ie Bniip (Gouden MedaülèO'S i 0 p„;:» 1 IfIJS. Tentoonstelling Paf^s;J 78.1 .xrIJS BÖULETFrères.LACRÖIX&Co. \i ~""• ■ Machine-Fabrikanten ■ 128 rm des Ecluses-St.-Ma.rtm.Parijs 't [Volledige inrioMingyan Fabrieken yóor: | allé"" soorten Van Porselein én Aardewerk. •Meer'dan(tuisend dezer Machineszijn zoo-*"" wel ""in als m> flefr'JJauwrtahtli :; in werking.-- -' > /: / :''f. ! De geïllustreerde ;Catalogu» wordt ópi ■ franco aanvrage franco toegezonden . f SCHEEPSBOUW' Voor ƒ 6.90 in pi» fSS.&O j Zoon extra ongekend koopje is nog nooit en door ""niemand. gëgeven'> fr:'i. 11 HANDBOEK lyoor: de KENNIS ;VAN DEN SCHEEPSBOUW""/; naar ide tenf van JOHN !W. GRIFFITHS en anderen/- bewerkt door H/W.' SCHOKKER/ Groot 4° form.* 805 blz. op best papier met 60 Platen.* Prijs ƒ55.50. Maar datï-is 'nu. toch bespotterlijk//'6.90'.v00r dat grootsche werk over den!- Scheepsbouw dat tot heden voor geen'cent' minder dan f 55.50 verkrijgbaar was; Ont-j breekt.: er: dan wat aan? Volstrekt- niet;'ik';' lever af fonkelnieuw""* geheel. compleet; de 60 platen voor ƒ 6.90 in plaats van ƒ55.50/: Wie een >Ex. wil'; hebben izënde Post wissel"" waarbij vermeld 'Scheepsbouw..: D. BOLLE Boekh. Hang b/d Vischmarkfc te Rotterdam. - 14053:;",http://resolver.kb.nl/resolve?urn=ddd:011007039:mpeg21:a0017:ocr,3,ddd:011007039:mpeg21:p003,Rotterdamsch nieuwsblad,763
1345311,1881/07/22 00:00:00,1397,ddd:010497717:mpeg21:a0004,http://imageviewer.kb.nl/ImagingService/imagingService?id=ddd:010497717:mpeg21:p001:image&x=92&y=4552&w=963&h=1397,ddd:010497717:mpeg21,1055,5949,92,4552,4,VENDUTIE MAANDAG 25 JULI 1881 voo* het COBIIISSIEHÜIS van EMANÜEL. ... EMANÜEL verkoopt op MAANDAG 25 JULI a. s. ... p. m. 17 ki.ten Best English Shagg Tabacco _„ To»r de PIJP en voor CIGARETTEN. Zö manden Scltserwater puik. ontvangen per -.m. ut Kapitein POORTMAN: Pi Dubbel Kcopdbrabantscli Gerstenbier i f 17 - per 50/| kruiken ._ . f 18._ Per 2-7 kruiken. CONTANT. 3386 STADSHERBERG.,http://resolver.kb.nl/resolve?urn=ddd:010497717:mpeg21:a0004:ocr,1,ddd:010497717:mpeg21:p001,"Java-bode : nieuws, handels- en advertentieblad voor Nederlandsch-Indie",963
3659968,1881/06/02 00:00:00,2158,ddd:010063436:mpeg21:a0021,http://imageviewer.kb.nl/ImagingService/imagingService?id=ddd:010063436:mpeg21:p004:image&x=644&y=3069&w=1696&h=2158,ddd:010063436:mpeg21,2340,5227,644,3069,12,"ACADEIIA MEÏfO-TRAJECOTA. Oud-Studenten der Utrechtsche Hoogeschool behoorende tot de Réunie 1849—1864 die verlangen deel te nemen aan het Réunie-Diner te houden op Woensdag 29 Juni te v ij f uren in de bovenzalen van de Sociëteit »de Vriendschap« Keistraat worden uitgenoodigd zich spoedig en wel uiterlijk vóór 15 Juni door het toezenden van een postwissel groot tien gulden (voor onkosten en het-Diner) aan te melden bij den Heer Mr. F. A. VAN HALL Pieterstraat Utrecht met opgave tevens van het jaar van inschrijving voor eene nauwkeurige Presentielijst. De Vereenigde Utrechtsche Reunie-Commissiëa over de jaren: 1849-1854. 1854-1859. 1859-1864.   Mr J I VAN GFUNS Raadsheer Mr. G. VAN TIENHOVEN Burge- Mr. G.J.PICKE Burgemeester Mid- Mr- f „„„„ w'urtó> Kaaasneer meester Amsterdam. delburg. 9 Mr. G. J. D. HONDIUS K.-Rechter y Mr. F. A. VAN HALL Bankier te te Vianen. Dr J A. MOLL te 's Hage. Utrecht. Ds. D. G. ESSCHER Predikant te Dr. G.P. VAN TIENHOVEN te 'sHage. „Die!^n-  n„„rT ... Ds. J. P. P. CLINGE DOORENBOS Dr. P. TEMPLEMAN VAN OER Jh£ r- £rRo°tE^'^d van ?re 2e predikant te Waardenburg. HOEVEN te Utrecht. M^T'g wél K.-Aecht^Te Prof. Dr. M. SALVERDA Inspect. Rotterdam Jlir.Mr. W. E VAN PANHUYS.Ref. M. O. te 's Hage. Ds P KNUTTEL Predikant te bij het Min. v. Kol. te 's Hage. Ds. H. VAN WOUDENRERG HAM- Noordgouwe. STRA/PredikantteOtjfenenMesren. Ds. P. ROMIJN Predikant te Win- Jhr. Mr. J. W.M.SCIIORERComm. jhr.E.VANCITTERSH.-Commiesbij terswijk. (4989) des Konings in N.-H. te Haarlem. het Min.v. W.H. enN.te Voorburg. Mr. P. J. SNEL Advocaat te 's-Hage. WAARSCHUWING Amerikaanscue Petr.ToestBlleii. f W Koopt geen Amerik. Toesteilen of vveest overtuigd van de echtheid fö^^ü^'Wi of van solk'le fabrikatie daar zij anders veel gevaarlijker en kostbaar- JÊËË a**_ der zijn dan gewone Stellen. Solide Petr. Toestellen 2 vl. van.af ƒ2.40 dito |k j|g Amerik. Toestellen 2 vl. van af ƒ4; de echte Amerik. Toestellen (waarvoor wij garandeeren) 2 vl. ƒ4.50 groote ƒ5.50. Tijdige bestelling wordt verzocht door «fe.^^^^^^^^H^^r B. 11. LTNSGHOTEN Jr. Rembrandtpl. 60 Amst. . (3738) /ÊÈÈm-1- PS. Fr"" toezending van Prijsc. en Teek. na ontvangst van Postzegel. Ver- fiï§i||l|l£=B^iflK^ zending geschied t alleen na ontvangst van Postwissel of per spoor tegen Rembours. fy^WWWMÊ 2H©M»n van het Üloed9 Bloedarmoede!! | QA^ I g"" |B H§ | bestaande uit zamen- || | DE ÖIJB tislMtdfc'OrilJi^ reeide6 sappfn'Van 1 ¦H KERS roode SALSEPARiLLE ca Kma zuivert en herstelt hel bloed van hen ff iS&mEHËTr $- cl'e li^en aan Eliereni Puisten Huiduitslag Wonden Bederf in het Bloed en Klie- jl IBPswßSd''-¦ ¦ "" 't rilCütiEfe aandoeningen Geheime Ziekten Pijnen Hardnekkige hoest Bloed- If :iO^|gsp^SJs^^ armoede Kwijning enz enz. 1 fclé- I^^^^^ fy uitstek tonisch kalmerend en een zeker zuiveringsmiddel bevordert het de eetlust g iÉJL*' S 5 i iÊÊBisWÊesMÊ? is een voed'mgsmiddel en Vfcormt de roode bloedbolletjes; versterkt de spieren en hetffl 1 vleeseh; geeft eene frisrhe kleur kracht en vrolijkheid aan personen die aan bloedarmoede lijden alsmede aan bleeke H m en zwakke kinderen; wekt de levenskrachten op; geefl krachten aan hen die van eene ziekte herstellen aan vrouwen jS 1 die op leeftijd komen en aan grijsaards; herstelt Üe evenredigheden in het bloed en voorkomt aldufcS beroerten en bloed- Eg 1 spuwragenyltijs fl. 2.50 per flacon. De brochure zeer interessant niet veelvuldige attesten is gratis verkrijgbaar m g bij LECI/AjUX apotht^er enchemist rue S'""-Cathéi'ine 164 te Bordeaux en in alle apotheken. (4301)",http://resolver.kb.nl/resolve?urn=ddd:010063436:mpeg21:a0021:ocr,4,ddd:010063436:mpeg21:p004,Het nieuws van den dag : kleine courant,1696
1909156,1881/10/03 00:00:00,2473,ddd:011007144:mpeg21:a0008,http://imageviewer.kb.nl/ImagingService/imagingService?id=ddd:011007144:mpeg21:p002:image&x=84&y=1444&w=772&h=2473,ddd:011007144:mpeg21,856,3917,84,1444,10,"Chemische Wasscherij .""''.'' '..'.. VAN""' : ■ .; Gek. PALTHE te Almelo. Depot te BoUerdam bij Mej. DE KOSTER 'Hoogstraat 227 van waar de goederen iederen (Woensdag n/m. worden opgezonden.'. ' 9209 Djeiara ffiiwip Vettig 1. Lrf""*\. De Notarissen SCHADEE VAN DEN BERG en VAN fllfÉlllli&s WIJNGAARDEN & VAN ■ YOLLENHOVEN resideerende te BoUerdam zijn voornemens op \Woènsdag den 12 Octóber 1881 bij opbod en op Woensdag den 19 daaraanvolgende bij afslag beide dagen des namiddags ten 5 ure in het Notarishuis aan de Geldersche Kade aldaar in het openbaar te veilen en te jverhoopen: f . [Een hecht sterk goed onderhouden en zeer aangenaam gesitueerd'■;''.-.. Heerenhuis met | riant uitzicht over de rivier de Maas bevattende groote Suite verscheidene groote fraai ingerichte en zeer logeabele Vertrekken ruim. Balkon groote Keuken Kelders Strijkkamer Badkamer Zolder Dienstbodénkamer vele .vaste Kasten en verdere gemakken .voorzien van Gas- en Waterleiding en alles .wat vérder tot een Heerenhuis behoort; voorts grooten welaangelegden TUIN en ERVE alles staande en gelegen aan de Veerkade té BoUerdam gemerkt No. 8 bij het kadaster bekend in.Sectie A Nommers 1963 en 2240 tezamen groot 6 arenB4' centiaren benevens een zestiende aandeel onverdeeld in een gemeene gang uitkomende in de Maasstraat kadastraal bekend: Sectie A Nommer' 2235 voor het geheel groot 1 are 40 centiaren. .• . ; Grondbelasting over 1881 ƒ 148.78 Zijnde geheel in eigen gebruik en te aanvaarden op den 2 Januari 1882 of zooveel vroeger als tusschen kooper en verkooper zal kunnen worden overeengekomen.. i. Te bezichtigen twee dagen vóór en op den dag der veiling van 11 tot 4 ure op vertoon van een permissiebiljet door de voornoemde Notarissen af te geven te wier kantore inmiddels nadere informatiën te bekomen zijn. ■'.'.■• ...  15806",http://resolver.kb.nl/resolve?urn=ddd:011007144:mpeg21:a0008:ocr,2,ddd:011007144:mpeg21:p002,Rotterdamsch nieuwsblad,772
1064800,1881/09/26 00:00:00,1936,ddd:010063550:mpeg21:a0027,http://imageviewer.kb.nl/ImagingService/imagingService?id=ddd:010063550:mpeg21:p008:image&x=1801&y=974&w=550&h=1936,ddd:010063550:mpeg21,2351,2910,1801,974,12,"Als le Hypotheek beschikbaar ƒ87000 aangeboden; op Huizen a 41/2% en Landerijen a 4i/4°/0. Adres franco brieven lett. R V Boekh. L. 1. E. v.d. BOR Nieuwmarkt. — NE. Gelden voor Taxatie worden niet gevraagd. Voor Leescirkels. De Docliler des Hemels Novelle van P. A. de ALARCON. Naar den vijfden druk uit het Spaansch vertaald door J. C. E. Goslkr. Een deel in gr. B°. ƒ 2.40. 3. J. VAN BREDERODE Haarlem Uitgever. ifiiiteit ralïifi Ter kennis van belanghebbenden wordt gebracht dat de Cursus 1881—1882 aanvangt Dinsdag 20 September 1881 en dat de INSCHRIJVING van hen die de lessen aan de Universiteit wenschen bij te wonen zal plaats hebben op Woensdag 21 en 28 September en 5 en 12 October e. k. in het gebouw der Universiteit van des voormiddags 9 tot 12 uren. Tevens wordt herinnerd dat ter gemoetkoming in de kosten van de Universiteit eene bijdrage wordt gevorderd: I°. Van ieder die als Student wil worden ingeschreven ƒ2OO p. jaar. (Studenten of Kweekelingen van in Amsterdam gevestigde Kweekscholen of Seminaria tot het opleiden van.'Leeraars voor eenig kerkgenootschap of Kweekelingen voor den geestelijken stand betaten de helft der bijdrage om als Student te worden ingeschreven.) 2"". Van ieder die zonder als Student te worden ingeschreven enkele ten hoogste vier lessen wil bijwonen voor iedere heelj. les ƒ3O p. jaar voor iedere halfj. les ƒl5 p. jaar. P.eze gelden behooren bij de inschrijving in handen van den Secretaris van College van Curatoren in hetzelfde gebouw en op dezelfde datums te worden gestort. De Rector-Magniiicus der Universiteit van Amsterdam voor den Cursus 1881—82 J. W. R. TILANUS. Amsterdam Sept. 1881. (8328)",http://resolver.kb.nl/resolve?urn=ddd:010063550:mpeg21:a0027:ocr,8,ddd:010063550:mpeg21:p008,Het nieuws van den dag : kleine courant,550
1870617,1881/06/25 00:00:00,1967,ddd:010104060:mpeg21:a0029,http://imageviewer.kb.nl/ImagingService/imagingService?id=ddd:010104060:mpeg21:p003:image&x=3930&y=3470&w=951&h=1967,ddd:010104060:mpeg21,4881,5437,3930,3470,8,"Drie COLPORTEURS gewoon met een net Publiek om te gaan kunnen onmiddeilyk tegen hoog Salaris GE"" PLAATST worden om met een Prachtwerk te Colportceren van twee onzer beste Schrijvers. Zonder goede getuigschriften komt men niet in aanmerking. Adres franco brieven lett. U L. Bureau Handelsblad. (24673) MINERALE EN BRONWATEREN. In een Comestiblesmagazijn bestaat gelegenheid tot plaatsing van een DEPOT m bovengenoemde wateren. Brieven met conditiën worden ingewacht onder lett. Alf Bureau Handelsblad. (24717) TE KOOP VOOR ƒ3OO door omstandigheden een AFFAIRE in Huishoudelijke Artikelen die daor een vrouw waargenomen kan worden. Adres franco brieven onder lett. AA bij den Boekhandelaar A. HOOGENBOOM Eeestraat 19 te Amsterdam. (24744) MEN VERLANGT een schoon ruim WINKELHUIS in het drukste gedeelte van Amsterdam. Opgaaf van stand en huurprijs lett. HM Bureau Handelsblad. (24757) te hcur ()iir.Wl¥_l_s7 bevattende 3 geplafonneerde Kamers Keuken Zolder met Meiden- en Provisiekamer vToolijk uitzicht en verder van alle gemakken voorzien. Huurprijs f 175. Te bevragen bij W- LEENEN Bnysdaclstraat bij ie Euysdaelkade n""\__. (24751) TE HUUR een onderste BOVENHUIS in de Nieuwe Leliestraat voorzien van alle gemakken en dadelijk te aanvaarden. Adres met franco brieven lett. IJM Dureau Handelsblad. (250_1) TE HUUR TEGEN PRIMO AUGUSTUS een zeer ruim BOVENHUIS gelegen aan de Prins Hendrikkade (vroegere Haringpakkerij). Te bevragen bij de Heeren VAN GEND EN LOOS alhier. (24781) Een jonge Duitsche KOOPMAN dio door ongeluk zgn eigendom verloren heeft de Hollandsche on de Fransche taal kent. ZOEKT PLACEMENT. Offerten onder U 1164 aan HAASENSTEIN & VOGLEE in Keulen. (24791) TE HUUR to SOEST by Soestdijk bij Burgerlieden zonder kinderen eene net gemeubileerde KAMER met oen of twee SLAAPKAMERS en vrij TUINTJE met ruim en net uitzicht; met of zonder Kost en Bediening. Ook tegen eenige vergoeding het gebruik van Keuken. Franco brieven bij K. BOSBOOM te Soest. (25005)",http://resolver.kb.nl/resolve?urn=ddd:010104060:mpeg21:a0029:ocr,3,ddd:010104060:mpeg21:p003,Algemeen Handelsblad,951
2054700,1881/01/10 00:00:00,2283,MMHCO01:000071506:mpeg21:a0010,http://imageviewer.kb.nl/ImagingService/imagingService?id=MMHCO01:000071506:mpeg21:p002:image&x=2883&y=3498&w=900&h=2283,MMHCO01:000071506:mpeg21,3783,5781,2883,3498,6,Advertentie Bij deze betuig ik ook namens mijne kinderen hartelijk dank aan allen die mij blijken hebben gegeven van hunne deelneming bij het verlies van mijn geliefden echtgenoot. Wed. A. DE GRAAF geb. Van Wilpe. Zwolle  8 Januari 1881. Aan allen die deelden in onze vreugde en smart betuigen wij den innigsten dank. Rotterdam 7 Januari 1881. H. VAN DE HAGT. H. J. VAN DE HAGT — V iveen. Faillissement. De schuldeischers in het faillissement van GEORGE MAY logementhouder en tapper te Harderwijk worden bij deze opgeroepen ter bijwoning der 2e vergadering tot verificatie van schuldvorderingen welke zal gehouden worden op Zaturdag 29 Januarij 1881 des namiddags ten drie ure in het Paleis van Justitie aan de Blijmarkt te Zwolle. De Curator in genoemd faillissement Mr. J. VAN SETTEN Advocaat. Openbare verkooping. Door den Majoor-Garnizoenskommandant zullen op 12 Januari a.s. in het openbaar worden verkocht buiten dienst gestelde linnen goederen kleine equlpementstukken en touwlijnnetten van bedkribben. De goederen zijn te bezichtigen in een der lokalen van de Ruiterstallen op 10 en 11 Januari des morgens van 10 tot 12 uur terwijl aldaar ook inzage kan genomen worden van de voorwaarden van verkoop. ALGEIEEIE SPA AM. AS t© Zwolle. Aan de deelnemers wordt ter kennis gebracht dat op Dinsdag 11 Januari a.s. des avonds van 6 tot 8 uur zitting zal worden gehouden in het lokaal aan de Diezerpoort tot uitbetaling der rente' op vertoon en afschrijving der boekjes. Zwolle  8 Januari 1881. G. W. RIBOW Pres. J. C. BORGMEIJER Secr.,http://resolver.kb.nl/resolve?urn=MMHCO01:000071506:mpeg21:a0010:ocr,2,MMHCO01:000071506:mpeg21:p002,Provinciale Overijsselsche en Zwolsche courant,900
281979,1881/07/27 00:00:00,291,ddd:010497721:mpeg21:a0016,http://imageviewer.kb.nl/ImagingService/imagingService?id=ddd:010497721:mpeg21:p003:image&x=80&y=174&w=969&h=291,ddd:010497721:mpeg21,1049,465,80,174,4,Verzoeke toezending vao de verschuldigde abonnementsgelden op den JAVABODE. De Uitgevers H. M. VAN DORP & Co.,http://resolver.kb.nl/resolve?urn=ddd:010497721:mpeg21:a0016:ocr,3,ddd:010497721:mpeg21:p003,"Java-bode : nieuws, handels- en advertentieblad voor Nederlandsch-Indie",969
5160666,1881/07/11 00:00:00,3306,ddd:011007086:mpeg21:a0020,http://imageviewer.kb.nl/ImagingService/imagingService?id=ddd:011007086:mpeg21:p004:image&x=1721&y=244&w=1561&h=3306,ddd:011007086:mpeg21,3282,3550,1721,244,8,"I: RTPI^EIIiI;:hW i 76■"">■■ - ■■■.:•■ 76 | |W BEDDEN DEKENS EN MATRASSEN.' || ■ I Inrichting tot liet Wasschen en Reinigen! van bovengenoemde artikelen. 3..""- H %~ï?-%';""; - IJZEREN LEDIKANTEN"". en WIEGEN. . 14443 1 Telefontoestelleii \ uitmuntend werkend op groote afstanden met SIGWAAMNRICHTING worden gelererd en geplaatst door -;r:4.---.- >:;^^^'„V*i^;rC^V.-:j»;*i;' '""''-'£ ""'■ • ||lïlstrs;>!Al M. BEKKING ;'Boerenvischmarkt No. 9 Rotterdam V; 4 en zijn bij hemvoor ieder belangstellende in werking te.bezichtigen. 14732 !. Fabriek van Electrisclie Schellen Bliksemafleiders Spreekbuizen enz. | J.TLlEGEE;Amsterdam^;y;f Halvemétaiisteeg' /> | uidenstraat rimstel 52. CATALOGUS op franco aanvraag gratis. 14133 1111 MUI Magazijn: Glashaven 4 Rotterdam. %SiÉ?StëÉids in voorraad groote sorteering -. ■'.'- . AX.S: . Pakking en Dewrance Kranen Afsluiters verschillende soorten van Stoom fluiten Proefkrauen Péilglaskranen Manometers Vacuummeters Lubricators Vetkranen OUe-Smeerpotten in verschillende modellen van Koper en GHas. Smeerkannen-in Koper en Blik met Veerafsluiting... !' :';^?«Gevulcanisèérdé India Rubber Kleppen Snaar Ringen enz. in alle formaten. Asbest Artikelen ter verpakking van Cilinders en Stoomleidingen. .Verschillende soorten Tucks zelfsmerende Hennep Victoria Lindsay en andere Pakkingstoffen. -: Drijfriemen van Engelsch- en Kroonleder Haar Staaldraad en Touw. Riemsehroeven Haken en Snoeren. (ïïüÜÏM WM§&B® ••'""■/ ..•■ JL®: '-■■"":-'''•' Verschillende soorten Bank- en ParallelschroevenAambeelden Moersleutels; Ratelboren Bank- Smee- en Voorkamers Veldsmidsen Vijlen Pijpwitsers enz. MacMne-Oliën Smeer Talk Poets-Lampkatoen Poetsdoeken enz. Geïllustreerde Catalogus wordt gratis verzonden ;% .^^T.V'F-'BASTETS Scheermessen en Scfieerrlemen a f 1.50. 3S*^^TVerkrijgbaar bij GEZUSTERS COUCKE '.. . ■■; .;■..- Hoogstraat 238 Rotterdam.",http://resolver.kb.nl/resolve?urn=ddd:011007086:mpeg21:a0020:ocr,4,ddd:011007086:mpeg21:p004,Rotterdamsch nieuwsblad,1561
8206378,1881/12/07 00:00:00,5158,ddd:010290323:mpeg21:a0032,http://imageviewer.kb.nl/ImagingService/imagingService?id=ddd:010290323:mpeg21:p004:image&x=113&y=1583&w=1591&h=5158,ddd:010290323:mpeg21,1704,6741,113,1583,6,"' -ss-_C_!'-sfP^-sfC^Tff-M'""T mmmimfm^mm/nmmmmmtdmm^mm^n^ TB.** """"jJCT QfEN THH MIIR J? 1? QENE2INQ nn Verkoudheid Boratontsteklng am. S * jj^R EMULSIE van TOLU BALBEM li Qf. § f T®l VanLE BEUFteßayonne j fë? $ % ""E»»——- ""^""""""'^ % j£ «O aVLaVa-L JCHA OH TI OB« <tma TOI.Ü-BIROOP «F t-R .>-. °* **?■*?•»»'""— B**""1 *nalMs tiM4taifh«du «Il d. «as» «aar keert d-ireabetaa 4a elfaaaekap Tfc: ""° «pi **• »•_net kiaaaraa a pereooea dl* leer aoeietijk teti inneou Mer aufeaaam na smaak 1». **P «o •.«_| . J* BSasoliU na Le Beat beeft kat foorkernen tv aelk ioo Mer ii w rol nn »eruc»tsode ditlen ie berot ook Si S !flt dea Balma ia uji nknl tut al «tja. aetiuddaeta «J heeft u doe ook de «heele oitwerkin» »ca. Hen neme «* ' «JU (leekte «ene doen na eea 1 twee ikeelepeitiu in wa «Iv nikervnicr of warme melk. Dt krachtdadige werkiag eo dea —~ rota na dit litetek.ad preparaat Hebben nie oamaakieU doen ontnam  aaa eiacoo dat op iedere -icoa de haudtee- iE Jt I keniaj na L. te Baar. - W ' Voor Java bij WANKtE en VAN AALST te Samarang. «j? f"""""" j AGTfiEWEEREfi.» GEWf EüSrj . VOOR aaoaHCXBVOViaPIBXsTXXtrOrSXtf [ AU9 gtaiiiß aaétöl«a«a y*a fuus tuicneo wr tas »»_ as vervcjlwme-hmj ib l4gi«B*Be»n aoor u*-u «oer oaiasts w»pan-Fab.""i.fe_t to «witetük het otdulïenüste tóïuropti en ttafni<aii aantnbaveWn doof de uitatoktn&eia vaa«line BtbriksUe bet rcralanst vaa xijna miYimi.a» «n tn du toordeellge prijsen rüurupruiWüde Uit sijn ulUmiond metat-|lek werk. Da naaawkemrij-heia zUnor Cmxnhynenltsprtn mecHamtch fli/ittl de souaitelt en de goeüa werking zijner geDrtveieerde Kevoivers de schoonheid èn de onwrikbare ajustatie van zyne Jatftgeweeran de Oulteagewoon goede kwaliteit zijner metallieke Cartouches onverroestelljk en meer als honderd maal dienende: de zorgvuldigheid waarmede alle ontvangen orders uitgevoerd worden zoo klein ook het bedrag daarvan moge zljix alles streeft naar een buitengewoon hooge classificatie en rechtvaardigt de grootevaam 9teunende op de beste referenties ln Indle zoowel als in andere werelddeelen. — De Heer OAIAVS is de schrijver van een werk : Behandeling der Wapenkunde groot boekdeel met 80 schoone gravuren Oeweeren Caranyaen Pistolen Revolver» ■chljven enz. een werk dat hij franco aan allen gratis zendt die hem eene gefrankeerde aanvraag doen^gericht aan zijn HOOFD-ET ARUisement is xva B'SAtrravzus paxul 8783^ || i■■ ' .—■ — i ■- .■■.._ iii -i ■■■■■■■■i ii — - i i ■ i — ■tl Boekhandel VISSER & Go. Batavia. Wij vestigen op >i-«nw de aandacht op bet in den Archipel zoo f»unstis; bekende Indische Kookboekje „Kokki Bitja"" door jNTcota Cornelia welk boekje toch in betrekkelijk korten tijd een zevende druk mocht b4even. Kokki Bitja bevat ongeveer 500 voorschriften voor iefeKer eten. %/mW~ lionna Cornelia de schrijfster (wier portret vóór in *t boekje) is bij vele Indische familiën bekend voor „lekker eten klaar maken"". Dit uitstekend Kookboekje is voorhanden bij alle soliede Boekhandelaren in Nederlandsch Indië tegen den prijs van / B.—' franco per post ƒ 8.50; en bij de uitgevers VISSER Sc Co. 4318 Batavia — Weltevreden. VISSER & Go. Boekhandelaren te Batavia debiteeren met veel succes het Indisch Prentenboek: Geïllustreerd Nederlandsen-Indisch Alphabet Dit Prentenboek door een onzer geachte ingezetenen zeer geestig geteekend is op een der voornaamste ateliers in Nederland op steen gebracht en keurig ja smaakvol in kleuren weergegeven. Met een zeer net in goud gedrukt omslag is dit Prentenboek een prettig en onderhoudend boek voor ieder kind en in hoofdzaak voor kinderen die door Baboe's wat Maleisch verstaan en wie men met behulp van die taal de waarde en de klank der Nederlandsche letters wil leeren. Js^T* Verschillende bladen in Indië en in Nederland recenseerden dit Prentenboek uitstekend. SJssJ"""" Voorhanden bij eiken Boekhandelaar in Indië. Mr* Prijs / 8.i— franco per post / 8.50 tegen postwissel en bij de uitgevers 4819 VISSER & Co. Batavia. — r - — . .mi Wij gaven uit: fflelati van Java „Angeline's Beloften"" _ een Boek voor Meisjes met 4 plaatjes. 2^"" Hit tteurig net gebonden Boekje durven tod* bifxonder aanbevelen voor lectuur aan jonge meisjes van ongeveer 12 tot 16 jaar. Voor een Cadeautie aan Meisjes van dien leeftijd is 't een uitstekend Boekje. In net linnen sterrpelbandje is de prijs / B.— franco per post / 3.50 terwijl het bii eiken Boekhandelaar voorhanden is alsook bij de uitgevers VISSER & Co. 4820 Boekhandelaren Batavia. Boekhandel VISSER & Go. Batavia D  Kwam yan de pers: Ketent op liet Voorloopig Beheer van lliaire nalatenschappen in «etolanteb-lndië _ Dooa p•• 7S . . 1* Luit.-Karartiermeuster. tslZn LTT\r f' P°Bt 90 cfB- Heeren Mili'airen die nog een ex. verlangen «e^en aan te vragen; de voorraad is „og maar gering. * »W Bij de meeete Boekhandelaren voorhanden 4521 VISSER Ac Co. _______________^_^^^^^ Batavia — Bjjswltk. Bij VISSER & Co. te Batavia E LAGER ONDERWIJS ïïï ""ïOT ONZE WEERBAARHEID DOOR ANTON BOELEN Gep. Majoor b/h. O-I. Leger. Uitgegeven geheel ten voordeele der Fröbelsjchool te Batavia- priis f 1 - «IV In Indië bij eiken Boekhandelaar voorUandc»< en bü de üiteevere 432* VISSER & Co. Batavia.",http://resolver.kb.nl/resolve?urn=ddd:010290323:mpeg21:a0032:ocr,4,ddd:010290323:mpeg21:p004,De locomotief : Samarangsch handels- en advertentie-blad,1591
8942855,1881/12/25 00:00:00,4144,MMKB08:000163724:mpeg21:a0023,http://imageviewer.kb.nl/ImagingService/imagingService?id=MMKB08:000163724:mpeg21:p006:image&x=1128&y=17&w=2111&h=4144,MMKB08:000163724:mpeg21,3239,4161,1128,17,6,"Advertentie 27 C. J. Van Doorne 27 OHOOESTBAAT Steen- en Handelsdrukkerij. Bovengenoemde beveelt zich aan voor het drukken van Gesteendrukte Visitekaarten op tilacé en fijn Dristol Karton in een net bewerkt étui b. f 1.- per 100 stuks met bijvoeging van een net bewerkten Kamer-Wand-Almanak. Specialiteit in alle soorten van Handelsdrukwerk nette en spoedige aflevering» tegen eoncurreerende prijzen* WWBIWWI^— H—■—I lllllllll I II l llllll III I I l i II l l l li lll l l lill l l ll ll MMnBWMMBMMBMB J. L. KLAM ER CHOORSTRAAT 28 SCHOEN- en LAARZEN-MAGAZIJN. ONTVANGEN VOOR HET WINTERSEIZOEN: een nieuwe collectie Heeren-Bottines Dames- en Kindcr-Laarzen zeer eiegant met laken en leder natte sorteering Dames«Sckoentjes  met flanel gevoerd alsmede grooten voorraad prima qualiteit YJlt-Pantoffel» en Overschoenen in alle grootten. — Voorhanden: Gutta-Pcrcha Smeer nieuw middel tegen vocht en bevorderlijk voor de zachtheid van het leder. Reparatiën -worden zoo spoedig mogelijk bewerkt. ¥ M. H. Jyl J1L % S %J? JHl Jl JB® JSi %£ Ah Levensverzekering-Maatschappij te Parijs. maatschappelijk Kapitaal 6 millioen francs. Deze Maatschappij sluit tegen vaste Premiën alle soorten van Verzekeringen op het Leven gemengde tijdelijke en uitzet-verzekeringen dadelijk ingaande en uitgestelde Lijfrenten enz. Tan de winsten der maatschappij wordt TACHTIG PEBC£WT aan de verzekerden uitgekeerd. Speciale combinatie volgens welke de verzekerden boven en behalve hun aandeel (80 pet.) in de winsten jaarlijks drie percent interest ontvangen over het geheele bedrag der door hen betaalde premiën. Tarieven en inlichtingen zijn kosteloos verkrijgbaar bij de Heeren Agenten: B. J. R. VAN HASSELT te Delft; J. A. C. FLEISCHACKER E. V. JELTES en D. W. P. KEUSKAMP te Gravenhage; F. BLOK en Mr. M. W. C. MELCHER8 te Botterdam; alsmede te Arnhem Spijkerstraat 105 ten kantore van de Directie voor Nederland van n La Confiance"" SLINGERVOET RAMONDT. ZUID-HOLLANDSCHE BIEBBRQUWERU DB1T <3- levert op fusten van 12' 25 50 en 100 liter PUIK LAGERBIER. Agent J. T. POST Vrouw-Juttenland No. 20 Delft STOLT ... STOUT DE CEKROONDE VALK onderscheidt zich door aangenamen smaak wordt door tal van geneeskundigen aanbevolen wegens rijkdom aan extract d. i. voedende bestanddeelen tegenover gering gehalte van alcohol is met gewoon Hollandsch bier vermengd ook voor kinderen eeu uitnemend versterkende drank. Het dagelijks toenemend debiet levert het beste bewijs voor de uitnemende eigenschappen dezer biersoort. j B in concurrentie met Engelsche fabrikaten tegen veel lageren prijs Princesse- en Bruine Bieren van onderscheidene qualiteiten. Bordeaux-Azijn Kruiden-Azijn Dragon-Azijn en Wijn-Azijn in onderscheidene prijzen. VAN VOLLENHOVEN & C\ AMSTERDAM.",http://resolver.kb.nl/resolve?urn=MMKB08:000163724:mpeg21:a0023:ocr,6,MMKB08:000163724:mpeg21:p006,Delftsche courant,2111
3470535,1881/04/30 00:00:00,3495,ddd:010104007:mpeg21:a0043,http://imageviewer.kb.nl/ImagingService/imagingService?id=ddd:010104007:mpeg21:p008:image&x=3956&y=223&w=993&h=3495,ddd:010104007:mpeg21,4949,3718,3956,223,8,"DE TWEHTSCHE BANKVEREENIGING NEEMT GELDEN a DEPOSITO: (128' - Met één dag opzegging tegen eene rente van 2V* pCti tien dagen > «ant 2s/i * i ééne maand vast tegen de prolongatierente der Amsterdamsche Beurs met een minimum van 3 * i tweemaandcnopzeggingtegCLT.ee~arente\sn. 31/! ' i drie maanden op endossable deposilobewijsen tegen eene rente van 4 * ADOLPH BOISSEVAIN & CV AMERIKAANSCHE BANK- en COMMISSIEZAAK. Koopen en verkoopen WISSELS en geven CRÈDIETBRIEYEN af op alle Bankplaatsen in de Vereenigde Staten vas Nool'd-Amerika. (16031) UOOTHRIASCIM STAATSSCHULD.  De Heeren BECKER & FULD  berichten dat f 3» NIEUWE COUPONSBI.ADEN uit te gevon tegen de door hen afgestempelde TALONS op Bordereaux: \ Voor Zilverrente Januari—Juli tot en met N°. 937 voor Stukken a FL. 1000. / / * ir 566 "" "" * "" 50. Voor Zilverrente April—October tot en met N"". SB4 voor Stukken a FL. 1000. « * « s 13* i il "" "" SO. Voor Papierrente Februari— Augustas « tot en-mot N% «94 voor Stukken a fS- 1000. ;/ ii II II «_ ii "" ii ii 50. Voor Papierrente Mei—November tot en met N°. 651 voor Stukken a FL. 1000. « r 11 ii 80 ii ■' ii ii 50. van af hodon ton hunnen Kantore verkrijgbaar zijn. (17267) mm Eerste Serie* KERKHOVEN & C°. en GEBROEDERS BOSSEVAIN maken bekend dat de COUPON N°. 23 der Certificaten Vereenigde a Amerikaansche Fondsen le Serie op 2 Mei a.s. zal worden a betaald mot: . . «. f 25 voor de Certificaten van f 1009 „ 2.50 ~ ~ >» p „ 100 „ 125 ~ „ ?> » )> 50 v Amsterdam 30 April 18S1. (17259) JW. Grünhut &C% amsterdam. SPUISTRAAT 18 4 *» belasten zich met den IN- en VERKOOP van EFFECTEN B en geven VOORSCHOT op solide FONDSEN. (411) k Wm. HEAT lf *% C% ï Bankiers en Makelaars S IS» Uroadstreet H£W-TOBH v voeren uit ORDERS IN COMMISSIE op de Effecten- jj beurs te New-York. y Wm. HEATH & C%_ f Bankiers IO Angel Court „ l_OM__t_-_-S (Engeland)» o bovelen zich in h«t bijzonder aan voor ZAKEN in verband t met Amerikaansche Fondsen enz. (12901) d ""^ABBPTA. fi Het BESTUUR bericht dat in de plaats van wijlen Dr. ö * J. VINKE als BESTUURSLID is opgetreden Ds. J. C o VAN MARKEN zoodat het Bestuur van Sarepta thans ï» rj samengesteld als volgt: _ ______ si Dr. E. LAURILLARD Voorz. H. VAN OS  ' Ds. B. J. ADRIANS. Directeur. *< Ds. J(. C. VAN MARKEN. Tevens berichten wij in dank ontvangen te hebben onder r] Lett. F ƒ 10. ■ st Amsterdam  April 1881. (1718/) jj met PApiraËi S waarop deze Courant gedrukt is wordt gefabrl'r.; ceerd en geleverd door L. VAN GERREVDTK'SIi ZONEN te Berghuizen bij Hattem. (1«89) * . .  - ■ Vj",http://resolver.kb.nl/resolve?urn=ddd:010104007:mpeg21:a0043:ocr,8,ddd:010104007:mpeg21:p008,Algemeen Handelsblad,993
3564204,1881/06/16 00:00:00,3934,ddd:011085883:mpeg21:a0018,http://imageviewer.kb.nl/ImagingService/imagingService?id=ddd:011085883:mpeg21:p003:image&x=76&y=2745&w=906&h=3934,ddd:011085883:mpeg21,982,6679,76,2745,4,"I fcj\Ül-DËPAK'I filïlSlVr. OPGAVE DEK BEPAALDE VENDUTIEN. Vrijdag den 17 Juni 18S1 : Wegens verhuizing ten huize van Mevrouw Klomp Passar-Ketjil van meubilaire goederen en Door den pandhouder Tjoa Sien Ing te Kampong Baroe van onuitgeioste pandgoederen. Zaterdag den 18 Juni 1881 : Door den Heer Wijthoff in het lokaal van het Vendukantoor van perceelen en Door J. C. Leuring aan de Kaliemaas van paarden aoerabaia den 14 Juni j 881 De Secretaris en Boekhouder BURGERMEESTRE. VENDUTIE Yrijdag 17 Juni ten huize van Mevrouw MP PASAR KETJIL (Kampement). Van HM- compleeten INBOEDEL enz. enz. 2073 JAN LEURING. Heden worden cjelost -k. 75 prachtige Saudel- vft wood Paarden waaronder 50 stuks boven de 4 Allen van zessen klaar. Sedert lang werd er zulk eene magnifieke lading hier niet aangevoerd. Verkoopdag ZATERDAG 18 dezer Te bezitchigen op het terrein naast de .N. I. Industrie Kalimaas Oostzijde. 2136 JAN LEURING. VENDUTIE Maandag 20 Juni ten huize van den Heer GQS&ËfiföXGlï* KAL.IE AöaiiS. Van ZEd. keurigen zoo goed als nieuwen INBOEDEL: ""W'eener Rotting-Ameublement. idem idem Wipstoelen. Keurige Gravures. Nette met Rips bekleedde Dirans en Schutsels. Tafels \ Knapen ( met Marmeren bladen. Waschtafels ) Amerikaansche Stoelen. Mooie Notenhouten Speeltafels. Glazen Kleer-en Dispenskasten. Geheel nieuwe Rotting-Matten en Zeilen. Eene fraaie collectie Bloemen enz. enz. enz. ZOOMEDE: Een élégante stevige Handwagen. Een flink hardloopend Bendiepaard. Een Palanquin. Een élégante solide Mylord enz. enz. enz. 8154 JAN LEURING. VENDUTIE Dinsdag» 21 Juni» op het tenein naast de N. I. Industrie Van 100 beden gelost wordende SAMMWOODjfInS. PAARDEN pwhUgft DU»»' Commissie- V endutie Pinsdac- 21 Juni. ' p C VAN DER HART",http://resolver.kb.nl/resolve?urn=ddd:011085883:mpeg21:a0018:ocr,3,ddd:011085883:mpeg21:p003,Soerabaijasch handelsblad,906
